"","zone","census","allHH","socialHH","nonsocialHH","privateHH"
"1","E01012320",2001,657,6,651,11
"2","E01012334",2001,627,31,596,115
"3","E01012335",2001,608,51,557,22
"4","E01012366",2001,768,59,709,72
"5","E01012321",2001,651,79,572,46
"6","E01012322",2001,504,3,501,7
"7","E01012323",2001,649,15,634,49
"8","E01012324",2001,621,10,611,22
"9","E01012328",2001,755,259,496,20
"10","E01012329",2001,747,3,744,15
"11","E01012330",2001,460,3,457,11
"12","E01012331",2001,506,19,487,40
"13","E01012349",2001,758,215,543,213
"14","E01012350",2001,736,129,607,101
"15","E01012351",2001,561,48,513,25
"16","E01012352",2001,765,280,485,106
"17","E01012332",2001,633,309,324,18
"18","E01012333",2001,623,144,479,24
"19","E01012325",2001,616,78,538,27
"20","E01012326",2001,494,197,297,6
"21","E01012309",2001,655,22,633,18
"22","E01012310",2001,867,137,730,21
"23","E01012311",2001,605,256,349,17
"24","E01012312",2001,622,419,203,17
"25","E01012313",2001,631,229,402,49
"26","E01012314",2001,591,308,283,18
"27","E01012362",2001,648,9,639,180
"28","E01012363",2001,682,15,667,140
"29","E01012364",2001,730,10,720,127
"30","E01012365",2001,534,3,531,23
"31","E01012353",2001,758,25,733,197
"32","E01012354",2001,599,40,559,209
"33","E01012355",2001,592,64,528,161
"34","E01012308",2001,1034,324,710,330
"35","E01012307",2001,709,69,640,101
"36","E01012342",2001,669,291,378,22
"37","E01012343",2001,867,85,782,32
"38","E01012327",2001,604,421,183,21
"39","E01012315",2001,675,11,664,24
"40","E01012316",2001,888,87,801,95
"41","E01012360",2001,764,114,650,52
"42","E01012361",2001,783,7,776,12
"43","E01012336",2001,740,113,627,4
"44","E01012337",2001,728,7,721,16
"45","E01012347",2001,722,61,661,18
"46","E01012348",2001,899,9,890,22
"47","E01012340",2001,781,85,696,80
"48","E01012341",2001,762,426,336,46
"49","E01012304",2001,639,228,411,117
"50","E01012305",2001,500,53,447,90
"51","E01012306",2001,597,36,561,63
"52","E01012317",2001,619,27,592,34
"53","E01012318",2001,714,496,218,29
"54","E01012319",2001,892,213,679,44
"55","E01012356",2001,690,28,662,145
"56","E01012357",2001,589,26,563,104
"57","E01012358",2001,683,189,494,60
"58","E01012359",2001,654,542,112,21
"59","E01012338",2001,713,109,604,60
"60","E01012339",2001,717,0,717,29
"61","E01012344",2001,456,74,382,42
"62","E01012345",2001,494,0,494,20
"63","E01012346",2001,480,44,436,18
"64","E01011954",2001,855,320,535,43
"65","E01011969",2001,608,16,592,20
"66","E01011970",2001,495,4,491,46
"67","E01011971",2001,518,6,512,11
"68","E01011972",2001,485,183,302,4
"69","E01011952",2001,624,327,297,29
"70","E01011953",2001,777,503,274,32
"71","E01011991",2001,744,187,557,49
"72","E01011992",2001,669,314,355,58
"73","E01011993",2001,826,474,352,44
"74","E01011994",2001,615,415,200,35
"75","E01012006",2001,623,267,356,17
"76","E01011955",2001,619,251,368,63
"77","E01011956",2001,625,420,205,19
"78","E01011957",2001,603,122,481,89
"79","E01011958",2001,620,179,441,78
"80","E01012004",2001,613,138,475,19
"81","E01012005",2001,508,19,489,0
"82","E01011959",2001,646,47,599,41
"83","E01011982",2001,476,7,469,3
"84","E01012003",2001,605,3,602,8
"85","E01011973",2001,647,150,497,181
"86","E01011974",2001,630,204,426,283
"87","E01011975",2001,713,27,686,150
"88","E01011976",2001,613,89,524,150
"89","E01011983",2001,462,9,453,14
"90","E01011965",2001,623,3,620,13
"91","E01011966",2001,608,70,538,42
"92","E01012002",2001,601,57,544,43
"93","E01011964",2001,530,35,495,92
"94","E01011999",2001,770,172,598,182
"95","E01012000",2001,667,456,211,69
"96","E01011967",2001,530,9,521,31
"97","E01011951",2001,722,80,642,144
"98","E01011950",2001,764,43,721,185
"99","E01011986",2001,528,44,484,10
"100","E01011987",2001,627,28,599,53
"101","E01012001",2001,853,434,419,81
"102","E01011984",2001,600,8,592,4
"103","E01011980",2001,760,360,400,18
"104","E01011981",2001,628,311,317,21
"105","E01011949",2001,744,267,477,31
"106","E01011985",2001,468,4,464,36
"107","E01011988",2001,743,342,401,13
"108","E01011989",2001,760,383,377,24
"109","E01011990",2001,628,141,487,21
"110","E01011995",2001,608,12,596,33
"111","E01011996",2001,636,59,577,52
"112","E01011997",2001,594,29,565,14
"113","E01011998",2001,615,104,511,19
"114","E01011961",2001,624,205,419,29
"115","E01011962",2001,640,285,355,16
"116","E01011977",2001,750,422,328,33
"117","E01011978",2001,727,425,302,59
"118","E01011979",2001,606,296,310,33
"119","E01011960",2001,618,8,610,8
"120","E01011963",2001,649,23,626,7
"121","E01011968",2001,926,154,772,77
"122","E01012068",2001,645,142,503,242
"123","E01012069",2001,507,184,323,125
"124","E01012070",2001,771,600,171,59
"125","E01012092",2001,499,189,310,159
"126","E01012093",2001,616,67,549,231
"127","E01012094",2001,728,113,615,154
"128","E01012058",2001,771,78,693,176
"129","E01012059",2001,758,250,508,114
"130","E01012060",2001,703,408,295,31
"131","E01012061",2001,616,319,297,19
"132","E01012036",2001,643,56,587,198
"133","E01012037",2001,655,89,566,175
"134","E01012038",2001,617,38,579,186
"135","E01012039",2001,524,51,473,206
"136","E01012040",2001,603,45,558,200
"137","E01012041",2001,750,478,272,94
"138","E01012088",2001,530,284,246,17
"139","E01012074",2001,632,231,401,13
"140","E01012075",2001,607,323,284,20
"141","E01012076",2001,611,408,203,31
"142","E01012077",2001,643,294,349,17
"143","E01012078",2001,610,65,545,139
"144","E01012079",2001,489,36,453,17
"145","E01012080",2001,481,67,414,15
"146","E01012081",2001,621,46,575,107
"147","E01012026",2001,609,20,589,44
"148","E01012027",2001,643,387,256,22
"149","E01012028",2001,622,440,182,25
"150","E01012029",2001,495,185,310,33
"151","E01012015",2001,757,394,363,18
"152","E01012016",2001,907,445,462,82
"153","E01012017",2001,741,116,625,69
"154","E01012089",2001,614,379,235,28
"155","E01012090",2001,643,472,171,13
"156","E01012091",2001,635,391,244,27
"157","E01012011",2001,757,511,246,29
"158","E01012012",2001,641,16,625,36
"159","E01012013",2001,601,147,454,56
"160","E01012014",2001,661,214,447,93
"161","E01012053",2001,622,14,608,23
"162","E01012054",2001,602,25,577,28
"163","E01012055",2001,630,10,620,11
"164","E01012056",2001,628,55,573,50
"165","E01012057",2001,621,35,586,62
"166","E01012082",2001,632,269,363,19
"167","E01012083",2001,621,298,323,15
"168","E01012084",2001,699,409,290,27
"169","E01012085",2001,622,320,302,25
"170","E01012018",2001,476,120,356,35
"171","E01012019",2001,615,501,114,34
"172","E01012020",2001,608,274,334,17
"173","E01012021",2001,509,290,219,27
"174","E01012007",2001,636,22,614,19
"175","E01012008",2001,535,25,510,10
"176","E01012009",2001,608,4,604,18
"177","E01012010",2001,520,10,510,6
"178","E01012046",2001,779,17,762,46
"179","E01012047",2001,583,38,545,15
"180","E01012048",2001,729,15,714,22
"181","E01012049",2001,628,26,602,33
"182","E01012050",2001,626,276,350,31
"183","E01012051",2001,520,198,322,23
"184","E01012052",2001,532,75,457,13
"185","E01012022",2001,611,42,569,22
"186","E01012023",2001,667,8,659,20
"187","E01012024",2001,623,12,611,23
"188","E01012025",2001,521,8,513,7
"189","E01012071",2001,567,4,563,0
"190","E01012072",2001,602,30,572,14
"191","E01012073",2001,579,4,575,14
"192","E01012062",2001,622,12,610,12
"193","E01012063",2001,646,40,606,20
"194","E01012064",2001,654,42,612,31
"195","E01012065",2001,740,41,699,24
"196","E01012066",2001,627,10,617,15
"197","E01012067",2001,749,47,702,10
"198","E01012086",2001,577,275,302,22
"199","E01012087",2001,634,24,610,23
"200","E01012042",2001,730,364,366,17
"201","E01012043",2001,608,67,541,14
"202","E01012044",2001,635,477,158,14
"203","E01012045",2001,643,441,202,17
"204","E01012030",2001,599,83,516,18
"205","E01012031",2001,708,336,372,15
"206","E01012032",2001,465,22,443,24
"207","E01012033",2001,643,394,249,13
"208","E01012034",2001,541,183,358,18
"209","E01012035",2001,623,265,358,20
"210","E01012100",2001,767,102,665,278
"211","E01012101",2001,638,54,584,95
"212","E01012102",2001,959,41,918,181
"213","E01012184",2001,630,75,555,45
"214","E01012105",2001,577,91,486,32
"215","E01012142",2001,727,189,538,23
"216","E01012143",2001,620,456,164,8
"217","E01012144",2001,619,43,576,31
"218","E01012106",2001,611,61,550,14
"219","E01012107",2001,634,304,330,22
"220","E01012103",2001,556,73,483,18
"221","E01012104",2001,606,397,209,19
"222","E01012185",2001,626,116,510,28
"223","E01012186",2001,768,21,747,31
"224","E01012176",2001,652,6,646,21
"225","E01012177",2001,600,4,596,13
"226","E01012178",2001,600,26,574,15
"227","E01012179",2001,634,0,634,20
"228","E01012180",2001,472,5,467,7
"229","E01012127",2001,577,470,107,14
"230","E01012128",2001,650,439,211,19
"231","E01012129",2001,579,89,490,10
"232","E01012130",2001,593,33,560,19
"233","E01012131",2001,652,422,230,8
"234","E01012138",2001,503,12,491,24
"235","E01012139",2001,750,9,741,7
"236","E01012140",2001,616,57,559,50
"237","E01012141",2001,495,3,492,10
"238","E01012154",2001,592,5,587,8
"239","E01012155",2001,745,281,464,35
"240","E01012156",2001,741,13,728,26
"241","E01012157",2001,742,99,643,85
"242","E01012158",2001,641,29,612,12
"243","E01012159",2001,755,146,609,206
"244","E01012160",2001,605,134,471,27
"245","E01012161",2001,590,18,572,94
"246","E01012169",2001,650,254,396,132
"247","E01012170",2001,631,468,163,21
"248","E01012166",2001,627,236,391,65
"249","E01012167",2001,598,73,525,12
"250","E01012175",2001,607,381,226,14
"251","E01012113",2001,621,404,217,19
"252","E01012114",2001,617,475,142,30
"253","E01012115",2001,485,248,237,38
"254","E01012116",2001,497,299,198,37
"255","E01012097",2001,520,87,433,7
"256","E01012098",2001,528,53,475,25
"257","E01012099",2001,642,206,436,66
"258","E01012095",2001,487,3,484,13
"259","E01012108",2001,615,262,353,19
"260","E01012109",2001,558,75,483,57
"261","E01012110",2001,591,26,565,44
"262","E01012111",2001,649,316,333,26
"263","E01012171",2001,614,184,430,23
"264","E01012172",2001,628,62,566,14
"265","E01012162",2001,596,12,584,75
"266","E01012163",2001,610,9,601,17
"267","E01012164",2001,645,75,570,92
"268","E01012165",2001,780,444,336,47
"269","E01012133",2001,557,138,419,43
"270","E01012135",2001,494,361,133,12
"271","E01012136",2001,589,45,544,88
"272","E01012096",2001,645,110,535,90
"273","E01012146",2001,527,6,521,4
"274","E01012173",2001,512,29,483,14
"275","E01012174",2001,493,3,490,7
"276","E01012168",2001,711,298,413,13
"277","E01012149",2001,497,12,485,5
"278","E01012147",2001,619,24,595,6
"279","E01012145",2001,650,127,523,31
"280","E01012112",2001,790,575,215,24
"281","E01012132",2001,884,259,625,82
"282","E01012137",2001,527,82,445,20
"283","E01012134",2001,685,202,483,33
"284","E01012181",2001,597,125,472,58
"285","E01012148",2001,636,376,260,44
"286","E01012150",2001,740,346,394,49
"287","E01012151",2001,655,16,639,15
"288","E01012152",2001,660,14,646,13
"289","E01012153",2001,621,64,557,11
"290","E01012121",2001,623,341,282,12
"291","E01012117",2001,756,217,539,155
"292","E01012118",2001,651,27,624,79
"293","E01012119",2001,640,227,413,56
"294","E01012122",2001,613,0,613,24
"295","E01012123",2001,606,127,479,24
"296","E01012125",2001,626,4,622,6
"297","E01012126",2001,479,0,479,8
"298","E01012124",2001,612,0,612,22
"299","E01012120",2001,602,23,579,38
"300","E01012182",2001,597,4,593,14
"301","E01012183",2001,621,7,614,15
"302","E01012242",2001,627,18,609,11
"303","E01012243",2001,596,5,591,20
"304","E01012244",2001,620,8,612,8
"305","E01012246",2001,563,9,554,18
"306","E01012296",2001,605,99,506,16
"307","E01012297",2001,771,10,761,16
"308","E01012256",2001,637,33,604,32
"309","E01012257",2001,641,6,635,13
"310","E01012275",2001,628,216,412,13
"311","E01012276",2001,776,391,385,36
"312","E01012277",2001,710,182,528,17
"313","E01012197",2001,768,121,647,104
"314","E01012198",2001,604,302,302,51
"315","E01012245",2001,740,368,372,20
"316","E01012196",2001,673,175,498,31
"317","E01012214",2001,604,112,492,21
"318","E01012215",2001,475,216,259,16
"319","E01012216",2001,505,148,357,36
"320","E01012278",2001,497,131,366,31
"321","E01012279",2001,605,38,567,52
"322","E01012280",2001,623,113,510,45
"323","E01012281",2001,626,298,328,34
"324","E01012255",2001,650,6,644,4
"325","E01012269",2001,613,20,593,40
"326","E01012293",2001,868,15,853,32
"327","E01012294",2001,434,23,411,19
"328","E01012295",2001,426,96,330,19
"329","E01012210",2001,641,10,631,13
"330","E01012211",2001,637,9,628,13
"331","E01012212",2001,613,8,605,17
"332","E01012213",2001,737,108,629,9
"333","E01012192",2001,732,113,619,35
"334","E01012193",2001,596,160,436,50
"335","E01012260",2001,743,62,681,99
"336","E01012261",2001,636,11,625,56
"337","E01012247",2001,500,209,291,14
"338","E01012249",2001,646,278,368,24
"339","E01012271",2001,527,278,249,15
"340","E01012272",2001,501,6,495,12
"341","E01012273",2001,615,346,269,9
"342","E01012274",2001,509,223,286,13
"343","E01012250",2001,625,347,278,23
"344","E01012248",2001,591,217,374,21
"345","E01012220",2001,632,436,196,12
"346","E01012221",2001,606,403,203,22
"347","E01012222",2001,610,252,358,74
"348","E01012194",2001,623,65,558,108
"349","E01012195",2001,643,464,179,22
"350","E01012258",2001,512,203,309,29
"351","E01012259",2001,725,30,695,52
"352","E01012268",2001,723,243,480,106
"353","E01012205",2001,622,66,556,14
"354","E01012187",2001,532,0,532,26
"355","E01012188",2001,493,0,493,8
"356","E01012189",2001,632,0,632,18
"357","E01012219",2001,681,74,607,12
"358","E01012251",2001,621,110,511,95
"359","E01012252",2001,631,444,187,35
"360","E01012253",2001,486,146,340,11
"361","E01012254",2001,643,254,389,106
"362","E01012206",2001,729,233,496,17
"363","E01012207",2001,645,89,556,19
"364","E01012208",2001,647,4,643,9
"365","E01012204",2001,631,19,612,14
"366","E01012262",2001,626,207,419,131
"367","E01012263",2001,628,89,539,256
"368","E01012264",2001,621,164,457,49
"369","E01012265",2001,775,194,581,268
"370","E01012266",2001,1054,890,164,41
"371","E01012267",2001,780,393,387,111
"372","E01012224",2001,768,6,762,14
"373","E01012225",2001,639,5,634,18
"374","E01012226",2001,598,0,598,10
"375","E01012190",2001,614,6,608,10
"376","E01012191",2001,712,161,551,13
"377","E01012209",2001,637,102,535,8
"378","E01012223",2001,627,21,606,15
"379","E01012217",2001,736,226,510,128
"380","E01012218",2001,621,11,610,37
"381","E01012286",2001,626,258,368,121
"382","E01012287",2001,749,354,395,219
"383","E01012288",2001,605,168,437,110
"384","E01012289",2001,500,60,440,42
"385","E01012238",2001,635,339,296,27
"386","E01012239",2001,732,497,235,32
"387","E01012240",2001,619,186,433,6
"388","E01012241",2001,601,4,597,16
"389","E01012290",2001,776,81,695,9
"390","E01012291",2001,633,234,399,27
"391","E01012292",2001,750,335,415,21
"392","E01012282",2001,529,162,367,12
"393","E01012283",2001,524,279,245,17
"394","E01012284",2001,598,374,224,11
"395","E01012285",2001,621,177,444,13
"396","E01012270",2001,562,85,477,23
"397","E01012199",2001,617,12,605,23
"398","E01012200",2001,748,82,666,27
"399","E01012201",2001,622,0,622,16
"400","E01012202",2001,623,54,569,63
"401","E01012203",2001,613,26,587,12
"402","E01012228",2001,530,0,530,18
"403","E01012230",2001,575,5,570,39
"404","E01012233",2001,524,10,514,16
"405","E01012236",2001,545,3,542,26
"406","E01012237",2001,503,0,503,12
"407","E01012234",2001,568,0,568,11
"408","E01012231",2001,532,7,525,10
"409","E01012232",2001,548,11,537,18
"410","E01012229",2001,545,0,545,16
"411","E01012227",2001,570,21,549,39
"412","E01012235",2001,416,6,410,14
"413","E01012298",2001,533,4,529,8
"414","E01012299",2001,621,16,605,95
"415","E01012300",2001,726,272,454,28
"416","E01012301",2001,562,0,562,17
"417","E01012302",2001,503,3,500,19
"418","E01012303",2001,615,3,612,33
"419","E01020613",2001,527,33,494,4
"420","E01020614",2001,648,123,525,17
"421","E01020622",2001,669,38,631,19
"422","E01020623",2001,625,9,616,23
"423","E01020615",2001,737,350,387,14
"424","E01020616",2001,741,296,445,33
"425","E01020617",2001,767,75,692,30
"426","E01020606",2001,732,121,611,116
"427","E01020611",2001,523,3,520,15
"428","E01020612",2001,667,7,660,6
"429","E01020596",2001,745,331,414,20
"430","E01020597",2001,654,22,632,22
"431","E01020598",2001,656,82,574,19
"432","E01020599",2001,863,488,375,7
"433","E01020601",2001,631,122,509,17
"434","E01020602",2001,874,495,379,9
"435","E01020592",2001,606,437,169,9
"436","E01020593",2001,600,155,445,66
"437","E01020618",2001,638,311,327,14
"438","E01020605",2001,773,3,770,25
"439","E01020594",2001,748,20,728,85
"440","E01020595",2001,736,29,707,22
"441","E01020603",2001,653,3,650,8
"442","E01020600",2001,636,3,633,11
"443","E01020590",2001,553,6,547,41
"444","E01020591",2001,644,260,384,48
"445","E01020608",2001,656,220,436,21
"446","E01020609",2001,613,159,454,7
"447","E01020610",2001,607,63,544,14
"448","E01020607",2001,689,246,443,28
"449","E01020619",2001,659,82,577,26
"450","E01020620",2001,622,161,461,29
"451","E01020621",2001,759,362,397,14
"452","E01020604",2001,597,146,451,19
"453","E01020634",2001,613,30,583,17
"454","E01020635",2001,590,32,558,20
"455","E01020636",2001,767,270,497,17
"456","E01020654",2001,628,90,538,23
"457","E01020676",2001,666,78,588,39
"458","E01020655",2001,660,123,537,21
"459","E01020656",2001,650,209,441,18
"460","E01020657",2001,608,52,556,17
"461","E01020627",2001,645,43,602,33
"462","E01020628",2001,638,33,605,17
"463","E01020629",2001,614,187,427,5
"464","E01020661",2001,663,134,529,69
"465","E01020662",2001,674,230,444,23
"466","E01020663",2001,721,72,649,50
"467","E01020678",2001,575,116,459,11
"468","E01020674",2001,716,250,466,19
"469","E01020653",2001,643,216,427,32
"470","E01020677",2001,635,250,385,21
"471","E01020638",2001,638,131,507,32
"472","E01020639",2001,636,346,290,31
"473","E01020626",2001,722,311,411,28
"474","E01020647",2001,772,444,328,19
"475","E01020648",2001,625,320,305,18
"476","E01020649",2001,654,166,488,86
"477","E01020673",2001,730,310,420,25
"478","E01020675",2001,742,345,397,23
"479","E01020670",2001,731,174,557,51
"480","E01020671",2001,627,48,579,131
"481","E01020672",2001,646,96,550,82
"482","E01020624",2001,642,50,592,116
"483","E01020625",2001,607,90,517,46
"484","E01020632",2001,780,50,730,55
"485","E01020667",2001,746,134,612,53
"486","E01020640",2001,675,45,630,47
"487","E01020641",2001,660,90,570,51
"488","E01020642",2001,614,47,567,29
"489","E01020643",2001,765,192,573,56
"490","E01020650",2001,622,166,456,19
"491","E01020651",2001,716,155,561,15
"492","E01020652",2001,627,169,458,23
"493","E01020668",2001,626,172,454,32
"494","E01020669",2001,578,189,389,10
"495","E01020644",2001,767,387,380,24
"496","E01020645",2001,638,297,341,16
"497","E01020637",2001,641,47,594,40
"498","E01020630",2001,619,197,422,16
"499","E01020631",2001,741,327,414,18
"500","E01020633",2001,583,216,367,32
"501","E01020664",2001,608,4,604,53
"502","E01020665",2001,622,210,412,8
"503","E01020666",2001,623,35,588,5
"504","E01020646",2001,664,192,472,34
"505","E01020658",2001,778,287,491,41
"506","E01020659",2001,636,11,625,39
"507","E01020660",2001,679,149,530,32
"508","E01020709",2001,458,26,432,48
"509","E01020717",2001,753,9,744,11
"510","E01020718",2001,615,35,580,50
"511","E01020719",2001,524,7,517,26
"512","E01020721",2001,469,3,466,15
"513","E01020720",2001,657,207,450,31
"514","E01020708",2001,479,8,471,61
"515","E01020710",2001,622,95,527,31
"516","E01020711",2001,775,338,437,30
"517","E01020716",2001,666,435,231,12
"518","E01020714",2001,600,34,566,19
"519","E01020679",2001,721,306,415,28
"520","E01020680",2001,594,12,582,57
"521","E01020681",2001,654,257,397,12
"522","E01020725",2001,642,109,533,21
"523","E01020726",2001,504,51,453,29
"524","E01020727",2001,517,295,222,9
"525","E01020729",2001,833,315,518,39
"526","E01020730",2001,732,282,450,20
"527","E01020731",2001,623,115,508,16
"528","E01020682",2001,836,9,827,15
"529","E01020683",2001,614,3,611,37
"530","E01020690",2001,589,12,577,27
"531","E01020691",2001,589,161,428,43
"532","E01020692",2001,657,3,654,31
"533","E01020693",2001,506,140,366,50
"534","E01020722",2001,861,441,420,42
"535","E01020723",2001,695,199,496,164
"536","E01020724",2001,616,404,212,19
"537","E01020728",2001,667,63,604,176
"538","E01020703",2001,625,129,496,304
"539","E01020707",2001,746,189,557,241
"540","E01020702",2001,641,11,630,75
"541","E01020712",2001,588,10,578,94
"542","E01020713",2001,548,3,545,52
"543","E01020704",2001,515,3,512,134
"544","E01020684",2001,858,43,815,126
"545","E01020705",2001,773,403,370,17
"546","E01020706",2001,833,57,776,53
"547","E01020715",2001,860,209,651,54
"548","E01020685",2001,672,135,537,42
"549","E01020686",2001,728,470,258,10
"550","E01020687",2001,665,162,503,11
"551","E01020688",2001,625,212,413,16
"552","E01020689",2001,612,334,278,25
"553","E01020696",2001,572,148,424,54
"554","E01020697",2001,631,14,617,78
"555","E01020694",2001,649,323,326,10
"556","E01020732",2001,657,24,633,39
"557","E01020695",2001,622,206,416,11
"558","E01020698",2001,610,8,602,19
"559","E01020699",2001,510,271,239,14
"560","E01020700",2001,678,290,388,19
"561","E01020701",2001,586,111,475,40
"562","E01020750",2001,538,23,515,4
"563","E01020785",2001,640,148,492,23
"564","E01020786",2001,629,12,617,13
"565","E01020787",2001,792,295,497,22
"566","E01020781",2001,491,119,372,8
"567","E01020782",2001,493,85,408,10
"568","E01020783",2001,610,84,526,34
"569","E01020784",2001,645,266,379,47
"570","E01020740",2001,507,43,464,27
"571","E01020741",2001,500,24,476,121
"572","E01020742",2001,614,78,536,110
"573","E01020743",2001,500,322,178,30
"574","E01020747",2001,583,366,217,15
"575","E01020748",2001,482,216,266,11
"576","E01020749",2001,750,316,434,9
"577","E01020773",2001,633,298,335,14
"578","E01020775",2001,780,456,324,12
"579","E01020776",2001,759,153,606,16
"580","E01020774",2001,906,65,841,77
"581","E01020755",2001,1106,343,763,31
"582","E01020756",2001,520,6,514,12
"583","E01020751",2001,759,53,706,67
"584","E01020752",2001,644,140,504,143
"585","E01020754",2001,539,164,375,21
"586","E01020753",2001,741,372,369,14
"587","E01020765",2001,709,269,440,22
"588","E01020757",2001,504,221,283,16
"589","E01020758",2001,636,283,353,44
"590","E01020759",2001,520,297,223,21
"591","E01020745",2001,612,311,301,15
"592","E01020760",2001,632,151,481,13
"593","E01020761",2001,499,135,364,13
"594","E01020762",2001,666,331,335,26
"595","E01020763",2001,687,231,456,34
"596","E01020764",2001,752,207,545,93
"597","E01020766",2001,681,174,507,14
"598","E01020767",2001,826,297,529,84
"599","E01020768",2001,625,67,558,27
"600","E01020770",2001,502,140,362,14
"601","E01020771",2001,456,189,267,11
"602","E01020733",2001,493,160,333,18
"603","E01020734",2001,512,219,293,13
"604","E01020735",2001,631,140,491,14
"605","E01020780",2001,506,172,334,7
"606","E01020746",2001,493,95,398,6
"607","E01020777",2001,637,294,343,23
"608","E01020778",2001,516,31,485,9
"609","E01020779",2001,617,0,617,4
"610","E01020769",2001,482,130,352,15
"611","E01020744",2001,463,84,379,9
"612","E01020736",2001,504,239,265,11
"613","E01020737",2001,565,29,536,31
"614","E01020738",2001,504,40,464,20
"615","E01020739",2001,713,237,476,75
"616","E01020788",2001,611,159,452,29
"617","E01020789",2001,600,195,405,11
"618","E01020790",2001,629,297,332,15
"619","E01020791",2001,596,259,337,12
"620","E01020792",2001,537,164,373,28
"621","E01020793",2001,727,345,382,20
"622","E01020794",2001,620,85,535,31
"623","E01020795",2001,610,180,430,53
"624","E01020772",2001,728,111,617,34
"625","E01020817",2001,546,8,538,10
"626","E01020818",2001,636,158,478,26
"627","E01020819",2001,501,269,232,5
"628","E01020837",2001,755,27,728,19
"629","E01020843",2001,639,87,552,19
"630","E01020809",2001,634,365,269,11
"631","E01020810",2001,525,63,462,30
"632","E01020811",2001,514,183,331,24
"633","E01020812",2001,646,176,470,16
"634","E01020827",2001,796,198,598,41
"635","E01020806",2001,631,229,402,11
"636","E01020807",2001,780,207,573,112
"637","E01020820",2001,730,364,366,41
"638","E01020842",2001,875,410,465,31
"639","E01020808",2001,634,115,519,41
"640","E01020797",2001,1091,442,649,87
"641","E01020798",2001,766,478,288,5
"642","E01020799",2001,700,244,456,26
"643","E01020835",2001,711,35,676,55
"644","E01020836",2001,755,314,441,45
"645","E01020821",2001,621,99,522,18
"646","E01020822",2001,719,53,666,38
"647","E01020823",2001,815,406,409,24
"648","E01020803",2001,822,30,792,99
"649","E01020804",2001,469,62,407,78
"650","E01020805",2001,953,505,448,30
"651","E01020800",2001,734,160,574,42
"652","E01020796",2001,549,104,445,22
"653","E01020828",2001,636,11,625,39
"654","E01020829",2001,746,17,729,25
"655","E01020830",2001,740,213,527,25
"656","E01020838",2001,827,100,727,108
"657","E01020839",2001,771,291,480,26
"658","E01020840",2001,731,282,449,29
"659","E01020841",2001,853,520,333,41
"660","E01020801",2001,738,67,671,33
"661","E01020802",2001,778,220,558,69
"662","E01020848",2001,518,69,449,40
"663","E01020850",2001,501,34,467,10
"664","E01020851",2001,631,3,628,22
"665","E01020813",2001,490,4,486,6
"666","E01020814",2001,565,129,436,15
"667","E01020815",2001,506,81,425,15
"668","E01020816",2001,561,327,234,20
"669","E01020849",2001,508,289,219,18
"670","E01020847",2001,580,337,243,33
"671","E01020844",2001,606,377,229,18
"672","E01020831",2001,651,252,399,11
"673","E01020833",2001,521,110,411,28
"674","E01020834",2001,595,274,321,9
"675","E01020825",2001,723,271,452,12
"676","E01020826",2001,646,219,427,12
"677","E01020832",2001,622,159,463,16
"678","E01020824",2001,750,254,496,17
"679","E01020845",2001,633,282,351,10
"680","E01020846",2001,538,117,421,19
"681","E01020858",2001,474,96,378,23
"682","E01020859",2001,528,4,524,45
"683","E01020860",2001,484,179,305,34
"684","E01020861",2001,546,40,506,53
"685","E01020862",2001,987,99,888,142
"686","E01020856",2001,719,156,563,57
"687","E01020864",2001,844,72,772,109
"688","E01020867",2001,950,185,765,184
"689","E01020865",2001,580,29,551,103
"690","E01020866",2001,449,51,398,168
"691","E01020857",2001,593,72,521,79
"692","E01020863",2001,546,12,534,131
"693","E01020852",2001,786,213,573,94
"694","E01020853",2001,617,109,508,26
"695","E01020854",2001,869,103,766,125
"696","E01020855",2001,488,42,446,17
"697","E01020889",2001,657,24,633,82
"698","E01020890",2001,765,90,675,76
"699","E01020891",2001,718,127,591,70
"700","E01020905",2001,661,117,544,54
"701","E01020906",2001,652,42,610,68
"702","E01020898",2001,742,519,223,16
"703","E01020887",2001,640,113,527,35
"704","E01020892",2001,481,99,382,53
"705","E01020894",2001,444,168,276,40
"706","E01020878",2001,620,363,257,12
"707","E01020876",2001,695,189,506,25
"708","E01020877",2001,733,51,682,66
"709","E01020879",2001,643,45,598,23
"710","E01020893",2001,707,96,611,94
"711","E01020903",2001,474,43,431,42
"712","E01020904",2001,548,40,508,53
"713","E01020899",2001,627,110,517,31
"714","E01020900",2001,545,172,373,12
"715","E01020901",2001,646,263,383,42
"716","E01020902",2001,649,396,253,15
"717","E01020875",2001,535,86,449,37
"718","E01020873",2001,713,430,283,21
"719","E01020874",2001,608,125,483,73
"720","E01020868",2001,667,97,570,100
"721","E01020869",2001,567,20,547,77
"722","E01020880",2001,640,93,547,157
"723","E01020881",2001,564,42,522,19
"724","E01020886",2001,595,71,524,41
"725","E01020883",2001,695,8,687,14
"726","E01020870",2001,606,8,598,9
"727","E01020871",2001,641,0,641,49
"728","E01020872",2001,794,87,707,79
"729","E01020882",2001,593,63,530,52
"730","E01020895",2001,615,216,399,31
"731","E01020896",2001,631,96,535,24
"732","E01020897",2001,606,311,295,19
"733","E01020888",2001,648,69,579,44
"734","E01020907",2001,657,224,433,23
"735","E01020908",2001,644,289,355,17
"736","E01020909",2001,715,507,208,26
"737","E01020884",2001,595,98,497,21
"738","E01020885",2001,510,344,166,8
"739","E01027356",2001,771,73,698,168
"740","E01027357",2001,480,15,465,17
"741","E01027366",2001,711,77,634,157
"742","E01027367",2001,527,84,443,246
"743","E01027358",2001,977,309,668,97
"744","E01027359",2001,932,482,450,60
"745","E01027360",2001,1080,306,774,87
"746","E01027361",2001,950,139,811,125
"747","E01027362",2001,492,125,367,34
"748","E01027363",2001,506,303,203,15
"749","E01027364",2001,863,47,816,68
"750","E01027370",2001,718,69,649,35
"751","E01027371",2001,593,220,373,48
"752","E01027372",2001,898,85,813,94
"753","E01027373",2001,837,96,741,207
"754","E01027368",2001,650,144,506,135
"755","E01027369",2001,674,54,620,51
"756","E01027365",2001,877,71,806,160
"757","E01027376",2001,734,298,436,21
"758","E01027377",2001,765,122,643,206
"759","E01027385",2001,494,268,226,17
"760","E01027387",2001,822,257,565,75
"761","E01027388",2001,627,325,302,14
"762","E01027389",2001,656,167,489,61
"763","E01027386",2001,585,128,457,18
"764","E01027382",2001,706,108,598,117
"765","E01027378",2001,438,7,431,45
"766","E01027379",2001,598,22,576,20
"767","E01027380",2001,610,106,504,153
"768","E01027381",2001,854,105,749,274
"769","E01027383",2001,600,130,470,64
"770","E01027384",2001,638,44,594,81
"771","E01027374",2001,853,149,704,181
"772","E01027375",2001,782,40,742,298
"773","E01027390",2001,882,256,626,71
"774","E01027392",2001,771,483,288,16
"775","E01027393",2001,621,362,259,14
"776","E01027416",2001,766,475,291,64
"777","E01027424",2001,766,392,374,33
"778","E01027414",2001,629,23,606,106
"779","E01027415",2001,760,216,544,110
"780","E01027431",2001,868,237,631,125
"781","E01027441",2001,784,133,651,76
"782","E01027442",2001,750,174,576,80
"783","E01027422",2001,820,395,425,41
"784","E01027423",2001,623,274,349,9
"785","E01027429",2001,883,504,379,18
"786","E01027430",2001,718,347,371,15
"787","E01027391",2001,587,150,437,29
"788","E01027425",2001,662,31,631,22
"789","E01027426",2001,492,338,154,14
"790","E01027427",2001,760,261,499,67
"791","E01027428",2001,635,8,627,24
"792","E01027437",2001,747,9,738,9
"793","E01027438",2001,611,9,602,13
"794","E01027439",2001,513,3,510,10
"795","E01027440",2001,591,15,576,18
"796","E01027400",2001,484,3,481,3
"797","E01027401",2001,544,3,541,9
"798","E01027402",2001,500,7,493,6
"799","E01027403",2001,485,5,480,7
"800","E01027411",2001,629,260,369,21
"801","E01027412",2001,616,428,188,39
"802","E01027413",2001,823,216,607,37
"803","E01027398",2001,847,506,341,33
"804","E01027409",2001,747,111,636,39
"805","E01027399",2001,589,8,581,12
"806","E01027404",2001,620,18,602,19
"807","E01027405",2001,642,12,630,7
"808","E01027395",2001,633,266,367,45
"809","E01027396",2001,550,200,350,6
"810","E01027397",2001,636,359,277,5
"811","E01027417",2001,685,58,627,36
"812","E01027418",2001,711,136,575,31
"813","E01027419",2001,770,180,590,49
"814","E01027420",2001,597,99,498,9
"815","E01027421",2001,724,332,392,14
"816","E01027410",2001,550,4,546,12
"817","E01027394",2001,530,13,517,39
"818","E01027406",2001,614,5,609,11
"819","E01027407",2001,630,8,622,33
"820","E01027408",2001,645,156,489,37
"821","E01027432",2001,760,131,629,112
"822","E01027433",2001,628,272,356,36
"823","E01027434",2001,630,152,478,21
"824","E01027435",2001,649,238,411,12
"825","E01027436",2001,660,198,462,15
"826","E01027443",2001,497,334,163,6
"827","E01027444",2001,502,67,435,54
"828","E01027445",2001,619,55,564,45
"829","E01027446",2001,579,3,576,16
"830","E01027451",2001,813,253,560,69
"831","E01027474",2001,628,258,370,19
"832","E01027475",2001,591,18,573,26
"833","E01027457",2001,500,13,487,27
"834","E01027462",2001,872,374,498,111
"835","E01027463",2001,642,40,602,34
"836","E01027447",2001,666,55,611,257
"837","E01027448",2001,679,23,656,70
"838","E01027450",2001,593,42,551,65
"839","E01027473",2001,707,41,666,157
"840","E01027461",2001,622,251,371,14
"841","E01027459",2001,512,153,359,7
"842","E01027452",2001,623,63,560,21
"843","E01027453",2001,791,166,625,57
"844","E01027454",2001,503,142,361,17
"845","E01027455",2001,629,16,613,9
"846","E01027456",2001,503,3,500,3
"847","E01027460",2001,724,37,687,21
"848","E01027458",2001,624,3,621,8
"849","E01027470",2001,425,3,422,19
"850","E01027464",2001,613,42,571,21
"851","E01027465",2001,619,23,596,50
"852","E01027466",2001,528,156,372,16
"853","E01027467",2001,506,4,502,28
"854","E01027468",2001,530,3,527,4
"855","E01027469",2001,530,3,527,10
"856","E01027449",2001,671,55,616,40
"857","E01027471",2001,619,0,619,24
"858","E01027472",2001,567,66,501,186
"859","E01027479",2001,937,151,786,192
"860","E01027480",2001,510,34,476,136
"861","E01027503",2001,699,85,614,136
"862","E01027511",2001,464,50,414,144
"863","E01027512",2001,477,38,439,143
"864","E01027484",2001,886,56,830,113
"865","E01027485",2001,633,234,399,45
"866","E01027486",2001,510,58,452,61
"867","E01027487",2001,516,84,432,43
"868","E01027483",2001,524,56,468,106
"869","E01027496",2001,516,106,410,23
"870","E01027513",2001,844,62,782,39
"871","E01027508",2001,468,38,430,28
"872","E01027489",2001,642,133,509,18
"873","E01027490",2001,779,209,570,76
"874","E01027491",2001,627,6,621,30
"875","E01027492",2001,725,19,706,55
"876","E01027493",2001,656,372,284,38
"877","E01027494",2001,898,26,872,75
"878","E01027476",2001,1066,252,814,145
"879","E01027497",2001,875,192,683,18
"880","E01027498",2001,958,497,461,34
"881","E01027499",2001,631,76,555,8
"882","E01027500",2001,759,229,530,49
"883","E01027501",2001,479,57,422,19
"884","E01027502",2001,479,16,463,21
"885","E01027504",2001,763,24,739,108
"886","E01027481",2001,737,134,603,123
"887","E01027482",2001,635,97,538,27
"888","E01027509",2001,610,55,555,28
"889","E01027506",2001,436,36,400,123
"890","E01027507",2001,517,13,504,29
"891","E01027510",2001,494,60,434,87
"892","E01027477",2001,521,8,513,115
"893","E01027478",2001,506,62,444,62
"894","E01027505",2001,541,28,513,90
"895","E01027495",2001,443,45,398,93
"896","E01027488",2001,830,148,682,153
"897","E01027541",2001,784,101,683,80
"898","E01027542",2001,762,387,375,68
"899","E01027543",2001,524,290,234,21
"900","E01027544",2001,641,91,550,44
"901","E01027545",2001,910,223,687,121
"902","E01027546",2001,831,129,702,127
"903","E01027528",2001,612,65,547,106
"904","E01027529",2001,488,16,472,36
"905","E01027539",2001,769,75,694,130
"906","E01027540",2001,665,366,299,77
"907","E01027533",2001,851,598,253,32
"908","E01027547",2001,598,350,248,19
"909","E01027548",2001,502,76,426,30
"910","E01027549",2001,454,7,447,4
"911","E01027524",2001,600,76,524,48
"912","E01027525",2001,728,277,451,62
"913","E01027526",2001,506,4,502,4
"914","E01027527",2001,612,368,244,17
"915","E01027536",2001,625,154,471,13
"916","E01027537",2001,636,168,468,29
"917","E01027538",2001,607,17,590,5
"918","E01027532",2001,855,32,823,73
"919","E01027553",2001,675,150,525,37
"920","E01027554",2001,629,46,583,17
"921","E01027534",2001,901,365,536,53
"922","E01027535",2001,654,6,648,14
"923","E01027530",2001,629,306,323,15
"924","E01027531",2001,609,140,469,40
"925","E01027515",2001,653,131,522,73
"926","E01027550",2001,609,183,426,45
"927","E01027551",2001,623,311,312,39
"928","E01027552",2001,577,137,440,71
"929","E01027517",2001,744,83,661,87
"930","E01027518",2001,625,377,248,9
"931","E01027519",2001,625,267,358,58
"932","E01027520",2001,570,16,554,10
"933","E01027521",2001,516,9,507,12
"934","E01027522",2001,606,304,302,22
"935","E01027523",2001,517,150,367,37
"936","E01027514",2001,639,119,520,13
"937","E01027516",2001,504,121,383,10
"938","E01008246",2001,632,261,371,12
"939","E01008247",2001,755,361,394,16
"940","E01008248",2001,605,28,577,22
"941","E01008249",2001,729,70,659,13
"942","E01008250",2001,603,188,415,15
"943","E01008197",2001,692,15,677,36
"944","E01008198",2001,591,247,344,14
"945","E01008199",2001,638,26,612,52
"946","E01008200",2001,531,4,527,21
"947","E01008195",2001,759,198,561,26
"948","E01008245",2001,636,86,550,20
"949","E01008243",2001,748,109,639,70
"950","E01008244",2001,827,251,576,124
"951","E01008214",2001,606,524,82,9
"952","E01008215",2001,762,520,242,44
"953","E01008178",2001,620,308,312,29
"954","E01008180",2001,641,511,130,4
"955","E01008182",2001,705,448,257,28
"956","E01008277",2001,645,233,412,10
"957","E01008280",2001,729,331,398,52
"958","E01008276",2001,724,215,509,41
"959","E01008279",2001,633,14,619,14
"960","E01008181",2001,625,158,467,11
"961","E01008179",2001,525,113,412,12
"962","E01008177",2001,616,90,526,41
"963","E01008203",2001,814,215,599,221
"964","E01008205",2001,652,50,602,40
"965","E01008166",2001,924,825,99,29
"966","E01008162",2001,756,368,388,63
"967","E01008163",2001,626,221,405,126
"968","E01008164",2001,773,210,563,256
"969","E01008168",2001,676,497,179,40
"970","E01008209",2001,723,269,454,59
"971","E01008210",2001,782,438,344,63
"972","E01008258",2001,755,594,161,35
"973","E01008259",2001,841,602,239,16
"974","E01008257",2001,698,390,308,95
"975","E01008169",2001,406,44,362,110
"976","E01008170",2001,778,418,360,134
"977","E01008171",2001,509,40,469,231
"978","E01008167",2001,629,185,444,140
"979","E01008262",2001,625,180,445,124
"980","E01008263",2001,644,346,298,17
"981","E01008264",2001,604,12,592,8
"982","E01008265",2001,615,187,428,12
"983","E01008266",2001,628,104,524,20
"984","E01008251",2001,830,70,760,264
"985","E01008252",2001,673,140,533,183
"986","E01008253",2001,790,60,730,346
"987","E01008254",2001,822,124,698,325
"988","E01008255",2001,703,256,447,30
"989","E01008204",2001,717,461,256,43
"990","E01008201",2001,610,429,181,15
"991","E01008202",2001,737,268,469,29
"992","E01008165",2001,583,350,233,26
"993","E01008212",2001,769,494,275,43
"994","E01008213",2001,616,246,370,3
"995","E01008228",2001,538,278,260,30
"996","E01008216",2001,716,447,269,22
"997","E01008211",2001,722,143,579,55
"998","E01008206",2001,727,143,584,20
"999","E01008207",2001,579,51,528,7
"1000","E01008208",2001,695,280,415,38
"1001","E01008286",2001,672,251,421,15
"1002","E01008287",2001,571,123,448,8
"1003","E01008283",2001,601,16,585,14
"1004","E01008284",2001,572,138,434,8
"1005","E01008281",2001,656,331,325,13
"1006","E01008282",2001,667,386,281,13
"1007","E01008231",2001,678,414,264,6
"1008","E01008240",2001,645,276,369,7
"1009","E01008241",2001,712,284,428,9
"1010","E01008242",2001,675,401,274,10
"1011","E01008235",2001,625,38,587,14
"1012","E01008236",2001,760,160,600,71
"1013","E01008237",2001,594,14,580,6
"1014","E01008238",2001,655,18,637,65
"1015","E01008219",2001,614,254,360,19
"1016","E01008275",2001,631,12,619,6
"1017","E01008267",2001,624,152,472,16
"1018","E01008269",2001,633,10,623,11
"1019","E01008270",2001,611,12,599,9
"1020","E01008271",2001,598,4,594,16
"1021","E01008285",2001,651,411,240,11
"1022","E01008232",2001,577,336,241,4
"1023","E01008233",2001,590,43,547,12
"1024","E01008229",2001,632,181,451,12
"1025","E01008230",2001,532,220,312,32
"1026","E01008256",2001,763,121,642,29
"1027","E01008272",2001,629,44,585,25
"1028","E01008273",2001,614,78,536,28
"1029","E01008274",2001,624,230,394,17
"1030","E01008268",2001,617,116,501,21
"1031","E01008260",2001,595,28,567,6
"1032","E01008261",2001,646,338,308,15
"1033","E01008239",2001,595,47,548,30
"1034","E01008234",2001,970,59,911,59
"1035","E01008193",2001,490,45,445,3
"1036","E01008194",2001,606,43,563,12
"1037","E01008218",2001,790,552,238,15
"1038","E01008225",2001,756,219,537,18
"1039","E01008220",2001,681,523,158,20
"1040","E01008221",2001,736,434,302,15
"1041","E01008227",2001,637,515,122,13
"1042","E01008278",2001,590,23,567,4
"1043","E01008188",2001,582,131,451,7
"1044","E01008184",2001,606,55,551,8
"1045","E01008185",2001,583,346,237,9
"1046","E01008189",2001,647,425,222,14
"1047","E01008190",2001,559,60,499,14
"1048","E01008191",2001,762,524,238,19
"1049","E01008192",2001,655,357,298,8
"1050","E01008217",2001,712,319,393,30
"1051","E01008183",2001,608,187,421,31
"1052","E01008186",2001,893,89,804,160
"1053","E01008187",2001,802,334,468,35
"1054","E01008196",2001,796,140,656,33
"1055","E01008222",2001,641,320,321,13
"1056","E01008223",2001,770,517,253,27
"1057","E01008224",2001,683,216,467,14
"1058","E01008226",2001,659,258,401,25
"1059","E01008172",2001,775,214,561,11
"1060","E01008173",2001,603,342,261,9
"1061","E01008174",2001,755,342,413,23
"1062","E01008175",2001,615,38,577,87
"1063","E01008176",2001,620,64,556,16
"1064","E01008294",2001,620,9,611,27
"1065","E01008306",2001,721,182,539,31
"1066","E01008307",2001,473,216,257,31
"1067","E01008308",2001,460,154,306,50
"1068","E01008311",2001,617,8,609,20
"1069","E01008312",2001,507,26,481,16
"1070","E01008313",2001,482,44,438,16
"1071","E01008309",2001,734,9,725,21
"1072","E01008310",2001,716,10,706,26
"1073","E01008352",2001,581,129,452,36
"1074","E01008357",2001,578,13,565,22
"1075","E01008358",2001,764,24,740,483
"1076","E01008336",2001,670,336,334,29
"1077","E01008337",2001,640,378,262,12
"1078","E01008338",2001,500,128,372,52
"1079","E01008339",2001,639,340,299,28
"1080","E01008340",2001,636,459,177,16
"1081","E01008341",2001,642,258,384,26
"1082","E01008342",2001,706,59,647,52
"1083","E01008293",2001,643,55,588,57
"1084","E01008456",2001,659,362,297,13
"1085","E01008457",2001,752,440,312,29
"1086","E01008458",2001,651,21,630,43
"1087","E01008459",2001,739,553,186,23
"1088","E01008460",2001,590,291,299,13
"1089","E01008418",2001,664,26,638,43
"1090","E01008420",2001,518,29,489,38
"1091","E01008422",2001,641,45,596,73
"1092","E01008424",2001,733,96,637,207
"1093","E01008351",2001,626,85,541,26
"1094","E01008354",2001,741,250,491,75
"1095","E01008355",2001,684,52,632,79
"1096","E01008356",2001,552,162,390,29
"1097","E01008353",2001,707,260,447,25
"1098","E01008378",2001,520,30,490,8
"1099","E01008423",2001,513,20,493,46
"1100","E01008421",2001,639,22,617,94
"1101","E01008419",2001,585,23,562,99
"1102","E01008317",2001,601,48,553,29
"1103","E01008319",2001,583,4,579,17
"1104","E01008320",2001,624,79,545,35
"1105","E01008321",2001,720,67,653,75
"1106","E01008322",2001,589,18,571,13
"1107","E01008323",2001,616,55,561,116
"1108","E01008295",2001,605,387,218,9
"1109","E01008374",2001,626,112,514,20
"1110","E01008375",2001,713,348,365,22
"1111","E01008376",2001,474,14,460,12
"1112","E01008377",2001,591,321,270,64
"1113","E01008379",2001,714,328,386,30
"1114","E01008380",2001,697,480,217,99
"1115","E01008442",2001,624,8,616,17
"1116","E01008444",2001,625,38,587,18
"1117","E01008447",2001,615,28,587,15
"1118","E01008448",2001,628,8,620,13
"1119","E01008445",2001,799,122,677,40
"1120","E01008446",2001,653,10,643,9
"1121","E01008441",2001,763,364,399,19
"1122","E01008296",2001,706,263,443,24
"1123","E01008297",2001,773,488,285,43
"1124","E01008298",2001,532,122,410,45
"1125","E01008299",2001,525,277,248,15
"1126","E01008314",2001,478,51,427,35
"1127","E01008315",2001,627,129,498,40
"1128","E01008316",2001,645,8,637,40
"1129","E01008363",2001,795,21,774,128
"1130","E01008365",2001,553,6,547,49
"1131","E01008318",2001,619,340,279,30
"1132","E01008366",2001,580,16,564,234
"1133","E01008369",2001,604,43,561,216
"1134","E01008371",2001,579,19,560,30
"1135","E01008372",2001,664,93,571,285
"1136","E01008373",2001,644,17,627,355
"1137","E01008400",2001,759,485,274,33
"1138","E01008401",2001,592,298,294,6
"1139","E01008402",2001,643,158,485,57
"1140","E01008403",2001,635,35,600,23
"1141","E01008404",2001,659,232,427,58
"1142","E01008405",2001,622,297,325,22
"1143","E01008443",2001,604,6,598,11
"1144","E01008324",2001,546,249,297,13
"1145","E01008325",2001,665,383,282,14
"1146","E01008326",2001,581,23,558,22
"1147","E01008327",2001,644,434,210,27
"1148","E01008328",2001,571,14,557,12
"1149","E01008329",2001,619,163,456,17
"1150","E01008330",2001,647,319,328,29
"1151","E01008300",2001,601,276,325,16
"1152","E01008450",2001,535,337,198,17
"1153","E01008451",2001,819,147,672,184
"1154","E01008452",2001,492,36,456,30
"1155","E01008409",2001,671,67,604,196
"1156","E01008411",2001,648,86,562,280
"1157","E01008370",2001,685,108,577,205
"1158","E01008367",2001,635,51,584,233
"1159","E01008368",2001,514,28,486,206
"1160","E01008359",2001,551,128,423,219
"1161","E01008360",2001,678,46,632,271
"1162","E01008361",2001,644,151,493,274
"1163","E01008362",2001,674,219,455,235
"1164","E01008364",2001,675,38,637,266
"1165","E01008303",2001,899,696,203,33
"1166","E01008343",2001,600,78,522,27
"1167","E01008344",2001,670,164,506,61
"1168","E01008345",2001,815,472,343,22
"1169","E01008346",2001,461,152,309,46
"1170","E01008347",2001,555,61,494,38
"1171","E01008348",2001,415,253,162,15
"1172","E01008349",2001,476,27,449,85
"1173","E01008350",2001,609,300,309,13
"1174","E01008430",2001,613,176,437,57
"1175","E01008431",2001,633,58,575,70
"1176","E01008433",2001,622,83,539,19
"1177","E01008434",2001,606,55,551,19
"1178","E01008435",2001,616,313,303,27
"1179","E01008436",2001,667,466,201,23
"1180","E01008381",2001,622,23,599,30
"1181","E01008382",2001,496,354,142,11
"1182","E01008383",2001,646,351,295,25
"1183","E01008384",2001,593,129,464,23
"1184","E01008385",2001,643,145,498,105
"1185","E01008386",2001,574,116,458,21
"1186","E01008387",2001,624,39,585,54
"1187","E01008393",2001,405,166,239,83
"1188","E01008396",2001,636,308,328,223
"1189","E01008398",2001,790,546,244,127
"1190","E01008453",2001,600,21,579,75
"1191","E01008454",2001,459,76,383,237
"1192","E01008455",2001,453,35,418,126
"1193","E01008449",2001,525,114,411,244
"1194","E01008410",2001,685,254,431,174
"1195","E01008412",2001,635,59,576,212
"1196","E01008413",2001,589,226,363,193
"1197","E01008406",2001,703,491,212,94
"1198","E01008407",2001,662,319,343,185
"1199","E01008408",2001,850,536,314,151
"1200","E01008399",2001,755,626,129,31
"1201","E01008397",2001,477,193,284,145
"1202","E01008394",2001,433,70,363,263
"1203","E01008395",2001,731,471,260,124
"1204","E01008439",2001,741,542,199,52
"1205","E01008440",2001,973,412,561,289
"1206","E01008414",2001,747,459,288,95
"1207","E01008415",2001,639,317,322,56
"1208","E01008416",2001,711,44,667,36
"1209","E01008417",2001,665,418,247,58
"1210","E01008391",2001,609,472,137,13
"1211","E01008392",2001,752,235,517,150
"1212","E01008304",2001,933,756,177,44
"1213","E01008305",2001,759,582,177,30
"1214","E01008301",2001,840,193,647,160
"1215","E01008302",2001,740,413,327,64
"1216","E01008432",2001,640,178,462,54
"1217","E01008288",2001,654,164,490,74
"1218","E01008289",2001,589,383,206,18
"1219","E01008290",2001,607,171,436,128
"1220","E01008291",2001,787,487,300,160
"1221","E01008292",2001,555,13,542,18
"1222","E01008388",2001,782,609,173,34
"1223","E01008389",2001,743,589,154,20
"1224","E01008426",2001,637,511,126,16
"1225","E01008429",2001,618,428,190,15
"1226","E01008437",2001,870,692,178,81
"1227","E01008438",2001,895,653,242,112
"1228","E01008331",2001,568,292,276,147
"1229","E01008332",2001,803,425,378,198
"1230","E01008333",2001,477,114,363,97
"1231","E01008334",2001,780,195,585,189
"1232","E01008335",2001,646,87,559,177
"1233","E01008390",2001,738,568,170,49
"1234","E01008427",2001,755,608,147,22
"1235","E01008428",2001,586,284,302,38
"1236","E01008425",2001,928,742,186,31
"1237","E01008551",2001,626,9,617,12
"1238","E01008547",2001,634,35,599,14
"1239","E01008548",2001,521,5,516,0
"1240","E01008549",2001,665,10,655,19
"1241","E01008504",2001,649,8,641,4
"1242","E01008478",2001,766,431,335,39
"1243","E01008480",2001,676,311,365,30
"1244","E01008578",2001,600,181,419,32
"1245","E01008583",2001,601,198,403,29
"1246","E01008546",2001,600,0,600,8
"1247","E01008520",2001,574,55,519,24
"1248","E01008523",2001,478,3,475,17
"1249","E01008550",2001,603,13,590,36
"1250","E01008577",2001,654,183,471,37
"1251","E01008579",2001,736,11,725,15
"1252","E01008580",2001,599,14,585,55
"1253","E01008581",2001,678,28,650,12
"1254","E01008582",2001,614,217,397,22
"1255","E01008521",2001,672,16,656,34
"1256","E01008522",2001,657,6,651,29
"1257","E01008517",2001,599,9,590,17
"1258","E01008519",2001,651,137,514,51
"1259","E01008584",2001,602,55,547,131
"1260","E01008585",2001,627,65,562,63
"1261","E01008587",2001,625,72,553,94
"1262","E01008588",2001,592,46,546,89
"1263","E01008589",2001,555,9,546,12
"1264","E01008564",2001,646,7,639,42
"1265","E01008565",2001,651,323,328,26
"1266","E01008518",2001,765,112,653,22
"1267","E01008567",2001,583,235,348,35
"1268","E01008479",2001,651,39,612,32
"1269","E01008475",2001,662,18,644,19
"1270","E01008476",2001,770,370,400,38
"1271","E01008477",2001,648,388,260,22
"1272","E01008552",2001,690,74,616,39
"1273","E01008553",2001,709,32,677,91
"1274","E01008554",2001,664,218,446,30
"1275","E01008555",2001,667,293,374,15
"1276","E01008586",2001,665,59,606,71
"1277","E01008495",2001,739,13,726,10
"1278","E01008496",2001,738,186,552,86
"1279","E01008497",2001,656,5,651,22
"1280","E01008498",2001,716,16,700,4
"1281","E01008568",2001,680,232,448,17
"1282","E01008569",2001,614,346,268,17
"1283","E01008570",2001,584,62,522,39
"1284","E01008566",2001,589,304,285,26
"1285","E01008505",2001,665,162,503,27
"1286","E01008506",2001,598,295,303,7
"1287","E01008507",2001,567,51,516,4
"1288","E01008500",2001,686,119,567,21
"1289","E01008556",2001,627,25,602,30
"1290","E01008557",2001,620,0,620,10
"1291","E01008493",2001,645,95,550,14
"1292","E01008494",2001,732,224,508,15
"1293","E01008499",2001,670,236,434,14
"1294","E01008470",2001,627,205,422,36
"1295","E01008502",2001,672,259,413,21
"1296","E01008516",2001,626,52,574,13
"1297","E01008488",2001,628,259,369,26
"1298","E01008489",2001,735,452,283,20
"1299","E01008490",2001,711,135,576,40
"1300","E01008491",2001,613,293,320,17
"1301","E01008558",2001,798,49,749,117
"1302","E01008560",2001,784,78,706,149
"1303","E01008561",2001,717,331,386,96
"1304","E01008562",2001,619,86,533,36
"1305","E01008563",2001,600,3,597,18
"1306","E01008559",2001,659,45,614,138
"1307","E01008525",2001,707,45,662,84
"1308","E01008527",2001,730,21,709,108
"1309","E01008503",2001,698,290,408,59
"1310","E01008501",2001,538,59,479,10
"1311","E01008469",2001,734,123,611,61
"1312","E01008472",2001,672,94,578,21
"1313","E01008473",2001,529,56,473,20
"1314","E01008474",2001,581,300,281,16
"1315","E01008471",2001,622,215,407,8
"1316","E01008513",2001,771,507,264,17
"1317","E01008514",2001,620,273,347,15
"1318","E01008515",2001,914,708,206,21
"1319","E01008526",2001,627,12,615,21
"1320","E01008530",2001,768,117,651,53
"1321","E01008486",2001,669,216,453,52
"1322","E01008487",2001,676,254,422,9
"1323","E01008466",2001,559,3,556,15
"1324","E01008467",2001,615,83,532,11
"1325","E01008468",2001,633,271,362,19
"1326","E01008461",2001,625,251,374,16
"1327","E01008483",2001,649,17,632,160
"1328","E01008528",2001,610,13,597,89
"1329","E01008529",2001,721,34,687,61
"1330","E01008524",2001,923,322,601,190
"1331","E01008484",2001,613,233,380,123
"1332","E01008485",2001,564,413,151,24
"1333","E01008481",2001,607,260,347,33
"1334","E01008482",2001,706,206,500,128
"1335","E01008492",2001,727,325,402,60
"1336","E01008462",2001,621,357,264,23
"1337","E01008463",2001,621,299,322,17
"1338","E01008464",2001,655,105,550,31
"1339","E01008465",2001,647,114,533,17
"1340","E01008531",2001,619,14,605,22
"1341","E01008532",2001,662,237,425,28
"1342","E01008534",2001,610,50,560,19
"1343","E01008538",2001,519,13,506,49
"1344","E01008512",2001,750,477,273,21
"1345","E01008508",2001,624,296,328,8
"1346","E01008509",2001,746,425,321,32
"1347","E01008510",2001,740,167,573,82
"1348","E01008539",2001,612,77,535,41
"1349","E01008540",2001,614,352,262,72
"1350","E01008541",2001,687,278,409,56
"1351","E01008544",2001,842,369,473,187
"1352","E01008545",2001,546,388,158,29
"1353","E01008542",2001,662,449,213,36
"1354","E01008543",2001,633,260,373,82
"1355","E01008571",2001,736,340,396,67
"1356","E01008511",2001,735,248,487,131
"1357","E01008572",2001,778,124,654,207
"1358","E01008573",2001,739,133,606,208
"1359","E01008574",2001,629,132,497,15
"1360","E01008576",2001,612,305,307,45
"1361","E01008575",2001,655,264,391,52
"1362","E01008535",2001,584,107,477,23
"1363","E01008536",2001,734,109,625,143
"1364","E01008537",2001,661,207,454,53
"1365","E01008533",2001,602,352,250,14
"1366","E01008595",2001,692,122,570,110
"1367","E01008596",2001,548,323,225,67
"1368","E01008597",2001,557,45,512,72
"1369","E01008598",2001,665,16,649,115
"1370","E01008599",2001,744,319,425,43
"1371","E01008664",2001,671,196,475,159
"1372","E01008665",2001,728,283,445,93
"1373","E01008666",2001,772,567,205,53
"1374","E01008667",2001,829,461,368,43
"1375","E01008668",2001,778,332,446,110
"1376","E01008673",2001,519,20,499,37
"1377","E01008675",2001,782,69,713,150
"1378","E01008676",2001,524,67,457,68
"1379","E01008677",2001,584,41,543,33
"1380","E01008678",2001,628,58,570,126
"1381","E01008647",2001,632,46,586,8
"1382","E01008648",2001,648,154,494,13
"1383","E01008649",2001,674,355,319,10
"1384","E01008651",2001,860,641,219,20
"1385","E01008682",2001,494,277,217,13
"1386","E01008683",2001,717,85,632,132
"1387","E01008679",2001,619,76,543,57
"1388","E01008680",2001,619,75,544,7
"1389","E01008681",2001,648,12,636,15
"1390","E01008674",2001,523,9,514,7
"1391","E01008650",2001,612,69,543,6
"1392","E01008635",2001,652,160,492,23
"1393","E01008600",2001,624,287,337,88
"1394","E01008604",2001,632,480,152,18
"1395","E01008660",2001,644,105,539,35
"1396","E01008661",2001,519,247,272,7
"1397","E01008633",2001,613,302,311,6
"1398","E01008634",2001,627,430,197,25
"1399","E01008636",2001,600,212,388,14
"1400","E01008637",2001,633,280,353,4
"1401","E01008639",2001,637,384,253,26
"1402","E01008657",2001,587,37,550,17
"1403","E01008652",2001,532,249,283,38
"1404","E01008653",2001,532,344,188,6
"1405","E01008654",2001,606,88,518,81
"1406","E01008655",2001,632,366,266,11
"1407","E01008640",2001,745,219,526,57
"1408","E01008641",2001,908,568,340,44
"1409","E01008642",2001,584,14,570,20
"1410","E01008638",2001,621,24,597,48
"1411","E01008594",2001,636,362,274,20
"1412","E01008590",2001,734,299,435,88
"1413","E01008591",2001,766,162,604,175
"1414","E01008592",2001,704,68,636,148
"1415","E01008601",2001,615,420,195,8
"1416","E01008671",2001,618,238,380,59
"1417","E01008672",2001,638,252,386,12
"1418","E01008669",2001,724,464,260,24
"1419","E01008622",2001,750,117,633,13
"1420","E01008623",2001,502,368,134,5
"1421","E01008625",2001,727,532,195,9
"1422","E01008626",2001,642,372,270,10
"1423","E01008608",2001,567,358,209,10
"1424","E01008602",2001,632,408,224,5
"1425","E01008603",2001,663,406,257,18
"1426","E01008670",2001,741,391,350,11
"1427","E01008656",2001,594,229,365,7
"1428","E01008658",2001,583,407,176,5
"1429","E01008643",2001,632,175,457,11
"1430","E01008644",2001,755,433,322,8
"1431","E01008645",2001,656,389,267,16
"1432","E01008646",2001,617,188,429,6
"1433","E01008609",2001,646,388,258,7
"1434","E01008605",2001,512,138,374,8
"1435","E01008606",2001,644,408,236,8
"1436","E01008607",2001,643,483,160,0
"1437","E01008593",2001,604,339,265,20
"1438","E01008631",2001,603,286,317,3
"1439","E01008632",2001,564,373,191,0
"1440","E01008659",2001,632,301,331,7
"1441","E01008662",2001,502,309,193,7
"1442","E01008663",2001,636,337,299,11
"1443","E01008684",2001,612,278,334,11
"1444","E01008685",2001,803,224,579,22
"1445","E01008686",2001,729,244,485,14
"1446","E01008687",2001,822,219,603,22
"1447","E01008624",2001,600,270,330,5
"1448","E01008688",2001,655,328,327,11
"1449","E01008689",2001,760,486,274,6
"1450","E01008690",2001,653,332,321,12
"1451","E01008691",2001,492,30,462,4
"1452","E01008692",2001,621,282,339,10
"1453","E01008627",2001,598,12,586,15
"1454","E01008628",2001,634,371,263,15
"1455","E01008629",2001,555,115,440,13
"1456","E01008630",2001,524,412,112,7
"1457","E01008610",2001,671,436,235,13
"1458","E01008611",2001,572,35,537,15
"1459","E01008612",2001,635,66,569,12
"1460","E01008613",2001,758,327,431,75
"1461","E01008616",2001,634,20,614,10
"1462","E01008618",2001,522,7,515,4
"1463","E01008619",2001,674,17,657,23
"1464","E01008621",2001,620,13,607,6
"1465","E01008620",2001,633,50,583,11
"1466","E01008617",2001,596,41,555,12
"1467","E01008614",2001,589,258,331,3
"1468","E01008615",2001,641,221,420,18
"1469","E01008713",2001,596,10,586,22
"1470","E01008726",2001,650,20,630,33
"1471","E01008722",2001,624,27,597,13
"1472","E01008724",2001,480,9,471,4
"1473","E01008725",2001,622,49,573,7
"1474","E01008723",2001,544,5,539,6
"1475","E01008727",2001,757,39,718,52
"1476","E01008728",2001,585,23,562,22
"1477","E01008792",2001,463,9,454,14
"1478","E01008837",2001,640,305,335,33
"1479","E01008838",2001,649,409,240,15
"1480","E01008839",2001,729,501,228,33
"1481","E01008840",2001,589,274,315,23
"1482","E01008841",2001,622,415,207,8
"1483","E01008698",2001,733,440,293,11
"1484","E01008842",2001,612,186,426,13
"1485","E01008817",2001,499,379,120,7
"1486","E01008821",2001,600,327,273,13
"1487","E01008822",2001,744,393,351,15
"1488","E01008819",2001,617,317,300,5
"1489","E01008712",2001,733,406,327,27
"1490","E01008820",2001,527,32,495,66
"1491","E01008818",2001,601,332,269,82
"1492","E01008708",2001,674,256,418,21
"1493","E01008709",2001,657,325,332,90
"1494","E01008710",2001,720,482,238,50
"1495","E01008711",2001,637,125,512,40
"1496","E01008786",2001,651,52,599,40
"1497","E01008787",2001,616,43,573,59
"1498","E01008788",2001,745,56,689,82
"1499","E01008789",2001,626,28,598,76
"1500","E01008790",2001,620,88,532,66
"1501","E01008791",2001,755,466,289,98
"1502","E01008855",2001,601,179,422,16
"1503","E01008856",2001,636,61,575,13
"1504","E01008876",2001,515,56,459,3
"1505","E01008877",2001,608,42,566,21
"1506","E01008699",2001,603,342,261,15
"1507","E01008693",2001,620,193,427,74
"1508","E01008694",2001,640,318,322,14
"1509","E01008695",2001,604,306,298,15
"1510","E01008696",2001,488,103,385,3
"1511","E01008697",2001,631,347,284,10
"1512","E01008878",2001,635,186,449,6
"1513","E01008857",2001,647,325,322,8
"1514","E01008858",2001,604,442,162,14
"1515","E01008859",2001,508,295,213,19
"1516","E01008860",2001,591,268,323,20
"1517","E01008853",2001,616,308,308,21
"1518","E01008854",2001,750,210,540,169
"1519","E01008879",2001,621,171,450,29
"1520","E01008880",2001,498,158,340,10
"1521","E01008873",2001,523,39,484,6
"1522","E01008874",2001,502,284,218,11
"1523","E01008875",2001,632,216,416,20
"1524","E01008701",2001,589,81,508,86
"1525","E01008704",2001,612,99,513,68
"1526","E01008706",2001,638,93,545,117
"1527","E01008707",2001,513,33,480,108
"1528","E01008815",2001,535,394,141,12
"1529","E01008816",2001,502,370,132,14
"1530","E01008812",2001,613,408,205,16
"1531","E01008762",2001,632,348,284,46
"1532","E01008756",2001,637,329,308,22
"1533","E01008831",2001,628,83,545,318
"1534","E01008834",2001,779,228,551,250
"1535","E01008705",2001,492,103,389,108
"1536","E01008703",2001,516,442,74,33
"1537","E01008700",2001,495,73,422,90
"1538","E01008813",2001,624,306,318,18
"1539","E01008814",2001,608,169,439,21
"1540","E01008810",2001,605,367,238,22
"1541","E01008811",2001,600,156,444,12
"1542","E01008757",2001,626,102,524,64
"1543","E01008758",2001,605,100,505,8
"1544","E01008759",2001,650,39,611,57
"1545","E01008761",2001,596,17,579,12
"1546","E01008735",2001,769,324,445,146
"1547","E01008736",2001,616,183,433,122
"1548","E01008737",2001,622,95,527,151
"1549","E01008738",2001,617,92,525,123
"1550","E01008836",2001,651,446,205,99
"1551","E01008702",2001,626,489,137,33
"1552","E01008850",2001,549,43,506,10
"1553","E01008851",2001,647,314,333,15
"1554","E01008845",2001,629,97,532,14
"1555","E01008846",2001,504,324,180,19
"1556","E01008847",2001,511,326,185,28
"1557","E01008832",2001,626,36,590,75
"1558","E01008833",2001,622,25,597,78
"1559","E01008830",2001,490,32,458,124
"1560","E01008760",2001,624,15,609,41
"1561","E01008848",2001,611,150,461,7
"1562","E01008849",2001,594,425,169,25
"1563","E01008852",2001,532,79,453,7
"1564","E01008843",2001,566,45,521,14
"1565","E01008844",2001,624,186,438,12
"1566","E01008867",2001,789,506,283,33
"1567","E01008868",2001,511,36,475,4
"1568","E01008869",2001,524,118,406,5
"1569","E01008870",2001,592,51,541,16
"1570","E01008871",2001,601,280,321,14
"1571","E01008872",2001,659,126,533,17
"1572","E01008729",2001,629,404,225,15
"1573","E01008730",2001,605,420,185,16
"1574","E01008731",2001,616,396,220,23
"1575","E01008732",2001,721,333,388,14
"1576","E01008733",2001,880,551,329,19
"1577","E01008734",2001,636,16,620,6
"1578","E01008740",2001,505,10,495,8
"1579","E01008781",2001,598,17,581,37
"1580","E01008782",2001,604,28,576,3
"1581","E01008783",2001,609,12,597,39
"1582","E01008784",2001,623,29,594,9
"1583","E01008785",2001,628,19,609,10
"1584","E01008835",2001,479,18,461,79
"1585","E01008823",2001,599,395,204,12
"1586","E01008824",2001,620,434,186,27
"1587","E01008825",2001,723,385,338,16
"1588","E01008826",2001,598,278,320,13
"1589","E01008827",2001,544,350,194,20
"1590","E01008828",2001,634,386,248,18
"1591","E01008829",2001,636,448,188,26
"1592","E01008779",2001,652,182,470,32
"1593","E01008780",2001,654,319,335,23
"1594","E01008741",2001,599,66,533,45
"1595","E01008739",2001,605,247,358,35
"1596","E01008799",2001,521,67,454,12
"1597","E01008861",2001,633,222,411,22
"1598","E01008862",2001,566,70,496,10
"1599","E01008863",2001,494,58,436,7
"1600","E01008864",2001,535,58,477,14
"1601","E01008865",2001,610,282,328,16
"1602","E01008866",2001,611,264,347,13
"1603","E01008809",2001,702,197,505,15
"1604","E01008773",2001,663,349,314,17
"1605","E01008776",2001,500,213,287,11
"1606","E01008777",2001,973,735,238,29
"1607","E01008778",2001,623,214,409,19
"1608","E01008803",2001,617,174,443,42
"1609","E01008804",2001,580,225,355,9
"1610","E01008805",2001,621,132,489,63
"1611","E01008806",2001,623,246,377,14
"1612","E01008807",2001,657,504,153,27
"1613","E01008768",2001,659,254,405,34
"1614","E01008769",2001,681,241,440,43
"1615","E01008766",2001,654,366,288,25
"1616","E01008763",2001,611,277,334,16
"1617","E01008764",2001,623,175,448,19
"1618","E01008774",2001,602,98,504,11
"1619","E01008775",2001,581,31,550,5
"1620","E01008808",2001,635,10,625,37
"1621","E01008772",2001,583,65,518,10
"1622","E01008802",2001,635,122,513,5
"1623","E01008800",2001,606,417,189,17
"1624","E01008801",2001,630,14,616,18
"1625","E01008793",2001,824,535,289,41
"1626","E01008795",2001,623,167,456,10
"1627","E01008797",2001,633,46,587,6
"1628","E01008770",2001,600,134,466,11
"1629","E01008771",2001,614,194,420,7
"1630","E01008765",2001,584,76,508,13
"1631","E01008767",2001,596,184,412,3
"1632","E01008798",2001,602,82,520,44
"1633","E01008796",2001,614,61,553,40
"1634","E01008794",2001,673,133,540,72
"1635","E01008720",2001,616,119,497,34
"1636","E01008721",2001,621,48,573,20
"1637","E01008755",2001,606,172,434,34
"1638","E01008750",2001,589,123,466,14
"1639","E01008751",2001,577,334,243,8
"1640","E01008752",2001,578,349,229,15
"1641","E01008753",2001,604,156,448,24
"1642","E01008754",2001,681,284,397,28
"1643","E01008749",2001,638,50,588,6
"1644","E01008714",2001,614,343,271,21
"1645","E01008715",2001,621,175,446,25
"1646","E01008716",2001,592,19,573,8
"1647","E01008717",2001,632,266,366,7
"1648","E01008718",2001,752,338,414,36
"1649","E01008719",2001,650,170,480,68
"1650","E01008747",2001,653,232,421,14
"1651","E01008748",2001,648,216,432,8
"1652","E01008742",2001,736,113,623,63
"1653","E01008743",2001,744,499,245,10
"1654","E01008744",2001,690,255,435,63
"1655","E01008745",2001,625,5,620,17
"1656","E01008746",2001,701,447,254,10
"1657","E01012607",2001,633,114,519,28
"1658","E01012608",2001,688,192,496,43
"1659","E01012633",2001,704,108,596,44
"1660","E01012634",2001,602,50,552,30
"1661","E01012635",2001,597,11,586,18
"1662","E01012636",2001,669,34,635,18
"1663","E01012581",2001,506,6,500,16
"1664","E01012582",2001,497,0,497,10
"1665","E01012583",2001,656,6,650,11
"1666","E01012587",2001,669,14,655,60
"1667","E01012588",2001,615,19,596,80
"1668","E01012574",2001,555,279,276,26
"1669","E01012577",2001,457,62,395,54
"1670","E01012578",2001,475,102,373,45
"1671","E01012605",2001,522,81,441,59
"1672","E01012606",2001,460,67,393,49
"1673","E01012579",2001,529,264,265,19
"1674","E01012580",2001,507,61,446,44
"1675","E01012642",2001,440,100,340,66
"1676","E01012645",2001,568,15,553,37
"1677","E01012656",2001,609,227,382,95
"1678","E01012657",2001,642,151,491,101
"1679","E01012658",2001,720,58,662,44
"1680","E01012585",2001,473,22,451,47
"1681","E01012586",2001,486,68,418,100
"1682","E01012629",2001,584,29,555,109
"1683","E01012631",2001,515,353,162,47
"1684","E01012655",2001,733,512,221,67
"1685","E01012643",2001,507,236,271,35
"1686","E01012644",2001,617,9,608,82
"1687","E01012630",2001,519,87,432,47
"1688","E01012575",2001,502,259,243,21
"1689","E01012571",2001,465,142,323,47
"1690","E01012572",2001,481,281,200,38
"1691","E01012573",2001,443,45,398,42
"1692","E01012576",2001,541,215,326,54
"1693","E01012637",2001,610,390,220,22
"1694","E01012638",2001,649,326,323,39
"1695","E01012639",2001,619,320,299,29
"1696","E01012640",2001,703,81,622,72
"1697","E01012641",2001,515,153,362,48
"1698","E01012622",2001,833,317,516,125
"1699","E01012623",2001,638,65,573,57
"1700","E01012624",2001,617,84,533,73
"1701","E01012625",2001,771,119,652,102
"1702","E01012595",2001,745,212,533,91
"1703","E01012596",2001,808,64,744,156
"1704","E01012584",2001,399,14,385,9
"1705","E01012609",2001,624,3,621,9
"1706","E01012610",2001,508,71,437,10
"1707","E01012611",2001,467,6,461,33
"1708","E01012612",2001,625,3,622,11
"1709","E01012613",2001,504,6,498,21
"1710","E01012632",2001,550,111,439,46
"1711","E01012600",2001,602,316,286,19
"1712","E01012601",2001,528,323,205,24
"1713","E01012602",2001,519,23,496,25
"1714","E01012603",2001,632,297,335,43
"1715","E01012604",2001,492,75,417,29
"1716","E01012594",2001,632,278,354,27
"1717","E01012618",2001,616,15,601,24
"1718","E01012619",2001,530,240,290,25
"1719","E01012620",2001,640,32,608,13
"1720","E01012621",2001,627,153,474,37
"1721","E01012593",2001,647,15,632,65
"1722","E01012597",2001,525,6,519,17
"1723","E01012598",2001,531,10,521,9
"1724","E01012599",2001,485,6,479,28
"1725","E01012589",2001,641,90,551,96
"1726","E01012590",2001,626,123,503,43
"1727","E01012591",2001,642,254,388,25
"1728","E01012648",2001,517,21,496,84
"1729","E01012652",2001,624,37,587,12
"1730","E01012617",2001,583,31,552,56
"1731","E01012650",2001,582,28,554,85
"1732","E01012646",2001,739,225,514,82
"1733","E01012647",2001,528,204,324,23
"1734","E01012651",2001,630,17,613,49
"1735","E01012649",2001,595,155,440,71
"1736","E01012653",2001,629,77,552,89
"1737","E01012654",2001,738,91,647,159
"1738","E01012659",2001,515,12,503,29
"1739","E01012660",2001,460,3,457,11
"1740","E01012661",2001,661,21,640,74
"1741","E01012614",2001,540,24,516,19
"1742","E01012615",2001,701,189,512,50
"1743","E01012616",2001,630,93,537,42
"1744","E01012626",2001,594,21,573,26
"1745","E01012627",2001,605,3,602,39
"1746","E01012628",2001,483,8,475,42
"1747","E01012592",2001,784,11,773,37
"1748","E01012663",2001,715,12,703,108
"1749","E01012664",2001,729,8,721,62
"1750","E01012665",2001,889,8,881,50
"1751","E01012719",2001,650,4,646,32
"1752","E01012716",2001,653,14,639,57
"1753","E01012717",2001,714,3,711,36
"1754","E01012703",2001,719,39,680,36
"1755","E01012704",2001,969,556,413,42
"1756","E01012706",2001,715,11,704,45
"1757","E01012662",2001,841,147,694,42
"1758","E01012666",2001,622,24,598,139
"1759","E01012667",2001,639,3,636,25
"1760","E01012668",2001,731,11,720,85
"1761","E01012669",2001,695,7,688,156
"1762","E01012718",2001,762,3,759,32
"1763","E01012723",2001,636,34,602,37
"1764","E01012705",2001,721,149,572,57
"1765","E01012690",2001,658,6,652,55
"1766","E01012691",2001,770,66,704,49
"1767","E01012692",2001,735,214,521,45
"1768","E01012693",2001,741,5,736,74
"1769","E01012711",2001,629,58,571,114
"1770","E01012750",2001,770,8,762,96
"1771","E01012747",2001,627,0,627,29
"1772","E01012748",2001,738,12,726,300
"1773","E01012749",2001,749,6,743,265
"1774","E01012683",2001,721,41,680,373
"1775","E01012681",2001,652,63,589,349
"1776","E01012707",2001,646,129,517,79
"1777","E01012720",2001,627,292,335,43
"1778","E01012721",2001,770,512,258,38
"1779","E01012724",2001,675,356,319,51
"1780","E01012684",2001,697,152,545,135
"1781","E01012682",2001,778,130,648,219
"1782","E01012678",2001,768,403,365,103
"1783","E01012679",2001,655,103,552,195
"1784","E01012680",2001,642,77,565,125
"1785","E01012676",2001,621,52,569,79
"1786","E01012677",2001,637,4,633,101
"1787","E01012722",2001,414,3,411,21
"1788","E01012708",2001,616,5,611,84
"1789","E01012709",2001,752,5,747,153
"1790","E01012710",2001,494,3,491,30
"1791","E01012675",2001,736,29,707,282
"1792","E01012673",2001,739,168,571,285
"1793","E01012735",2001,782,18,764,385
"1794","E01012736",2001,581,17,564,217
"1795","E01012737",2001,837,32,805,455
"1796","E01012738",2001,632,28,604,208
"1797","E01012739",2001,612,106,506,85
"1798","E01012733",2001,495,22,473,155
"1799","E01012734",2001,637,10,627,128
"1800","E01012742",2001,539,23,516,79
"1801","E01012670",2001,625,36,589,222
"1802","E01012715",2001,731,6,725,89
"1803","E01012712",2001,691,3,688,47
"1804","E01012713",2001,750,9,741,70
"1805","E01012740",2001,646,17,629,88
"1806","E01012741",2001,603,6,597,54
"1807","E01012751",2001,681,9,672,422
"1808","E01012671",2001,572,10,562,299
"1809","E01012672",2001,497,12,485,234
"1810","E01012674",2001,743,13,730,372
"1811","E01012714",2001,771,42,729,61
"1812","E01012686",2001,618,297,321,35
"1813","E01012687",2001,627,293,334,40
"1814","E01012688",2001,618,66,552,59
"1815","E01012689",2001,640,45,595,75
"1816","E01012695",2001,609,38,571,92
"1817","E01012743",2001,744,13,731,182
"1818","E01012744",2001,748,118,630,121
"1819","E01012745",2001,768,10,758,131
"1820","E01012746",2001,795,36,759,127
"1821","E01012696",2001,638,10,628,102
"1822","E01012697",2001,640,65,575,37
"1823","E01012698",2001,637,214,423,87
"1824","E01012685",2001,624,10,614,90
"1825","E01012694",2001,644,57,587,97
"1826","E01012752",2001,546,7,539,209
"1827","E01012753",2001,484,7,477,86
"1828","E01012754",2001,596,14,582,222
"1829","E01012755",2001,617,5,612,97
"1830","E01012726",2001,771,41,730,116
"1831","E01012728",2001,732,13,719,252
"1832","E01012729",2001,745,3,742,48
"1833","E01012730",2001,613,4,609,46
"1834","E01012731",2001,719,23,696,63
"1835","E01012732",2001,739,165,574,75
"1836","E01012701",2001,628,5,623,55
"1837","E01012702",2001,767,217,550,68
"1838","E01012699",2001,756,37,719,55
"1839","E01012700",2001,769,9,760,52
"1840","E01012725",2001,593,7,586,59
"1841","E01012727",2001,635,4,631,28
"1842","E01012392",2001,499,3,496,16
"1843","E01012393",2001,615,6,609,9
"1844","E01012395",2001,592,0,592,3
"1845","E01012411",2001,603,48,555,37
"1846","E01012421",2001,528,3,525,17
"1847","E01012423",2001,636,64,572,42
"1848","E01012374",2001,599,3,596,3
"1849","E01012375",2001,470,0,470,4
"1850","E01012376",2001,490,0,490,3
"1851","E01012368",2001,757,178,579,64
"1852","E01012412",2001,609,196,413,38
"1853","E01012413",2001,645,251,394,24
"1854","E01012414",2001,488,3,485,13
"1855","E01012410",2001,501,6,495,10
"1856","E01012419",2001,490,293,197,10
"1857","E01012420",2001,730,523,207,16
"1858","E01012422",2001,637,322,315,12
"1859","E01012377",2001,715,280,435,13
"1860","E01012390",2001,651,184,467,11
"1861","E01012394",2001,614,175,439,42
"1862","E01012369",2001,596,179,417,9
"1863","E01012425",2001,652,214,438,26
"1864","E01012426",2001,543,25,518,28
"1865","E01012427",2001,619,170,449,25
"1866","E01012442",2001,583,292,291,24
"1867","E01012378",2001,636,24,612,18
"1868","E01012379",2001,621,77,544,67
"1869","E01012380",2001,604,336,268,11
"1870","E01012388",2001,635,262,373,21
"1871","E01012370",2001,781,29,752,116
"1872","E01012367",2001,712,284,428,91
"1873","E01012441",2001,907,360,547,106
"1874","E01012424",2001,609,352,257,19
"1875","E01012443",2001,475,79,396,16
"1876","E01012389",2001,659,4,655,9
"1877","E01012391",2001,607,180,427,33
"1878","E01012401",2001,771,30,741,40
"1879","E01012385",2001,534,25,509,22
"1880","E01012386",2001,459,0,459,6
"1881","E01012387",2001,499,11,488,20
"1882","E01012434",2001,585,12,573,19
"1883","E01012435",2001,606,5,601,6
"1884","E01012444",2001,410,290,120,18
"1885","E01012445",2001,509,366,143,16
"1886","E01012384",2001,716,248,468,28
"1887","E01012381",2001,839,647,192,12
"1888","E01012382",2001,703,482,221,27
"1889","E01012402",2001,607,269,338,17
"1890","E01012398",2001,495,108,387,16
"1891","E01012400",2001,495,50,445,13
"1892","E01012404",2001,589,77,512,24
"1893","E01012405",2001,779,84,695,39
"1894","E01012416",2001,606,126,480,41
"1895","E01012417",2001,504,16,488,89
"1896","E01012428",2001,713,126,587,42
"1897","E01012429",2001,607,197,410,19
"1898","E01012430",2001,637,271,366,68
"1899","E01012431",2001,746,60,686,110
"1900","E01012408",2001,701,433,268,38
"1901","E01012399",2001,635,285,350,7
"1902","E01012403",2001,617,309,308,19
"1903","E01012396",2001,600,288,312,17
"1904","E01012397",2001,618,364,254,12
"1905","E01012383",2001,728,223,505,25
"1906","E01012432",2001,652,117,535,43
"1907","E01012433",2001,661,285,376,35
"1908","E01012436",2001,486,283,203,15
"1909","E01012440",2001,513,16,497,15
"1910","E01012438",2001,503,292,211,19
"1911","E01012439",2001,620,324,296,20
"1912","E01012437",2001,532,273,259,17
"1913","E01012409",2001,575,199,376,25
"1914","E01012406",2001,604,223,381,10
"1915","E01012407",2001,665,391,274,31
"1916","E01012418",2001,628,3,625,11
"1917","E01012415",2001,524,10,514,18
"1918","E01012371",2001,507,6,501,15
"1919","E01012372",2001,495,4,491,10
"1920","E01012373",2001,540,6,534,7
"1921","E01012471",2001,488,3,485,18
"1922","E01012472",2001,751,84,667,17
"1923","E01012476",2001,628,78,550,32
"1924","E01012477",2001,607,4,603,11
"1925","E01012554",2001,807,77,730,40
"1926","E01012473",2001,620,31,589,5
"1927","E01012474",2001,643,183,460,31
"1928","E01012475",2001,623,78,545,29
"1929","E01012467",2001,511,0,511,10
"1930","E01012468",2001,670,51,619,15
"1931","E01012469",2001,579,35,544,30
"1932","E01012470",2001,507,158,349,10
"1933","E01012460",2001,618,235,383,18
"1934","E01012462",2001,643,80,563,46
"1935","E01012463",2001,513,6,507,14
"1936","E01012464",2001,590,172,418,19
"1937","E01012465",2001,600,77,523,43
"1938","E01012466",2001,708,428,280,40
"1939","E01012461",2001,548,6,542,19
"1940","E01012459",2001,695,391,304,31
"1941","E01012526",2001,629,373,256,24
"1942","E01012534",2001,658,320,338,20
"1943","E01012535",2001,728,344,384,21
"1944","E01012537",2001,722,357,365,26
"1945","E01012539",2001,703,279,424,10
"1946","E01012540",2001,526,54,472,13
"1947","E01012541",2001,510,98,412,13
"1948","E01012542",2001,639,135,504,24
"1949","E01012543",2001,519,30,489,16
"1950","E01012544",2001,589,104,485,17
"1951","E01012538",2001,615,10,605,26
"1952","E01012536",2001,655,247,408,16
"1953","E01012545",2001,621,472,149,11
"1954","E01012546",2001,633,534,99,17
"1955","E01012533",2001,575,371,204,27
"1956","E01012521",2001,643,97,546,18
"1957","E01012522",2001,630,253,377,14
"1958","E01012561",2001,671,71,600,46
"1959","E01012562",2001,468,3,465,8
"1960","E01012567",2001,488,3,485,3
"1961","E01012568",2001,505,6,499,18
"1962","E01012569",2001,523,0,523,3
"1963","E01012570",2001,601,272,329,26
"1964","E01012563",2001,631,0,631,17
"1965","E01012564",2001,523,6,517,13
"1966","E01012565",2001,542,72,470,26
"1967","E01012566",2001,462,0,462,11
"1968","E01012523",2001,612,46,566,64
"1969","E01012524",2001,639,18,621,17
"1970","E01012525",2001,645,119,526,51
"1971","E01012520",2001,612,308,304,16
"1972","E01012481",2001,699,118,581,76
"1973","E01012482",2001,661,210,451,32
"1974","E01012478",2001,608,142,466,31
"1975","E01012547",2001,664,28,636,13
"1976","E01012548",2001,606,64,542,17
"1977","E01012549",2001,645,15,630,12
"1978","E01012550",2001,708,17,691,12
"1979","E01012457",2001,754,131,623,117
"1980","E01012453",2001,616,343,273,16
"1981","E01012454",2001,767,135,632,88
"1982","E01012455",2001,785,396,389,106
"1983","E01012551",2001,602,12,590,25
"1984","E01012552",2001,646,117,529,30
"1985","E01012553",2001,502,0,502,6
"1986","E01012555",2001,530,10,520,5
"1987","E01012556",2001,637,22,615,16
"1988","E01012491",2001,628,145,483,8
"1989","E01012492",2001,612,3,609,9
"1990","E01012493",2001,613,0,613,10
"1991","E01012494",2001,637,0,637,13
"1992","E01012500",2001,537,6,531,9
"1993","E01012501",2001,600,6,594,30
"1994","E01012495",2001,492,0,492,11
"1995","E01012496",2001,587,43,544,10
"1996","E01012497",2001,520,185,335,13
"1997","E01012498",2001,637,247,390,19
"1998","E01012499",2001,510,14,496,51
"1999","E01012479",2001,754,234,520,84
"2000","E01012480",2001,642,175,467,65
"2001","E01012484",2001,810,74,736,157
"2002","E01012510",2001,770,170,600,124
"2003","E01012511",2001,770,51,719,121
"2004","E01012512",2001,692,4,688,25
"2005","E01012483",2001,860,450,410,56
"2006","E01012509",2001,717,14,703,39
"2007","E01012456",2001,824,385,439,108
"2008","E01012458",2001,686,123,563,65
"2009","E01012527",2001,633,56,577,24
"2010","E01012528",2001,502,6,496,13
"2011","E01012529",2001,616,34,582,13
"2012","E01012530",2001,527,9,518,14
"2013","E01012531",2001,650,28,622,15
"2014","E01012532",2001,596,3,593,8
"2015","E01012504",2001,611,142,469,45
"2016","E01012505",2001,638,222,416,18
"2017","E01012506",2001,617,348,269,10
"2018","E01012507",2001,757,160,597,120
"2019","E01012508",2001,723,394,329,20
"2020","E01012513",2001,644,65,579,30
"2021","E01012514",2001,637,32,605,32
"2022","E01012515",2001,627,119,508,49
"2023","E01012516",2001,644,67,577,63
"2024","E01012517",2001,630,13,617,30
"2025","E01012518",2001,615,69,546,26
"2026","E01012519",2001,634,55,579,21
"2027","E01012489",2001,592,10,582,15
"2028","E01012490",2001,645,10,635,11
"2029","E01012485",2001,603,111,492,14
"2030","E01012486",2001,635,10,625,21
"2031","E01012487",2001,608,28,580,29
"2032","E01012557",2001,731,20,711,95
"2033","E01012558",2001,742,9,733,53
"2034","E01012559",2001,600,21,579,18
"2035","E01012560",2001,626,137,489,15
"2036","E01012450",2001,631,37,594,37
"2037","E01012451",2001,631,190,441,19
"2038","E01012448",2001,469,12,457,15
"2039","E01012488",2001,629,3,626,32
"2040","E01012502",2001,610,9,601,24
"2041","E01012503",2001,494,8,486,41
"2042","E01012449",2001,647,0,647,8
"2043","E01012452",2001,630,4,626,18
"2044","E01012446",2001,510,4,506,7
"2045","E01012447",2001,487,3,484,4
"2046","E01018308",2001,771,110,661,60
"2047","E01018336",2001,524,12,512,22
"2048","E01018337",2001,524,42,482,34
"2049","E01018338",2001,671,48,623,55
"2050","E01018358",2001,443,25,418,24
"2051","E01018359",2001,409,9,400,6
"2052","E01018360",2001,709,64,645,161
"2053","E01018366",2001,639,9,630,21
"2054","E01018367",2001,792,148,644,39
"2055","E01018378",2001,498,225,273,21
"2056","E01018379",2001,608,60,548,26
"2057","E01018380",2001,502,62,440,6
"2058","E01018364",2001,736,366,370,13
"2059","E01018365",2001,863,70,793,44
"2060","E01018374",2001,645,31,614,58
"2061","E01018375",2001,745,22,723,210
"2062","E01018376",2001,636,38,598,39
"2063","E01018377",2001,598,16,582,37
"2064","E01018362",2001,603,26,577,22
"2065","E01018363",2001,463,10,453,18
"2066","E01018309",2001,650,114,536,25
"2067","E01018310",2001,626,357,269,38
"2068","E01018311",2001,658,395,263,31
"2069","E01018312",2001,599,188,411,19
"2070","E01018313",2001,589,71,518,17
"2071","E01018314",2001,656,257,399,28
"2072","E01018315",2001,498,53,445,17
"2073","E01018316",2001,571,309,262,18
"2074","E01018317",2001,726,465,261,20
"2075","E01018349",2001,643,52,591,36
"2076","E01018350",2001,773,3,770,31
"2077","E01018368",2001,569,63,506,38
"2078","E01018370",2001,522,3,519,17
"2079","E01018383",2001,599,23,576,32
"2080","E01018384",2001,621,3,618,19
"2081","E01018345",2001,499,48,451,18
"2082","E01018346",2001,545,17,528,29
"2083","E01018347",2001,630,218,412,27
"2084","E01018327",2001,910,330,580,213
"2085","E01018318",2001,873,349,524,163
"2086","E01018343",2001,749,136,613,204
"2087","E01018361",2001,631,13,618,181
"2088","E01018328",2001,417,12,405,136
"2089","E01018329",2001,597,105,492,217
"2090","E01018330",2001,474,3,471,108
"2091","E01018331",2001,685,7,678,246
"2092","E01018326",2001,851,181,670,236
"2093","E01018319",2001,1010,144,866,183
"2094","E01018344",2001,851,28,823,129
"2095","E01018381",2001,521,14,507,66
"2096","E01018382",2001,712,196,516,54
"2097","E01018385",2001,833,29,804,66
"2098","E01018323",2001,567,54,513,34
"2099","E01018324",2001,536,5,531,33
"2100","E01018325",2001,580,45,535,17
"2101","E01018348",2001,840,23,817,49
"2102","E01018320",2001,609,10,599,20
"2103","E01018321",2001,518,59,459,32
"2104","E01018322",2001,515,6,509,16
"2105","E01018340",2001,653,112,541,59
"2106","E01018341",2001,507,28,479,23
"2107","E01018342",2001,873,62,811,203
"2108","E01018332",2001,469,53,416,25
"2109","E01018333",2001,627,3,624,49
"2110","E01018334",2001,654,9,645,31
"2111","E01018351",2001,623,417,206,32
"2112","E01018352",2001,811,41,770,68
"2113","E01018353",2001,625,64,561,36
"2114","E01018354",2001,619,179,440,36
"2115","E01018371",2001,701,134,567,87
"2116","E01018372",2001,775,16,759,165
"2117","E01018369",2001,569,33,536,55
"2118","E01018335",2001,801,33,768,134
"2119","E01018339",2001,807,71,736,74
"2120","E01018373",2001,800,44,756,106
"2121","E01018355",2001,544,126,418,45
"2122","E01018356",2001,549,34,515,90
"2123","E01018357",2001,500,8,492,53
"2124","E01018393",2001,699,45,654,68
"2125","E01018411",2001,919,17,902,24
"2126","E01018412",2001,598,97,501,43
"2127","E01018413",2001,501,8,493,14
"2128","E01018414",2001,627,20,607,42
"2129","E01018415",2001,660,111,549,42
"2130","E01018416",2001,510,12,498,19
"2131","E01018424",2001,677,39,638,28
"2132","E01018425",2001,612,12,600,50
"2133","E01018426",2001,721,158,563,25
"2134","E01018427",2001,497,3,494,4
"2135","E01018419",2001,530,14,516,18
"2136","E01018420",2001,509,19,490,6
"2137","E01018421",2001,539,16,523,21
"2138","E01018422",2001,495,64,431,37
"2139","E01018423",2001,619,216,403,13
"2140","E01018400",2001,979,492,487,62
"2141","E01018401",2001,610,203,407,19
"2142","E01018395",2001,641,39,602,24
"2143","E01018396",2001,598,171,427,17
"2144","E01018398",2001,728,183,545,63
"2145","E01018399",2001,614,83,531,44
"2146","E01018402",2001,787,158,629,130
"2147","E01018403",2001,761,20,741,19
"2148","E01018397",2001,594,19,575,29
"2149","E01018408",2001,750,31,719,9
"2150","E01018409",2001,746,116,630,29
"2151","E01018410",2001,642,7,635,14
"2152","E01018404",2001,606,7,599,30
"2153","E01018405",2001,583,9,574,24
"2154","E01018406",2001,553,8,545,40
"2155","E01018407",2001,619,4,615,17
"2156","E01018436",2001,618,21,597,30
"2157","E01018437",2001,638,132,506,64
"2158","E01018438",2001,630,3,627,14
"2159","E01018439",2001,523,4,519,17
"2160","E01018440",2001,625,33,592,45
"2161","E01018441",2001,633,22,611,38
"2162","E01018442",2001,662,40,622,24
"2163","E01018443",2001,634,12,622,42
"2164","E01018432",2001,619,116,503,24
"2165","E01018433",2001,592,42,550,12
"2166","E01018434",2001,614,48,566,31
"2167","E01018435",2001,636,252,384,56
"2168","E01018428",2001,590,70,520,39
"2169","E01018429",2001,656,89,567,34
"2170","E01018430",2001,556,37,519,9
"2171","E01018431",2001,467,3,464,60
"2172","E01018417",2001,695,50,645,23
"2173","E01018418",2001,621,45,576,45
"2174","E01018394",2001,675,39,636,58
"2175","E01018387",2001,742,0,742,0
"2176","E01018388",2001,754,320,434,78
"2177","E01018389",2001,727,39,688,51
"2178","E01018390",2001,757,24,733,45
"2179","E01018391",2001,697,134,563,83
"2180","E01018392",2001,776,10,766,42
"2181","E01018386",2001,613,57,556,57
"2182","E01018472",2001,655,46,609,43
"2183","E01018473",2001,629,21,608,18
"2184","E01018474",2001,583,7,576,13
"2185","E01018475",2001,534,0,534,10
"2186","E01018476",2001,509,245,264,29
"2187","E01018477",2001,636,224,412,21
"2188","E01018478",2001,521,192,329,30
"2189","E01018479",2001,637,49,588,41
"2190","E01018463",2001,601,76,525,99
"2191","E01018466",2001,1016,409,607,118
"2192","E01018467",2001,735,100,635,156
"2193","E01018459",2001,506,247,259,20
"2194","E01018460",2001,628,45,583,64
"2195","E01018461",2001,641,161,480,25
"2196","E01018482",2001,631,206,425,20
"2197","E01018483",2001,625,53,572,29
"2198","E01018484",2001,617,424,193,32
"2199","E01018485",2001,595,290,305,31
"2200","E01018499",2001,624,71,553,21
"2201","E01018500",2001,527,3,524,15
"2202","E01018501",2001,764,84,680,61
"2203","E01018502",2001,516,3,513,13
"2204","E01018464",2001,600,25,575,73
"2205","E01018496",2001,525,80,445,25
"2206","E01018497",2001,506,17,489,84
"2207","E01018498",2001,620,230,390,62
"2208","E01018462",2001,631,219,412,91
"2209","E01018465",2001,784,37,747,123
"2210","E01018468",2001,610,5,605,18
"2211","E01018469",2001,627,71,556,39
"2212","E01018470",2001,581,9,572,24
"2213","E01018471",2001,601,3,598,12
"2214","E01018486",2001,626,168,458,149
"2215","E01018487",2001,632,23,609,133
"2216","E01018488",2001,601,6,595,24
"2217","E01018489",2001,522,11,511,138
"2218","E01018510",2001,626,45,581,12
"2219","E01018511",2001,635,210,425,12
"2220","E01018512",2001,713,188,525,37
"2221","E01018513",2001,652,3,649,16
"2222","E01018445",2001,649,292,357,39
"2223","E01018446",2001,494,167,327,4
"2224","E01018447",2001,635,40,595,123
"2225","E01018448",2001,614,25,589,73
"2226","E01018490",2001,620,0,620,13
"2227","E01018491",2001,537,18,519,19
"2228","E01018492",2001,515,5,510,4
"2229","E01018505",2001,401,6,395,4
"2230","E01018506",2001,523,3,520,3
"2231","E01018507",2001,523,3,520,3
"2232","E01018454",2001,602,217,385,50
"2233","E01018455",2001,605,44,561,21
"2234","E01018456",2001,587,6,581,12
"2235","E01018457",2001,524,17,507,70
"2236","E01018451",2001,755,272,483,42
"2237","E01018444",2001,762,74,688,69
"2238","E01018480",2001,696,47,649,70
"2239","E01018515",2001,593,33,560,63
"2240","E01018516",2001,587,23,564,19
"2241","E01018517",2001,591,13,578,29
"2242","E01018508",2001,476,6,470,6
"2243","E01018509",2001,492,37,455,46
"2244","E01018493",2001,605,44,561,18
"2245","E01018494",2001,583,0,583,26
"2246","E01018495",2001,520,4,516,19
"2247","E01018452",2001,524,146,378,11
"2248","E01018453",2001,628,199,429,74
"2249","E01018503",2001,663,0,663,24
"2250","E01018504",2001,772,142,630,81
"2251","E01018514",2001,727,93,634,84
"2252","E01018449",2001,704,55,649,25
"2253","E01018450",2001,784,43,741,83
"2254","E01018481",2001,764,71,693,158
"2255","E01018458",2001,828,83,745,70
"2256","E01018534",2001,926,480,446,48
"2257","E01018535",2001,629,167,462,19
"2258","E01018536",2001,715,24,691,52
"2259","E01018537",2001,813,33,780,45
"2260","E01018518",2001,680,18,662,40
"2261","E01018569",2001,530,4,526,9
"2262","E01018570",2001,483,28,455,23
"2263","E01018571",2001,596,51,545,42
"2264","E01018546",2001,591,169,422,24
"2265","E01018547",2001,625,77,548,12
"2266","E01018548",2001,631,226,405,15
"2267","E01018549",2001,639,94,545,27
"2268","E01018544",2001,627,6,621,18
"2269","E01018545",2001,827,10,817,38
"2270","E01018532",2001,852,225,627,36
"2271","E01018533",2001,602,6,596,8
"2272","E01018525",2001,543,299,244,14
"2273","E01018519",2001,676,90,586,113
"2274","E01018520",2001,492,109,383,82
"2275","E01018563",2001,717,529,188,28
"2276","E01018564",2001,903,237,666,120
"2277","E01018523",2001,618,299,319,9
"2278","E01018524",2001,625,444,181,7
"2279","E01018541",2001,624,87,537,25
"2280","E01018542",2001,483,361,122,5
"2281","E01018543",2001,606,160,446,55
"2282","E01018528",2001,493,6,487,6
"2283","E01018529",2001,647,4,643,5
"2284","E01018530",2001,483,3,480,12
"2285","E01018531",2001,631,9,622,45
"2286","E01018560",2001,474,7,467,5
"2287","E01018561",2001,471,0,471,7
"2288","E01018562",2001,509,3,506,10
"2289","E01018538",2001,471,245,226,9
"2290","E01018539",2001,517,238,279,9
"2291","E01018540",2001,606,43,563,14
"2292","E01018522",2001,624,263,361,15
"2293","E01018521",2001,510,255,255,20
"2294","E01018550",2001,490,347,143,6
"2295","E01018551",2001,642,441,201,12
"2296","E01018552",2001,573,212,361,24
"2297","E01018553",2001,638,285,353,11
"2298","E01018556",2001,612,65,547,6
"2299","E01018557",2001,667,275,392,13
"2300","E01018558",2001,496,3,493,7
"2301","E01018559",2001,468,0,468,10
"2302","E01018565",2001,628,32,596,20
"2303","E01018566",2001,604,8,596,12
"2304","E01018567",2001,607,12,595,14
"2305","E01018568",2001,504,6,498,4
"2306","E01018554",2001,964,4,960,14
"2307","E01018555",2001,476,4,472,7
"2308","E01018526",2001,656,6,650,19
"2309","E01018527",2001,637,8,629,14
"2310","E01018661",2001,492,11,481,20
"2311","E01018585",2001,626,92,534,37
"2312","E01018586",2001,655,19,636,51
"2313","E01018587",2001,609,3,606,33
"2314","E01018662",2001,467,3,464,14
"2315","E01018663",2001,601,9,592,18
"2316","E01018664",2001,576,9,567,18
"2317","E01018665",2001,475,93,382,16
"2318","E01018657",2001,512,198,314,14
"2319","E01018658",2001,486,4,482,4
"2320","E01018659",2001,507,0,507,3
"2321","E01018660",2001,403,22,381,12
"2322","E01018655",2001,644,27,617,28
"2323","E01018656",2001,637,4,633,24
"2324","E01018592",2001,693,83,610,23
"2325","E01018593",2001,769,68,701,25
"2326","E01018594",2001,773,390,383,28
"2327","E01018595",2001,728,168,560,71
"2328","E01018596",2001,723,436,287,23
"2329","E01018582",2001,767,41,726,98
"2330","E01018583",2001,755,26,729,70
"2331","E01018584",2001,654,5,649,53
"2332","E01018612",2001,496,105,391,18
"2333","E01018613",2001,745,264,481,42
"2334","E01018600",2001,643,7,636,39
"2335","E01018601",2001,775,83,692,95
"2336","E01018602",2001,715,46,669,82
"2337","E01018652",2001,607,8,599,54
"2338","E01018654",2001,850,47,803,91
"2339","E01018648",2001,871,88,783,238
"2340","E01018649",2001,527,10,517,48
"2341","E01018650",2001,605,64,541,51
"2342","E01018651",2001,475,40,435,77
"2343","E01018598",2001,522,17,505,69
"2344","E01018599",2001,478,18,460,43
"2345","E01018588",2001,616,6,610,51
"2346","E01018589",2001,615,3,612,23
"2347","E01018590",2001,736,43,693,31
"2348","E01018653",2001,883,4,879,64
"2349","E01018605",2001,481,4,477,27
"2350","E01018609",2001,739,84,655,28
"2351","E01018610",2001,835,205,630,63
"2352","E01018611",2001,751,405,346,35
"2353","E01018666",2001,713,9,704,17
"2354","E01018667",2001,682,58,624,55
"2355","E01018668",2001,629,10,619,44
"2356","E01018606",2001,728,128,600,127
"2357","E01018607",2001,496,0,496,16
"2358","E01018608",2001,507,4,503,12
"2359","E01018603",2001,497,0,497,12
"2360","E01018604",2001,606,103,503,39
"2361","E01018580",2001,508,10,498,51
"2362","E01018581",2001,533,61,472,20
"2363","E01018572",2001,648,11,637,36
"2364","E01018573",2001,646,0,646,43
"2365","E01018574",2001,899,154,745,88
"2366","E01018575",2001,472,10,462,60
"2367","E01018576",2001,728,39,689,120
"2368","E01018577",2001,993,106,887,77
"2369","E01018578",2001,473,11,462,36
"2370","E01018579",2001,482,167,315,24
"2371","E01018641",2001,499,0,499,8
"2372","E01018642",2001,521,0,521,19
"2373","E01018643",2001,589,40,549,14
"2374","E01018644",2001,627,9,618,57
"2375","E01018614",2001,622,3,619,35
"2376","E01018618",2001,602,179,423,37
"2377","E01018619",2001,526,12,514,20
"2378","E01018620",2001,565,168,397,22
"2379","E01018621",2001,517,15,502,14
"2380","E01018628",2001,629,37,592,11
"2381","E01018629",2001,625,187,438,46
"2382","E01018630",2001,615,84,531,56
"2383","E01018631",2001,705,356,349,25
"2384","E01018626",2001,1027,219,808,102
"2385","E01018632",2001,650,9,641,39
"2386","E01018633",2001,612,8,604,21
"2387","E01018615",2001,490,10,480,68
"2388","E01018616",2001,498,45,453,33
"2389","E01018617",2001,692,95,597,32
"2390","E01018622",2001,665,125,540,128
"2391","E01018623",2001,642,29,613,68
"2392","E01018624",2001,762,29,733,221
"2393","E01018625",2001,610,6,604,89
"2394","E01018635",2001,535,35,500,98
"2395","E01018636",2001,571,65,506,9
"2396","E01018627",2001,770,63,707,176
"2397","E01018634",2001,752,17,735,19
"2398","E01018645",2001,880,465,415,32
"2399","E01018646",2001,698,256,442,26
"2400","E01018647",2001,617,113,504,29
"2401","E01018669",2001,1043,57,986,57
"2402","E01018670",2001,930,58,872,59
"2403","E01018591",2001,952,78,874,55
"2404","E01018597",2001,933,63,870,146
"2405","E01018637",2001,528,244,284,27
"2406","E01018638",2001,628,218,410,26
"2407","E01018639",2001,649,83,566,94
"2408","E01018640",2001,640,340,300,17
"2409","E01018685",2001,597,303,294,12
"2410","E01018686",2001,530,52,478,18
"2411","E01018687",2001,583,13,570,7
"2412","E01018688",2001,625,12,613,48
"2413","E01018689",2001,620,55,565,37
"2414","E01018690",2001,854,9,845,32
"2415","E01018675",2001,858,55,803,24
"2416","E01018708",2001,833,58,775,60
"2417","E01018721",2001,874,75,799,40
"2418","E01018671",2001,514,5,509,8
"2419","E01018672",2001,620,234,386,25
"2420","E01018673",2001,514,39,475,15
"2421","E01018674",2001,634,53,581,44
"2422","E01018684",2001,851,27,824,54
"2423","E01018695",2001,616,23,593,37
"2424","E01018696",2001,625,8,617,38
"2425","E01018697",2001,752,118,634,21
"2426","E01018698",2001,789,35,754,34
"2427","E01018704",2001,535,99,436,8
"2428","E01018705",2001,610,11,599,13
"2429","E01018706",2001,514,96,418,24
"2430","E01018718",2001,633,33,600,24
"2431","E01018722",2001,903,60,843,73
"2432","E01018713",2001,885,78,807,91
"2433","E01018714",2001,750,251,499,80
"2434","E01018715",2001,721,91,630,82
"2435","E01018726",2001,606,170,436,13
"2436","E01018727",2001,722,18,704,44
"2437","E01018728",2001,644,139,505,13
"2438","E01018729",2001,768,296,472,16
"2439","E01018709",2001,626,50,576,78
"2440","E01018710",2001,577,203,374,20
"2441","E01018711",2001,719,55,664,84
"2442","E01018712",2001,647,118,529,55
"2443","E01018716",2001,628,279,349,14
"2444","E01018717",2001,742,48,694,37
"2445","E01018719",2001,631,121,510,23
"2446","E01018720",2001,661,258,403,12
"2447","E01018701",2001,626,288,338,13
"2448","E01018699",2001,490,92,398,16
"2449","E01018700",2001,474,3,471,8
"2450","E01018702",2001,474,27,447,8
"2451","E01018703",2001,592,22,570,20
"2452","E01018693",2001,625,0,625,25
"2453","E01018694",2001,621,7,614,23
"2454","E01018691",2001,629,66,563,25
"2455","E01018692",2001,668,19,649,28
"2456","E01018676",2001,624,11,613,32
"2457","E01018677",2001,615,13,602,38
"2458","E01018678",2001,496,4,492,12
"2459","E01018679",2001,613,159,454,18
"2460","E01018680",2001,613,10,603,59
"2461","E01018681",2001,626,49,577,26
"2462","E01018682",2001,499,131,368,20
"2463","E01018683",2001,644,8,636,39
"2464","E01018733",2001,591,24,567,24
"2465","E01018734",2001,491,145,346,9
"2466","E01018748",2001,528,341,187,15
"2467","E01018749",2001,631,119,512,18
"2468","E01018743",2001,601,39,562,19
"2469","E01018744",2001,628,198,430,10
"2470","E01018736",2001,537,46,491,31
"2471","E01018737",2001,499,6,493,15
"2472","E01018732",2001,510,37,473,33
"2473","E01018745",2001,723,376,347,38
"2474","E01018746",2001,639,169,470,31
"2475","E01018747",2001,613,74,539,29
"2476","E01018741",2001,519,28,491,9
"2477","E01018738",2001,502,390,112,11
"2478","E01018739",2001,505,273,232,15
"2479","E01018730",2001,632,215,417,14
"2480","E01018731",2001,612,77,535,41
"2481","E01018740",2001,614,346,268,14
"2482","E01018742",2001,638,22,616,12
"2483","E01018735",2001,482,19,463,32
"2484","E01018723",2001,504,80,424,30
"2485","E01018724",2001,624,10,614,40
"2486","E01018725",2001,507,53,454,66
"2487","E01018707",2001,718,67,651,57
"2488","E01019126",2001,709,184,525,86
"2489","E01019127",2001,673,14,659,47
"2490","E01019132",2001,698,49,649,73
"2491","E01019134",2001,614,104,510,15
"2492","E01019135",2001,627,276,351,11
"2493","E01019136",2001,531,53,478,32
"2494","E01019137",2001,508,80,428,107
"2495","E01019130",2001,651,55,596,31
"2496","E01019131",2001,733,19,714,102
"2497","E01019107",2001,692,18,674,57
"2498","E01019083",2001,721,35,686,103
"2499","E01019081",2001,773,307,466,41
"2500","E01019082",2001,635,52,583,72
"2501","E01019102",2001,675,65,610,101
"2502","E01019133",2001,620,47,573,58
"2503","E01019128",2001,636,60,576,67
"2504","E01019093",2001,579,54,525,21
"2505","E01019094",2001,685,148,537,29
"2506","E01019114",2001,614,43,571,64
"2507","E01019115",2001,758,235,523,77
"2508","E01019096",2001,889,136,753,34
"2509","E01019097",2001,778,545,233,19
"2510","E01019098",2001,688,171,517,28
"2511","E01019099",2001,698,240,458,35
"2512","E01019095",2001,657,320,337,35
"2513","E01019088",2001,871,205,666,155
"2514","E01019091",2001,653,19,634,51
"2515","E01019084",2001,623,149,474,31
"2516","E01019085",2001,506,32,474,21
"2517","E01019086",2001,428,27,401,39
"2518","E01019087",2001,637,21,616,18
"2519","E01019078",2001,633,13,620,27
"2520","E01019079",2001,619,73,546,18
"2521","E01019080",2001,766,234,532,87
"2522","E01019090",2001,615,18,597,104
"2523","E01019116",2001,589,93,496,86
"2524","E01019118",2001,622,8,614,83
"2525","E01019122",2001,634,335,299,40
"2526","E01019123",2001,639,270,369,15
"2527","E01019124",2001,763,23,740,9
"2528","E01019125",2001,686,39,647,28
"2529","E01019120",2001,753,47,706,58
"2530","E01019121",2001,1008,246,762,147
"2531","E01019111",2001,636,276,360,44
"2532","E01019112",2001,626,345,281,12
"2533","E01019113",2001,734,479,255,18
"2534","E01019108",2001,621,358,263,11
"2535","E01019109",2001,735,280,455,18
"2536","E01019110",2001,817,479,338,11
"2537","E01019119",2001,624,11,613,18
"2538","E01019117",2001,512,4,508,21
"2539","E01019129",2001,663,11,652,20
"2540","E01019089",2001,643,229,414,48
"2541","E01019100",2001,648,26,622,38
"2542","E01019101",2001,596,9,587,15
"2543","E01019103",2001,485,116,369,27
"2544","E01019104",2001,773,274,499,77
"2545","E01019105",2001,504,41,463,117
"2546","E01019106",2001,633,56,577,48
"2547","E01019092",2001,653,64,589,82
"2548","E01019144",2001,586,38,548,31
"2549","E01019145",2001,808,6,802,66
"2550","E01019146",2001,569,29,540,30
"2551","E01019147",2001,658,4,654,74
"2552","E01019148",2001,617,9,608,12
"2553","E01019149",2001,598,18,580,84
"2554","E01019150",2001,735,104,631,55
"2555","E01019151",2001,608,123,485,7
"2556","E01019152",2001,446,8,438,32
"2557","E01019153",2001,465,3,462,6
"2558","E01019154",2001,632,6,626,15
"2559","E01019155",2001,688,4,684,11
"2560","E01019162",2001,633,3,630,15
"2561","E01019163",2001,504,6,498,28
"2562","E01019164",2001,581,411,170,24
"2563","E01019165",2001,661,147,514,48
"2564","E01019166",2001,634,162,472,47
"2565","E01019156",2001,742,321,421,106
"2566","E01019159",2001,500,11,489,61
"2567","E01019167",2001,726,14,712,49
"2568","E01019168",2001,616,58,558,47
"2569","E01019169",2001,513,3,510,32
"2570","E01019170",2001,501,6,495,22
"2571","E01019171",2001,636,0,636,89
"2572","E01019176",2001,610,7,603,10
"2573","E01019177",2001,516,202,314,12
"2574","E01019178",2001,588,12,576,32
"2575","E01019179",2001,497,3,494,15
"2576","E01019161",2001,608,161,447,18
"2577","E01019160",2001,629,291,338,10
"2578","E01019140",2001,496,192,304,59
"2579","E01019172",2001,641,11,630,94
"2580","E01019173",2001,610,46,564,69
"2581","E01019174",2001,474,149,325,27
"2582","E01019175",2001,567,152,415,20
"2583","E01019157",2001,745,73,672,208
"2584","E01019158",2001,621,25,596,164
"2585","E01019141",2001,743,142,601,193
"2586","E01019142",2001,646,19,627,109
"2587","E01019143",2001,660,107,553,161
"2588","E01019180",2001,604,8,596,21
"2589","E01019181",2001,671,56,615,97
"2590","E01019182",2001,621,24,597,28
"2591","E01019183",2001,568,274,294,17
"2592","E01019184",2001,654,60,594,46
"2593","E01019185",2001,626,10,616,21
"2594","E01019186",2001,601,7,594,53
"2595","E01019187",2001,539,106,433,20
"2596","E01019138",2001,615,24,591,57
"2597","E01019139",2001,709,94,615,358
"2598","E01019226",2001,448,15,433,55
"2599","E01019227",2001,626,245,381,47
"2600","E01019228",2001,559,21,538,107
"2601","E01019229",2001,765,29,736,77
"2602","E01019225",2001,803,33,770,118
"2603","E01019200",2001,651,89,562,70
"2604","E01019201",2001,639,187,452,66
"2605","E01019202",2001,627,197,430,78
"2606","E01019188",2001,620,139,481,35
"2607","E01019189",2001,637,99,538,44
"2608","E01019190",2001,624,7,617,16
"2609","E01019191",2001,631,24,607,23
"2610","E01019244",2001,640,8,632,17
"2611","E01019238",2001,519,6,513,23
"2612","E01019240",2001,544,15,529,50
"2613","E01019241",2001,599,46,553,7
"2614","E01019243",2001,603,27,576,18
"2615","E01019251",2001,520,22,498,29
"2616","E01019196",2001,747,99,648,51
"2617","E01019203",2001,760,50,710,64
"2618","E01019195",2001,503,6,497,18
"2619","E01019192",2001,604,9,595,8
"2620","E01019254",2001,596,42,554,12
"2621","E01019255",2001,556,11,545,11
"2622","E01019237",2001,599,47,552,108
"2623","E01019242",2001,620,98,522,69
"2624","E01019234",2001,820,294,526,122
"2625","E01019235",2001,662,19,643,63
"2626","E01019204",2001,488,75,413,118
"2627","E01019206",2001,729,56,673,340
"2628","E01019219",2001,839,46,793,95
"2629","E01019224",2001,844,68,776,42
"2630","E01019239",2001,567,23,544,54
"2631","E01019249",2001,638,11,627,33
"2632","E01019250",2001,519,49,470,48
"2633","E01019233",2001,636,114,522,9
"2634","E01019218",2001,599,171,428,30
"2635","E01019215",2001,648,204,444,46
"2636","E01019207",2001,673,148,525,78
"2637","E01019205",2001,772,177,595,105
"2638","E01019193",2001,627,374,253,27
"2639","E01019194",2001,597,254,343,22
"2640","E01019230",2001,807,321,486,17
"2641","E01019231",2001,835,406,429,9
"2642","E01019232",2001,664,114,550,18
"2643","E01019252",2001,664,169,495,20
"2644","E01019236",2001,689,41,648,175
"2645","E01019209",2001,653,134,519,48
"2646","E01019211",2001,745,21,724,125
"2647","E01019216",2001,765,104,661,140
"2648","E01019217",2001,728,81,647,122
"2649","E01019220",2001,583,51,532,112
"2650","E01019221",2001,664,213,451,20
"2651","E01019222",2001,650,264,386,12
"2652","E01019197",2001,752,450,302,26
"2653","E01019198",2001,624,230,394,36
"2654","E01019199",2001,474,200,274,12
"2655","E01019245",2001,640,373,267,16
"2656","E01019246",2001,622,226,396,28
"2657","E01019247",2001,633,114,519,17
"2658","E01019248",2001,507,270,237,17
"2659","E01019210",2001,574,188,386,20
"2660","E01019208",2001,623,215,408,16
"2661","E01019212",2001,616,19,597,86
"2662","E01019213",2001,712,49,663,61
"2663","E01019214",2001,812,97,715,54
"2664","E01019223",2001,619,29,590,9
"2665","E01019253",2001,626,28,598,19
"2666","E01019297",2001,488,84,404,29
"2667","E01019268",2001,466,42,424,33
"2668","E01019269",2001,664,346,318,26
"2669","E01019270",2001,545,165,380,36
"2670","E01019280",2001,1003,459,544,158
"2671","E01019281",2001,516,98,418,42
"2672","E01019282",2001,495,86,409,36
"2673","E01019260",2001,630,159,471,34
"2674","E01019261",2001,614,14,600,8
"2675","E01019262",2001,619,49,570,10
"2676","E01019284",2001,616,259,357,21
"2677","E01019285",2001,627,179,448,54
"2678","E01019286",2001,610,99,511,42
"2679","E01019287",2001,508,14,494,11
"2680","E01019288",2001,530,0,530,6
"2681","E01019276",2001,412,21,391,50
"2682","E01019277",2001,592,285,307,32
"2683","E01019278",2001,486,37,449,31
"2684","E01019263",2001,531,242,289,12
"2685","E01019264",2001,649,112,537,24
"2686","E01019265",2001,619,175,444,49
"2687","E01019266",2001,594,63,531,36
"2688","E01019267",2001,605,331,274,33
"2689","E01019256",2001,629,32,597,37
"2690","E01019291",2001,590,200,390,41
"2691","E01019292",2001,493,29,464,25
"2692","E01019294",2001,630,217,413,12
"2693","E01019295",2001,613,363,250,8
"2694","E01019296",2001,622,234,388,25
"2695","E01019301",2001,722,492,230,35
"2696","E01019302",2001,410,69,341,28
"2697","E01019271",2001,518,185,333,21
"2698","E01019272",2001,613,228,385,46
"2699","E01019273",2001,593,43,550,47
"2700","E01019274",2001,735,234,501,57
"2701","E01019275",2001,934,183,751,31
"2702","E01019279",2001,633,25,608,76
"2703","E01019303",2001,649,24,625,71
"2704","E01019304",2001,585,40,545,64
"2705","E01019257",2001,515,123,392,30
"2706","E01019258",2001,624,28,596,35
"2707","E01019300",2001,637,28,609,58
"2708","E01019259",2001,579,57,522,86
"2709","E01019298",2001,652,78,574,33
"2710","E01019299",2001,882,196,686,106
"2711","E01019293",2001,578,35,543,73
"2712","E01019289",2001,618,211,407,20
"2713","E01019290",2001,467,59,408,50
"2714","E01019283",2001,553,63,490,53
"2715","E01019305",2001,937,129,808,112
"2716","E01019314",2001,429,17,412,53
"2717","E01019320",2001,580,36,544,68
"2718","E01019321",2001,575,58,517,73
"2719","E01019322",2001,596,62,534,90
"2720","E01019315",2001,649,16,633,93
"2721","E01019316",2001,437,10,427,88
"2722","E01019338",2001,543,7,536,89
"2723","E01019327",2001,642,136,506,67
"2724","E01019332",2001,612,201,411,23
"2725","E01019333",2001,493,140,353,78
"2726","E01019335",2001,601,127,474,65
"2727","E01019336",2001,718,85,633,124
"2728","E01019334",2001,598,56,542,22
"2729","E01019328",2001,517,45,472,10
"2730","E01019329",2001,475,8,467,32
"2731","E01019330",2001,622,31,591,73
"2732","E01019331",2001,619,83,536,28
"2733","E01019312",2001,557,29,528,66
"2734","E01019326",2001,631,29,602,45
"2735","E01019313",2001,609,53,556,72
"2736","E01019311",2001,569,33,536,60
"2737","E01019308",2001,565,103,462,142
"2738","E01019339",2001,611,35,576,90
"2739","E01019337",2001,574,74,500,50
"2740","E01019310",2001,515,20,495,112
"2741","E01019319",2001,561,67,494,94
"2742","E01019323",2001,479,16,463,55
"2743","E01019324",2001,489,12,477,88
"2744","E01019306",2001,654,96,558,100
"2745","E01019307",2001,648,48,600,71
"2746","E01019325",2001,556,22,534,94
"2747","E01019309",2001,881,38,843,179
"2748","E01019317",2001,514,3,511,59
"2749","E01019318",2001,586,119,467,92
"2750","E01019340",2001,499,12,487,93
"2751","E01019374",2001,742,193,549,151
"2752","E01019375",2001,698,88,610,101
"2753","E01019376",2001,607,116,491,113
"2754","E01019395",2001,946,126,820,217
"2755","E01019396",2001,926,69,857,120
"2756","E01019397",2001,793,68,725,193
"2757","E01019398",2001,483,145,338,53
"2758","E01019399",2001,477,139,338,21
"2759","E01019387",2001,906,66,840,116
"2760","E01019370",2001,898,76,822,99
"2761","E01019359",2001,914,221,693,51
"2762","E01019365",2001,902,30,872,141
"2763","E01019346",2001,845,151,694,96
"2764","E01019360",2001,783,75,708,176
"2765","E01019371",2001,905,254,651,29
"2766","E01019363",2001,860,151,709,140
"2767","E01019364",2001,814,302,512,76
"2768","E01019362",2001,900,11,889,39
"2769","E01019358",2001,785,76,709,65
"2770","E01019366",2001,765,87,678,29
"2771","E01019394",2001,808,14,794,105
"2772","E01019367",2001,932,104,828,95
"2773","E01019368",2001,830,7,823,36
"2774","E01019369",2001,858,76,782,28
"2775","E01019361",2001,795,63,732,25
"2776","E01019356",2001,747,88,659,192
"2777","E01019381",2001,854,38,816,107
"2778","E01019386",2001,745,40,705,146
"2779","E01019350",2001,809,90,719,163
"2780","E01019351",2001,761,26,735,121
"2781","E01019344",2001,468,36,432,46
"2782","E01019345",2001,534,35,499,43
"2783","E01019384",2001,942,22,920,128
"2784","E01019385",2001,540,144,396,68
"2785","E01019372",2001,528,83,445,96
"2786","E01019373",2001,486,10,476,85
"2787","E01019377",2001,738,30,708,59
"2788","E01019383",2001,848,25,823,75
"2789","E01019352",2001,870,29,841,95
"2790","E01019348",2001,494,3,491,42
"2791","E01019382",2001,918,157,761,66
"2792","E01019347",2001,613,33,580,47
"2793","E01019341",2001,737,22,715,21
"2794","E01019342",2001,481,64,417,52
"2795","E01019343",2001,649,20,629,67
"2796","E01019392",2001,924,98,826,149
"2797","E01019388",2001,781,171,610,60
"2798","E01019389",2001,861,231,630,69
"2799","E01019390",2001,870,65,805,102
"2800","E01019349",2001,777,50,727,73
"2801","E01019357",2001,797,25,772,122
"2802","E01019353",2001,635,48,587,41
"2803","E01019354",2001,703,76,627,88
"2804","E01019355",2001,621,4,617,25
"2805","E01019378",2001,568,54,514,17
"2806","E01019379",2001,610,31,579,42
"2807","E01019380",2001,464,7,457,34
"2808","E01019391",2001,743,56,687,26
"2809","E01019393",2001,833,10,823,54
"2810","E01004768",2001,604,6,598,19
"2811","E01004803",2001,605,9,596,26
"2812","E01004804",2001,584,12,572,13
"2813","E01004807",2001,502,7,495,13
"2814","E01004808",2001,578,9,569,13
"2815","E01004788",2001,637,7,630,11
"2816","E01004810",2001,641,16,625,18
"2817","E01004805",2001,651,18,633,14
"2818","E01004806",2001,643,20,623,13
"2819","E01004790",2001,640,88,552,24
"2820","E01004769",2001,626,11,615,23
"2821","E01004770",2001,622,6,616,26
"2822","E01004771",2001,621,7,614,7
"2823","E01004773",2001,614,9,605,26
"2824","E01004809",2001,773,166,607,49
"2825","E01004881",2001,780,210,570,57
"2826","E01004888",2001,586,170,416,3
"2827","E01004889",2001,632,173,459,22
"2828","E01004890",2001,584,6,578,67
"2829","E01004777",2001,665,160,505,52
"2830","E01004774",2001,639,182,457,49
"2831","E01004772",2001,714,356,358,20
"2832","E01004766",2001,777,111,666,98
"2833","E01004767",2001,650,47,603,45
"2834","E01004824",2001,459,56,403,41
"2835","E01004789",2001,573,7,566,11
"2836","E01004791",2001,613,33,580,23
"2837","E01004792",2001,645,8,637,6
"2838","E01004784",2001,506,0,506,5
"2839","E01004785",2001,628,92,536,15
"2840","E01004786",2001,618,53,565,21
"2841","E01004779",2001,556,139,417,21
"2842","E01004781",2001,586,44,542,56
"2843","E01004882",2001,612,91,521,32
"2844","E01004883",2001,614,33,581,44
"2845","E01004884",2001,589,15,574,14
"2846","E01004921",2001,737,76,661,58
"2847","E01004924",2001,602,14,588,7
"2848","E01004925",2001,625,31,594,28
"2849","E01004867",2001,610,61,549,56
"2850","E01004864",2001,690,66,624,44
"2851","E01004782",2001,511,169,342,11
"2852","E01004783",2001,648,28,620,22
"2853","E01004780",2001,609,12,597,33
"2854","E01004778",2001,505,23,482,18
"2855","E01004802",2001,711,438,273,26
"2856","E01004926",2001,530,301,229,23
"2857","E01004927",2001,738,384,354,75
"2858","E01004929",2001,666,229,437,58
"2859","E01004820",2001,613,259,354,73
"2860","E01004825",2001,584,296,288,51
"2861","E01004826",2001,605,162,443,111
"2862","E01004865",2001,647,145,502,75
"2863","E01004866",2001,712,387,325,52
"2864","E01004840",2001,657,99,558,35
"2865","E01004841",2001,666,478,188,20
"2866","E01004842",2001,736,60,676,17
"2867","E01004919",2001,643,5,638,29
"2868","E01004920",2001,668,141,527,22
"2869","E01004787",2001,723,437,286,38
"2870","E01004793",2001,647,347,300,7
"2871","E01004794",2001,642,358,284,17
"2872","E01004795",2001,680,238,442,17
"2873","E01004797",2001,496,233,263,17
"2874","E01004775",2001,616,18,598,14
"2875","E01004885",2001,524,9,515,18
"2876","E01004886",2001,622,271,351,12
"2877","E01004887",2001,584,211,373,11
"2878","E01004922",2001,727,198,529,71
"2879","E01004868",2001,647,78,569,133
"2880","E01004869",2001,815,197,618,166
"2881","E01004870",2001,658,63,595,191
"2882","E01004871",2001,488,38,450,80
"2883","E01004848",2001,669,442,227,40
"2884","E01004821",2001,1052,784,268,40
"2885","E01004822",2001,618,272,346,63
"2886","E01004823",2001,739,475,264,42
"2887","E01004818",2001,600,195,405,123
"2888","E01004819",2001,541,32,509,43
"2889","E01004928",2001,658,63,595,88
"2890","E01004930",2001,639,45,594,20
"2891","E01004931",2001,719,280,439,23
"2892","E01004932",2001,609,25,584,118
"2893","E01004923",2001,605,15,590,86
"2894","E01004834",2001,570,41,529,57
"2895","E01004843",2001,598,20,578,22
"2896","E01004838",2001,621,157,464,72
"2897","E01004845",2001,546,42,504,23
"2898","E01004917",2001,660,150,510,17
"2899","E01004798",2001,680,225,455,27
"2900","E01004799",2001,586,3,583,12
"2901","E01004800",2001,518,0,518,21
"2902","E01004801",2001,627,474,153,9
"2903","E01004796",2001,656,34,622,38
"2904","E01004897",2001,479,6,473,19
"2905","E01004844",2001,578,3,575,7
"2906","E01004835",2001,572,33,539,19
"2907","E01004836",2001,587,23,564,25
"2908","E01004837",2001,581,5,576,20
"2909","E01004827",2001,668,270,398,44
"2910","E01004853",2001,489,234,255,38
"2911","E01004849",2001,494,107,387,67
"2912","E01004850",2001,686,357,329,70
"2913","E01004851",2001,610,368,242,34
"2914","E01004817",2001,624,209,415,57
"2915","E01004815",2001,569,101,468,48
"2916","E01004811",2001,661,252,409,64
"2917","E01004812",2001,508,49,459,97
"2918","E01004813",2001,511,108,403,49
"2919","E01004828",2001,623,166,457,81
"2920","E01004829",2001,487,94,393,71
"2921","E01004832",2001,638,24,614,71
"2922","E01004854",2001,439,72,367,63
"2923","E01004878",2001,531,70,461,22
"2924","E01004918",2001,506,5,501,12
"2925","E01004911",2001,704,210,494,41
"2926","E01004912",2001,607,26,581,8
"2927","E01004913",2001,593,108,485,33
"2928","E01004914",2001,508,4,504,8
"2929","E01004915",2001,535,7,528,6
"2930","E01004916",2001,629,192,437,32
"2931","E01004877",2001,636,424,212,16
"2932","E01004879",2001,477,211,266,26
"2933","E01004846",2001,502,127,375,46
"2934","E01004847",2001,553,236,317,42
"2935","E01004852",2001,472,142,330,34
"2936","E01004839",2001,790,559,231,44
"2937","E01004833",2001,599,19,580,44
"2938","E01004830",2001,732,192,540,84
"2939","E01004831",2001,616,6,610,54
"2940","E01004814",2001,519,47,472,62
"2941","E01004855",2001,598,86,512,53
"2942","E01004856",2001,635,200,435,49
"2943","E01004857",2001,614,197,417,75
"2944","E01004893",2001,553,3,550,7
"2945","E01004894",2001,683,78,605,47
"2946","E01004898",2001,666,8,658,18
"2947","E01004891",2001,754,65,689,28
"2948","E01004901",2001,637,9,628,15
"2949","E01004880",2001,512,4,508,9
"2950","E01004875",2001,652,90,562,25
"2951","E01004872",2001,601,165,436,28
"2952","E01004873",2001,611,272,339,20
"2953","E01004816",2001,514,118,396,23
"2954","E01004899",2001,602,90,512,20
"2955","E01004900",2001,572,21,551,22
"2956","E01004892",2001,683,27,656,23
"2957","E01004896",2001,546,3,543,9
"2958","E01004895",2001,613,189,424,24
"2959","E01004938",2001,632,381,251,13
"2960","E01004939",2001,673,151,522,31
"2961","E01004936",2001,790,49,741,49
"2962","E01004776",2001,684,147,537,61
"2963","E01004902",2001,677,114,563,52
"2964","E01004906",2001,743,274,469,37
"2965","E01004858",2001,667,218,449,49
"2966","E01004859",2001,654,362,292,31
"2967","E01004860",2001,648,97,551,32
"2968","E01004861",2001,524,346,178,18
"2969","E01004862",2001,585,339,246,18
"2970","E01004863",2001,599,305,294,34
"2971","E01004874",2001,660,218,442,12
"2972","E01004876",2001,704,306,398,18
"2973","E01004907",2001,545,199,346,20
"2974","E01004908",2001,564,77,487,6
"2975","E01004909",2001,607,196,411,13
"2976","E01004910",2001,625,83,542,31
"2977","E01004903",2001,516,14,502,9
"2978","E01004904",2001,629,83,546,25
"2979","E01004905",2001,657,147,510,37
"2980","E01004937",2001,568,12,556,27
"2981","E01004940",2001,601,26,575,23
"2982","E01004933",2001,557,0,557,37
"2983","E01004934",2001,553,123,430,18
"2984","E01004935",2001,576,36,540,30
"2985","E01005014",2001,648,38,610,97
"2986","E01005015",2001,658,207,451,33
"2987","E01005016",2001,721,23,698,74
"2988","E01005017",2001,617,50,567,27
"2989","E01005018",2001,637,128,509,47
"2990","E01005021",2001,403,0,403,12
"2991","E01005023",2001,613,90,523,12
"2992","E01005019",2001,598,30,568,20
"2993","E01005046",2001,619,0,619,19
"2994","E01005048",2001,636,3,633,6
"2995","E01005049",2001,732,10,722,51
"2996","E01005051",2001,639,97,542,32
"2997","E01005047",2001,562,10,552,21
"2998","E01005020",2001,512,6,506,6
"2999","E01005022",2001,633,10,623,44
"3000","E01004976",2001,634,219,415,20
"3001","E01004977",2001,636,117,519,20
"3002","E01004978",2001,636,56,580,52
"3003","E01004981",2001,619,81,538,21
"3004","E01004982",2001,634,14,620,22
"3005","E01004965",2001,499,18,481,14
"3006","E01004966",2001,582,249,333,10
"3007","E01004967",2001,474,3,471,3
"3008","E01004961",2001,622,182,440,32
"3009","E01004963",2001,643,81,562,15
"3010","E01004968",2001,597,4,593,3
"3011","E01005052",2001,576,4,572,8
"3012","E01005053",2001,623,57,566,39
"3013","E01005050",2001,648,47,601,32
"3014","E01004960",2001,615,432,183,25
"3015","E01004954",2001,615,98,517,34
"3016","E01004955",2001,566,122,444,30
"3017","E01004956",2001,705,163,542,51
"3018","E01004957",2001,716,399,317,25
"3019","E01004958",2001,634,132,502,89
"3020","E01004959",2001,619,127,492,70
"3021","E01004979",2001,604,172,432,103
"3022","E01004980",2001,537,74,463,74
"3023","E01005024",2001,512,96,416,101
"3024","E01005026",2001,537,35,502,93
"3025","E01004964",2001,654,63,591,62
"3026","E01004962",2001,651,13,638,68
"3027","E01004947",2001,682,100,582,71
"3028","E01004948",2001,765,215,550,65
"3029","E01004949",2001,602,3,599,13
"3030","E01004950",2001,612,51,561,7
"3031","E01004951",2001,633,11,622,7
"3032","E01004952",2001,627,0,627,13
"3033","E01004953",2001,614,63,551,10
"3034","E01005027",2001,606,63,543,55
"3035","E01005028",2001,749,380,369,30
"3036","E01005029",2001,627,63,564,44
"3037","E01005025",2001,644,55,589,47
"3038","E01005005",2001,627,26,601,14
"3039","E01005006",2001,623,135,488,12
"3040","E01005000",2001,585,0,585,17
"3041","E01005001",2001,488,26,462,13
"3042","E01005030",2001,692,298,394,126
"3043","E01005054",2001,610,34,576,32
"3044","E01005059",2001,532,156,376,13
"3045","E01005060",2001,656,49,607,36
"3046","E01005002",2001,636,58,578,11
"3047","E01005003",2001,637,104,533,56
"3048","E01004997",2001,610,37,573,50
"3049","E01004998",2001,627,10,617,32
"3050","E01004999",2001,594,48,546,16
"3051","E01004991",2001,517,60,457,27
"3052","E01004992",2001,632,38,594,79
"3053","E01004993",2001,543,145,398,18
"3054","E01004994",2001,610,172,438,81
"3055","E01004990",2001,616,119,497,40
"3056","E01005004",2001,849,518,331,24
"3057","E01004996",2001,648,247,401,90
"3058","E01005008",2001,704,339,365,70
"3059","E01005009",2001,688,203,485,110
"3060","E01005055",2001,590,10,580,19
"3061","E01005056",2001,612,18,594,20
"3062","E01005057",2001,587,60,527,55
"3063","E01005058",2001,510,3,507,9
"3064","E01004945",2001,615,41,574,24
"3065","E01005010",2001,639,51,588,31
"3066","E01005012",2001,626,201,425,34
"3067","E01005013",2001,607,204,403,53
"3068","E01004995",2001,618,5,613,17
"3069","E01004984",2001,599,15,584,35
"3070","E01004985",2001,606,15,591,19
"3071","E01004989",2001,497,3,494,31
"3072","E01005007",2001,736,30,706,39
"3073","E01005011",2001,591,13,578,17
"3074","E01004986",2001,756,134,622,83
"3075","E01004987",2001,669,342,327,20
"3076","E01004988",2001,614,72,542,24
"3077","E01004983",2001,525,23,502,86
"3078","E01004946",2001,772,476,296,26
"3079","E01004941",2001,621,187,434,38
"3080","E01004942",2001,629,366,263,16
"3081","E01004943",2001,581,106,475,58
"3082","E01004944",2001,616,22,594,27
"3083","E01004969",2001,727,42,685,90
"3084","E01004970",2001,606,26,580,23
"3085","E01004971",2001,606,8,598,24
"3086","E01005034",2001,616,24,592,52
"3087","E01005039",2001,673,210,463,68
"3088","E01004972",2001,561,221,340,33
"3089","E01004973",2001,647,28,619,60
"3090","E01004975",2001,723,143,580,87
"3091","E01005045",2001,658,119,539,53
"3092","E01004974",2001,613,22,591,41
"3093","E01005036",2001,871,406,465,104
"3094","E01005037",2001,635,16,619,49
"3095","E01005033",2001,579,12,567,92
"3096","E01005035",2001,623,57,566,50
"3097","E01005031",2001,629,171,458,27
"3098","E01005032",2001,506,185,321,50
"3099","E01005038",2001,495,3,492,18
"3100","E01005040",2001,713,72,641,56
"3101","E01005041",2001,523,6,517,25
"3102","E01005042",2001,619,62,557,50
"3103","E01005043",2001,508,7,501,84
"3104","E01005044",2001,475,32,443,138
"3105","E01005098",2001,737,452,285,52
"3106","E01005099",2001,606,441,165,15
"3107","E01005100",2001,629,219,410,18
"3108","E01005102",2001,621,53,568,46
"3109","E01005103",2001,761,345,416,51
"3110","E01005101",2001,628,288,340,45
"3111","E01005135",2001,598,316,282,35
"3112","E01005136",2001,614,132,482,38
"3113","E01005138",2001,788,539,249,29
"3114","E01005140",2001,739,112,627,109
"3115","E01005141",2001,754,519,235,15
"3116","E01005139",2001,635,162,473,25
"3117","E01005137",2001,879,498,381,25
"3118","E01005251",2001,624,297,327,27
"3119","E01005252",2001,772,362,410,34
"3120","E01005160",2001,652,110,542,56
"3121","E01005161",2001,664,21,643,81
"3122","E01005162",2001,611,116,495,77
"3123","E01005163",2001,660,63,597,104
"3124","E01005104",2001,647,403,244,28
"3125","E01005253",2001,632,320,312,23
"3126","E01005254",2001,643,67,576,29
"3127","E01005247",2001,612,59,553,26
"3128","E01005248",2001,589,39,550,23
"3129","E01005249",2001,608,199,409,47
"3130","E01005250",2001,626,282,344,26
"3131","E01005205",2001,738,470,268,69
"3132","E01005206",2001,631,120,511,114
"3133","E01005207",2001,611,66,545,131
"3134","E01005164",2001,583,177,406,158
"3135","E01005223",2001,660,149,511,108
"3136","E01005224",2001,665,102,563,149
"3137","E01005225",2001,748,247,501,82
"3138","E01005226",2001,630,44,586,122
"3139","E01005229",2001,604,21,583,38
"3140","E01005165",2001,762,256,506,286
"3141","E01005166",2001,582,153,429,161
"3142","E01005167",2001,477,119,358,116
"3143","E01005145",2001,483,58,425,119
"3144","E01005146",2001,627,68,559,128
"3145","E01005149",2001,429,25,404,110
"3146","E01005202",2001,720,399,321,72
"3147","E01005203",2001,817,608,209,51
"3148","E01005204",2001,709,556,153,13
"3149","E01005227",2001,628,155,473,117
"3150","E01005228",2001,732,514,218,72
"3151","E01005147",2001,638,412,226,71
"3152","E01005148",2001,601,225,376,107
"3153","E01005142",2001,646,457,189,60
"3154","E01005143",2001,609,202,407,148
"3155","E01005144",2001,816,552,264,53
"3156","E01005256",2001,656,397,259,42
"3157","E01005257",2001,733,439,294,67
"3158","E01005258",2001,755,224,531,73
"3159","E01005259",2001,743,344,399,90
"3160","E01005260",2001,585,39,546,55
"3161","E01005261",2001,642,442,200,27
"3162","E01005255",2001,774,544,230,39
"3163","E01005097",2001,642,472,170,25
"3164","E01005093",2001,630,312,318,71
"3165","E01005094",2001,724,331,393,114
"3166","E01005095",2001,780,505,275,65
"3167","E01005129",2001,731,535,196,76
"3168","E01005132",2001,742,510,232,44
"3169","E01005133",2001,637,534,103,21
"3170","E01005134",2001,566,124,442,232
"3171","E01005130",2001,736,586,150,34
"3172","E01005131",2001,848,331,517,200
"3173","E01005128",2001,860,105,755,627
"3174","E01005096",2001,778,546,232,68
"3175","E01005105",2001,603,399,204,50
"3176","E01005106",2001,594,269,325,103
"3177","E01005107",2001,622,410,212,43
"3178","E01005092",2001,743,326,417,113
"3179","E01005127",2001,1071,232,839,459
"3180","E01005211",2001,619,422,197,99
"3181","E01005212",2001,405,358,47,16
"3182","E01005213",2001,837,704,133,51
"3183","E01005189",2001,802,488,314,71
"3184","E01005190",2001,771,212,559,106
"3185","E01005108",2001,726,378,348,91
"3186","E01005109",2001,743,263,480,106
"3187","E01005110",2001,531,89,442,94
"3188","E01005061",2001,697,552,145,52
"3189","E01005062",2001,621,427,194,89
"3190","E01005063",2001,615,492,123,31
"3191","E01005065",2001,731,514,217,96
"3192","E01005066",2001,415,350,65,24
"3193","E01005214",2001,705,182,523,118
"3194","E01005208",2001,556,300,256,71
"3195","E01005209",2001,538,418,120,50
"3196","E01005210",2001,471,311,160,103
"3197","E01005232",2001,618,239,379,105
"3198","E01005235",2001,677,435,242,65
"3199","E01005239",2001,626,496,130,38
"3200","E01005186",2001,721,345,376,73
"3201","E01005067",2001,531,372,159,40
"3202","E01005187",2001,735,166,569,170
"3203","E01005188",2001,645,56,589,91
"3204","E01005191",2001,758,286,472,99
"3205","E01005192",2001,596,61,535,83
"3206","E01005193",2001,680,98,582,123
"3207","E01005236",2001,590,205,385,217
"3208","E01005237",2001,483,115,368,116
"3209","E01005230",2001,684,275,409,248
"3210","E01005231",2001,477,48,429,313
"3211","E01005064",2001,631,298,333,236
"3212","E01005201",2001,645,231,414,175
"3213","E01005195",2001,634,449,185,68
"3214","E01005196",2001,627,485,142,23
"3215","E01005197",2001,620,261,359,83
"3216","E01005198",2001,601,392,209,45
"3217","E01005240",2001,721,343,378,128
"3218","E01005243",2001,754,616,138,51
"3219","E01005245",2001,733,552,181,58
"3220","E01005246",2001,613,392,221,78
"3221","E01005244",2001,627,213,414,205
"3222","E01005241",2001,772,188,584,182
"3223","E01005242",2001,760,425,335,164
"3224","E01005285",2001,408,234,174,88
"3225","E01005288",2001,539,146,393,217
"3226","E01005286",2001,478,93,385,186
"3227","E01005287",2001,595,316,279,117
"3228","E01005284",2001,478,107,371,209
"3229","E01005280",2001,506,282,224,48
"3230","E01005281",2001,506,155,351,169
"3231","E01005238",2001,512,128,384,118
"3232","E01005233",2001,603,185,418,172
"3233","E01005234",2001,533,224,309,113
"3234","E01005199",2001,674,116,558,180
"3235","E01005200",2001,707,198,509,104
"3236","E01005194",2001,677,121,556,203
"3237","E01005297",2001,689,152,537,186
"3238","E01005298",2001,559,98,461,146
"3239","E01005302",2001,775,207,568,306
"3240","E01005303",2001,837,353,484,245
"3241","E01005296",2001,574,118,456,92
"3242","E01005299",2001,488,45,443,87
"3243","E01005159",2001,568,46,522,123
"3244","E01005150",2001,738,145,593,421
"3245","E01005151",2001,769,208,561,190
"3246","E01005152",2001,601,42,559,86
"3247","E01005178",2001,609,270,339,82
"3248","E01005179",2001,682,139,543,232
"3249","E01005180",2001,712,459,253,50
"3250","E01005181",2001,604,106,498,152
"3251","E01005182",2001,441,277,164,33
"3252","E01005183",2001,631,411,220,46
"3253","E01005219",2001,758,137,621,266
"3254","E01005220",2001,630,65,565,192
"3255","E01005221",2001,648,77,571,220
"3256","E01005222",2001,771,222,549,198
"3257","E01005282",2001,497,75,422,111
"3258","E01005283",2001,402,65,337,260
"3259","E01005271",2001,556,104,452,287
"3260","E01005184",2001,599,112,487,274
"3261","E01005185",2001,448,78,370,280
"3262","E01005154",2001,616,57,559,298
"3263","E01005156",2001,607,26,581,129
"3264","E01005158",2001,627,246,381,98
"3265","E01005300",2001,491,20,471,60
"3266","E01005301",2001,598,26,572,166
"3267","E01005215",2001,622,80,542,140
"3268","E01005216",2001,623,82,541,77
"3269","E01005217",2001,616,27,589,66
"3270","E01005218",2001,609,133,476,106
"3271","E01005118",2001,487,141,346,44
"3272","E01005120",2001,643,212,431,72
"3273","E01005272",2001,745,508,237,40
"3274","E01005273",2001,522,132,390,212
"3275","E01005270",2001,658,405,253,57
"3276","E01005278",2001,507,87,420,118
"3277","E01005279",2001,648,356,292,59
"3278","E01005305",2001,505,14,491,135
"3279","E01005309",2001,768,166,602,376
"3280","E01005310",2001,572,235,337,235
"3281","E01005311",2001,613,75,538,156
"3282","E01005312",2001,626,177,449,280
"3283","E01005157",2001,606,11,595,36
"3284","E01005155",2001,674,29,645,128
"3285","E01005153",2001,772,164,608,174
"3286","E01005082",2001,623,329,294,47
"3287","E01005274",2001,634,280,354,102
"3288","E01005275",2001,712,62,650,443
"3289","E01005276",2001,617,79,538,260
"3290","E01005277",2001,644,33,611,248
"3291","E01005083",2001,806,30,776,530
"3292","E01005076",2001,672,75,597,429
"3293","E01005080",2001,626,31,595,284
"3294","E01005081",2001,716,486,230,56
"3295","E01005125",2001,613,279,334,62
"3296","E01005306",2001,689,119,570,130
"3297","E01005307",2001,619,62,557,168
"3298","E01005308",2001,619,254,365,78
"3299","E01005304",2001,615,105,510,251
"3300","E01005121",2001,612,385,227,40
"3301","E01005122",2001,628,319,309,32
"3302","E01005123",2001,614,417,197,31
"3303","E01005124",2001,623,407,216,28
"3304","E01005119",2001,622,346,276,34
"3305","E01005077",2001,592,421,171,33
"3306","E01005078",2001,622,129,493,198
"3307","E01005079",2001,571,191,380,56
"3308","E01005084",2001,636,282,354,37
"3309","E01005172",2001,773,101,672,250
"3310","E01005173",2001,625,43,582,173
"3311","E01005174",2001,622,8,614,118
"3312","E01005175",2001,641,148,493,89
"3313","E01005176",2001,812,100,712,226
"3314","E01005177",2001,627,83,544,100
"3315","E01005264",2001,611,316,295,32
"3316","E01005265",2001,639,351,288,21
"3317","E01005266",2001,801,443,358,32
"3318","E01005262",2001,724,321,403,40
"3319","E01005115",2001,646,309,337,8
"3320","E01005126",2001,670,84,586,68
"3321","E01005168",2001,509,28,481,30
"3322","E01005169",2001,446,21,425,40
"3323","E01005170",2001,579,11,568,99
"3324","E01005171",2001,601,59,542,71
"3325","E01005263",2001,723,345,378,33
"3326","E01005267",2001,658,134,524,39
"3327","E01005268",2001,847,83,764,111
"3328","E01005269",2001,605,86,519,15
"3329","E01005116",2001,762,330,432,34
"3330","E01005113",2001,815,510,305,30
"3331","E01005114",2001,767,83,684,35
"3332","E01005111",2001,634,274,360,23
"3333","E01005069",2001,641,85,556,58
"3334","E01005071",2001,616,281,335,24
"3335","E01005072",2001,644,361,283,14
"3336","E01005073",2001,600,109,491,16
"3337","E01005112",2001,624,237,387,31
"3338","E01005117",2001,810,595,215,25
"3339","E01005089",2001,595,429,166,15
"3340","E01005085",2001,509,353,156,18
"3341","E01005086",2001,630,408,222,37
"3342","E01005295",2001,672,188,484,32
"3343","E01005289",2001,619,421,198,30
"3344","E01005291",2001,756,524,232,28
"3345","E01005087",2001,623,484,139,30
"3346","E01005088",2001,641,471,170,23
"3347","E01005090",2001,751,570,181,22
"3348","E01005091",2001,627,473,154,26
"3349","E01005074",2001,623,351,272,18
"3350","E01005075",2001,597,290,307,33
"3351","E01005070",2001,641,416,225,35
"3352","E01005068",2001,623,348,275,46
"3353","E01005319",2001,728,408,320,31
"3354","E01005317",2001,744,345,399,36
"3355","E01005292",2001,652,405,247,24
"3356","E01005293",2001,526,65,461,24
"3357","E01005294",2001,630,126,504,24
"3358","E01005290",2001,610,371,239,19
"3359","E01005313",2001,630,372,258,14
"3360","E01005314",2001,631,338,293,11
"3361","E01005315",2001,766,493,273,19
"3362","E01005316",2001,648,220,428,47
"3363","E01005318",2001,627,340,287,30
"3364","E01005357",2001,624,16,608,11
"3365","E01005358",2001,737,198,539,40
"3366","E01005359",2001,720,17,703,31
"3367","E01005360",2001,671,213,458,10
"3368","E01005444",2001,682,57,625,55
"3369","E01005445",2001,639,136,503,57
"3370","E01005441",2001,762,326,436,26
"3371","E01005442",2001,589,12,577,24
"3372","E01005443",2001,539,3,536,13
"3373","E01005446",2001,606,116,490,25
"3374","E01005447",2001,634,242,392,56
"3375","E01005361",2001,723,28,695,14
"3376","E01005390",2001,602,36,566,21
"3377","E01005394",2001,635,72,563,14
"3378","E01005395",2001,607,8,599,36
"3379","E01005396",2001,583,105,478,8
"3380","E01005399",2001,655,7,648,24
"3381","E01005403",2001,533,88,445,18
"3382","E01005355",2001,628,54,574,36
"3383","E01005356",2001,519,22,497,17
"3384","E01005410",2001,588,17,571,19
"3385","E01005411",2001,632,95,537,46
"3386","E01005414",2001,480,26,454,41
"3387","E01005415",2001,510,130,380,18
"3388","E01005425",2001,711,469,242,38
"3389","E01005426",2001,883,126,757,41
"3390","E01005452",2001,535,10,525,24
"3391","E01005453",2001,531,10,521,36
"3392","E01005401",2001,577,5,572,11
"3393","E01005391",2001,632,158,474,10
"3394","E01005392",2001,773,393,380,26
"3395","E01005393",2001,523,42,481,4
"3396","E01005397",2001,635,97,538,31
"3397","E01005398",2001,622,7,615,39
"3398","E01005402",2001,639,67,572,39
"3399","E01005400",2001,744,349,395,22
"3400","E01005335",2001,531,4,527,14
"3401","E01005337",2001,664,109,555,44
"3402","E01005339",2001,600,3,597,11
"3403","E01005340",2001,601,266,335,20
"3404","E01005421",2001,618,151,467,64
"3405","E01005422",2001,501,347,154,16
"3406","E01005423",2001,681,243,438,77
"3407","E01005424",2001,669,100,569,111
"3408","E01005454",2001,566,44,522,17
"3409","E01005455",2001,608,22,586,37
"3410","E01005456",2001,763,319,444,60
"3411","E01005448",2001,770,393,377,60
"3412","E01005449",2001,589,287,302,28
"3413","E01005407",2001,644,0,644,43
"3414","E01005416",2001,525,8,517,61
"3415","E01005417",2001,602,15,587,23
"3416","E01005412",2001,653,3,650,41
"3417","E01005348",2001,650,329,321,47
"3418","E01005350",2001,949,754,195,31
"3419","E01005432",2001,610,381,229,39
"3420","E01005433",2001,621,343,278,46
"3421","E01005336",2001,623,3,620,6
"3422","E01005329",2001,612,8,604,22
"3423","E01005330",2001,617,15,602,19
"3424","E01005333",2001,501,6,495,9
"3425","E01005351",2001,480,75,405,57
"3426","E01005352",2001,462,166,296,39
"3427","E01005353",2001,569,404,165,27
"3428","E01005354",2001,459,100,359,42
"3429","E01005349",2001,511,114,397,62
"3430","E01005338",2001,760,346,414,26
"3431","E01005334",2001,508,7,501,9
"3432","E01005327",2001,592,108,484,31
"3433","E01005328",2001,750,428,322,27
"3434","E01005331",2001,635,88,547,35
"3435","E01005418",2001,581,9,572,18
"3436","E01005387",2001,621,27,594,30
"3437","E01005388",2001,583,93,490,30
"3438","E01005389",2001,678,280,398,49
"3439","E01005450",2001,635,69,566,96
"3440","E01005451",2001,499,13,486,27
"3441","E01005428",2001,506,39,467,101
"3442","E01005431",2001,713,39,674,90
"3443","E01005408",2001,672,75,597,43
"3444","E01005409",2001,618,13,605,79
"3445","E01005404",2001,619,24,595,39
"3446","E01005405",2001,452,145,307,10
"3447","E01005406",2001,596,21,575,37
"3448","E01005419",2001,627,29,598,48
"3449","E01005420",2001,744,207,537,38
"3450","E01005413",2001,617,3,614,18
"3451","E01005427",2001,449,126,323,59
"3452","E01005326",2001,523,88,435,74
"3453","E01005321",2001,547,110,437,69
"3454","E01005429",2001,442,94,348,54
"3455","E01005430",2001,633,39,594,70
"3456","E01005463",2001,524,188,336,82
"3457","E01005457",2001,476,192,284,48
"3458","E01005458",2001,556,249,307,76
"3459","E01005460",2001,666,154,512,95
"3460","E01005459",2001,527,331,196,36
"3461","E01005434",2001,789,393,396,87
"3462","E01005437",2001,497,9,488,53
"3463","E01005320",2001,638,111,527,101
"3464","E01005435",2001,467,35,432,50
"3465","E01005436",2001,510,0,510,22
"3466","E01005461",2001,485,71,414,58
"3467","E01005462",2001,536,59,477,36
"3468","E01005383",2001,599,208,391,27
"3469","E01005384",2001,612,42,570,43
"3470","E01005385",2001,656,475,181,17
"3471","E01005386",2001,691,385,306,40
"3472","E01005381",2001,640,319,321,42
"3473","E01005342",2001,656,291,365,35
"3474","E01005343",2001,528,160,368,31
"3475","E01005344",2001,661,157,504,76
"3476","E01005345",2001,618,12,606,28
"3477","E01005346",2001,609,57,552,13
"3478","E01005347",2001,516,42,474,43
"3479","E01005341",2001,596,105,491,48
"3480","E01005332",2001,776,166,610,56
"3481","E01005322",2001,523,239,284,56
"3482","E01005323",2001,595,205,390,43
"3483","E01005324",2001,689,471,218,15
"3484","E01005325",2001,517,400,117,12
"3485","E01005438",2001,778,64,714,102
"3486","E01005439",2001,642,37,605,34
"3487","E01005382",2001,631,263,368,37
"3488","E01005377",2001,495,359,136,16
"3489","E01005379",2001,490,311,179,23
"3490","E01005380",2001,501,262,239,19
"3491","E01005378",2001,643,42,601,63
"3492","E01005376",2001,592,264,328,42
"3493","E01005362",2001,606,50,556,36
"3494","E01005364",2001,691,17,674,29
"3495","E01005368",2001,687,118,569,69
"3496","E01005369",2001,641,135,506,92
"3497","E01005370",2001,717,362,355,38
"3498","E01005371",2001,515,58,457,66
"3499","E01005363",2001,660,96,564,71
"3500","E01005365",2001,610,13,597,22
"3501","E01005366",2001,721,343,378,16
"3502","E01005367",2001,550,4,546,7
"3503","E01005440",2001,631,198,433,21
"3504","E01005372",2001,527,126,401,25
"3505","E01005373",2001,517,17,500,16
"3506","E01005374",2001,624,151,473,19
"3507","E01005375",2001,646,13,633,10
"3508","E01005518",2001,609,126,483,39
"3509","E01005522",2001,716,94,622,128
"3510","E01005523",2001,629,53,576,81
"3511","E01005520",2001,734,100,634,47
"3512","E01005519",2001,592,63,529,19
"3513","E01005597",2001,588,39,549,44
"3514","E01005598",2001,623,10,613,34
"3515","E01005594",2001,587,116,471,11
"3516","E01005596",2001,639,22,617,53
"3517","E01005516",2001,536,18,518,17
"3518","E01005517",2001,641,30,611,34
"3519","E01005521",2001,615,52,563,64
"3520","E01005578",2001,519,250,269,42
"3521","E01005579",2001,535,387,148,12
"3522","E01005595",2001,747,419,328,57
"3523","E01005586",2001,696,408,288,29
"3524","E01005593",2001,519,225,294,28
"3525","E01005489",2001,507,38,469,16
"3526","E01005490",2001,410,194,216,19
"3527","E01005491",2001,701,161,540,35
"3528","E01005493",2001,609,8,601,29
"3529","E01005494",2001,640,48,592,48
"3530","E01005495",2001,648,124,524,51
"3531","E01005499",2001,637,40,597,68
"3532","E01005492",2001,627,8,619,11
"3533","E01005488",2001,585,7,578,28
"3534","E01005571",2001,612,8,604,42
"3535","E01005572",2001,641,3,638,27
"3536","E01005573",2001,570,33,537,10
"3537","E01005574",2001,647,17,630,45
"3538","E01005570",2001,595,15,580,49
"3539","E01005587",2001,511,10,501,12
"3540","E01005588",2001,683,239,444,30
"3541","E01005580",2001,591,48,543,84
"3542","E01005581",2001,622,249,373,70
"3543","E01005582",2001,425,90,335,64
"3544","E01005583",2001,501,169,332,66
"3545","E01005584",2001,453,105,348,50
"3546","E01005585",2001,467,52,415,46
"3547","E01005496",2001,527,330,197,22
"3548","E01005589",2001,648,46,602,72
"3549","E01005590",2001,518,94,424,55
"3550","E01005591",2001,611,61,550,44
"3551","E01005592",2001,638,292,346,37
"3552","E01005486",2001,588,73,515,119
"3553","E01005487",2001,529,71,458,71
"3554","E01005482",2001,918,658,260,61
"3555","E01005483",2001,763,464,299,65
"3556","E01005484",2001,620,330,290,75
"3557","E01005472",2001,651,230,421,63
"3558","E01005473",2001,499,93,406,37
"3559","E01005474",2001,476,46,430,17
"3560","E01005575",2001,716,9,707,32
"3561","E01005576",2001,528,3,525,7
"3562","E01005577",2001,623,20,603,13
"3563","E01005563",2001,576,67,509,56
"3564","E01005565",2001,549,271,278,18
"3565","E01005566",2001,621,227,394,55
"3566","E01005469",2001,651,16,635,33
"3567","E01005568",2001,692,412,280,76
"3568","E01005569",2001,631,245,386,27
"3569","E01005567",2001,654,151,503,54
"3570","E01005556",2001,617,32,585,51
"3571","E01005559",2001,640,318,322,32
"3572","E01005560",2001,653,24,629,36
"3573","E01005561",2001,559,56,503,45
"3574","E01005562",2001,658,175,483,34
"3575","E01005557",2001,512,0,512,8
"3576","E01005558",2001,608,188,420,38
"3577","E01005555",2001,492,36,456,11
"3578","E01005564",2001,595,118,477,118
"3579","E01005470",2001,463,74,389,70
"3580","E01005471",2001,516,34,482,51
"3581","E01005485",2001,584,128,456,108
"3582","E01005475",2001,525,189,336,28
"3583","E01005464",2001,611,398,213,14
"3584","E01005465",2001,633,124,509,60
"3585","E01005466",2001,991,723,268,23
"3586","E01005467",2001,742,412,330,34
"3587","E01005468",2001,578,8,570,25
"3588","E01005476",2001,611,39,572,39
"3589","E01005477",2001,756,163,593,146
"3590","E01005478",2001,636,93,543,25
"3591","E01005479",2001,693,136,557,41
"3592","E01005480",2001,733,199,534,24
"3593","E01005481",2001,601,123,478,28
"3594","E01005497",2001,739,327,412,32
"3595","E01005501",2001,842,425,417,75
"3596","E01005502",2001,650,130,520,41
"3597","E01005504",2001,628,129,499,34
"3598","E01005505",2001,740,150,590,53
"3599","E01005509",2001,840,428,412,58
"3600","E01005510",2001,440,3,437,8
"3601","E01005511",2001,489,48,441,14
"3602","E01005512",2001,650,156,494,32
"3603","E01005513",2001,619,361,258,24
"3604","E01005514",2001,634,221,413,50
"3605","E01005515",2001,645,408,237,20
"3606","E01005506",2001,657,206,451,21
"3607","E01005507",2001,667,27,640,62
"3608","E01005508",2001,571,6,565,6
"3609","E01005503",2001,531,7,524,15
"3610","E01005500",2001,646,74,572,37
"3611","E01005498",2001,595,46,549,62
"3612","E01005524",2001,602,88,514,43
"3613","E01005525",2001,742,365,377,33
"3614","E01005526",2001,625,225,400,14
"3615","E01005528",2001,655,253,402,19
"3616","E01005536",2001,612,99,513,39
"3617","E01005543",2001,501,59,442,8
"3618","E01005529",2001,761,444,317,22
"3619","E01005527",2001,608,420,188,16
"3620","E01005551",2001,785,550,235,29
"3621","E01005552",2001,726,496,230,32
"3622","E01005553",2001,630,290,340,32
"3623","E01005554",2001,649,166,483,22
"3624","E01005534",2001,581,128,453,30
"3625","E01005535",2001,597,113,484,48
"3626","E01005540",2001,532,29,503,31
"3627","E01005541",2001,675,64,611,58
"3628","E01005542",2001,607,236,371,39
"3629","E01005537",2001,566,4,562,11
"3630","E01005538",2001,567,204,363,21
"3631","E01005539",2001,660,172,488,55
"3632","E01005546",2001,609,185,424,25
"3633","E01005547",2001,627,109,518,55
"3634","E01005548",2001,637,259,378,46
"3635","E01005533",2001,742,137,605,74
"3636","E01005549",2001,595,9,586,15
"3637","E01005550",2001,627,15,612,11
"3638","E01005544",2001,610,11,599,16
"3639","E01005545",2001,481,5,476,17
"3640","E01005530",2001,642,4,638,9
"3641","E01005531",2001,492,77,415,18
"3642","E01005532",2001,657,297,360,19
"3643","E01005659",2001,640,226,414,25
"3644","E01005660",2001,703,422,281,34
"3645","E01005663",2001,603,193,410,32
"3646","E01005664",2001,637,417,220,12
"3647","E01005665",2001,629,462,167,23
"3648","E01005708",2001,717,215,502,48
"3649","E01005703",2001,748,436,312,37
"3650","E01005704",2001,665,147,518,49
"3651","E01005706",2001,663,296,367,22
"3652","E01005707",2001,734,404,330,33
"3653","E01005705",2001,760,199,561,38
"3654","E01005702",2001,764,222,542,31
"3655","E01005709",2001,635,385,250,22
"3656","E01005710",2001,617,131,486,19
"3657","E01005661",2001,620,260,360,16
"3658","E01005662",2001,608,399,209,19
"3659","E01005670",2001,711,339,372,37
"3660","E01005672",2001,609,51,558,100
"3661","E01005676",2001,520,15,505,14
"3662","E01005677",2001,623,90,533,35
"3663","E01005686",2001,633,105,528,66
"3664","E01005691",2001,625,69,556,29
"3665","E01005692",2001,689,325,364,83
"3666","E01005688",2001,604,123,481,21
"3667","E01005711",2001,616,44,572,27
"3668","E01005712",2001,641,148,493,44
"3669","E01005713",2001,633,11,622,14
"3670","E01005714",2001,618,246,372,18
"3671","E01005715",2001,719,51,668,35
"3672","E01005718",2001,750,164,586,29
"3673","E01005675",2001,401,42,359,61
"3674","E01005678",2001,661,341,320,33
"3675","E01005679",2001,674,373,301,30
"3676","E01005673",2001,585,111,474,61
"3677","E01005693",2001,639,28,611,49
"3678","E01005687",2001,712,118,594,73
"3679","E01005689",2001,619,348,271,27
"3680","E01005690",2001,686,102,584,28
"3681","E01005649",2001,625,50,575,102
"3682","E01005650",2001,616,243,373,133
"3683","E01005651",2001,488,129,359,88
"3684","E01005646",2001,493,76,417,121
"3685","E01005647",2001,644,87,557,132
"3686","E01005648",2001,743,48,695,170
"3687","E01005652",2001,511,171,340,40
"3688","E01005653",2001,594,238,356,93
"3689","E01005696",2001,600,108,492,18
"3690","E01005698",2001,762,445,317,27
"3691","E01005700",2001,657,85,572,61
"3692","E01005694",2001,621,45,576,37
"3693","E01005674",2001,577,158,419,47
"3694","E01005671",2001,719,252,467,45
"3695","E01005716",2001,625,12,613,14
"3696","E01005717",2001,547,11,536,14
"3697","E01005734",2001,615,111,504,48
"3698","E01005735",2001,586,15,571,16
"3699","E01005736",2001,639,14,625,34
"3700","E01005737",2001,618,10,608,9
"3701","E01005739",2001,626,13,613,19
"3702","E01005740",2001,670,40,630,32
"3703","E01005741",2001,661,48,613,10
"3704","E01005742",2001,648,35,613,27
"3705","E01005738",2001,730,16,714,30
"3706","E01005697",2001,649,31,618,32
"3707","E01005695",2001,607,8,599,16
"3708","E01005701",2001,618,24,594,58
"3709","E01005699",2001,654,23,631,29
"3710","E01005625",2001,556,29,527,40
"3711","E01005627",2001,487,21,466,15
"3712","E01005609",2001,620,445,175,38
"3713","E01005611",2001,718,347,371,87
"3714","E01005612",2001,895,693,202,65
"3715","E01005613",2001,660,372,288,74
"3716","E01005614",2001,519,119,400,105
"3717","E01005615",2001,635,137,498,155
"3718","E01005624",2001,715,348,367,42
"3719","E01005683",2001,734,506,228,44
"3720","E01005684",2001,471,63,408,112
"3721","E01005685",2001,739,302,437,142
"3722","E01005680",2001,739,321,418,200
"3723","E01005626",2001,522,11,511,25
"3724","E01005628",2001,615,54,561,104
"3725","E01005622",2001,674,107,567,90
"3726","E01005623",2001,501,10,491,27
"3727","E01005725",2001,520,352,168,13
"3728","E01005726",2001,625,147,478,60
"3729","E01005727",2001,664,115,549,109
"3730","E01005728",2001,609,22,587,34
"3731","E01005733",2001,514,241,273,18
"3732","E01005631",2001,923,590,333,90
"3733","E01005632",2001,612,105,507,96
"3734","E01005633",2001,600,243,357,21
"3735","E01005634",2001,591,13,578,24
"3736","E01005635",2001,683,83,600,179
"3737","E01005636",2001,579,70,509,54
"3738","E01005637",2001,652,122,530,74
"3739","E01005629",2001,639,133,506,49
"3740","E01005630",2001,652,94,558,73
"3741","E01005719",2001,836,340,496,122
"3742","E01005720",2001,721,209,512,92
"3743","E01005722",2001,649,277,372,85
"3744","E01005723",2001,650,304,346,55
"3745","E01005724",2001,646,96,550,22
"3746","E01005610",2001,609,472,137,33
"3747","E01005606",2001,1026,662,364,116
"3748","E01005607",2001,764,208,556,160
"3749","E01005608",2001,872,584,288,122
"3750","E01005654",2001,654,131,523,157
"3751","E01005656",2001,640,114,526,113
"3752","E01005657",2001,673,149,524,121
"3753","E01005721",2001,847,305,542,129
"3754","E01005681",2001,491,353,138,25
"3755","E01005682",2001,1048,815,233,88
"3756","E01005658",2001,717,556,161,31
"3757","E01005655",2001,822,616,206,106
"3758","E01005729",2001,707,430,277,51
"3759","E01005730",2001,639,87,552,47
"3760","E01005731",2001,582,315,267,16
"3761","E01005732",2001,556,270,286,23
"3762","E01005599",2001,777,346,431,55
"3763","E01005600",2001,624,115,509,64
"3764","E01005601",2001,654,259,395,66
"3765","E01005602",2001,828,477,351,29
"3766","E01005603",2001,636,95,541,99
"3767","E01005604",2001,711,156,555,48
"3768","E01005605",2001,666,113,553,89
"3769","E01005638",2001,662,186,476,90
"3770","E01005666",2001,844,126,718,379
"3771","E01005667",2001,739,572,167,34
"3772","E01005668",2001,757,416,341,116
"3773","E01005669",2001,742,444,298,86
"3774","E01005639",2001,628,428,200,21
"3775","E01005640",2001,553,264,289,19
"3776","E01005641",2001,635,238,397,27
"3777","E01005642",2001,525,14,511,21
"3778","E01005643",2001,668,88,580,23
"3779","E01005644",2001,561,22,539,32
"3780","E01005645",2001,599,32,567,15
"3781","E01005616",2001,637,281,356,15
"3782","E01005617",2001,588,91,497,31
"3783","E01005618",2001,669,274,395,22
"3784","E01005619",2001,529,163,366,36
"3785","E01005620",2001,657,121,536,33
"3786","E01005621",2001,674,182,492,74
"3787","E01005886",2001,643,104,539,68
"3788","E01005888",2001,611,92,519,36
"3789","E01005889",2001,707,147,560,52
"3790","E01005891",2001,581,3,578,33
"3791","E01005894",2001,591,22,569,44
"3792","E01005896",2001,682,14,668,116
"3793","E01005893",2001,660,133,527,73
"3794","E01005890",2001,609,144,465,50
"3795","E01005887",2001,617,194,423,48
"3796","E01005919",2001,646,329,317,25
"3797","E01005920",2001,629,18,611,25
"3798","E01005921",2001,706,128,578,94
"3799","E01005922",2001,646,30,616,35
"3800","E01005892",2001,559,80,479,43
"3801","E01005895",2001,495,117,378,12
"3802","E01005862",2001,611,35,576,13
"3803","E01005753",2001,616,331,285,22
"3804","E01005754",2001,892,627,265,18
"3805","E01005755",2001,689,334,355,36
"3806","E01005756",2001,707,468,239,27
"3807","E01005745",2001,588,63,525,37
"3808","E01005746",2001,771,408,363,24
"3809","E01005747",2001,582,3,579,25
"3810","E01005748",2001,636,8,628,11
"3811","E01005863",2001,778,45,733,124
"3812","E01005864",2001,631,24,607,137
"3813","E01005869",2001,624,56,568,20
"3814","E01005866",2001,763,64,699,255
"3815","E01005914",2001,670,87,583,25
"3816","E01005915",2001,713,185,528,47
"3817","E01005916",2001,726,60,666,107
"3818","E01005917",2001,811,203,608,117
"3819","E01005867",2001,672,52,620,70
"3820","E01005868",2001,606,0,606,30
"3821","E01005865",2001,619,25,594,70
"3822","E01005859",2001,619,49,570,164
"3823","E01005743",2001,588,25,563,29
"3824","E01005744",2001,590,84,506,44
"3825","E01005749",2001,631,10,621,41
"3826","E01005750",2001,725,13,712,88
"3827","E01005751",2001,588,10,578,55
"3828","E01005900",2001,750,169,581,55
"3829","E01005897",2001,599,187,412,25
"3830","E01005898",2001,702,118,584,23
"3831","E01005903",2001,636,3,633,14
"3832","E01005904",2001,623,20,603,21
"3833","E01005860",2001,595,13,582,23
"3834","E01005861",2001,730,107,623,43
"3835","E01005856",2001,664,39,625,57
"3836","E01005853",2001,681,223,458,43
"3837","E01005905",2001,622,268,354,28
"3838","E01005899",2001,635,54,581,32
"3839","E01005901",2001,619,34,585,14
"3840","E01005902",2001,730,344,386,17
"3841","E01005752",2001,634,236,398,24
"3842","E01005852",2001,689,47,642,65
"3843","E01005854",2001,747,11,736,59
"3844","E01005855",2001,595,8,587,51
"3845","E01005857",2001,609,20,589,41
"3846","E01005858",2001,842,6,836,111
"3847","E01005766",2001,631,139,492,149
"3848","E01005757",2001,697,73,624,79
"3849","E01005758",2001,985,714,271,49
"3850","E01005918",2001,870,666,204,53
"3851","E01005873",2001,585,35,550,26
"3852","E01005870",2001,601,46,555,62
"3853","E01005871",2001,618,34,584,85
"3854","E01005875",2001,643,11,632,23
"3855","E01005764",2001,774,156,618,71
"3856","E01005816",2001,698,41,657,103
"3857","E01005817",2001,633,29,604,70
"3858","E01005822",2001,844,427,417,115
"3859","E01005880",2001,662,32,630,47
"3860","E01005881",2001,512,0,512,24
"3861","E01005883",2001,645,6,639,27
"3862","E01005908",2001,578,4,574,27
"3863","E01005823",2001,632,141,491,38
"3864","E01005818",2001,550,121,429,39
"3865","E01005819",2001,648,4,644,25
"3866","E01005820",2001,640,44,596,48
"3867","E01005821",2001,654,91,563,48
"3868","E01005765",2001,574,11,563,29
"3869","E01005825",2001,661,77,584,42
"3870","E01005876",2001,638,26,612,54
"3871","E01005877",2001,634,109,525,54
"3872","E01005872",2001,796,88,708,79
"3873","E01005874",2001,792,415,377,47
"3874","E01005878",2001,661,270,391,26
"3875","E01005879",2001,609,119,490,48
"3876","E01005884",2001,606,6,600,5
"3877","E01005885",2001,614,34,580,94
"3878","E01005882",2001,476,0,476,9
"3879","E01005835",2001,571,9,562,22
"3880","E01005837",2001,670,23,647,36
"3881","E01005843",2001,588,3,585,15
"3882","E01005832",2001,601,91,510,45
"3883","E01005833",2001,470,146,324,11
"3884","E01005769",2001,638,30,608,70
"3885","E01005778",2001,656,40,616,50
"3886","E01005779",2001,591,21,570,56
"3887","E01005780",2001,562,32,530,54
"3888","E01005781",2001,826,392,434,30
"3889","E01005759",2001,625,49,576,37
"3890","E01005760",2001,758,77,681,118
"3891","E01005804",2001,448,104,344,31
"3892","E01005797",2001,654,100,554,99
"3893","E01005800",2001,656,26,630,35
"3894","E01005824",2001,606,56,550,42
"3895","E01005826",2001,610,336,274,19
"3896","E01005827",2001,610,30,580,15
"3897","E01005828",2001,609,429,180,22
"3898","E01005829",2001,498,193,305,12
"3899","E01005770",2001,641,56,585,43
"3900","E01005771",2001,541,36,505,38
"3901","E01005768",2001,598,7,591,12
"3902","E01005775",2001,636,17,619,18
"3903","E01005761",2001,536,149,387,46
"3904","E01005762",2001,651,405,246,28
"3905","E01005763",2001,626,248,378,35
"3906","E01005799",2001,642,348,294,49
"3907","E01005830",2001,724,123,601,54
"3908","E01005831",2001,639,19,620,49
"3909","E01005801",2001,641,27,614,51
"3910","E01005802",2001,607,17,590,24
"3911","E01005803",2001,608,8,600,12
"3912","E01005798",2001,768,133,635,90
"3913","E01005767",2001,610,6,604,10
"3914","E01005776",2001,593,8,585,37
"3915","E01005772",2001,574,36,538,25
"3916","E01005773",2001,613,55,558,37
"3917","E01005774",2001,662,339,323,14
"3918","E01005909",2001,640,37,603,25
"3919","E01005910",2001,763,248,515,42
"3920","E01005911",2001,558,25,533,14
"3921","E01005912",2001,636,8,628,41
"3922","E01005782",2001,565,15,550,19
"3923","E01005783",2001,653,84,569,29
"3924","E01005784",2001,526,3,523,11
"3925","E01005785",2001,655,28,627,46
"3926","E01005786",2001,606,6,600,29
"3927","E01005834",2001,616,197,419,23
"3928","E01005840",2001,747,85,662,65
"3929","E01005838",2001,748,40,708,114
"3930","E01005836",2001,771,53,718,68
"3931","E01005927",2001,493,12,481,13
"3932","E01005928",2001,683,201,482,26
"3933","E01005929",2001,603,17,586,24
"3934","E01005930",2001,564,9,555,15
"3935","E01005813",2001,617,3,614,18
"3936","E01005814",2001,541,7,534,9
"3937","E01005815",2001,587,6,581,18
"3938","E01005806",2001,504,4,500,8
"3939","E01005790",2001,506,145,361,21
"3940","E01005787",2001,476,4,472,4
"3941","E01005788",2001,623,31,592,26
"3942","E01005777",2001,681,128,553,23
"3943","E01005807",2001,617,0,617,3
"3944","E01005805",2001,595,30,565,24
"3945","E01005839",2001,506,0,506,4
"3946","E01005841",2001,616,33,583,18
"3947","E01005849",2001,637,33,604,16
"3948","E01005851",2001,614,6,608,25
"3949","E01005844",2001,535,5,530,22
"3950","E01005845",2001,618,10,608,26
"3951","E01005808",2001,518,0,518,13
"3952","E01005809",2001,512,0,512,15
"3953","E01005810",2001,669,29,640,49
"3954","E01005811",2001,653,7,646,29
"3955","E01005812",2001,473,0,473,4
"3956","E01005842",2001,643,8,635,23
"3957","E01005913",2001,669,43,626,36
"3958","E01005906",2001,646,3,643,18
"3959","E01005907",2001,615,3,612,35
"3960","E01005791",2001,659,89,570,42
"3961","E01005793",2001,643,45,598,59
"3962","E01005795",2001,517,0,517,17
"3963","E01005796",2001,510,8,502,31
"3964","E01005789",2001,614,24,590,48
"3965","E01005850",2001,763,173,590,33
"3966","E01005846",2001,607,41,566,25
"3967","E01005847",2001,632,13,619,50
"3968","E01005848",2001,616,3,613,9
"3969","E01005794",2001,508,3,505,10
"3970","E01005792",2001,603,3,600,19
"3971","E01005931",2001,634,36,598,18
"3972","E01005923",2001,634,3,631,8
"3973","E01005924",2001,523,7,516,20
"3974","E01005925",2001,617,63,554,16
"3975","E01005926",2001,479,4,475,19
"3976","E01005932",2001,540,3,537,10
"3977","E01006053",2001,646,10,636,42
"3978","E01006054",2001,706,222,484,53
"3979","E01006055",2001,611,31,580,62
"3980","E01006057",2001,584,13,571,59
"3981","E01006058",2001,715,50,665,129
"3982","E01006059",2001,599,22,577,47
"3983","E01005938",2001,630,147,483,27
"3984","E01005939",2001,485,6,479,14
"3985","E01005940",2001,606,68,538,14
"3986","E01005955",2001,617,12,605,19
"3987","E01006056",2001,475,293,182,26
"3988","E01006061",2001,720,350,370,36
"3989","E01006062",2001,692,0,692,35
"3990","E01006063",2001,557,21,536,24
"3991","E01005936",2001,600,57,543,16
"3992","E01005937",2001,647,199,448,35
"3993","E01005945",2001,623,324,299,32
"3994","E01005946",2001,630,69,561,85
"3995","E01005947",2001,755,189,566,118
"3996","E01005956",2001,584,60,524,17
"3997","E01005957",2001,615,50,565,37
"3998","E01005958",2001,648,252,396,27
"3999","E01005959",2001,636,231,405,25
"4000","E01005954",2001,759,268,491,59
"4001","E01005960",2001,722,223,499,89
"4002","E01005949",2001,704,125,579,79
"4003","E01005933",2001,535,313,222,18
"4004","E01005934",2001,627,119,508,28
"4005","E01005935",2001,581,284,297,44
"4006","E01005941",2001,674,130,544,124
"4007","E01005942",2001,705,71,634,26
"4008","E01005943",2001,747,45,702,83
"4009","E01005944",2001,598,53,545,88
"4010","E01006064",2001,650,331,319,18
"4011","E01006065",2001,473,241,232,14
"4012","E01006066",2001,585,76,509,57
"4013","E01006060",2001,626,235,391,64
"4014","E01006073",2001,584,249,335,70
"4015","E01006067",2001,601,20,581,27
"4016","E01006068",2001,758,173,585,129
"4017","E01006069",2001,651,309,342,23
"4018","E01006000",2001,782,325,457,85
"4019","E01005995",2001,518,9,509,14
"4020","E01005996",2001,628,95,533,37
"4021","E01005997",2001,655,80,575,49
"4022","E01005993",2001,621,52,569,32
"4023","E01005994",2001,602,57,545,75
"4024","E01005999",2001,757,192,565,104
"4025","E01006002",2001,574,71,503,28
"4026","E01006004",2001,622,7,615,49
"4027","E01006005",2001,653,237,416,104
"4028","E01006007",2001,653,52,601,114
"4029","E01006006",2001,616,9,607,38
"4030","E01006003",2001,628,23,605,42
"4031","E01006001",2001,668,43,625,72
"4032","E01005998",2001,711,23,688,80
"4033","E01005950",2001,501,77,424,89
"4034","E01005951",2001,755,123,632,132
"4035","E01005952",2001,951,744,207,54
"4036","E01005953",2001,754,188,566,130
"4037","E01005948",2001,781,324,457,186
"4038","E01005961",2001,508,18,490,45
"4039","E01005962",2001,603,48,555,44
"4040","E01005968",2001,628,10,618,39
"4041","E01005969",2001,585,8,577,24
"4042","E01006022",2001,640,93,547,84
"4043","E01006023",2001,732,340,392,49
"4044","E01006070",2001,627,17,610,61
"4045","E01006071",2001,643,24,619,21
"4046","E01006072",2001,662,5,657,13
"4047","E01006017",2001,544,0,544,12
"4048","E01006018",2001,582,6,576,10
"4049","E01006009",2001,584,52,532,50
"4050","E01006021",2001,619,29,590,30
"4051","E01006010",2001,635,264,371,39
"4052","E01006008",2001,620,61,559,47
"4053","E01006012",2001,637,87,550,42
"4054","E01006015",2001,522,21,501,22
"4055","E01006016",2001,846,421,425,83
"4056","E01006013",2001,552,61,491,19
"4057","E01006014",2001,480,138,342,18
"4058","E01006019",2001,785,371,414,18
"4059","E01006020",2001,589,160,429,20
"4060","E01006011",2001,617,328,289,24
"4061","E01005963",2001,511,31,480,38
"4062","E01005964",2001,624,32,592,47
"4063","E01005965",2001,625,254,371,43
"4064","E01005966",2001,516,113,403,32
"4065","E01005967",2001,662,342,320,21
"4066","E01006031",2001,649,304,345,29
"4067","E01006032",2001,522,167,355,16
"4068","E01006033",2001,605,124,481,49
"4069","E01006034",2001,646,264,382,28
"4070","E01006035",2001,700,210,490,36
"4071","E01006036",2001,639,170,469,45
"4072","E01005970",2001,645,7,638,27
"4073","E01005972",2001,722,117,605,105
"4074","E01005974",2001,735,87,648,123
"4075","E01005975",2001,655,158,497,54
"4076","E01006037",2001,614,4,610,16
"4077","E01006038",2001,600,52,548,22
"4078","E01006024",2001,601,7,594,16
"4079","E01006026",2001,697,102,595,75
"4080","E01006047",2001,553,68,485,44
"4081","E01006048",2001,714,61,653,89
"4082","E01006049",2001,678,86,592,67
"4083","E01006051",2001,703,94,609,60
"4084","E01005990",2001,630,27,603,31
"4085","E01005991",2001,634,44,590,48
"4086","E01005985",2001,716,28,688,22
"4087","E01005987",2001,700,0,700,49
"4088","E01005988",2001,532,4,528,8
"4089","E01005989",2001,502,3,499,14
"4090","E01005986",2001,544,90,454,22
"4091","E01005992",2001,584,113,471,48
"4092","E01005971",2001,631,60,571,69
"4093","E01005973",2001,596,19,577,25
"4094","E01005976",2001,614,260,354,17
"4095","E01005977",2001,657,35,622,27
"4096","E01005978",2001,591,239,352,29
"4097","E01006050",2001,783,528,255,16
"4098","E01006027",2001,651,408,243,25
"4099","E01006025",2001,581,357,224,14
"4100","E01006052",2001,836,504,332,30
"4101","E01006028",2001,864,368,496,60
"4102","E01006029",2001,660,97,563,64
"4103","E01006030",2001,732,249,483,47
"4104","E01006039",2001,439,75,364,33
"4105","E01006040",2001,462,87,375,106
"4106","E01006041",2001,615,34,581,72
"4107","E01005979",2001,732,194,538,22
"4108","E01005980",2001,636,242,394,31
"4109","E01005981",2001,764,384,380,27
"4110","E01005982",2001,552,200,352,14
"4111","E01005983",2001,699,11,688,43
"4112","E01005984",2001,735,458,277,22
"4113","E01006042",2001,698,48,650,60
"4114","E01006043",2001,628,86,542,58
"4115","E01006044",2001,606,65,541,21
"4116","E01006045",2001,536,4,532,8
"4117","E01006046",2001,633,9,624,33
"4118","E01006109",2001,876,697,179,61
"4119","E01006110",2001,609,99,510,117
"4120","E01006111",2001,488,235,253,84
"4121","E01006112",2001,507,183,324,108
"4122","E01006185",2001,773,392,381,167
"4123","E01006188",2001,499,93,406,86
"4124","E01006116",2001,551,14,537,38
"4125","E01006117",2001,639,34,605,9
"4126","E01006118",2001,599,182,417,24
"4127","E01006119",2001,627,29,598,10
"4128","E01006121",2001,626,42,584,26
"4129","E01006189",2001,730,153,577,55
"4130","E01006186",2001,624,120,504,84
"4131","E01006187",2001,1051,139,912,188
"4132","E01006141",2001,574,145,429,18
"4133","E01006145",2001,653,299,354,57
"4134","E01006146",2001,656,51,605,64
"4135","E01006113",2001,465,22,443,66
"4136","E01006114",2001,566,177,389,60
"4137","E01006115",2001,596,150,446,96
"4138","E01006122",2001,683,19,664,11
"4139","E01006123",2001,627,38,589,37
"4140","E01006124",2001,597,10,587,11
"4141","E01006131",2001,642,42,600,60
"4142","E01006128",2001,739,45,694,55
"4143","E01006155",2001,645,20,625,86
"4144","E01006157",2001,593,67,526,25
"4145","E01006159",2001,694,307,387,33
"4146","E01006182",2001,596,20,576,30
"4147","E01006183",2001,629,44,585,45
"4148","E01006130",2001,735,60,675,41
"4149","E01006132",2001,645,106,539,30
"4150","E01006125",2001,625,92,533,27
"4151","E01006126",2001,727,295,432,24
"4152","E01006127",2001,629,48,581,18
"4153","E01006184",2001,720,231,489,49
"4154","E01006179",2001,895,332,563,102
"4155","E01006158",2001,756,296,460,35
"4156","E01006156",2001,643,179,464,13
"4157","E01006198",2001,620,109,511,79
"4158","E01006199",2001,742,187,555,67
"4159","E01006200",2001,645,180,465,35
"4160","E01006201",2001,639,82,557,100
"4161","E01006202",2001,524,15,509,151
"4162","E01006203",2001,507,10,497,17
"4163","E01006197",2001,606,59,547,54
"4164","E01006120",2001,571,3,568,29
"4165","E01006133",2001,651,8,643,22
"4166","E01006129",2001,622,166,456,29
"4167","E01006180",2001,730,82,648,132
"4168","E01006181",2001,630,106,524,53
"4169","E01006142",2001,785,205,580,66
"4170","E01006143",2001,759,64,695,194
"4171","E01006144",2001,681,318,363,68
"4172","E01006147",2001,551,0,551,23
"4173","E01006149",2001,655,106,549,64
"4174","E01006150",2001,734,56,678,142
"4175","E01006165",2001,751,110,641,112
"4176","E01006154",2001,637,27,610,105
"4177","E01006166",2001,645,182,463,30
"4178","E01006169",2001,674,63,611,31
"4179","E01006170",2001,680,115,565,28
"4180","E01006171",2001,749,323,426,26
"4181","E01006174",2001,820,66,754,157
"4182","E01006164",2001,723,99,624,51
"4183","E01006178",2001,741,45,696,54
"4184","E01006098",2001,518,3,515,27
"4185","E01006099",2001,541,35,506,71
"4186","E01006097",2001,757,46,711,153
"4187","E01006160",2001,900,257,643,236
"4188","E01006161",2001,716,17,699,195
"4189","E01006162",2001,718,7,711,187
"4190","E01006163",2001,826,19,807,231
"4191","E01006172",2001,667,94,573,5
"4192","E01006151",2001,588,6,582,23
"4193","E01006152",2001,610,6,604,16
"4194","E01006153",2001,642,32,610,17
"4195","E01006148",2001,631,28,603,67
"4196","E01006104",2001,715,80,635,47
"4197","E01006105",2001,752,447,305,52
"4198","E01006106",2001,613,136,477,27
"4199","E01006107",2001,638,229,409,55
"4200","E01006108",2001,637,436,201,42
"4201","E01006102",2001,574,87,487,24
"4202","E01006173",2001,608,18,590,20
"4203","E01006175",2001,737,392,345,20
"4204","E01006176",2001,711,70,641,45
"4205","E01006177",2001,596,289,307,19
"4206","E01006167",2001,743,502,241,21
"4207","E01006168",2001,689,528,161,17
"4208","E01006095",2001,594,6,588,20
"4209","E01006091",2001,554,63,491,37
"4210","E01006092",2001,497,303,194,12
"4211","E01006096",2001,522,4,518,26
"4212","E01006090",2001,624,12,612,35
"4213","E01006094",2001,605,5,600,12
"4214","E01006100",2001,599,63,536,94
"4215","E01006103",2001,599,10,589,27
"4216","E01006101",2001,506,3,503,7
"4217","E01006195",2001,649,0,649,29
"4218","E01006196",2001,676,19,657,27
"4219","E01006190",2001,624,7,617,17
"4220","E01006210",2001,645,79,566,30
"4221","E01006211",2001,621,191,430,25
"4222","E01006206",2001,615,199,416,26
"4223","E01006207",2001,758,445,313,43
"4224","E01006208",2001,633,199,434,19
"4225","E01006204",2001,603,60,543,35
"4226","E01006205",2001,510,9,501,12
"4227","E01006209",2001,633,15,618,20
"4228","E01006191",2001,587,16,571,13
"4229","E01006192",2001,611,28,583,30
"4230","E01006093",2001,610,32,578,57
"4231","E01006089",2001,551,57,494,60
"4232","E01006080",2001,746,45,701,126
"4233","E01006078",2001,774,84,690,152
"4234","E01006193",2001,586,3,583,43
"4235","E01006194",2001,729,104,625,144
"4236","E01006079",2001,604,34,570,37
"4237","E01006074",2001,598,214,384,28
"4238","E01006075",2001,718,23,695,127
"4239","E01006076",2001,732,50,682,116
"4240","E01006087",2001,563,78,485,80
"4241","E01006088",2001,668,21,647,115
"4242","E01006083",2001,482,7,475,26
"4243","E01006084",2001,587,6,581,32
"4244","E01006139",2001,604,8,596,55
"4245","E01006140",2001,612,60,552,33
"4246","E01006085",2001,611,32,579,62
"4247","E01006086",2001,636,138,498,33
"4248","E01006077",2001,780,132,648,175
"4249","E01006081",2001,510,5,505,20
"4250","E01006082",2001,631,14,617,91
"4251","E01006134",2001,501,4,497,18
"4252","E01006135",2001,617,28,589,31
"4253","E01006136",2001,617,4,613,42
"4254","E01006137",2001,500,3,497,19
"4255","E01006138",2001,744,154,590,32
"4256","E01006319",2001,499,25,474,33
"4257","E01006315",2001,518,5,513,19
"4258","E01006316",2001,578,15,563,30
"4259","E01006317",2001,658,116,542,23
"4260","E01006229",2001,637,11,626,37
"4261","E01006230",2001,564,51,513,6
"4262","E01006233",2001,564,0,564,8
"4263","E01006237",2001,530,21,509,9
"4264","E01006238",2001,717,313,404,43
"4265","E01006259",2001,496,56,440,21
"4266","E01006318",2001,631,3,628,12
"4267","E01006320",2001,551,0,551,7
"4268","E01006321",2001,682,11,671,29
"4269","E01006312",2001,617,3,614,23
"4270","E01006313",2001,463,183,280,15
"4271","E01006314",2001,687,13,674,40
"4272","E01006234",2001,521,88,433,15
"4273","E01006235",2001,662,330,332,19
"4274","E01006231",2001,613,36,577,22
"4275","E01006232",2001,573,13,560,29
"4276","E01006253",2001,647,178,469,38
"4277","E01006254",2001,610,345,265,19
"4278","E01006255",2001,649,4,645,37
"4279","E01006256",2001,524,49,475,23
"4280","E01006260",2001,618,251,367,10
"4281","E01006372",2001,571,4,567,10
"4282","E01006373",2001,631,5,626,28
"4283","E01006374",2001,685,17,668,24
"4284","E01006370",2001,734,87,647,217
"4285","E01006390",2001,671,138,533,26
"4286","E01006391",2001,648,48,600,23
"4287","E01006388",2001,675,220,455,27
"4288","E01006389",2001,481,61,420,11
"4289","E01006236",2001,630,9,621,32
"4290","E01006257",2001,500,10,490,46
"4291","E01006258",2001,605,17,588,76
"4292","E01006369",2001,737,200,537,104
"4293","E01006371",2001,639,20,619,54
"4294","E01006375",2001,653,8,645,105
"4295","E01006386",2001,904,642,262,35
"4296","E01006387",2001,543,52,491,33
"4297","E01006392",2001,607,303,304,37
"4298","E01006306",2001,810,350,460,91
"4299","E01006307",2001,606,203,403,40
"4300","E01006350",2001,623,421,202,25
"4301","E01006351",2001,718,523,195,24
"4302","E01006357",2001,638,433,205,12
"4303","E01006360",2001,691,484,207,22
"4304","E01006361",2001,671,383,288,39
"4305","E01006356",2001,597,296,301,17
"4306","E01006396",2001,533,3,530,26
"4307","E01006397",2001,580,238,342,20
"4308","E01006398",2001,487,159,328,23
"4309","E01006399",2001,677,110,567,48
"4310","E01006308",2001,641,154,487,67
"4311","E01006309",2001,560,185,375,59
"4312","E01006310",2001,635,227,408,48
"4313","E01006311",2001,610,234,376,20
"4314","E01006305",2001,614,342,272,11
"4315","E01006269",2001,638,132,506,37
"4316","E01006271",2001,645,47,598,44
"4317","E01006272",2001,653,67,586,56
"4318","E01006273",2001,620,163,457,25
"4319","E01006276",2001,593,15,578,30
"4320","E01006358",2001,756,181,575,67
"4321","E01006359",2001,602,155,447,28
"4322","E01006353",2001,620,39,581,31
"4323","E01006354",2001,620,180,440,74
"4324","E01006355",2001,618,15,603,44
"4325","E01006352",2001,675,106,569,115
"4326","E01006349",2001,571,81,490,46
"4327","E01006404",2001,637,185,452,56
"4328","E01006405",2001,635,186,449,57
"4329","E01006411",2001,804,544,260,33
"4330","E01006286",2001,646,60,586,18
"4331","E01006277",2001,569,5,564,9
"4332","E01006274",2001,612,230,382,55
"4333","E01006275",2001,638,314,324,32
"4334","E01006270",2001,654,321,333,18
"4335","E01006289",2001,766,450,316,22
"4336","E01006239",2001,860,503,357,26
"4337","E01006240",2001,576,361,215,22
"4338","E01006241",2001,595,258,337,27
"4339","E01006287",2001,474,9,465,3
"4340","E01006362",2001,709,7,702,37
"4341","E01006363",2001,719,0,719,7
"4342","E01006364",2001,717,218,499,44
"4343","E01006365",2001,620,21,599,27
"4344","E01006366",2001,744,176,568,17
"4345","E01006367",2001,631,19,612,14
"4346","E01006368",2001,676,54,622,46
"4347","E01006285",2001,609,10,599,16
"4348","E01006278",2001,688,80,608,33
"4349","E01006279",2001,509,7,502,11
"4350","E01006280",2001,623,103,520,14
"4351","E01006281",2001,633,16,617,21
"4352","E01006406",2001,630,46,584,17
"4353","E01006407",2001,593,6,587,17
"4354","E01006408",2001,631,255,376,20
"4355","E01006409",2001,575,12,563,9
"4356","E01006410",2001,534,14,520,12
"4357","E01006393",2001,605,6,599,15
"4358","E01006394",2001,610,3,607,5
"4359","E01006395",2001,537,4,533,6
"4360","E01006400",2001,483,4,479,12
"4361","E01006401",2001,531,6,525,11
"4362","E01006402",2001,470,3,467,4
"4363","E01006403",2001,659,4,655,9
"4364","E01006290",2001,617,9,608,24
"4365","E01006291",2001,623,126,497,55
"4366","E01006292",2001,626,40,586,28
"4367","E01006293",2001,673,206,467,26
"4368","E01006242",2001,730,62,668,44
"4369","E01006243",2001,667,14,653,21
"4370","E01006244",2001,765,136,629,87
"4371","E01006245",2001,652,131,521,30
"4372","E01006217",2001,650,209,441,33
"4373","E01006218",2001,625,120,505,85
"4374","E01006219",2001,513,9,504,29
"4375","E01006215",2001,661,284,377,44
"4376","E01006213",2001,630,263,367,37
"4377","E01006294",2001,716,43,673,85
"4378","E01006295",2001,769,153,616,79
"4379","E01006288",2001,684,364,320,32
"4380","E01006377",2001,588,7,581,12
"4381","E01006378",2001,592,4,588,13
"4382","E01006322",2001,542,151,391,60
"4383","E01006329",2001,449,116,333,42
"4384","E01006216",2001,567,81,486,23
"4385","E01006214",2001,602,96,506,60
"4386","E01006212",2001,563,61,502,19
"4387","E01006282",2001,592,122,470,21
"4388","E01006283",2001,654,230,424,45
"4389","E01006284",2001,595,214,381,25
"4390","E01006336",2001,658,461,197,18
"4391","E01006337",2001,597,105,492,14
"4392","E01006376",2001,673,293,380,32
"4393","E01006381",2001,514,9,505,15
"4394","E01006382",2001,514,5,509,9
"4395","E01006383",2001,629,74,555,19
"4396","E01006384",2001,589,9,580,32
"4397","E01006385",2001,583,6,577,8
"4398","E01006379",2001,603,21,582,14
"4399","E01006380",2001,689,348,341,18
"4400","E01006250",2001,661,4,657,41
"4401","E01006251",2001,569,0,569,23
"4402","E01006338",2001,640,83,557,66
"4403","E01006333",2001,727,59,668,93
"4404","E01006334",2001,768,24,744,115
"4405","E01006328",2001,633,51,582,121
"4406","E01006330",2001,620,13,607,13
"4407","E01006331",2001,630,3,627,13
"4408","E01006332",2001,604,65,539,74
"4409","E01006248",2001,753,518,235,14
"4410","E01006249",2001,610,234,376,23
"4411","E01006262",2001,570,261,309,18
"4412","E01006263",2001,635,11,624,8
"4413","E01006266",2001,643,9,634,18
"4414","E01006267",2001,767,438,329,21
"4415","E01006268",2001,635,78,557,45
"4416","E01006323",2001,621,84,537,171
"4417","E01006324",2001,641,190,451,35
"4418","E01006325",2001,604,40,564,44
"4419","E01006326",2001,635,46,589,72
"4420","E01006327",2001,590,357,233,31
"4421","E01006297",2001,675,344,331,41
"4422","E01006335",2001,699,89,610,73
"4423","E01006252",2001,608,9,599,16
"4424","E01006246",2001,737,202,535,27
"4425","E01006247",2001,557,44,513,15
"4426","E01006226",2001,642,41,601,25
"4427","E01006224",2001,515,6,509,11
"4428","E01006220",2001,694,258,436,24
"4429","E01006221",2001,626,13,613,46
"4430","E01006222",2001,609,0,609,14
"4431","E01006223",2001,673,26,647,82
"4432","E01006225",2001,622,44,578,18
"4433","E01006261",2001,649,143,506,30
"4434","E01006264",2001,520,5,515,3
"4435","E01006265",2001,618,41,577,47
"4436","E01006296",2001,654,334,320,32
"4437","E01006298",2001,670,284,386,52
"4438","E01006299",2001,636,22,614,31
"4439","E01006300",2001,605,33,572,12
"4440","E01006301",2001,528,11,517,12
"4441","E01006346",2001,774,119,655,64
"4442","E01006342",2001,630,249,381,25
"4443","E01006344",2001,573,263,310,0
"4444","E01006227",2001,583,59,524,13
"4445","E01006228",2001,610,47,563,74
"4446","E01006345",2001,638,28,610,11
"4447","E01006343",2001,643,8,635,25
"4448","E01006348",2001,650,6,644,22
"4449","E01006339",2001,592,18,574,10
"4450","E01006340",2001,598,190,408,21
"4451","E01006341",2001,664,236,428,34
"4452","E01006347",2001,634,5,629,9
"4453","E01006302",2001,606,24,582,45
"4454","E01006303",2001,593,14,579,32
"4455","E01006304",2001,596,105,491,14
"4456","E01024891",2001,646,172,474,9
"4457","E01024892",2001,635,103,532,16
"4458","E01024894",2001,505,110,395,14
"4459","E01024859",2001,673,10,663,54
"4460","E01024861",2001,520,26,494,10
"4461","E01024862",2001,640,13,627,26
"4462","E01024893",2001,616,23,593,103
"4463","E01024896",2001,585,101,484,27
"4464","E01024897",2001,548,17,531,41
"4465","E01024898",2001,699,19,680,131
"4466","E01024895",2001,619,23,596,154
"4467","E01024856",2001,617,15,602,91
"4468","E01024875",2001,401,30,371,112
"4469","E01024876",2001,508,69,439,134
"4470","E01024877",2001,516,135,381,107
"4471","E01024878",2001,489,37,452,128
"4472","E01024889",2001,611,68,543,61
"4473","E01024890",2001,638,194,444,75
"4474","E01024883",2001,637,242,395,32
"4475","E01024884",2001,638,139,499,18
"4476","E01024885",2001,732,56,676,170
"4477","E01024886",2001,621,21,600,99
"4478","E01024879",2001,575,116,459,47
"4479","E01024880",2001,623,133,490,24
"4480","E01024912",2001,578,10,568,15
"4481","E01024913",2001,507,7,500,6
"4482","E01024914",2001,612,0,612,12
"4483","E01024911",2001,732,175,557,49
"4484","E01024902",2001,633,80,553,63
"4485","E01024881",2001,634,26,608,61
"4486","E01024882",2001,666,95,571,93
"4487","E01024857",2001,630,191,439,73
"4488","E01024858",2001,592,82,510,236
"4489","E01024855",2001,763,277,486,109
"4490","E01024864",2001,738,38,700,70
"4491","E01024865",2001,748,330,418,24
"4492","E01024866",2001,733,313,420,14
"4493","E01024867",2001,591,3,588,16
"4494","E01024863",2001,613,210,403,17
"4495","E01024860",2001,501,45,456,17
"4496","E01024868",2001,482,18,464,34
"4497","E01024869",2001,619,3,616,20
"4498","E01024870",2001,502,25,477,30
"4499","E01024872",2001,617,273,344,43
"4500","E01024899",2001,642,199,443,35
"4501","E01024900",2001,639,291,348,83
"4502","E01024907",2001,624,26,598,134
"4503","E01024908",2001,759,143,616,191
"4504","E01024909",2001,631,123,508,129
"4505","E01024901",2001,578,3,575,14
"4506","E01024887",2001,595,100,495,39
"4507","E01024888",2001,641,29,612,42
"4508","E01024874",2001,425,9,416,14
"4509","E01024910",2001,625,24,601,114
"4510","E01024904",2001,752,30,722,112
"4511","E01024906",2001,1033,184,849,261
"4512","E01024905",2001,498,8,490,18
"4513","E01024903",2001,480,188,292,14
"4514","E01024873",2001,596,85,511,22
"4515","E01024871",2001,491,6,485,24
"4516","E01024951",2001,470,307,163,11
"4517","E01024952",2001,530,278,252,15
"4518","E01024953",2001,629,437,192,10
"4519","E01024954",2001,634,96,538,30
"4520","E01024978",2001,573,62,511,39
"4521","E01024979",2001,589,3,586,31
"4522","E01024980",2001,580,48,532,34
"4523","E01024921",2001,857,22,835,73
"4524","E01024946",2001,517,42,475,10
"4525","E01024947",2001,499,3,496,18
"4526","E01024955",2001,645,14,631,34
"4527","E01024956",2001,604,0,604,15
"4528","E01024957",2001,533,6,527,12
"4529","E01024958",2001,562,138,424,17
"4530","E01024948",2001,642,11,631,23
"4531","E01024949",2001,530,109,421,25
"4532","E01024950",2001,524,3,521,16
"4533","E01024977",2001,872,39,833,22
"4534","E01024967",2001,526,9,517,14
"4535","E01024968",2001,495,3,492,25
"4536","E01024969",2001,599,164,435,15
"4537","E01024970",2001,560,3,557,12
"4538","E01024971",2001,489,15,474,13
"4539","E01024972",2001,536,3,533,8
"4540","E01024937",2001,635,10,625,31
"4541","E01024929",2001,527,232,295,17
"4542","E01024930",2001,629,62,567,39
"4543","E01024931",2001,668,79,589,72
"4544","E01024932",2001,411,3,408,6
"4545","E01024933",2001,632,163,469,33
"4546","E01024964",2001,613,29,584,16
"4547","E01024974",2001,617,23,594,34
"4548","E01024975",2001,427,9,418,36
"4549","E01024976",2001,623,78,545,29
"4550","E01024934",2001,589,13,576,9
"4551","E01024935",2001,629,3,626,8
"4552","E01024919",2001,544,342,202,11
"4553","E01024920",2001,929,98,831,24
"4554","E01024925",2001,741,290,451,71
"4555","E01024926",2001,723,317,406,29
"4556","E01024927",2001,679,65,614,47
"4557","E01024928",2001,652,80,572,38
"4558","E01024936",2001,731,19,712,97
"4559","E01024938",2001,646,18,628,17
"4560","E01024939",2001,558,6,552,6
"4561","E01024940",2001,727,182,545,147
"4562","E01024941",2001,699,270,429,35
"4563","E01024965",2001,559,3,556,15
"4564","E01024966",2001,623,7,616,32
"4565","E01024963",2001,657,61,596,31
"4566","E01024923",2001,508,21,487,20
"4567","E01024924",2001,599,54,545,11
"4568","E01024942",2001,781,399,382,21
"4569","E01024943",2001,709,140,569,52
"4570","E01024944",2001,504,38,466,15
"4571","E01024945",2001,652,188,464,34
"4572","E01024959",2001,708,265,443,76
"4573","E01024960",2001,630,143,487,31
"4574","E01024961",2001,642,29,613,28
"4575","E01024962",2001,610,0,610,14
"4576","E01024922",2001,476,43,433,20
"4577","E01024915",2001,781,142,639,44
"4578","E01024916",2001,631,0,631,17
"4579","E01024917",2001,737,127,610,65
"4580","E01024918",2001,707,6,701,33
"4581","E01024973",2001,871,31,840,52
"4582","E01024993",2001,574,26,548,18
"4583","E01025026",2001,518,14,504,73
"4584","E01025027",2001,662,65,597,163
"4585","E01025028",2001,529,55,474,18
"4586","E01025031",2001,491,13,478,34
"4587","E01025007",2001,483,3,480,18
"4588","E01025008",2001,501,0,501,15
"4589","E01025009",2001,713,77,636,88
"4590","E01025011",2001,638,129,509,101
"4591","E01025012",2001,653,37,616,26
"4592","E01025013",2001,634,122,512,59
"4593","E01025019",2001,602,9,593,26
"4594","E01025014",2001,608,53,555,63
"4595","E01025015",2001,621,22,599,20
"4596","E01025010",2001,523,27,496,15
"4597","E01024998",2001,650,131,519,49
"4598","E01025004",2001,608,14,594,31
"4599","E01025006",2001,621,211,410,59
"4600","E01025023",2001,590,3,587,23
"4601","E01025024",2001,576,56,520,43
"4602","E01025025",2001,671,43,628,57
"4603","E01025018",2001,498,5,493,33
"4604","E01025005",2001,723,22,701,44
"4605","E01025001",2001,751,112,639,71
"4606","E01025002",2001,634,15,619,69
"4607","E01025016",2001,618,3,615,18
"4608","E01024996",2001,630,25,605,271
"4609","E01024984",2001,612,4,608,68
"4610","E01024985",2001,614,13,601,38
"4611","E01024986",2001,897,27,870,382
"4612","E01024987",2001,718,67,651,341
"4613","E01024988",2001,752,15,737,220
"4614","E01024989",2001,646,15,631,106
"4615","E01024997",2001,654,3,651,36
"4616","E01024999",2001,635,79,556,31
"4617","E01025000",2001,606,8,598,39
"4618","E01025029",2001,917,45,872,50
"4619","E01025030",2001,604,151,453,80
"4620","E01024994",2001,596,5,591,43
"4621","E01024995",2001,653,3,650,108
"4622","E01025017",2001,783,241,542,44
"4623","E01025003",2001,752,4,748,55
"4624","E01024981",2001,624,21,603,63
"4625","E01024982",2001,625,34,591,103
"4626","E01024983",2001,600,9,591,67
"4627","E01025020",2001,507,96,411,42
"4628","E01025021",2001,651,44,607,67
"4629","E01025022",2001,624,14,610,72
"4630","E01024990",2001,733,36,697,144
"4631","E01024991",2001,503,12,491,111
"4632","E01024992",2001,718,3,715,25
"4633","E01025060",2001,578,16,562,87
"4634","E01025061",2001,653,101,552,24
"4635","E01025062",2001,707,71,636,132
"4636","E01025063",2001,709,216,493,24
"4637","E01025064",2001,661,18,643,15
"4638","E01025065",2001,784,76,708,114
"4639","E01025066",2001,609,22,587,43
"4640","E01025032",2001,609,185,424,33
"4641","E01025033",2001,506,15,491,25
"4642","E01025034",2001,694,20,674,60
"4643","E01025048",2001,645,52,593,18
"4644","E01025049",2001,764,151,613,128
"4645","E01025050",2001,626,48,578,59
"4646","E01025053",2001,499,67,432,50
"4647","E01025070",2001,525,118,407,59
"4648","E01025071",2001,617,62,555,93
"4649","E01025072",2001,645,42,603,134
"4650","E01025073",2001,607,19,588,53
"4651","E01025074",2001,586,8,578,15
"4652","E01025067",2001,672,33,639,145
"4653","E01025068",2001,692,115,577,119
"4654","E01025069",2001,594,14,580,72
"4655","E01025057",2001,696,10,686,51
"4656","E01025058",2001,659,184,475,29
"4657","E01025059",2001,679,191,488,22
"4658","E01025051",2001,621,232,389,30
"4659","E01025052",2001,639,12,627,15
"4660","E01025044",2001,496,17,479,68
"4661","E01025045",2001,513,303,210,20
"4662","E01025046",2001,600,207,393,76
"4663","E01025081",2001,634,4,630,20
"4664","E01025082",2001,666,356,310,32
"4665","E01025083",2001,714,86,628,141
"4666","E01025084",2001,551,51,500,72
"4667","E01025047",2001,483,30,453,101
"4668","E01025041",2001,609,242,367,83
"4669","E01025042",2001,512,31,481,74
"4670","E01025043",2001,482,62,420,61
"4671","E01025055",2001,668,143,525,78
"4672","E01025075",2001,661,86,575,51
"4673","E01025076",2001,649,142,507,64
"4674","E01025077",2001,613,171,442,38
"4675","E01025078",2001,613,15,598,12
"4676","E01025035",2001,647,113,534,26
"4677","E01025036",2001,648,119,529,149
"4678","E01025037",2001,603,108,495,50
"4679","E01025038",2001,609,39,570,14
"4680","E01025039",2001,502,3,499,19
"4681","E01025040",2001,588,7,581,18
"4682","E01025056",2001,600,16,584,15
"4683","E01025054",2001,659,165,494,42
"4684","E01025079",2001,725,8,717,14
"4685","E01025080",2001,663,21,642,40
"4686","E01025088",2001,461,6,455,34
"4687","E01025096",2001,608,4,604,52
"4688","E01025097",2001,639,188,451,29
"4689","E01025098",2001,516,5,511,50
"4690","E01025148",2001,905,34,871,86
"4691","E01025168",2001,492,28,464,27
"4692","E01025169",2001,508,31,477,25
"4693","E01025130",2001,910,32,878,88
"4694","E01025132",2001,539,11,528,78
"4695","E01025166",2001,505,34,471,45
"4696","E01025167",2001,443,16,427,80
"4697","E01025158",2001,617,3,614,16
"4698","E01025159",2001,611,21,590,48
"4699","E01025160",2001,554,5,549,13
"4700","E01025089",2001,595,38,557,22
"4701","E01025090",2001,720,3,717,23
"4702","E01025085",2001,630,9,621,59
"4703","E01025086",2001,654,7,647,33
"4704","E01025087",2001,616,4,612,177
"4705","E01025161",2001,626,6,620,29
"4706","E01025133",2001,674,40,634,28
"4707","E01025131",2001,635,54,581,69
"4708","E01025108",2001,506,42,464,39
"4709","E01025109",2001,453,14,439,27
"4710","E01025112",2001,802,191,611,194
"4711","E01025138",2001,614,16,598,104
"4712","E01025139",2001,781,24,757,407
"4713","E01025140",2001,713,42,671,255
"4714","E01025136",2001,767,194,573,230
"4715","E01025137",2001,617,33,584,56
"4716","E01025162",2001,709,7,702,24
"4717","E01025163",2001,621,3,618,26
"4718","E01025164",2001,652,27,625,47
"4719","E01025165",2001,506,0,506,28
"4720","E01025113",2001,638,5,633,100
"4721","E01025118",2001,487,16,471,96
"4722","E01025119",2001,611,3,608,71
"4723","E01025111",2001,719,36,683,78
"4724","E01025110",2001,861,70,791,475
"4725","E01025120",2001,609,15,594,229
"4726","E01025116",2001,619,37,582,162
"4727","E01025117",2001,742,37,705,424
"4728","E01025170",2001,838,42,796,54
"4729","E01025171",2001,751,274,477,56
"4730","E01025172",2001,659,20,639,91
"4731","E01025173",2001,794,210,584,45
"4732","E01025149",2001,923,62,861,125
"4733","E01025150",2001,628,46,582,46
"4734","E01025151",2001,747,273,474,120
"4735","E01025152",2001,596,147,449,43
"4736","E01025154",2001,649,355,294,22
"4737","E01025155",2001,515,3,512,13
"4738","E01025156",2001,488,343,145,23
"4739","E01025157",2001,608,290,318,19
"4740","E01025153",2001,515,34,481,30
"4741","E01025126",2001,544,7,537,65
"4742","E01025095",2001,503,3,500,78
"4743","E01025091",2001,618,192,426,53
"4744","E01025092",2001,515,205,310,28
"4745","E01025093",2001,501,57,444,177
"4746","E01025094",2001,605,154,451,118
"4747","E01025099",2001,674,82,592,240
"4748","E01025104",2001,967,98,869,403
"4749","E01025128",2001,681,52,629,193
"4750","E01025129",2001,528,3,525,210
"4751","E01025125",2001,406,11,395,148
"4752","E01025147",2001,635,23,612,144
"4753","E01025134",2001,443,7,436,60
"4754","E01025135",2001,566,11,555,63
"4755","E01025121",2001,652,20,632,82
"4756","E01025122",2001,738,8,730,92
"4757","E01025123",2001,617,6,611,42
"4758","E01025124",2001,626,212,414,64
"4759","E01025114",2001,702,9,693,54
"4760","E01025115",2001,627,144,483,63
"4761","E01025146",2001,648,6,642,48
"4762","E01025144",2001,723,148,575,122
"4763","E01025100",2001,627,60,567,96
"4764","E01025101",2001,613,250,363,94
"4765","E01025102",2001,516,15,501,111
"4766","E01025103",2001,502,5,497,29
"4767","E01025145",2001,627,29,598,130
"4768","E01025143",2001,643,223,420,51
"4769","E01025141",2001,600,70,530,41
"4770","E01025127",2001,607,3,604,25
"4771","E01025142",2001,630,10,620,20
"4772","E01025105",2001,509,4,505,139
"4773","E01025106",2001,702,45,657,97
"4774","E01025107",2001,560,8,552,84
"4775","E01025191",2001,491,8,483,17
"4776","E01025192",2001,609,56,553,73
"4777","E01025193",2001,616,147,469,16
"4778","E01025194",2001,612,50,562,82
"4779","E01025195",2001,490,10,480,24
"4780","E01025196",2001,732,33,699,167
"4781","E01025197",2001,565,5,560,22
"4782","E01025198",2001,631,85,546,68
"4783","E01025199",2001,632,20,612,53
"4784","E01025200",2001,615,104,511,43
"4785","E01025201",2001,637,87,550,47
"4786","E01025202",2001,569,55,514,27
"4787","E01025205",2001,606,66,540,94
"4788","E01025206",2001,493,51,442,15
"4789","E01025207",2001,648,127,521,86
"4790","E01025208",2001,638,250,388,31
"4791","E01025220",2001,626,282,344,51
"4792","E01025221",2001,520,172,348,33
"4793","E01025222",2001,587,52,535,32
"4794","E01025223",2001,604,123,481,68
"4795","E01025203",2001,731,28,703,55
"4796","E01025178",2001,663,67,596,56
"4797","E01025179",2001,658,17,641,57
"4798","E01025180",2001,719,46,673,40
"4799","E01025226",2001,654,168,486,123
"4800","E01025227",2001,899,182,717,179
"4801","E01025228",2001,612,20,592,31
"4802","E01025204",2001,695,18,677,46
"4803","E01025211",2001,674,50,624,30
"4804","E01025174",2001,610,3,607,26
"4805","E01025175",2001,644,39,605,27
"4806","E01025176",2001,893,139,754,120
"4807","E01025177",2001,714,17,697,33
"4808","E01025181",2001,626,309,317,32
"4809","E01025182",2001,619,128,491,101
"4810","E01025183",2001,626,88,538,96
"4811","E01025184",2001,634,30,604,170
"4812","E01025210",2001,772,146,626,46
"4813","E01025217",2001,622,46,576,96
"4814","E01025218",2001,468,159,309,71
"4815","E01025219",2001,613,27,586,121
"4816","E01025188",2001,854,203,651,124
"4817","E01025189",2001,647,37,610,88
"4818","E01025229",2001,761,34,727,120
"4819","E01025230",2001,526,60,466,102
"4820","E01025224",2001,728,74,654,96
"4821","E01025225",2001,620,8,612,25
"4822","E01025216",2001,508,106,402,17
"4823","E01025190",2001,620,37,583,25
"4824","E01025209",2001,652,167,485,13
"4825","E01025187",2001,565,85,480,13
"4826","E01025212",2001,565,6,559,5
"4827","E01025213",2001,420,23,397,25
"4828","E01025214",2001,522,8,514,9
"4829","E01025215",2001,514,94,420,55
"4830","E01025185",2001,767,69,698,101
"4831","E01025186",2001,627,38,589,131
"4832","E01025282",2001,569,15,554,23
"4833","E01025278",2001,790,15,775,19
"4834","E01025279",2001,647,6,641,41
"4835","E01025280",2001,638,12,626,45
"4836","E01025281",2001,557,3,554,19
"4837","E01025277",2001,727,42,685,32
"4838","E01025257",2001,502,0,502,3
"4839","E01025258",2001,626,4,622,14
"4840","E01025259",2001,886,15,871,26
"4841","E01025256",2001,639,68,571,27
"4842","E01025299",2001,620,9,611,22
"4843","E01025301",2001,484,62,422,27
"4844","E01025302",2001,519,8,511,7
"4845","E01025303",2001,630,6,624,45
"4846","E01025300",2001,560,173,387,20
"4847","E01025253",2001,471,7,464,9
"4848","E01025254",2001,470,8,462,15
"4849","E01025255",2001,575,10,565,17
"4850","E01025260",2001,731,355,376,36
"4851","E01025262",2001,718,245,473,23
"4852","E01025263",2001,648,344,304,28
"4853","E01025264",2001,649,308,341,42
"4854","E01025251",2001,558,105,453,48
"4855","E01025241",2001,626,11,615,21
"4856","E01025242",2001,616,7,609,8
"4857","E01025243",2001,705,90,615,73
"4858","E01025239",2001,653,98,555,18
"4859","E01025237",2001,657,203,454,26
"4860","E01025238",2001,650,297,353,26
"4861","E01025234",2001,553,155,398,11
"4862","E01025235",2001,621,22,599,19
"4863","E01025245",2001,902,338,564,60
"4864","E01025252",2001,629,151,478,31
"4865","E01025261",2001,650,22,628,34
"4866","E01025233",2001,508,9,499,27
"4867","E01025240",2001,656,8,648,11
"4868","E01025266",2001,526,3,523,21
"4869","E01025309",2001,553,88,465,25
"4870","E01025283",2001,518,321,197,14
"4871","E01025284",2001,604,105,499,16
"4872","E01025285",2001,472,127,345,28
"4873","E01025286",2001,616,367,249,17
"4874","E01025287",2001,747,372,375,29
"4875","E01025236",2001,574,285,289,19
"4876","E01025288",2001,791,146,645,151
"4877","E01025270",2001,626,52,574,36
"4878","E01025272",2001,488,31,457,10
"4879","E01025273",2001,506,0,506,12
"4880","E01025274",2001,741,109,632,202
"4881","E01025275",2001,742,213,529,112
"4882","E01025294",2001,608,45,563,111
"4883","E01025246",2001,498,34,464,57
"4884","E01025276",2001,638,30,608,117
"4885","E01025310",2001,702,76,626,104
"4886","E01025311",2001,647,64,583,85
"4887","E01025312",2001,639,37,602,103
"4888","E01025313",2001,697,336,361,87
"4889","E01025314",2001,718,91,627,166
"4890","E01025308",2001,516,40,476,117
"4891","E01025271",2001,644,217,427,27
"4892","E01025267",2001,618,167,451,14
"4893","E01025268",2001,727,289,438,27
"4894","E01025269",2001,626,213,413,22
"4895","E01025265",2001,656,90,566,25
"4896","E01025231",2001,585,12,573,42
"4897","E01025232",2001,737,68,669,162
"4898","E01025295",2001,788,385,403,57
"4899","E01025296",2001,606,175,431,47
"4900","E01025297",2001,675,122,553,99
"4901","E01025298",2001,596,88,508,70
"4902","E01025292",2001,758,280,478,147
"4903","E01025293",2001,852,387,465,100
"4904","E01025244",2001,480,35,445,88
"4905","E01025247",2001,547,105,442,67
"4906","E01025248",2001,468,251,217,24
"4907","E01025249",2001,428,56,372,20
"4908","E01025250",2001,553,173,380,42
"4909","E01025304",2001,597,57,540,47
"4910","E01025305",2001,635,97,538,79
"4911","E01025306",2001,589,93,496,250
"4912","E01025307",2001,1200,613,587,173
"4913","E01025289",2001,606,109,497,116
"4914","E01025290",2001,596,88,508,206
"4915","E01025291",2001,609,70,539,102
"4916","E01025315",2001,492,18,474,133
"4917","E01025320",2001,484,0,484,174
"4918","E01025331",2001,499,31,468,69
"4919","E01025348",2001,622,38,584,57
"4920","E01025349",2001,534,29,505,41
"4921","E01025344",2001,599,81,518,76
"4922","E01025345",2001,604,8,596,62
"4923","E01025346",2001,647,29,618,85
"4924","E01025347",2001,655,82,573,56
"4925","E01025334",2001,626,44,582,64
"4926","E01025335",2001,668,225,443,50
"4927","E01025329",2001,618,137,481,22
"4928","E01025330",2001,601,128,473,35
"4929","E01025338",2001,644,30,614,79
"4930","E01025339",2001,634,115,519,34
"4931","E01025342",2001,623,43,580,41
"4932","E01025322",2001,508,28,480,109
"4933","E01025326",2001,615,13,602,54
"4934","E01025327",2001,490,23,467,20
"4935","E01025321",2001,555,55,500,109
"4936","E01025343",2001,586,32,554,50
"4937","E01025340",2001,594,23,571,49
"4938","E01025341",2001,465,3,462,7
"4939","E01025354",2001,559,25,534,65
"4940","E01025328",2001,477,4,473,26
"4941","E01025325",2001,714,180,534,97
"4942","E01025316",2001,544,3,541,24
"4943","E01025317",2001,448,13,435,43
"4944","E01025318",2001,443,38,405,22
"4945","E01025319",2001,507,17,490,37
"4946","E01025350",2001,526,64,462,31
"4947","E01025351",2001,655,21,634,77
"4948","E01025333",2001,478,3,475,26
"4949","E01025352",2001,551,0,551,8
"4950","E01025353",2001,443,8,435,21
"4951","E01025323",2001,450,30,420,24
"4952","E01025324",2001,557,3,554,13
"4953","E01025332",2001,436,3,433,3
"4954","E01025336",2001,429,3,426,23
"4955","E01025337",2001,655,57,598,26
"4956","E01025355",2001,755,13,742,30
"4957","E01025361",2001,848,41,807,63
"4958","E01025362",2001,648,143,505,23
"4959","E01025393",2001,578,69,509,58
"4960","E01025395",2001,644,52,592,48
"4961","E01025396",2001,614,311,303,58
"4962","E01025397",2001,613,61,552,101
"4963","E01025398",2001,536,158,378,35
"4964","E01025363",2001,523,109,414,12
"4965","E01025364",2001,525,4,521,17
"4966","E01025366",2001,487,113,374,45
"4967","E01025367",2001,561,15,546,36
"4968","E01025368",2001,642,56,586,95
"4969","E01025369",2001,524,118,406,103
"4970","E01025381",2001,598,183,415,35
"4971","E01025382",2001,755,311,444,83
"4972","E01025383",2001,691,55,636,39
"4973","E01025385",2001,598,340,258,28
"4974","E01025386",2001,599,133,466,44
"4975","E01025387",2001,497,90,407,11
"4976","E01025372",2001,404,64,340,47
"4977","E01025373",2001,648,61,587,52
"4978","E01025356",2001,628,85,543,69
"4979","E01025374",2001,616,175,441,22
"4980","E01025371",2001,632,226,406,71
"4981","E01025394",2001,596,131,465,49
"4982","E01025391",2001,638,218,420,23
"4983","E01025392",2001,524,53,471,67
"4984","E01025388",2001,632,61,571,108
"4985","E01025389",2001,541,113,428,56
"4986","E01025390",2001,515,190,325,28
"4987","E01025370",2001,518,7,511,63
"4988","E01025377",2001,536,14,522,24
"4989","E01025378",2001,611,9,602,84
"4990","E01025379",2001,634,267,367,21
"4991","E01025380",2001,564,12,552,16
"4992","E01025384",2001,523,45,478,28
"4993","E01025365",2001,595,19,576,21
"4994","E01025357",2001,618,108,510,53
"4995","E01025358",2001,856,19,837,56
"4996","E01025359",2001,670,80,590,35
"4997","E01025360",2001,868,193,675,94
"4998","E01025375",2001,634,28,606,36
"4999","E01025376",2001,887,295,592,73
"5000","E01025424",2001,512,10,502,18
"5001","E01025425",2001,541,3,538,8
"5002","E01025426",2001,496,0,496,18
"5003","E01025466",2001,625,39,586,11
"5004","E01025456",2001,413,15,398,28
"5005","E01025458",2001,636,85,551,46
"5006","E01025413",2001,768,39,729,28
"5007","E01025414",2001,683,0,683,8
"5008","E01025467",2001,884,5,879,23
"5009","E01025408",2001,640,6,634,13
"5010","E01025409",2001,605,16,589,21
"5011","E01025410",2001,457,0,457,6
"5012","E01025403",2001,586,3,583,8
"5013","E01025457",2001,626,15,611,58
"5014","E01025463",2001,576,4,572,14
"5015","E01025464",2001,532,4,528,10
"5016","E01025465",2001,492,53,439,17
"5017","E01025448",2001,713,12,701,52
"5018","E01025449",2001,434,45,389,9
"5019","E01025450",2001,428,104,324,24
"5020","E01025411",2001,754,13,741,50
"5021","E01025412",2001,689,142,547,30
"5022","E01025427",2001,752,237,515,46
"5023","E01025428",2001,609,116,493,20
"5024","E01025429",2001,613,310,303,15
"5025","E01025404",2001,566,0,566,6
"5026","E01025405",2001,568,100,468,33
"5027","E01025406",2001,512,51,461,9
"5028","E01025407",2001,619,156,463,33
"5029","E01025399",2001,597,161,436,26
"5030","E01025400",2001,516,43,473,9
"5031","E01025401",2001,625,9,616,25
"5032","E01025402",2001,430,42,388,30
"5033","E01025442",2001,520,114,406,33
"5034","E01025443",2001,620,3,617,18
"5035","E01025444",2001,544,15,529,31
"5036","E01025461",2001,615,15,600,8
"5037","E01025462",2001,645,4,641,31
"5038","E01025439",2001,557,3,554,15
"5039","E01025453",2001,571,9,562,35
"5040","E01025454",2001,519,45,474,15
"5041","E01025455",2001,603,6,597,16
"5042","E01025440",2001,619,7,612,18
"5043","E01025441",2001,587,56,531,26
"5044","E01025436",2001,817,18,799,31
"5045","E01025437",2001,678,44,634,39
"5046","E01025438",2001,511,3,508,12
"5047","E01025417",2001,622,50,572,13
"5048","E01025418",2001,599,16,583,43
"5049","E01025419",2001,605,104,501,23
"5050","E01025420",2001,847,36,811,27
"5051","E01025421",2001,497,59,438,27
"5052","E01025422",2001,641,99,542,34
"5053","E01025431",2001,745,71,674,66
"5054","E01025433",2001,732,15,717,34
"5055","E01025416",2001,600,36,564,16
"5056","E01025451",2001,710,4,706,12
"5057","E01025452",2001,707,331,376,34
"5058","E01025446",2001,656,61,595,18
"5059","E01025435",2001,627,67,560,49
"5060","E01025415",2001,832,136,696,34
"5061","E01025423",2001,617,333,284,14
"5062","E01025430",2001,789,23,766,20
"5063","E01025432",2001,604,93,511,23
"5064","E01025434",2001,823,3,820,7
"5065","E01025447",2001,521,343,178,12
"5066","E01025445",2001,499,265,234,10
"5067","E01025459",2001,665,6,659,49
"5068","E01025460",2001,904,348,556,28
"5069","E01025496",2001,478,38,440,21
"5070","E01025497",2001,477,8,469,22
"5071","E01025498",2001,492,4,488,27
"5072","E01025532",2001,508,7,501,19
"5073","E01025533",2001,641,86,555,69
"5074","E01025530",2001,631,12,619,29
"5075","E01025531",2001,440,19,421,26
"5076","E01025507",2001,502,4,498,23
"5077","E01025508",2001,510,8,502,25
"5078","E01025509",2001,538,90,448,26
"5079","E01025513",2001,798,53,745,29
"5080","E01025514",2001,850,21,829,49
"5081","E01025515",2001,630,40,590,40
"5082","E01025495",2001,801,45,756,43
"5083","E01025474",2001,477,59,418,78
"5084","E01025483",2001,799,256,543,26
"5085","E01025484",2001,666,11,655,30
"5086","E01025485",2001,646,44,602,70
"5087","E01025486",2001,642,52,590,29
"5088","E01025487",2001,630,93,537,25
"5089","E01025510",2001,493,3,490,18
"5090","E01025511",2001,464,8,456,22
"5091","E01025512",2001,590,31,559,42
"5092","E01025538",2001,648,39,609,32
"5093","E01025539",2001,501,41,460,23
"5094","E01025516",2001,641,49,592,16
"5095","E01025517",2001,601,163,438,46
"5096","E01025499",2001,604,52,552,57
"5097","E01025501",2001,494,9,485,15
"5098","E01025502",2001,638,6,632,13
"5099","E01025519",2001,531,5,526,14
"5100","E01025500",2001,609,65,544,70
"5101","E01025518",2001,625,165,460,111
"5102","E01025488",2001,640,120,520,103
"5103","E01025489",2001,542,37,505,65
"5104","E01025490",2001,492,62,430,101
"5105","E01025491",2001,557,27,530,25
"5106","E01025479",2001,834,46,788,108
"5107","E01025506",2001,837,28,809,42
"5108","E01025522",2001,516,83,433,17
"5109","E01025468",2001,603,30,573,15
"5110","E01025469",2001,760,310,450,36
"5111","E01025470",2001,551,6,545,17
"5112","E01025471",2001,601,269,332,25
"5113","E01025480",2001,488,221,267,19
"5114","E01025481",2001,674,355,319,13
"5115","E01025482",2001,611,377,234,26
"5116","E01025520",2001,527,222,305,24
"5117","E01025521",2001,636,220,416,33
"5118","E01025523",2001,616,113,503,42
"5119","E01025524",2001,766,442,324,25
"5120","E01025525",2001,649,125,524,12
"5121","E01025526",2001,747,141,606,51
"5122","E01025475",2001,618,3,615,11
"5123","E01025476",2001,521,17,504,27
"5124","E01025477",2001,474,26,448,27
"5125","E01025478",2001,484,0,484,0
"5126","E01025472",2001,549,0,549,11
"5127","E01025473",2001,598,98,500,29
"5128","E01025492",2001,494,83,411,11
"5129","E01025527",2001,617,318,299,14
"5130","E01025528",2001,542,345,197,17
"5131","E01025529",2001,524,192,332,23
"5132","E01025503",2001,517,187,330,40
"5133","E01025504",2001,482,247,235,36
"5134","E01025505",2001,666,160,506,30
"5135","E01025493",2001,652,425,227,23
"5136","E01025494",2001,662,293,369,55
"5137","E01025534",2001,597,41,556,22
"5138","E01025535",2001,586,59,527,25
"5139","E01025536",2001,626,272,354,19
"5140","E01025537",2001,645,58,587,30
"5141","E01025540",2001,466,14,452,26
"5142","E01025573",2001,603,7,596,36
"5143","E01025574",2001,730,158,572,103
"5144","E01025581",2001,630,10,620,97
"5145","E01025582",2001,612,58,554,126
"5146","E01025583",2001,667,25,642,147
"5147","E01025584",2001,879,142,737,312
"5148","E01025605",2001,582,13,569,25
"5149","E01025606",2001,506,177,329,31
"5150","E01025607",2001,625,33,592,33
"5151","E01025608",2001,605,5,600,27
"5152","E01025590",2001,621,261,360,38
"5153","E01025591",2001,777,3,774,29
"5154","E01025592",2001,622,336,286,34
"5155","E01025593",2001,621,6,615,33
"5156","E01025586",2001,637,7,630,43
"5157","E01025587",2001,619,21,598,34
"5158","E01025588",2001,672,26,646,49
"5159","E01025589",2001,467,44,423,48
"5160","E01025563",2001,469,4,465,30
"5161","E01025564",2001,683,13,670,21
"5162","E01025565",2001,644,10,634,47
"5163","E01025557",2001,628,10,618,32
"5164","E01025575",2001,521,298,223,33
"5165","E01025578",2001,637,142,495,41
"5166","E01025579",2001,517,131,386,62
"5167","E01025580",2001,513,26,487,18
"5168","E01025609",2001,786,46,740,118
"5169","E01025547",2001,638,35,603,92
"5170","E01025549",2001,663,27,636,58
"5171","E01025553",2001,887,27,860,66
"5172","E01025548",2001,750,6,744,51
"5173","E01025558",2001,738,71,667,29
"5174","E01025559",2001,634,83,551,62
"5175","E01025560",2001,651,4,647,28
"5176","E01025556",2001,641,47,594,45
"5177","E01025554",2001,749,75,674,30
"5178","E01025570",2001,719,20,699,218
"5179","E01025571",2001,600,4,596,106
"5180","E01025572",2001,631,31,600,21
"5181","E01025604",2001,620,6,614,89
"5182","E01025585",2001,763,41,722,53
"5183","E01025561",2001,576,7,569,21
"5184","E01025562",2001,806,55,751,67
"5185","E01025555",2001,695,13,682,23
"5186","E01025542",2001,616,5,611,25
"5187","E01025601",2001,635,6,629,16
"5188","E01025602",2001,618,9,609,51
"5189","E01025603",2001,709,8,701,27
"5190","E01025543",2001,630,14,616,89
"5191","E01025544",2001,767,103,664,58
"5192","E01025541",2001,618,34,584,81
"5193","E01025576",2001,1030,20,1010,62
"5194","E01025577",2001,626,103,523,68
"5195","E01025552",2001,484,6,478,20
"5196","E01025550",2001,663,7,656,11
"5197","E01025594",2001,735,3,732,49
"5198","E01025595",2001,608,0,608,22
"5199","E01025596",2001,500,15,485,16
"5200","E01025597",2001,480,3,477,18
"5201","E01025598",2001,748,54,694,89
"5202","E01025551",2001,560,22,538,14
"5203","E01025545",2001,619,5,614,12
"5204","E01025546",2001,711,55,656,98
"5205","E01025567",2001,765,102,663,53
"5206","E01025568",2001,829,17,812,61
"5207","E01025569",2001,868,8,860,40
"5208","E01025566",2001,797,17,780,16
"5209","E01025599",2001,432,8,424,25
"5210","E01025600",2001,614,11,603,24
"5211","E01006448",2001,736,375,361,26
"5212","E01006492",2001,498,126,372,13
"5213","E01006493",2001,499,370,129,14
"5214","E01006494",2001,535,304,231,19
"5215","E01006495",2001,495,270,225,14
"5216","E01006490",2001,584,27,557,40
"5217","E01006491",2001,562,12,550,30
"5218","E01006454",2001,515,3,512,9
"5219","E01006456",2001,613,142,471,18
"5220","E01006457",2001,545,17,528,9
"5221","E01006458",2001,496,134,362,5
"5222","E01006447",2001,748,471,277,21
"5223","E01006415",2001,554,237,317,15
"5224","E01006417",2001,763,483,280,24
"5225","E01006436",2001,642,316,326,26
"5226","E01006437",2001,640,264,376,49
"5227","E01006455",2001,634,236,398,46
"5228","E01006506",2001,593,28,565,74
"5229","E01006507",2001,638,298,340,32
"5230","E01006508",2001,618,142,476,32
"5231","E01006509",2001,677,318,359,19
"5232","E01006510",2001,511,20,491,34
"5233","E01006446",2001,592,215,377,33
"5234","E01006438",2001,485,47,438,10
"5235","E01006439",2001,658,189,469,41
"5236","E01006434",2001,625,231,394,34
"5237","E01006435",2001,639,241,398,14
"5238","E01006418",2001,530,230,300,15
"5239","E01006416",2001,628,278,350,25
"5240","E01006412",2001,594,355,239,15
"5241","E01006413",2001,896,693,203,25
"5242","E01006414",2001,618,324,294,11
"5243","E01006441",2001,1007,400,607,42
"5244","E01006460",2001,628,368,260,14
"5245","E01006461",2001,611,265,346,26
"5246","E01006463",2001,783,313,470,81
"5247","E01006464",2001,745,218,527,13
"5248","E01006466",2001,775,147,628,61
"5249","E01006467",2001,624,431,193,18
"5250","E01006468",2001,589,399,190,14
"5251","E01006469",2001,656,481,175,5
"5252","E01006470",2001,597,355,242,19
"5253","E01006453",2001,522,335,187,9
"5254","E01006462",2001,648,44,604,28
"5255","E01006459",2001,608,73,535,43
"5256","E01006498",2001,531,21,510,22
"5257","E01006499",2001,638,84,554,67
"5258","E01006496",2001,628,184,444,15
"5259","E01006442",2001,727,491,236,25
"5260","E01006443",2001,704,382,322,26
"5261","E01006444",2001,500,298,202,17
"5262","E01006445",2001,525,277,248,9
"5263","E01006440",2001,581,283,298,23
"5264","E01006465",2001,585,60,525,8
"5265","E01006482",2001,563,144,419,24
"5266","E01006483",2001,622,215,407,27
"5267","E01006484",2001,618,225,393,40
"5268","E01006449",2001,631,156,475,44
"5269","E01006450",2001,602,266,336,27
"5270","E01006451",2001,603,163,440,60
"5271","E01006452",2001,584,56,528,129
"5272","E01006497",2001,476,50,426,30
"5273","E01006500",2001,472,216,256,16
"5274","E01006501",2001,643,71,572,31
"5275","E01006504",2001,598,300,298,22
"5276","E01006505",2001,728,366,362,21
"5277","E01006485",2001,617,57,560,38
"5278","E01006486",2001,530,14,516,37
"5279","E01006487",2001,608,10,598,18
"5280","E01006488",2001,695,16,679,20
"5281","E01006489",2001,613,46,567,56
"5282","E01006472",2001,624,25,599,23
"5283","E01006477",2001,622,216,406,31
"5284","E01006478",2001,636,260,376,29
"5285","E01006479",2001,594,151,443,27
"5286","E01006480",2001,650,356,294,17
"5287","E01006481",2001,635,265,370,15
"5288","E01006473",2001,486,28,458,8
"5289","E01006474",2001,621,15,606,20
"5290","E01006475",2001,526,18,508,14
"5291","E01006476",2001,529,4,525,4
"5292","E01006471",2001,644,8,636,21
"5293","E01006502",2001,731,39,692,37
"5294","E01006503",2001,569,34,535,20
"5295","E01006424",2001,762,11,751,18
"5296","E01006420",2001,555,22,533,23
"5297","E01006421",2001,468,9,459,13
"5298","E01006425",2001,585,129,456,22
"5299","E01006433",2001,645,169,476,20
"5300","E01006430",2001,590,348,242,11
"5301","E01006427",2001,643,38,605,13
"5302","E01006419",2001,641,17,624,34
"5303","E01006422",2001,535,15,520,11
"5304","E01006423",2001,532,14,518,14
"5305","E01006426",2001,638,331,307,25
"5306","E01006428",2001,593,204,389,24
"5307","E01006429",2001,498,256,242,17
"5308","E01006431",2001,611,164,447,11
"5309","E01006432",2001,616,262,354,16
"5310","E01006651",2001,567,21,546,27
"5311","E01006653",2001,674,244,430,46
"5312","E01006655",2001,632,201,431,52
"5313","E01006660",2001,634,268,366,33
"5314","E01006658",2001,690,350,340,50
"5315","E01006656",2001,656,56,600,97
"5316","E01006657",2001,563,98,465,110
"5317","E01006652",2001,631,30,601,109
"5318","E01006780",2001,576,23,553,116
"5319","E01006783",2001,615,39,576,102
"5320","E01006784",2001,531,19,512,94
"5321","E01006785",2001,604,52,552,111
"5322","E01006786",2001,676,92,584,47
"5323","E01006781",2001,560,29,531,39
"5324","E01006782",2001,613,58,555,115
"5325","E01006661",2001,722,438,284,15
"5326","E01006662",2001,765,510,255,28
"5327","E01006663",2001,609,233,376,40
"5328","E01006664",2001,709,347,362,91
"5329","E01006669",2001,557,66,491,32
"5330","E01006659",2001,526,244,282,54
"5331","E01006654",2001,621,121,500,60
"5332","E01006734",2001,630,402,228,32
"5333","E01006735",2001,620,384,236,25
"5334","E01006736",2001,626,286,340,35
"5335","E01006737",2001,580,315,265,17
"5336","E01006787",2001,517,69,448,160
"5337","E01006788",2001,598,70,528,86
"5338","E01006790",2001,658,335,323,79
"5339","E01006791",2001,770,402,368,88
"5340","E01006665",2001,634,26,608,32
"5341","E01006666",2001,528,16,512,16
"5342","E01006667",2001,613,139,474,38
"5343","E01006668",2001,591,9,582,40
"5344","E01006670",2001,646,33,613,49
"5345","E01006607",2001,636,287,349,23
"5346","E01006612",2001,721,420,301,31
"5347","E01006789",2001,591,141,450,54
"5348","E01006733",2001,616,168,448,55
"5349","E01006729",2001,547,347,200,16
"5350","E01006705",2001,674,75,599,205
"5351","E01006613",2001,606,263,343,22
"5352","E01006608",2001,656,224,432,118
"5353","E01006609",2001,543,101,442,90
"5354","E01006610",2001,637,184,453,110
"5355","E01006672",2001,736,389,347,30
"5356","E01006598",2001,641,407,234,21
"5357","E01006599",2001,634,491,143,18
"5358","E01006601",2001,570,355,215,23
"5359","E01006602",2001,542,423,119,16
"5360","E01006603",2001,601,272,329,13
"5361","E01006600",2001,582,248,334,23
"5362","E01006730",2001,550,277,273,15
"5363","E01006731",2001,522,252,270,23
"5364","E01006732",2001,634,504,130,21
"5365","E01006698",2001,703,101,602,138
"5366","E01006700",2001,624,188,436,112
"5367","E01006611",2001,728,119,609,205
"5368","E01006614",2001,677,117,560,162
"5369","E01006615",2001,635,179,456,154
"5370","E01006623",2001,496,0,496,12
"5371","E01006624",2001,663,209,454,28
"5372","E01006627",2001,550,108,442,38
"5373","E01006671",2001,512,149,363,23
"5374","E01006701",2001,631,184,447,44
"5375","E01006702",2001,687,323,364,67
"5376","E01006703",2001,803,493,310,79
"5377","E01006699",2001,745,440,305,69
"5378","E01006778",2001,835,478,357,142
"5379","E01006762",2001,642,236,406,50
"5380","E01006616",2001,608,232,376,21
"5381","E01006541",2001,770,189,581,92
"5382","E01006543",2001,508,38,470,40
"5383","E01006544",2001,704,318,386,105
"5384","E01006604",2001,609,226,383,25
"5385","E01006605",2001,685,348,337,20
"5386","E01006625",2001,608,54,554,19
"5387","E01006626",2001,600,85,515,28
"5388","E01006618",2001,678,222,456,14
"5389","E01006637",2001,547,337,210,22
"5390","E01006638",2001,631,382,249,55
"5391","E01006639",2001,612,152,460,50
"5392","E01006644",2001,725,345,380,44
"5393","E01006645",2001,667,431,236,21
"5394","E01006558",2001,817,354,463,165
"5395","E01006559",2001,669,357,312,139
"5396","E01006561",2001,644,272,372,133
"5397","E01006562",2001,690,309,381,98
"5398","E01006542",2001,621,144,477,174
"5399","E01006545",2001,622,22,600,123
"5400","E01006546",2001,578,32,546,167
"5401","E01006547",2001,762,125,637,258
"5402","E01006548",2001,727,119,608,160
"5403","E01006766",2001,605,140,465,174
"5404","E01006767",2001,629,138,491,130
"5405","E01006768",2001,579,95,484,124
"5406","E01006763",2001,641,40,601,147
"5407","E01006764",2001,636,82,554,210
"5408","E01006765",2001,630,145,485,88
"5409","E01006761",2001,740,244,496,94
"5410","E01006606",2001,638,171,467,72
"5411","E01006640",2001,602,112,490,44
"5412","E01006619",2001,702,62,640,86
"5413","E01006620",2001,614,91,523,28
"5414","E01006621",2001,556,32,524,12
"5415","E01006622",2001,590,12,578,36
"5416","E01006617",2001,628,75,553,67
"5417","E01006779",2001,850,691,159,6
"5418","E01006776",2001,724,407,317,49
"5419","E01006777",2001,841,580,261,114
"5420","E01006704",2001,768,582,186,23
"5421","E01006646",2001,718,515,203,59
"5422","E01006648",2001,647,475,172,20
"5423","E01006564",2001,685,266,419,42
"5424","E01006560",2001,820,647,173,35
"5425","E01006563",2001,808,595,213,48
"5426","E01006540",2001,708,280,428,182
"5427","E01006647",2001,604,478,126,17
"5428","E01006693",2001,755,438,317,49
"5429","E01006641",2001,646,49,597,26
"5430","E01006642",2001,675,394,281,37
"5431","E01006643",2001,683,349,334,35
"5432","E01006574",2001,652,307,345,43
"5433","E01006572",2001,534,315,219,34
"5434","E01006567",2001,837,392,445,82
"5435","E01006568",2001,601,104,497,51
"5436","E01006570",2001,564,30,534,62
"5437","E01006571",2001,590,250,340,29
"5438","E01006711",2001,635,127,508,134
"5439","E01006717",2001,539,23,516,55
"5440","E01006718",2001,630,76,554,100
"5441","E01006719",2001,605,69,536,93
"5442","E01006714",2001,680,304,376,116
"5443","E01006715",2001,639,104,535,161
"5444","E01006692",2001,875,228,647,268
"5445","E01006759",2001,450,79,371,101
"5446","E01006760",2001,747,219,528,265
"5447","E01006690",2001,724,279,445,206
"5448","E01006695",2001,848,357,491,251
"5449","E01006712",2001,550,54,496,94
"5450","E01006713",2001,614,46,568,99
"5451","E01006569",2001,625,247,378,28
"5452","E01006573",2001,765,226,539,120
"5453","E01006565",2001,631,169,462,53
"5454","E01006696",2001,683,239,444,144
"5455","E01006697",2001,741,136,605,199
"5456","E01006691",2001,720,226,494,225
"5457","E01006694",2001,808,141,667,316
"5458","E01006746",2001,603,315,288,93
"5459","E01006747",2001,479,208,271,114
"5460","E01006748",2001,667,160,507,205
"5461","E01006749",2001,624,314,310,153
"5462","E01006750",2001,795,499,296,142
"5463","E01006751",2001,725,464,261,92
"5464","E01006512",2001,499,166,333,142
"5465","E01006716",2001,605,148,457,130
"5466","E01006566",2001,619,116,503,45
"5467","E01006585",2001,628,309,319,25
"5468","E01006586",2001,724,220,504,100
"5469","E01006587",2001,614,155,459,64
"5470","E01006649",2001,572,143,429,96
"5471","E01006650",2001,631,332,299,186
"5472","E01006513",2001,431,102,329,182
"5473","E01006511",2001,503,203,300,76
"5474","E01006517",2001,772,310,462,134
"5475","E01006584",2001,570,32,538,65
"5476","E01006579",2001,623,13,610,21
"5477","E01006575",2001,566,112,454,66
"5478","E01006576",2001,708,34,674,107
"5479","E01006577",2001,551,14,537,17
"5480","E01006725",2001,668,170,498,132
"5481","E01006726",2001,619,99,520,187
"5482","E01006727",2001,630,54,576,166
"5483","E01006728",2001,829,276,553,239
"5484","E01006752",2001,644,206,438,155
"5485","E01006720",2001,753,262,491,217
"5486","E01006773",2001,580,45,535,35
"5487","E01006774",2001,567,53,514,18
"5488","E01006578",2001,573,20,553,87
"5489","E01006580",2001,519,11,508,9
"5490","E01006581",2001,619,8,611,31
"5491","E01006673",2001,760,533,227,140
"5492","E01006514",2001,625,332,293,155
"5493","E01006515",2001,630,417,213,68
"5494","E01006516",2001,844,590,254,174
"5495","E01006557",2001,518,33,485,247
"5496","E01006550",2001,417,35,382,178
"5497","E01006721",2001,803,319,484,196
"5498","E01006722",2001,551,49,502,233
"5499","E01006723",2001,692,123,569,251
"5500","E01006724",2001,540,47,493,185
"5501","E01006552",2001,716,319,397,192
"5502","E01006556",2001,820,407,413,187
"5503","E01006674",2001,728,533,195,74
"5504","E01006679",2001,644,485,159,59
"5505","E01006709",2001,780,453,327,18
"5506","E01006775",2001,600,387,213,9
"5507","E01006769",2001,730,494,236,13
"5508","E01006770",2001,616,336,280,21
"5509","E01006771",2001,652,409,243,27
"5510","E01006772",2001,501,94,407,17
"5511","E01006597",2001,676,18,658,53
"5512","E01006582",2001,572,6,566,18
"5513","E01006591",2001,643,7,636,139
"5514","E01006592",2001,554,12,542,35
"5515","E01006589",2001,588,14,574,18
"5516","E01006590",2001,624,42,582,141
"5517","E01006593",2001,631,27,604,197
"5518","E01006588",2001,638,54,584,149
"5519","E01006555",2001,454,32,422,101
"5520","E01006553",2001,526,38,488,197
"5521","E01006549",2001,837,256,581,421
"5522","E01006677",2001,697,405,292,78
"5523","E01006675",2001,949,470,479,268
"5524","E01006520",2001,1047,402,645,427
"5525","E01006518",2001,658,361,297,64
"5526","E01006676",2001,752,448,304,82
"5527","E01006678",2001,769,519,250,76
"5528","E01006630",2001,671,526,145,37
"5529","E01006632",2001,717,389,328,54
"5530","E01006710",2001,609,96,513,67
"5531","E01006706",2001,608,389,219,15
"5532","E01006707",2001,604,375,229,15
"5533","E01006708",2001,706,333,373,22
"5534","E01006792",2001,600,43,557,18
"5535","E01006800",2001,702,16,686,33
"5536","E01006801",2001,638,26,612,8
"5537","E01006794",2001,639,56,583,47
"5538","E01006796",2001,566,8,558,12
"5539","E01006539",2001,587,25,562,30
"5540","E01006532",2001,594,17,577,12
"5541","E01006594",2001,566,14,552,29
"5542","E01006583",2001,467,0,467,3
"5543","E01006529",2001,537,33,504,72
"5544","E01006526",2001,617,72,545,40
"5545","E01006554",2001,569,102,467,234
"5546","E01006551",2001,675,491,184,57
"5547","E01006522",2001,890,273,617,428
"5548","E01006524",2001,401,40,361,81
"5549","E01006525",2001,474,16,458,17
"5550","E01006595",2001,766,50,716,86
"5551","E01006596",2001,575,16,559,53
"5552","E01006689",2001,681,43,638,38
"5553","E01006633",2001,651,406,245,80
"5554","E01006634",2001,715,193,522,157
"5555","E01006635",2001,604,115,489,100
"5556","E01006636",2001,616,30,586,158
"5557","E01006631",2001,634,145,489,65
"5558","E01006797",2001,691,281,410,11
"5559","E01006798",2001,614,48,566,25
"5560","E01006799",2001,941,382,559,101
"5561","E01006793",2001,645,176,469,41
"5562","E01006795",2001,640,38,602,67
"5563","E01006628",2001,647,73,574,89
"5564","E01006629",2001,532,134,398,32
"5565","E01006528",2001,552,81,471,115
"5566","E01006523",2001,782,289,493,205
"5567","E01006521",2001,740,221,519,148
"5568","E01006527",2001,619,178,441,35
"5569","E01006680",2001,603,23,580,14
"5570","E01006682",2001,502,12,490,8
"5571","E01006683",2001,590,9,581,9
"5572","E01006686",2001,538,8,530,23
"5573","E01006681",2001,678,178,500,30
"5574","E01006534",2001,662,193,469,18
"5575","E01006535",2001,621,184,437,24
"5576","E01006536",2001,757,257,500,40
"5577","E01006537",2001,543,29,514,36
"5578","E01006538",2001,537,50,487,35
"5579","E01006530",2001,621,12,609,10
"5580","E01006531",2001,696,89,607,8
"5581","E01006533",2001,621,140,481,23
"5582","E01006684",2001,648,30,618,39
"5583","E01006685",2001,612,23,589,92
"5584","E01006687",2001,717,245,472,71
"5585","E01006688",2001,697,85,612,128
"5586","E01006519",2001,511,14,497,26
"5587","E01006744",2001,704,113,591,90
"5588","E01006745",2001,682,143,539,186
"5589","E01006740",2001,789,472,317,90
"5590","E01006742",2001,567,156,411,48
"5591","E01006743",2001,585,194,391,46
"5592","E01006741",2001,775,398,377,33
"5593","E01006738",2001,666,268,398,53
"5594","E01006739",2001,715,447,268,36
"5595","E01006753",2001,650,349,301,33
"5596","E01006754",2001,752,401,351,67
"5597","E01006755",2001,610,444,166,27
"5598","E01006756",2001,639,374,265,42
"5599","E01006757",2001,599,322,277,25
"5600","E01006758",2001,606,312,294,30
"5601","E01006882",2001,512,22,490,3
"5602","E01006883",2001,615,35,580,51
"5603","E01006884",2001,635,71,564,20
"5604","E01006885",2001,547,26,521,37
"5605","E01006886",2001,586,10,576,16
"5606","E01006887",2001,596,138,458,24
"5607","E01006804",2001,666,106,560,11
"5608","E01006806",2001,614,20,594,11
"5609","E01006807",2001,601,8,593,8
"5610","E01006802",2001,731,172,559,34
"5611","E01006803",2001,601,7,594,23
"5612","E01006808",2001,539,10,529,15
"5613","E01006809",2001,605,7,598,19
"5614","E01006805",2001,630,180,450,27
"5615","E01006849",2001,645,347,298,11
"5616","E01006850",2001,727,326,401,9
"5617","E01006851",2001,573,85,488,20
"5618","E01006852",2001,521,8,513,8
"5619","E01006853",2001,598,73,525,12
"5620","E01006854",2001,625,117,508,45
"5621","E01006855",2001,642,160,482,15
"5622","E01006839",2001,581,131,450,7
"5623","E01006840",2001,632,62,570,37
"5624","E01006842",2001,608,341,267,19
"5625","E01006836",2001,626,160,466,25
"5626","E01006837",2001,610,97,513,21
"5627","E01006838",2001,604,124,480,36
"5628","E01006843",2001,548,136,412,10
"5629","E01006841",2001,605,44,561,8
"5630","E01006914",2001,535,10,525,11
"5631","E01006915",2001,654,214,440,26
"5632","E01006916",2001,645,113,532,46
"5633","E01006917",2001,643,20,623,15
"5634","E01006918",2001,495,50,445,34
"5635","E01006919",2001,633,297,336,24
"5636","E01006818",2001,536,45,491,8
"5637","E01006810",2001,490,5,485,3
"5638","E01006811",2001,630,143,487,9
"5639","E01006812",2001,617,325,292,13
"5640","E01006813",2001,687,197,490,42
"5641","E01006814",2001,612,10,602,11
"5642","E01006815",2001,564,143,421,29
"5643","E01006822",2001,561,36,525,12
"5644","E01006823",2001,583,13,570,0
"5645","E01006824",2001,491,7,484,5
"5646","E01006825",2001,549,8,541,15
"5647","E01006866",2001,642,341,301,11
"5648","E01006867",2001,629,46,583,18
"5649","E01006868",2001,639,349,290,6
"5650","E01006869",2001,617,162,455,33
"5651","E01006871",2001,634,394,240,17
"5652","E01006819",2001,608,145,463,19
"5653","E01006820",2001,581,254,327,41
"5654","E01006821",2001,715,359,356,26
"5655","E01006834",2001,607,149,458,64
"5656","E01006832",2001,757,273,484,34
"5657","E01006877",2001,718,209,509,71
"5658","E01006880",2001,759,337,422,88
"5659","E01006881",2001,723,271,452,80
"5660","E01006863",2001,738,264,474,85
"5661","E01006864",2001,749,42,707,43
"5662","E01006865",2001,793,400,393,20
"5663","E01006872",2001,608,263,345,65
"5664","E01006873",2001,506,355,151,9
"5665","E01006874",2001,655,321,334,88
"5666","E01006870",2001,652,61,591,71
"5667","E01006845",2001,707,116,591,72
"5668","E01006856",2001,614,23,591,52
"5669","E01006857",2001,553,24,529,11
"5670","E01006858",2001,563,191,372,23
"5671","E01006859",2001,634,16,618,22
"5672","E01006860",2001,570,192,378,23
"5673","E01006861",2001,584,450,134,9
"5674","E01006862",2001,601,285,316,15
"5675","E01006878",2001,647,83,564,46
"5676","E01006879",2001,599,239,360,11
"5677","E01006904",2001,649,178,471,26
"5678","E01006876",2001,670,38,632,66
"5679","E01006833",2001,632,44,588,46
"5680","E01006831",2001,648,104,544,57
"5681","E01006835",2001,623,68,555,38
"5682","E01006816",2001,643,404,239,14
"5683","E01006817",2001,618,381,237,17
"5684","E01006899",2001,605,111,494,94
"5685","E01006875",2001,484,127,357,59
"5686","E01006826",2001,640,293,347,6
"5687","E01006827",2001,557,9,548,9
"5688","E01006828",2001,842,26,816,19
"5689","E01006829",2001,465,48,417,4
"5690","E01006830",2001,495,352,143,11
"5691","E01006905",2001,596,301,295,6
"5692","E01006906",2001,622,55,567,66
"5693","E01006907",2001,625,129,496,26
"5694","E01006902",2001,619,14,605,14
"5695","E01006903",2001,736,313,423,49
"5696","E01006912",2001,498,253,245,12
"5697","E01006913",2001,501,259,242,0
"5698","E01006901",2001,534,14,520,35
"5699","E01006896",2001,666,14,652,11
"5700","E01006897",2001,628,74,554,21
"5701","E01006846",2001,620,38,582,25
"5702","E01006847",2001,644,442,202,4
"5703","E01006848",2001,623,82,541,23
"5704","E01006844",2001,772,218,554,85
"5705","E01006892",2001,598,140,458,18
"5706","E01006893",2001,619,49,570,61
"5707","E01006894",2001,620,93,527,6
"5708","E01006890",2001,628,61,567,32
"5709","E01006898",2001,707,172,535,24
"5710","E01006900",2001,569,56,513,42
"5711","E01006908",2001,614,284,330,15
"5712","E01006909",2001,514,355,159,19
"5713","E01006910",2001,706,350,356,16
"5714","E01006911",2001,611,20,591,13
"5715","E01006895",2001,649,16,633,14
"5716","E01006891",2001,554,66,488,4
"5717","E01006888",2001,509,5,504,4
"5718","E01006889",2001,584,25,559,8
"5719","E01006946",2001,719,26,693,29
"5720","E01007028",2001,607,20,587,28
"5721","E01007029",2001,642,17,625,12
"5722","E01007030",2001,621,81,540,36
"5723","E01007036",2001,544,0,544,14
"5724","E01007031",2001,607,48,559,19
"5725","E01007032",2001,520,9,511,19
"5726","E01007033",2001,635,14,621,34
"5727","E01007035",2001,629,38,591,83
"5728","E01006947",2001,629,18,611,28
"5729","E01006948",2001,699,257,442,24
"5730","E01006949",2001,696,137,559,53
"5731","E01006944",2001,809,88,721,172
"5732","E01006951",2001,721,53,668,72
"5733","E01007034",2001,564,15,549,15
"5734","E01006968",2001,909,136,773,381
"5735","E01006969",2001,644,21,623,185
"5736","E01006975",2001,892,71,821,426
"5737","E01006945",2001,832,27,805,292
"5738","E01006950",2001,777,107,670,357
"5739","E01007055",2001,592,234,358,56
"5740","E01007056",2001,661,13,648,65
"5741","E01007057",2001,632,12,620,62
"5742","E01007062",2001,584,19,565,37
"5743","E01007063",2001,625,39,586,61
"5744","E01007064",2001,477,13,464,42
"5745","E01007058",2001,633,10,623,112
"5746","E01007059",2001,620,6,614,55
"5747","E01007060",2001,513,70,443,57
"5748","E01007061",2001,529,3,526,60
"5749","E01006998",2001,663,26,637,117
"5750","E01006934",2001,644,23,621,84
"5751","E01006970",2001,763,19,744,295
"5752","E01006994",2001,627,37,590,125
"5753","E01006996",2001,646,40,606,153
"5754","E01006997",2001,598,15,583,73
"5755","E01006995",2001,480,12,468,40
"5756","E01006999",2001,654,22,632,31
"5757","E01007000",2001,517,152,365,34
"5758","E01007001",2001,644,41,603,79
"5759","E01007002",2001,584,8,576,21
"5760","E01006971",2001,744,36,708,169
"5761","E01006972",2001,860,151,709,114
"5762","E01006973",2001,621,6,615,74
"5763","E01006974",2001,565,3,562,47
"5764","E01006935",2001,651,6,645,98
"5765","E01006928",2001,587,59,528,28
"5766","E01006929",2001,618,13,605,55
"5767","E01006930",2001,628,80,548,25
"5768","E01006931",2001,643,23,620,32
"5769","E01006932",2001,597,7,590,17
"5770","E01006933",2001,601,66,535,27
"5771","E01006927",2001,752,76,676,49
"5772","E01006924",2001,671,204,467,25
"5773","E01006925",2001,601,140,461,19
"5774","E01006920",2001,718,51,667,49
"5775","E01006921",2001,621,3,618,15
"5776","E01006922",2001,604,6,598,16
"5777","E01006923",2001,724,4,720,14
"5778","E01006926",2001,700,8,692,21
"5779","E01006989",2001,565,3,562,13
"5780","E01006990",2001,504,5,499,14
"5781","E01006985",2001,616,22,594,14
"5782","E01006986",2001,527,0,527,26
"5783","E01006987",2001,562,7,555,17
"5784","E01006988",2001,637,124,513,21
"5785","E01007079",2001,632,6,626,29
"5786","E01007080",2001,621,35,586,26
"5787","E01007081",2001,642,12,630,38
"5788","E01007078",2001,652,9,643,26
"5789","E01006991",2001,621,4,617,6
"5790","E01006992",2001,465,52,413,23
"5791","E01006993",2001,593,5,588,14
"5792","E01007082",2001,606,4,602,31
"5793","E01007075",2001,634,3,631,25
"5794","E01007076",2001,584,21,563,33
"5795","E01007077",2001,601,34,567,21
"5796","E01007067",2001,581,6,575,33
"5797","E01007068",2001,487,10,477,9
"5798","E01007069",2001,640,103,537,23
"5799","E01007070",2001,619,4,615,8
"5800","E01007101",2001,604,6,598,4
"5801","E01007093",2001,406,35,371,18
"5802","E01007094",2001,629,8,621,20
"5803","E01007095",2001,704,12,692,56
"5804","E01007096",2001,580,3,577,23
"5805","E01007100",2001,607,45,562,10
"5806","E01007097",2001,631,6,625,14
"5807","E01007098",2001,628,25,603,21
"5808","E01007099",2001,643,67,576,26
"5809","E01007074",2001,631,138,493,14
"5810","E01007071",2001,491,3,488,9
"5811","E01007072",2001,701,39,662,19
"5812","E01007073",2001,496,5,491,6
"5813","E01007065",2001,504,7,497,31
"5814","E01007066",2001,596,12,584,40
"5815","E01007027",2001,897,6,891,32
"5816","E01007037",2001,672,36,636,22
"5817","E01007038",2001,584,149,435,6
"5818","E01007022",2001,612,183,429,68
"5819","E01007023",2001,524,7,517,14
"5820","E01007020",2001,580,208,372,13
"5821","E01006936",2001,710,16,694,62
"5822","E01006937",2001,486,0,486,8
"5823","E01006938",2001,518,41,477,15
"5824","E01006939",2001,639,25,614,58
"5825","E01006940",2001,599,19,580,81
"5826","E01006943",2001,502,0,502,7
"5827","E01007083",2001,478,90,388,10
"5828","E01007085",2001,611,310,301,16
"5829","E01007086",2001,497,254,243,9
"5830","E01007091",2001,630,169,461,18
"5831","E01007092",2001,611,281,330,18
"5832","E01007089",2001,669,286,383,15
"5833","E01007026",2001,531,199,332,17
"5834","E01007024",2001,449,238,211,12
"5835","E01006979",2001,638,354,284,23
"5836","E01006980",2001,629,354,275,13
"5837","E01007025",2001,539,6,533,7
"5838","E01007021",2001,542,11,531,12
"5839","E01007105",2001,670,103,567,45
"5840","E01007106",2001,649,114,535,20
"5841","E01007107",2001,497,6,491,8
"5842","E01007108",2001,608,41,567,4
"5843","E01007039",2001,494,32,462,10
"5844","E01007040",2001,556,58,498,24
"5845","E01007042",2001,544,59,485,8
"5846","E01007044",2001,617,37,580,17
"5847","E01007045",2001,495,15,480,13
"5848","E01007046",2001,578,39,539,18
"5849","E01007043",2001,615,18,597,14
"5850","E01007084",2001,541,9,532,15
"5851","E01007053",2001,515,59,456,9
"5852","E01007041",2001,567,84,483,22
"5853","E01007109",2001,643,67,576,66
"5854","E01007104",2001,545,0,545,38
"5855","E01006954",2001,615,72,543,109
"5856","E01006941",2001,635,22,613,97
"5857","E01006942",2001,601,54,547,46
"5858","E01007090",2001,550,287,263,19
"5859","E01007087",2001,643,349,294,12
"5860","E01007088",2001,588,172,416,11
"5861","E01007054",2001,583,143,440,27
"5862","E01007048",2001,523,300,223,23
"5863","E01007102",2001,554,8,546,66
"5864","E01007103",2001,614,6,608,40
"5865","E01006955",2001,615,44,571,58
"5866","E01006956",2001,689,97,592,128
"5867","E01006958",2001,688,136,552,142
"5868","E01006981",2001,611,311,300,37
"5869","E01006982",2001,561,51,510,91
"5870","E01006983",2001,505,68,437,40
"5871","E01006984",2001,482,276,206,14
"5872","E01006978",2001,522,14,508,29
"5873","E01006959",2001,685,45,640,98
"5874","E01006952",2001,720,399,321,37
"5875","E01006953",2001,675,243,432,84
"5876","E01006977",2001,758,395,363,42
"5877","E01006957",2001,809,372,437,113
"5878","E01006976",2001,516,80,436,18
"5879","E01007014",2001,637,51,586,30
"5880","E01007015",2001,500,30,470,3
"5881","E01007018",2001,616,238,378,61
"5882","E01007047",2001,680,237,443,12
"5883","E01007011",2001,678,386,292,56
"5884","E01007016",2001,633,176,457,75
"5885","E01007017",2001,630,243,387,66
"5886","E01007004",2001,665,287,378,68
"5887","E01007005",2001,622,344,278,55
"5888","E01007019",2001,602,369,233,33
"5889","E01007049",2001,621,189,432,27
"5890","E01007050",2001,482,80,402,17
"5891","E01007051",2001,602,308,294,26
"5892","E01007052",2001,540,177,363,23
"5893","E01007012",2001,606,98,508,126
"5894","E01007013",2001,627,137,490,125
"5895","E01007006",2001,585,209,376,76
"5896","E01007003",2001,587,192,395,105
"5897","E01006964",2001,646,151,495,113
"5898","E01006967",2001,769,365,404,80
"5899","E01007007",2001,784,626,158,16
"5900","E01007008",2001,631,322,309,56
"5901","E01007009",2001,662,356,306,90
"5902","E01007010",2001,682,373,309,71
"5903","E01006965",2001,597,267,330,18
"5904","E01006966",2001,647,155,492,72
"5905","E01006960",2001,495,10,485,38
"5906","E01006961",2001,607,128,479,94
"5907","E01006962",2001,659,191,468,57
"5908","E01006963",2001,622,200,422,102
"5909","E01007229",2001,624,12,612,118
"5910","E01007230",2001,564,25,539,52
"5911","E01007231",2001,655,25,630,157
"5912","E01007237",2001,790,118,672,124
"5913","E01007238",2001,757,209,548,183
"5914","E01007236",2001,585,47,538,73
"5915","E01007232",2001,558,14,544,111
"5916","E01007233",2001,628,77,551,100
"5917","E01007234",2001,637,39,598,117
"5918","E01007218",2001,627,55,572,147
"5919","E01007307",2001,647,16,631,83
"5920","E01007308",2001,720,25,695,49
"5921","E01007312",2001,671,104,567,23
"5922","E01007313",2001,721,118,603,69
"5923","E01007315",2001,614,7,607,24
"5924","E01007316",2001,605,6,599,31
"5925","E01007314",2001,596,16,580,78
"5926","E01007310",2001,513,13,500,31
"5927","E01007311",2001,617,14,603,31
"5928","E01007235",2001,583,12,571,67
"5929","E01007211",2001,496,16,480,23
"5930","E01007219",2001,610,37,573,105
"5931","E01007220",2001,638,215,423,114
"5932","E01007215",2001,652,149,503,192
"5933","E01007216",2001,628,36,592,128
"5934","E01007275",2001,635,34,601,123
"5935","E01007309",2001,592,7,585,25
"5936","E01007210",2001,715,239,476,26
"5937","E01007205",2001,626,217,409,24
"5938","E01007203",2001,674,29,645,37
"5939","E01007212",2001,607,26,581,31
"5940","E01007213",2001,602,6,596,32
"5941","E01007214",2001,604,131,473,66
"5942","E01007217",2001,741,26,715,191
"5943","E01007276",2001,601,22,579,69
"5944","E01007277",2001,617,127,490,138
"5945","E01007278",2001,612,128,484,131
"5946","E01007272",2001,631,154,477,96
"5947","E01007273",2001,663,276,387,116
"5948","E01007274",2001,720,469,251,52
"5949","E01007209",2001,884,499,385,31
"5950","E01007206",2001,575,99,476,35
"5951","E01007207",2001,690,382,308,29
"5952","E01007204",2001,635,414,221,52
"5953","E01007269",2001,621,341,280,41
"5954","E01007270",2001,735,209,526,120
"5955","E01007271",2001,640,40,600,118
"5956","E01007132",2001,545,204,341,84
"5957","E01007134",2001,638,109,529,112
"5958","E01007120",2001,499,226,273,30
"5959","E01007121",2001,727,456,271,50
"5960","E01007122",2001,763,490,273,85
"5961","E01007123",2001,623,317,306,72
"5962","E01007124",2001,644,498,146,21
"5963","E01007208",2001,698,107,591,59
"5964","E01007221",2001,635,25,610,49
"5965","E01007225",2001,730,6,724,22
"5966","E01007227",2001,600,194,406,44
"5967","E01007228",2001,710,256,454,13
"5968","E01007222",2001,675,8,667,29
"5969","E01007223",2001,623,36,587,39
"5970","E01007199",2001,596,3,593,22
"5971","E01007195",2001,632,4,628,13
"5972","E01007200",2001,644,20,624,21
"5973","E01007201",2001,616,11,605,47
"5974","E01007202",2001,636,104,532,53
"5975","E01007193",2001,616,12,604,93
"5976","E01007194",2001,671,32,639,75
"5977","E01007125",2001,665,137,528,104
"5978","E01007156",2001,602,44,558,66
"5979","E01007157",2001,594,9,585,57
"5980","E01007158",2001,619,12,607,53
"5981","E01007159",2001,651,15,636,41
"5982","E01007133",2001,822,566,256,87
"5983","E01007126",2001,878,473,405,151
"5984","E01007127",2001,606,273,333,129
"5985","E01007128",2001,769,455,314,94
"5986","E01007129",2001,600,211,389,147
"5987","E01007224",2001,618,6,612,26
"5988","E01007226",2001,731,3,728,47
"5989","E01007265",2001,525,47,478,11
"5990","E01007306",2001,668,16,652,31
"5991","E01007299",2001,588,61,527,15
"5992","E01007297",2001,646,170,476,25
"5993","E01007298",2001,614,18,596,12
"5994","E01007305",2001,714,16,698,34
"5995","E01007301",2001,676,68,608,20
"5996","E01007302",2001,680,127,553,56
"5997","E01007300",2001,761,307,454,37
"5998","E01007119",2001,611,376,235,16
"5999","E01007161",2001,610,39,571,24
"6000","E01007162",2001,552,348,204,9
"6001","E01007160",2001,777,127,650,131
"6002","E01007155",2001,796,249,547,177
"6003","E01007240",2001,727,134,593,226
"6004","E01007241",2001,703,51,652,35
"6005","E01007242",2001,796,31,765,70
"6006","E01007291",2001,746,273,473,128
"6007","E01007292",2001,645,194,451,134
"6008","E01007294",2001,636,66,570,110
"6009","E01007179",2001,618,133,485,143
"6010","E01007130",2001,591,82,509,124
"6011","E01007131",2001,669,163,506,133
"6012","E01007180",2001,648,81,567,111
"6013","E01007181",2001,620,18,602,126
"6014","E01007243",2001,756,84,672,42
"6015","E01007244",2001,734,34,700,143
"6016","E01007239",2001,661,115,546,128
"6017","E01007266",2001,619,18,601,24
"6018","E01007267",2001,622,59,563,22
"6019","E01007268",2001,630,17,613,19
"6020","E01007264",2001,653,3,650,13
"6021","E01007259",2001,496,7,489,7
"6022","E01007261",2001,610,6,604,12
"6023","E01007252",2001,646,5,641,36
"6024","E01007245",2001,620,10,610,15
"6025","E01007246",2001,589,3,586,16
"6026","E01007247",2001,546,3,543,11
"6027","E01007163",2001,626,78,548,37
"6028","E01007249",2001,561,190,371,26
"6029","E01007251",2001,489,43,446,20
"6030","E01007257",2001,600,277,323,30
"6031","E01007303",2001,774,433,341,32
"6032","E01007304",2001,621,294,327,20
"6033","E01007282",2001,636,14,622,96
"6034","E01007263",2001,640,208,432,21
"6035","E01007196",2001,706,13,693,67
"6036","E01007197",2001,665,10,655,65
"6037","E01007198",2001,798,104,694,170
"6038","E01007175",2001,708,266,442,89
"6039","E01007290",2001,666,311,355,109
"6040","E01007295",2001,625,215,410,132
"6041","E01007296",2001,707,105,602,144
"6042","E01007293",2001,594,375,219,61
"6043","E01007283",2001,469,3,466,6
"6044","E01007281",2001,586,37,549,23
"6045","E01007258",2001,612,11,601,17
"6046","E01007262",2001,600,6,594,12
"6047","E01007260",2001,641,23,618,10
"6048","E01007176",2001,633,86,547,87
"6049","E01007177",2001,664,214,450,12
"6050","E01007178",2001,652,114,538,83
"6051","E01007173",2001,557,29,528,24
"6052","E01007174",2001,616,85,531,44
"6053","E01007250",2001,543,39,504,8
"6054","E01007253",2001,713,222,491,23
"6055","E01007254",2001,571,3,568,3
"6056","E01007248",2001,571,20,551,63
"6057","E01007289",2001,613,387,226,43
"6058","E01007138",2001,748,261,487,91
"6059","E01007139",2001,605,85,520,67
"6060","E01007115",2001,637,138,499,29
"6061","E01007141",2001,767,208,559,151
"6062","E01007116",2001,622,20,602,44
"6063","E01007111",2001,591,5,586,21
"6064","E01007112",2001,635,48,587,33
"6065","E01007113",2001,583,31,552,33
"6066","E01007114",2001,578,165,413,42
"6067","E01007287",2001,865,64,801,22
"6068","E01007284",2001,680,12,668,24
"6069","E01007285",2001,605,26,579,22
"6070","E01007280",2001,735,21,714,35
"6071","E01007279",2001,650,40,610,18
"6072","E01007286",2001,629,82,547,17
"6073","E01007255",2001,637,77,560,17
"6074","E01007256",2001,736,8,728,23
"6075","E01007183",2001,519,3,516,28
"6076","E01007154",2001,623,39,584,7
"6077","E01007110",2001,681,22,659,37
"6078","E01007117",2001,631,23,608,47
"6079","E01007118",2001,642,211,431,28
"6080","E01007151",2001,623,14,609,8
"6081","E01007152",2001,729,124,605,44
"6082","E01007153",2001,610,202,408,12
"6083","E01007140",2001,742,71,671,100
"6084","E01007142",2001,642,32,610,48
"6085","E01007143",2001,635,75,560,79
"6086","E01007182",2001,663,57,606,40
"6087","E01007184",2001,635,22,613,40
"6088","E01007185",2001,640,61,579,67
"6089","E01007192",2001,609,134,475,11
"6090","E01007288",2001,759,162,597,28
"6091","E01007144",2001,538,14,524,116
"6092","E01007145",2001,525,3,522,9
"6093","E01007146",2001,633,5,628,21
"6094","E01007147",2001,618,6,612,9
"6095","E01007148",2001,658,0,658,14
"6096","E01007135",2001,608,19,589,19
"6097","E01007136",2001,703,290,413,27
"6098","E01007137",2001,731,172,559,44
"6099","E01007170",2001,624,17,607,26
"6100","E01007186",2001,637,0,637,9
"6101","E01007187",2001,627,11,616,9
"6102","E01007188",2001,613,5,608,12
"6103","E01007189",2001,644,8,636,13
"6104","E01007190",2001,596,3,593,18
"6105","E01007191",2001,538,3,535,5
"6106","E01007171",2001,614,12,602,44
"6107","E01007172",2001,579,43,536,12
"6108","E01007165",2001,558,3,555,9
"6109","E01007149",2001,622,7,615,6
"6110","E01007150",2001,577,4,573,8
"6111","E01007164",2001,634,78,556,36
"6112","E01007166",2001,616,9,607,20
"6113","E01007167",2001,616,138,478,38
"6114","E01007168",2001,745,241,504,22
"6115","E01007169",2001,722,123,599,40
"6116","E01012933",2001,466,11,455,31
"6117","E01012934",2001,714,64,650,79
"6118","E01012938",2001,763,41,722,52
"6119","E01012939",2001,605,8,597,16
"6120","E01012940",2001,707,11,696,58
"6121","E01012941",2001,734,58,676,40
"6122","E01012942",2001,696,14,682,39
"6123","E01012935",2001,640,10,630,18
"6124","E01012937",2001,985,70,915,104
"6125","E01012929",2001,631,125,506,65
"6126","E01012930",2001,641,23,618,51
"6127","E01012931",2001,752,347,405,72
"6128","E01012932",2001,637,178,459,97
"6129","E01012928",2001,757,414,343,42
"6130","E01012946",2001,713,407,306,35
"6131","E01012949",2001,621,179,442,57
"6132","E01012943",2001,639,62,577,125
"6133","E01012936",2001,630,33,597,177
"6134","E01012945",2001,637,58,579,173
"6135","E01012952",2001,645,20,625,225
"6136","E01012951",2001,588,15,573,189
"6137","E01012944",2001,659,32,627,328
"6138","E01012947",2001,584,28,556,69
"6139","E01012948",2001,655,60,595,307
"6140","E01012950",2001,604,6,598,35
"6141","E01012990",2001,502,66,436,55
"6142","E01012991",2001,576,75,501,45
"6143","E01012992",2001,593,78,515,158
"6144","E01012982",2001,686,12,674,133
"6145","E01012975",2001,604,5,599,26
"6146","E01012976",2001,602,153,449,29
"6147","E01012977",2001,602,23,579,46
"6148","E01012979",2001,699,7,692,99
"6149","E01012980",2001,693,149,544,111
"6150","E01012984",2001,605,18,587,33
"6151","E01012985",2001,703,71,632,53
"6152","E01012981",2001,547,55,492,115
"6153","E01012978",2001,613,8,605,18
"6154","E01012983",2001,565,6,559,60
"6155","E01012989",2001,670,41,629,47
"6156","E01013125",2001,614,89,525,67
"6157","E01013126",2001,526,15,511,37
"6158","E01013059",2001,608,41,567,23
"6159","E01013060",2001,735,3,732,30
"6160","E01013061",2001,662,91,571,20
"6161","E01013057",2001,579,13,566,45
"6162","E01013048",2001,677,80,597,66
"6163","E01012986",2001,661,72,589,61
"6164","E01012987",2001,584,33,551,32
"6165","E01012988",2001,554,36,518,49
"6166","E01013052",2001,572,23,549,25
"6167","E01013053",2001,647,6,641,20
"6168","E01013054",2001,664,9,655,78
"6169","E01013055",2001,632,103,529,50
"6170","E01013056",2001,605,192,413,85
"6171","E01013058",2001,568,98,470,25
"6172","E01013119",2001,580,39,541,192
"6173","E01013049",2001,722,117,605,118
"6174","E01013050",2001,687,9,678,36
"6175","E01013051",2001,651,123,528,39
"6176","E01013046",2001,750,7,743,44
"6177","E01013047",2001,710,139,571,72
"6178","E01012927",2001,625,0,625,18
"6179","E01012922",2001,590,46,544,61
"6180","E01012923",2001,579,54,525,224
"6181","E01012925",2001,525,20,505,59
"6182","E01012926",2001,932,44,888,37
"6183","E01012924",2001,645,17,628,40
"6184","E01013027",2001,676,100,576,61
"6185","E01013034",2001,574,30,544,70
"6186","E01013120",2001,675,11,664,27
"6187","E01013121",2001,608,42,566,48
"6188","E01013123",2001,594,31,563,36
"6189","E01013124",2001,811,190,621,84
"6190","E01013064",2001,516,3,513,19
"6191","E01013065",2001,746,54,692,32
"6192","E01013066",2001,654,7,647,26
"6193","E01013067",2001,640,3,637,31
"6194","E01013068",2001,625,24,601,33
"6195","E01013070",2001,652,8,644,34
"6196","E01013071",2001,773,391,382,48
"6197","E01013069",2001,705,78,627,35
"6198","E01013038",2001,602,362,240,20
"6199","E01013045",2001,642,309,333,16
"6200","E01013022",2001,655,65,590,40
"6201","E01013023",2001,656,14,642,56
"6202","E01013024",2001,661,68,593,34
"6203","E01013122",2001,534,19,515,36
"6204","E01013127",2001,553,27,526,49
"6205","E01013062",2001,767,108,659,130
"6206","E01013063",2001,649,57,592,46
"6207","E01013036",2001,736,173,563,112
"6208","E01013037",2001,624,12,612,48
"6209","E01013040",2001,625,54,571,74
"6210","E01013041",2001,828,182,646,96
"6211","E01013042",2001,578,0,578,15
"6212","E01013043",2001,550,43,507,21
"6213","E01013044",2001,596,3,593,33
"6214","E01013039",2001,638,78,560,32
"6215","E01012919",2001,521,34,487,36
"6216","E01012921",2001,488,32,456,41
"6217","E01013035",2001,559,10,549,26
"6218","E01013029",2001,635,83,552,63
"6219","E01013030",2001,626,64,562,59
"6220","E01013031",2001,603,13,590,8
"6221","E01013032",2001,597,11,586,26
"6222","E01012958",2001,487,10,477,8
"6223","E01012961",2001,669,78,591,10
"6224","E01012954",2001,507,27,480,32
"6225","E01012956",2001,492,53,439,15
"6226","E01012966",2001,554,52,502,18
"6227","E01012955",2001,653,12,641,54
"6228","E01012953",2001,477,11,466,39
"6229","E01012962",2001,469,6,463,22
"6230","E01012959",2001,619,7,612,39
"6231","E01012964",2001,747,219,528,21
"6232","E01012965",2001,401,21,380,21
"6233","E01012967",2001,637,16,621,17
"6234","E01012968",2001,656,4,652,24
"6235","E01012969",2001,469,67,402,37
"6236","E01012920",2001,543,32,511,27
"6237","E01012957",2001,743,91,652,86
"6238","E01012960",2001,624,22,602,65
"6239","E01012963",2001,744,350,394,26
"6240","E01013112",2001,654,11,643,8
"6241","E01013025",2001,564,78,486,40
"6242","E01013026",2001,634,41,593,42
"6243","E01013018",2001,605,89,516,29
"6244","E01013019",2001,481,38,443,46
"6245","E01013021",2001,630,11,619,67
"6246","E01013115",2001,611,3,608,37
"6247","E01013110",2001,618,71,547,43
"6248","E01013111",2001,616,23,593,40
"6249","E01013105",2001,639,144,495,12
"6250","E01013117",2001,593,3,590,30
"6251","E01013118",2001,637,14,623,3
"6252","E01013108",2001,616,4,612,19
"6253","E01013116",2001,600,3,597,24
"6254","E01013113",2001,634,8,626,31
"6255","E01013114",2001,631,3,628,11
"6256","E01013102",2001,652,36,616,33
"6257","E01013094",2001,543,71,472,27
"6258","E01013095",2001,617,30,587,59
"6259","E01013096",2001,598,63,535,43
"6260","E01013097",2001,642,10,632,73
"6261","E01013010",2001,616,102,514,54
"6262","E01013006",2001,602,50,552,74
"6263","E01013103",2001,601,4,597,19
"6264","E01013104",2001,589,3,586,20
"6265","E01013106",2001,474,158,316,9
"6266","E01013109",2001,606,6,600,63
"6267","E01013085",2001,651,59,592,33
"6268","E01013081",2001,608,38,570,83
"6269","E01013082",2001,599,12,587,64
"6270","E01013078",2001,549,48,501,38
"6271","E01013028",2001,602,43,559,30
"6272","E01012970",2001,605,46,559,44
"6273","E01012971",2001,635,4,631,14
"6274","E01012972",2001,586,19,567,7
"6275","E01012973",2001,668,4,664,50
"6276","E01012974",2001,650,73,577,22
"6277","E01013092",2001,620,66,554,31
"6278","E01013033",2001,582,42,540,31
"6279","E01013098",2001,622,0,622,26
"6280","E01013099",2001,552,167,385,35
"6281","E01013100",2001,595,10,585,23
"6282","E01013101",2001,613,46,567,31
"6283","E01013008",2001,626,14,612,100
"6284","E01013009",2001,729,250,479,74
"6285","E01013013",2001,645,3,642,100
"6286","E01013014",2001,606,94,512,31
"6287","E01013107",2001,762,236,526,52
"6288","E01013093",2001,641,7,634,36
"6289","E01013088",2001,646,3,643,14
"6290","E01013089",2001,674,8,666,44
"6291","E01013090",2001,575,44,531,22
"6292","E01013091",2001,612,58,554,30
"6293","E01013007",2001,596,52,544,64
"6294","E01013011",2001,645,99,546,37
"6295","E01013012",2001,485,0,485,5
"6296","E01013005",2001,520,9,511,35
"6297","E01012998",2001,632,13,619,7
"6298","E01012996",2001,590,15,575,26
"6299","E01013015",2001,587,20,567,76
"6300","E01013016",2001,617,10,607,25
"6301","E01013017",2001,657,166,491,34
"6302","E01013020",2001,625,42,583,54
"6303","E01013003",2001,589,163,426,13
"6304","E01013076",2001,577,105,472,45
"6305","E01013079",2001,645,7,638,68
"6306","E01013080",2001,595,103,492,121
"6307","E01013083",2001,592,57,535,151
"6308","E01013084",2001,639,289,350,56
"6309","E01013086",2001,642,168,474,61
"6310","E01013087",2001,529,77,452,55
"6311","E01013074",2001,628,23,605,46
"6312","E01012999",2001,637,35,602,162
"6313","E01013001",2001,722,88,634,41
"6314","E01012997",2001,790,95,695,157
"6315","E01012993",2001,623,69,554,16
"6316","E01012994",2001,762,230,532,30
"6317","E01012995",2001,731,261,470,33
"6318","E01013002",2001,633,243,390,50
"6319","E01013000",2001,752,172,580,165
"6320","E01013004",2001,642,125,517,71
"6321","E01013075",2001,475,23,452,17
"6322","E01013077",2001,632,77,555,11
"6323","E01013072",2001,609,144,465,20
"6324","E01013073",2001,594,50,544,51
"6325","E01012779",2001,641,409,232,75
"6326","E01012780",2001,601,447,154,29
"6327","E01012781",2001,500,360,140,19
"6328","E01012831",2001,574,16,558,19
"6329","E01012832",2001,475,163,312,20
"6330","E01012782",2001,568,396,172,35
"6331","E01012785",2001,582,418,164,23
"6332","E01012786",2001,623,357,266,19
"6333","E01012787",2001,632,381,251,40
"6334","E01012788",2001,591,360,231,28
"6335","E01012789",2001,561,322,239,35
"6336","E01012875",2001,760,616,144,17
"6337","E01012876",2001,641,429,212,20
"6338","E01012877",2001,504,387,117,10
"6339","E01012878",2001,629,429,200,25
"6340","E01012879",2001,691,536,155,16
"6341","E01012906",2001,615,389,226,16
"6342","E01012908",2001,485,249,236,16
"6343","E01012790",2001,574,302,272,9
"6344","E01012783",2001,460,354,106,18
"6345","E01012784",2001,473,260,213,18
"6346","E01012778",2001,539,390,149,11
"6347","E01012764",2001,548,13,535,30
"6348","E01012765",2001,620,25,595,59
"6349","E01012768",2001,666,16,650,60
"6350","E01012769",2001,690,14,676,40
"6351","E01012910",2001,467,25,442,25
"6352","E01012912",2001,641,24,617,22
"6353","E01012905",2001,548,263,285,13
"6354","E01012829",2001,612,48,564,24
"6355","E01012830",2001,617,23,594,31
"6356","E01012822",2001,652,101,551,64
"6357","E01012911",2001,485,8,477,19
"6358","E01012909",2001,582,38,544,34
"6359","E01012907",2001,582,146,436,14
"6360","E01012904",2001,617,145,472,53
"6361","E01012873",2001,630,464,166,25
"6362","E01012874",2001,660,429,231,25
"6363","E01012915",2001,626,352,274,20
"6364","E01012917",2001,746,425,321,40
"6365","E01012918",2001,590,345,245,37
"6366","E01012880",2001,659,496,163,20
"6367","E01012881",2001,619,412,207,31
"6368","E01012839",2001,532,126,406,6
"6369","E01012840",2001,623,343,280,18
"6370","E01012833",2001,634,372,262,17
"6371","E01012835",2001,519,4,515,11
"6372","E01012836",2001,758,503,255,17
"6373","E01012837",2001,769,439,330,13
"6374","E01012838",2001,581,374,207,13
"6375","E01012834",2001,613,358,255,16
"6376","E01012824",2001,601,165,436,16
"6377","E01012825",2001,665,112,553,18
"6378","E01012826",2001,698,303,395,19
"6379","E01012827",2001,739,285,454,36
"6380","E01012828",2001,673,206,467,12
"6381","E01012823",2001,690,396,294,25
"6382","E01012821",2001,736,453,283,22
"6383","E01012916",2001,618,73,545,119
"6384","E01012914",2001,400,23,377,231
"6385","E01012766",2001,558,25,533,43
"6386","E01012767",2001,543,64,479,106
"6387","E01012818",2001,512,17,495,31
"6388","E01012812",2001,520,3,517,11
"6389","E01012813",2001,565,19,546,27
"6390","E01012814",2001,619,22,597,14
"6391","E01012815",2001,590,33,557,44
"6392","E01012913",2001,673,253,420,53
"6393","E01012791",2001,642,9,633,17
"6394","E01012792",2001,642,45,597,50
"6395","E01012793",2001,610,105,505,25
"6396","E01012794",2001,625,18,607,71
"6397","E01012761",2001,713,235,478,275
"6398","E01012868",2001,614,63,551,262
"6399","E01012869",2001,600,33,567,287
"6400","E01012871",2001,599,63,536,214
"6401","E01012872",2001,620,89,531,312
"6402","E01012819",2001,609,34,575,73
"6403","E01012817",2001,628,27,601,114
"6404","E01012804",2001,668,39,629,68
"6405","E01012806",2001,701,94,607,143
"6406","E01012807",2001,587,75,512,69
"6407","E01012841",2001,638,545,93,22
"6408","E01012844",2001,602,478,124,18
"6409","E01012849",2001,680,381,299,6
"6410","E01012895",2001,793,625,168,13
"6411","E01012897",2001,648,552,96,4
"6412","E01012898",2001,732,468,264,29
"6413","E01012870",2001,608,30,578,258
"6414","E01012866",2001,660,35,625,240
"6415","E01012762",2001,615,31,584,175
"6416","E01012763",2001,789,65,724,425
"6417","E01012758",2001,645,36,609,163
"6418","E01012774",2001,653,212,441,55
"6419","E01012795",2001,775,364,411,19
"6420","E01012797",2001,636,161,475,68
"6421","E01012798",2001,825,532,293,18
"6422","E01012801",2001,643,107,536,81
"6423","E01012816",2001,553,52,501,45
"6424","E01012896",2001,601,82,519,49
"6425","E01012848",2001,493,139,354,89
"6426","E01012894",2001,616,351,265,16
"6427","E01012901",2001,593,68,525,49
"6428","E01012845",2001,608,373,235,17
"6429","E01012846",2001,624,378,246,24
"6430","E01012847",2001,504,298,206,15
"6431","E01012842",2001,595,352,243,17
"6432","E01012843",2001,603,347,256,30
"6433","E01012820",2001,514,25,489,67
"6434","E01012902",2001,589,31,558,28
"6435","E01012903",2001,780,120,660,121
"6436","E01012899",2001,646,27,619,62
"6437","E01012900",2001,711,100,611,125
"6438","E01012802",2001,651,39,612,105
"6439","E01012803",2001,629,44,585,113
"6440","E01012799",2001,623,13,610,166
"6441","E01012800",2001,731,83,648,107
"6442","E01012796",2001,585,33,552,49
"6443","E01012850",2001,747,261,486,310
"6444","E01012856",2001,766,528,238,53
"6445","E01012857",2001,688,393,295,89
"6446","E01012852",2001,653,353,300,96
"6447","E01012867",2001,518,150,368,169
"6448","E01012862",2001,592,204,388,79
"6449","E01012759",2001,750,55,695,182
"6450","E01012760",2001,716,36,680,201
"6451","E01012756",2001,661,27,634,115
"6452","E01012757",2001,631,27,604,207
"6453","E01012805",2001,657,157,500,108
"6454","E01012808",2001,863,428,435,83
"6455","E01012809",2001,801,121,680,254
"6456","E01012810",2001,778,213,565,30
"6457","E01012811",2001,796,78,718,143
"6458","E01012863",2001,628,22,606,111
"6459","E01012864",2001,601,23,578,214
"6460","E01012865",2001,653,44,609,172
"6461","E01012773",2001,739,21,718,91
"6462","E01012776",2001,652,21,631,101
"6463","E01012777",2001,801,404,397,35
"6464","E01012775",2001,648,283,365,37
"6465","E01012770",2001,596,16,580,21
"6466","E01012771",2001,640,57,583,24
"6467","E01012772",2001,603,19,584,69
"6468","E01012853",2001,960,433,527,288
"6469","E01012854",2001,940,597,343,113
"6470","E01012855",2001,778,557,221,30
"6471","E01012851",2001,873,523,350,160
"6472","E01012859",2001,601,41,560,218
"6473","E01012889",2001,608,294,314,113
"6474","E01012891",2001,659,159,500,231
"6475","E01012892",2001,639,39,600,195
"6476","E01012893",2001,607,247,360,101
"6477","E01012890",2001,664,351,313,89
"6478","E01012888",2001,687,94,593,157
"6479","E01012886",2001,650,295,355,19
"6480","E01012860",2001,497,131,366,36
"6481","E01012861",2001,645,37,608,230
"6482","E01012858",2001,532,345,187,32
"6483","E01012882",2001,644,19,625,47
"6484","E01012883",2001,747,161,586,37
"6485","E01012884",2001,796,349,447,23
"6486","E01012885",2001,783,332,451,26
"6487","E01012887",2001,729,453,276,24
"6488","E01013174",2001,534,321,213,33
"6489","E01013175",2001,536,37,499,37
"6490","E01013176",2001,597,10,587,46
"6491","E01013177",2001,727,352,375,22
"6492","E01013178",2001,647,16,631,40
"6493","E01013179",2001,620,138,482,22
"6494","E01013180",2001,619,41,578,48
"6495","E01013136",2001,789,570,219,88
"6496","E01013137",2001,877,716,161,26
"6497","E01013139",2001,749,386,363,107
"6498","E01013142",2001,649,143,506,154
"6499","E01013218",2001,641,102,539,135
"6500","E01013219",2001,639,66,573,106
"6501","E01013220",2001,742,96,646,146
"6502","E01013221",2001,861,250,611,203
"6503","E01013222",2001,673,26,647,172
"6504","E01013148",2001,571,3,568,16
"6505","E01013144",2001,771,485,286,22
"6506","E01013145",2001,508,3,505,17
"6507","E01013146",2001,568,85,483,41
"6508","E01013201",2001,630,40,590,178
"6509","E01013202",2001,601,10,591,119
"6510","E01013203",2001,662,56,606,243
"6511","E01013195",2001,604,42,562,105
"6512","E01013196",2001,536,16,520,138
"6513","E01013140",2001,607,50,557,158
"6514","E01013141",2001,614,35,579,137
"6515","E01013138",2001,587,168,419,140
"6516","E01013143",2001,563,21,542,95
"6517","E01013173",2001,478,57,421,27
"6518","E01013223",2001,1000,18,982,45
"6519","E01013224",2001,635,95,540,31
"6520","E01013226",2001,584,11,573,22
"6521","E01013231",2001,644,36,608,77
"6522","E01013233",2001,614,16,598,83
"6523","E01013187",2001,757,242,515,156
"6524","E01013188",2001,674,10,664,56
"6525","E01013234",2001,611,34,577,60
"6526","E01013232",2001,584,230,354,44
"6527","E01013147",2001,613,204,409,29
"6528","E01013230",2001,527,9,518,23
"6529","E01013128",2001,620,46,574,107
"6530","E01013198",2001,621,37,584,102
"6531","E01013199",2001,457,14,443,116
"6532","E01013200",2001,515,0,515,11
"6533","E01013159",2001,594,33,561,180
"6534","E01013161",2001,513,28,485,100
"6535","E01013162",2001,643,23,620,210
"6536","E01013165",2001,560,59,501,172
"6537","E01013163",2001,602,19,583,20
"6538","E01013164",2001,542,75,467,24
"6539","E01013160",2001,632,7,625,41
"6540","E01013158",2001,593,50,543,34
"6541","E01013197",2001,530,5,525,46
"6542","E01013227",2001,754,107,647,31
"6543","E01013228",2001,669,23,646,58
"6544","E01013229",2001,577,206,371,42
"6545","E01013149",2001,487,3,484,15
"6546","E01013150",2001,517,3,514,15
"6547","E01013131",2001,741,148,593,127
"6548","E01013132",2001,624,59,565,20
"6549","E01013133",2001,732,56,676,142
"6550","E01013134",2001,671,146,525,16
"6551","E01013211",2001,619,21,598,47
"6552","E01013212",2001,587,435,152,14
"6553","E01013206",2001,603,199,404,35
"6554","E01013207",2001,600,62,538,32
"6555","E01013181",2001,587,36,551,192
"6556","E01013182",2001,625,8,617,26
"6557","E01013183",2001,599,32,567,48
"6558","E01013184",2001,599,17,582,129
"6559","E01013185",2001,611,59,552,54
"6560","E01013186",2001,500,6,494,16
"6561","E01013129",2001,614,25,589,232
"6562","E01013151",2001,531,6,525,26
"6563","E01013152",2001,616,7,609,18
"6564","E01013155",2001,612,6,606,11
"6565","E01013156",2001,607,238,369,57
"6566","E01013154",2001,632,0,632,16
"6567","E01013130",2001,624,254,370,23
"6568","E01013135",2001,756,201,555,19
"6569","E01013208",2001,513,358,155,19
"6570","E01013209",2001,663,385,278,12
"6571","E01013210",2001,516,289,227,23
"6572","E01013204",2001,589,214,375,23
"6573","E01013205",2001,498,298,200,36
"6574","E01013166",2001,636,3,633,19
"6575","E01013167",2001,636,12,624,12
"6576","E01013169",2001,531,95,436,13
"6577","E01013157",2001,636,6,630,42
"6578","E01013153",2001,647,3,644,27
"6579","E01013194",2001,672,8,664,32
"6580","E01013189",2001,607,15,592,7
"6581","E01013190",2001,664,6,658,17
"6582","E01013191",2001,627,9,618,7
"6583","E01013192",2001,709,249,460,40
"6584","E01013193",2001,736,10,726,16
"6585","E01013170",2001,599,59,540,17
"6586","E01013171",2001,499,9,490,3
"6587","E01013172",2001,628,39,589,34
"6588","E01013168",2001,629,7,622,22
"6589","E01013225",2001,413,5,408,53
"6590","E01013213",2001,593,179,414,46
"6591","E01013214",2001,629,19,610,32
"6592","E01013215",2001,520,3,517,14
"6593","E01013216",2001,501,6,495,21
"6594","E01013217",2001,617,34,583,15
"6595","E01013254",2001,702,174,528,110
"6596","E01013255",2001,741,38,703,106
"6597","E01013256",2001,639,12,627,60
"6598","E01013257",2001,657,18,639,23
"6599","E01013258",2001,636,179,457,30
"6600","E01013259",2001,631,202,429,29
"6601","E01013303",2001,524,77,447,48
"6602","E01013304",2001,521,27,494,30
"6603","E01013305",2001,603,16,587,47
"6604","E01013307",2001,627,73,554,50
"6605","E01013288",2001,612,20,592,42
"6606","E01013291",2001,610,280,330,28
"6607","E01013292",2001,719,16,703,41
"6608","E01013294",2001,608,72,536,34
"6609","E01013270",2001,745,85,660,83
"6610","E01013308",2001,642,100,542,41
"6611","E01013309",2001,637,67,570,87
"6612","E01013306",2001,592,83,509,44
"6613","E01013293",2001,634,36,598,31
"6614","E01013289",2001,629,10,619,38
"6615","E01013290",2001,714,38,676,75
"6616","E01013286",2001,1057,245,812,105
"6617","E01013287",2001,679,42,637,66
"6618","E01013245",2001,553,137,416,48
"6619","E01013246",2001,586,102,484,45
"6620","E01013247",2001,604,37,567,47
"6621","E01013248",2001,631,23,608,46
"6622","E01013249",2001,611,213,398,30
"6623","E01013297",2001,617,101,516,41
"6624","E01013300",2001,600,99,501,176
"6625","E01013302",2001,547,28,519,27
"6626","E01013331",2001,780,400,380,25
"6627","E01013332",2001,620,102,518,145
"6628","E01013296",2001,600,116,484,197
"6629","E01013298",2001,506,211,295,36
"6630","E01013299",2001,628,390,238,16
"6631","E01013330",2001,634,159,475,175
"6632","E01013301",2001,605,57,548,32
"6633","E01013333",2001,602,48,554,47
"6634","E01013334",2001,634,55,579,44
"6635","E01013295",2001,592,20,572,17
"6636","E01013310",2001,608,139,469,30
"6637","E01013312",2001,742,298,444,102
"6638","E01013313",2001,630,60,570,58
"6639","E01013314",2001,617,106,511,30
"6640","E01013271",2001,626,198,428,34
"6641","E01013272",2001,755,221,534,143
"6642","E01013273",2001,712,23,689,22
"6643","E01013267",2001,451,49,402,48
"6644","E01013268",2001,523,66,457,61
"6645","E01013269",2001,645,59,586,33
"6646","E01013285",2001,529,38,491,9
"6647","E01013279",2001,694,426,268,29
"6648","E01013321",2001,626,29,597,25
"6649","E01013316",2001,589,3,586,14
"6650","E01013274",2001,652,31,621,121
"6651","E01013275",2001,635,31,604,22
"6652","E01013276",2001,703,147,556,39
"6653","E01013277",2001,615,13,602,31
"6654","E01013317",2001,606,120,486,22
"6655","E01013318",2001,616,82,534,41
"6656","E01013319",2001,634,228,406,35
"6657","E01013315",2001,753,363,390,26
"6658","E01013311",2001,742,436,306,20
"6659","E01013320",2001,597,123,474,37
"6660","E01013238",2001,742,187,555,72
"6661","E01013240",2001,698,293,405,35
"6662","E01013278",2001,618,406,212,14
"6663","E01013280",2001,587,62,525,27
"6664","E01013281",2001,514,231,283,10
"6665","E01013283",2001,528,237,291,20
"6666","E01013284",2001,629,293,336,24
"6667","E01013282",2001,605,191,414,21
"6668","E01013239",2001,668,43,625,104
"6669","E01013236",2001,668,32,636,33
"6670","E01013237",2001,630,304,326,28
"6671","E01013235",2001,624,24,600,24
"6672","E01013261",2001,640,8,632,20
"6673","E01013262",2001,615,23,592,20
"6674","E01013263",2001,666,34,632,18
"6675","E01013264",2001,689,53,636,23
"6676","E01013265",2001,707,8,699,21
"6677","E01013266",2001,731,12,719,46
"6678","E01013260",2001,662,11,651,13
"6679","E01013241",2001,729,43,686,58
"6680","E01013242",2001,656,15,641,32
"6681","E01013243",2001,689,37,652,41
"6682","E01013244",2001,705,211,494,25
"6683","E01013324",2001,570,20,550,58
"6684","E01013326",2001,686,77,609,44
"6685","E01013327",2001,678,69,609,43
"6686","E01013328",2001,506,20,486,17
"6687","E01013329",2001,670,133,537,47
"6688","E01013325",2001,628,14,614,53
"6689","E01013322",2001,642,70,572,78
"6690","E01013323",2001,513,99,414,77
"6691","E01013250",2001,673,125,548,15
"6692","E01013251",2001,706,22,684,17
"6693","E01013252",2001,642,5,637,20
"6694","E01013253",2001,709,93,616,44
"6695","E01013436",2001,564,40,524,155
"6696","E01013438",2001,623,129,494,30
"6697","E01013439",2001,578,8,570,15
"6698","E01013440",2001,770,6,764,27
"6699","E01013370",2001,746,75,671,44
"6700","E01013375",2001,597,3,594,23
"6701","E01013376",2001,613,28,585,12
"6702","E01013373",2001,622,117,505,18
"6703","E01013374",2001,593,6,587,22
"6704","E01013377",2001,652,14,638,19
"6705","E01013371",2001,576,8,568,13
"6706","E01013372",2001,783,7,776,26
"6707","E01013404",2001,598,256,342,12
"6708","E01013407",2001,631,86,545,14
"6709","E01013408",2001,627,9,618,9
"6710","E01013410",2001,605,492,113,18
"6711","E01013411",2001,712,3,709,21
"6712","E01013409",2001,703,95,608,22
"6713","E01013405",2001,624,9,615,9
"6714","E01013406",2001,631,101,530,51
"6715","E01013428",2001,622,118,504,18
"6716","E01013429",2001,591,33,558,40
"6717","E01013430",2001,651,106,545,24
"6718","E01013431",2001,629,50,579,41
"6719","E01013435",2001,616,51,565,18
"6720","E01013432",2001,635,11,624,16
"6721","E01013433",2001,642,5,637,18
"6722","E01013434",2001,618,13,605,16
"6723","E01013344",2001,602,27,575,220
"6724","E01013346",2001,768,112,656,103
"6725","E01013379",2001,608,39,569,42
"6726","E01013380",2001,608,68,540,96
"6727","E01013385",2001,629,246,383,23
"6728","E01013387",2001,670,3,667,15
"6729","E01013388",2001,513,3,510,21
"6730","E01013389",2001,513,7,506,17
"6731","E01013437",2001,489,39,450,38
"6732","E01013347",2001,632,346,286,32
"6733","E01013345",2001,733,90,643,125
"6734","E01013343",2001,779,52,727,187
"6735","E01013349",2001,526,293,233,18
"6736","E01013350",2001,633,283,350,40
"6737","E01013348",2001,662,29,633,160
"6738","E01013368",2001,837,41,796,226
"6739","E01013386",2001,645,330,315,35
"6740","E01013382",2001,625,193,432,33
"6741","E01013383",2001,648,181,467,123
"6742","E01013426",2001,677,61,616,16
"6743","E01013427",2001,604,0,604,13
"6744","E01013421",2001,493,35,458,52
"6745","E01013422",2001,619,28,591,35
"6746","E01013392",2001,603,29,574,61
"6747","E01013335",2001,627,267,360,19
"6748","E01013336",2001,632,119,513,27
"6749","E01013337",2001,630,23,607,28
"6750","E01013338",2001,645,51,594,28
"6751","E01013339",2001,623,21,602,7
"6752","E01013369",2001,899,206,693,255
"6753","E01013366",2001,869,286,583,311
"6754","E01013367",2001,914,424,490,198
"6755","E01013415",2001,948,169,779,330
"6756","E01013416",2001,761,316,445,140
"6757","E01013419",2001,640,74,566,37
"6758","E01013420",2001,714,6,708,33
"6759","E01013402",2001,638,3,635,33
"6760","E01013381",2001,611,24,587,38
"6761","E01013384",2001,620,221,399,49
"6762","E01013403",2001,603,56,547,117
"6763","E01013398",2001,524,146,378,43
"6764","E01013399",2001,647,401,246,33
"6765","E01013400",2001,492,46,446,184
"6766","E01013401",2001,506,53,453,69
"6767","E01013393",2001,670,79,591,64
"6768","E01013394",2001,656,299,357,44
"6769","E01013395",2001,617,24,593,101
"6770","E01013396",2001,667,66,601,70
"6771","E01013441",2001,685,36,649,83
"6772","E01013445",2001,740,257,483,56
"6773","E01013413",2001,702,12,690,97
"6774","E01013417",2001,741,71,670,180
"6775","E01013397",2001,611,49,562,41
"6776","E01013390",2001,765,81,684,152
"6777","E01013391",2001,716,41,675,147
"6778","E01013446",2001,625,180,445,20
"6779","E01013447",2001,604,252,352,13
"6780","E01013448",2001,644,293,351,40
"6781","E01013442",2001,622,137,485,6
"6782","E01013443",2001,710,414,296,19
"6783","E01013444",2001,593,259,334,16
"6784","E01013418",2001,753,159,594,145
"6785","E01013360",2001,634,20,614,155
"6786","E01013361",2001,647,23,624,129
"6787","E01013362",2001,730,55,675,123
"6788","E01013363",2001,641,115,526,164
"6789","E01013364",2001,723,129,594,249
"6790","E01013351",2001,746,19,727,32
"6791","E01013352",2001,763,75,688,35
"6792","E01013451",2001,463,20,443,27
"6793","E01013452",2001,597,29,568,26
"6794","E01013414",2001,716,53,663,156
"6795","E01013357",2001,740,28,712,35
"6796","E01013358",2001,635,12,623,47
"6797","E01013412",2001,866,68,798,206
"6798","E01013359",2001,614,168,446,12
"6799","E01013353",2001,712,229,483,24
"6800","E01013354",2001,611,6,605,25
"6801","E01013355",2001,676,9,667,36
"6802","E01013356",2001,659,43,616,16
"6803","E01013449",2001,667,133,534,23
"6804","E01013450",2001,487,25,462,52
"6805","E01013365",2001,1132,126,1006,131
"6806","E01013378",2001,490,76,414,101
"6807","E01013340",2001,516,10,506,26
"6808","E01013341",2001,615,64,551,18
"6809","E01013342",2001,545,10,535,35
"6810","E01013423",2001,525,0,525,8
"6811","E01013424",2001,496,18,478,7
"6812","E01013425",2001,655,45,610,33
"6813","E01027558",2001,791,33,758,66
"6814","E01027559",2001,699,80,619,87
"6815","E01027569",2001,546,22,524,107
"6816","E01027570",2001,977,106,871,88
"6817","E01027567",2001,764,90,674,83
"6818","E01027585",2001,811,39,772,120
"6819","E01027562",2001,589,18,571,82
"6820","E01027568",2001,753,66,687,75
"6821","E01027571",2001,767,37,730,88
"6822","E01027572",2001,921,121,800,152
"6823","E01027573",2001,634,73,561,79
"6824","E01027576",2001,629,3,626,23
"6825","E01027557",2001,648,3,645,191
"6826","E01027561",2001,767,50,717,77
"6827","E01027577",2001,813,49,764,124
"6828","E01027574",2001,653,6,647,23
"6829","E01027575",2001,859,122,737,43
"6830","E01027579",2001,494,212,282,17
"6831","E01027580",2001,488,257,231,27
"6832","E01027581",2001,1043,96,947,185
"6833","E01027582",2001,609,59,550,34
"6834","E01027578",2001,724,18,706,132
"6835","E01027586",2001,740,37,703,154
"6836","E01027560",2001,822,59,763,58
"6837","E01027563",2001,646,98,548,43
"6838","E01027556",2001,639,48,591,66
"6839","E01027555",2001,758,41,717,47
"6840","E01027564",2001,524,141,383,46
"6841","E01027565",2001,640,6,634,24
"6842","E01027566",2001,509,28,481,37
"6843","E01027583",2001,730,7,723,67
"6844","E01027584",2001,693,155,538,33
"6845","E01027591",2001,678,42,636,52
"6846","E01027597",2001,643,11,632,91
"6847","E01027599",2001,721,288,433,50
"6848","E01027623",2001,516,3,513,19
"6849","E01027625",2001,642,269,373,44
"6850","E01027626",2001,570,52,518,32
"6851","E01027627",2001,746,36,710,114
"6852","E01027624",2001,531,11,520,24
"6853","E01027618",2001,1000,44,956,62
"6854","E01027598",2001,824,21,803,31
"6855","E01027592",2001,698,28,670,88
"6856","E01027590",2001,850,147,703,101
"6857","E01027613",2001,722,34,688,125
"6858","E01027617",2001,414,25,389,80
"6859","E01027605",2001,512,71,441,72
"6860","E01027606",2001,637,11,626,25
"6861","E01027616",2001,551,165,386,33
"6862","E01027608",2001,623,193,430,64
"6863","E01027609",2001,532,254,278,20
"6864","E01027610",2001,601,75,526,58
"6865","E01027611",2001,880,46,834,92
"6866","E01027612",2001,751,382,369,27
"6867","E01027603",2001,718,71,647,89
"6868","E01027604",2001,729,17,712,102
"6869","E01027607",2001,547,3,544,16
"6870","E01027614",2001,554,42,512,16
"6871","E01027615",2001,499,0,499,12
"6872","E01027593",2001,701,62,639,132
"6873","E01027587",2001,601,197,404,14
"6874","E01027588",2001,605,35,570,103
"6875","E01027589",2001,643,97,546,52
"6876","E01027602",2001,901,115,786,315
"6877","E01027628",2001,702,72,630,162
"6878","E01027633",2001,721,16,705,82
"6879","E01027630",2001,744,146,598,193
"6880","E01027631",2001,627,10,617,75
"6881","E01027632",2001,516,46,470,54
"6882","E01027637",2001,772,28,744,109
"6883","E01027620",2001,639,44,595,87
"6884","E01027621",2001,893,94,799,74
"6885","E01027629",2001,609,332,277,20
"6886","E01027635",2001,836,140,696,157
"6887","E01027636",2001,822,52,770,116
"6888","E01027622",2001,770,46,724,90
"6889","E01027594",2001,642,268,374,48
"6890","E01027595",2001,618,51,567,59
"6891","E01027596",2001,653,28,625,63
"6892","E01027601",2001,746,58,688,64
"6893","E01027600",2001,708,82,626,84
"6894","E01027619",2001,894,60,834,191
"6895","E01027634",2001,653,64,589,38
"6896","E01027666",2001,654,50,604,77
"6897","E01027667",2001,508,37,471,89
"6898","E01027685",2001,579,93,486,94
"6899","E01027686",2001,445,10,435,129
"6900","E01027712",2001,481,27,454,44
"6901","E01027713",2001,638,40,598,103
"6902","E01027714",2001,495,60,435,60
"6903","E01027715",2001,407,26,381,169
"6904","E01027736",2001,587,53,534,95
"6905","E01027737",2001,539,52,487,169
"6906","E01027688",2001,630,67,563,84
"6907","E01027643",2001,591,65,526,82
"6908","E01027705",2001,650,82,568,117
"6909","E01027706",2001,885,212,673,148
"6910","E01027707",2001,701,97,604,72
"6911","E01027708",2001,610,28,582,86
"6912","E01027709",2001,512,14,498,14
"6913","E01027710",2001,468,175,293,22
"6914","E01027711",2001,493,120,373,29
"6915","E01027687",2001,572,26,546,54
"6916","E01027644",2001,642,102,540,66
"6917","E01027645",2001,610,28,582,84
"6918","E01027647",2001,640,58,582,45
"6919","E01027681",2001,631,48,583,104
"6920","E01027693",2001,678,7,671,110
"6921","E01027701",2001,632,46,586,108
"6922","E01027702",2001,514,85,429,72
"6923","E01027642",2001,570,15,555,72
"6924","E01027674",2001,526,10,516,18
"6925","E01027675",2001,782,11,771,34
"6926","E01027646",2001,608,30,578,64
"6927","E01027641",2001,469,5,464,22
"6928","E01027664",2001,769,52,717,141
"6929","E01027665",2001,427,9,418,66
"6930","E01027722",2001,536,3,533,36
"6931","E01027676",2001,641,172,469,12
"6932","E01027668",2001,654,44,610,90
"6933","E01027669",2001,853,167,686,95
"6934","E01027673",2001,775,92,683,164
"6935","E01027690",2001,610,9,601,32
"6936","E01027638",2001,581,9,572,36
"6937","E01027639",2001,562,3,559,28
"6938","E01027640",2001,647,53,594,43
"6939","E01027738",2001,589,29,560,61
"6940","E01027739",2001,456,17,439,63
"6941","E01027741",2001,618,66,552,26
"6942","E01027723",2001,738,259,479,41
"6943","E01027720",2001,648,132,516,56
"6944","E01027721",2001,663,3,660,63
"6945","E01027691",2001,640,25,615,66
"6946","E01027689",2001,640,77,563,61
"6947","E01027670",2001,640,0,640,30
"6948","E01027671",2001,608,6,602,23
"6949","E01027672",2001,657,3,654,25
"6950","E01027704",2001,479,23,456,33
"6951","E01027740",2001,929,567,362,26
"6952","E01027692",2001,517,79,438,128
"6953","E01027657",2001,539,29,510,121
"6954","E01027658",2001,732,38,694,141
"6955","E01027649",2001,637,96,541,87
"6956","E01027651",2001,597,296,301,29
"6957","E01027650",2001,608,57,551,18
"6958","E01027648",2001,625,112,513,41
"6959","E01027726",2001,591,36,555,48
"6960","E01027727",2001,621,68,553,49
"6961","E01027728",2001,609,38,571,18
"6962","E01027729",2001,639,116,523,88
"6963","E01027680",2001,721,35,686,275
"6964","E01027652",2001,642,9,633,154
"6965","E01027659",2001,776,58,718,299
"6966","E01027655",2001,492,57,435,77
"6967","E01027677",2001,622,28,594,183
"6968","E01027678",2001,704,156,548,248
"6969","E01027683",2001,570,33,537,25
"6970","E01027684",2001,558,59,499,65
"6971","E01027695",2001,629,81,548,43
"6972","E01027696",2001,498,24,474,48
"6973","E01027703",2001,692,46,646,126
"6974","E01027697",2001,586,19,567,30
"6975","E01027660",2001,642,68,574,39
"6976","E01027661",2001,615,76,539,31
"6977","E01027662",2001,443,3,440,16
"6978","E01027663",2001,617,6,611,32
"6979","E01027733",2001,521,7,514,21
"6980","E01027734",2001,563,25,538,66
"6981","E01027735",2001,601,11,590,135
"6982","E01027694",2001,523,40,483,76
"6983","E01027682",2001,630,18,612,85
"6984","E01027679",2001,763,7,756,163
"6985","E01027656",2001,796,24,772,181
"6986","E01027730",2001,635,21,614,136
"6987","E01027731",2001,628,29,599,121
"6988","E01027732",2001,523,8,515,69
"6989","E01027716",2001,593,3,590,21
"6990","E01027717",2001,613,8,605,41
"6991","E01027718",2001,531,0,531,40
"6992","E01027719",2001,625,23,602,43
"6993","E01027653",2001,626,90,536,56
"6994","E01027654",2001,466,4,462,39
"6995","E01027698",2001,620,0,620,45
"6996","E01027699",2001,511,6,505,10
"6997","E01027700",2001,484,24,460,17
"6998","E01027724",2001,639,54,585,39
"6999","E01027725",2001,582,75,507,44
"7000","E01027743",2001,530,45,485,70
"7001","E01027751",2001,502,25,477,58
"7002","E01027752",2001,515,36,479,123
"7003","E01027761",2001,517,25,492,51
"7004","E01027762",2001,512,43,469,79
"7005","E01027759",2001,558,59,499,83
"7006","E01027765",2001,618,89,529,35
"7007","E01027766",2001,568,157,411,70
"7008","E01027767",2001,610,32,578,34
"7009","E01027768",2001,496,5,491,27
"7010","E01027769",2001,507,149,358,46
"7011","E01027770",2001,763,105,658,175
"7012","E01027745",2001,537,70,467,49
"7013","E01027746",2001,595,84,511,34
"7014","E01027747",2001,476,70,406,116
"7015","E01027748",2001,525,68,457,25
"7016","E01027749",2001,775,445,330,16
"7017","E01027750",2001,605,82,523,127
"7018","E01027771",2001,492,76,416,337
"7019","E01027772",2001,526,19,507,112
"7020","E01027754",2001,458,85,373,213
"7021","E01027755",2001,619,107,512,494
"7022","E01027753",2001,569,37,532,80
"7023","E01027773",2001,491,18,473,108
"7024","E01027763",2001,522,25,497,83
"7025","E01027764",2001,488,44,444,71
"7026","E01027742",2001,560,62,498,68
"7027","E01027760",2001,580,49,531,135
"7028","E01027744",2001,553,34,519,110
"7029","E01027756",2001,493,54,439,45
"7030","E01027757",2001,1037,112,925,93
"7031","E01027758",2001,512,25,487,94
"7032","E01027776",2001,638,32,606,60
"7033","E01027777",2001,657,24,633,165
"7034","E01027783",2001,785,14,771,102
"7035","E01027784",2001,720,186,534,74
"7036","E01027792",2001,860,14,846,130
"7037","E01027793",2001,646,163,483,27
"7038","E01027794",2001,792,34,758,50
"7039","E01027795",2001,733,224,509,77
"7040","E01027801",2001,754,62,692,62
"7041","E01027802",2001,681,33,648,121
"7042","E01027775",2001,626,56,570,75
"7043","E01027780",2001,737,40,697,214
"7044","E01027781",2001,634,123,511,80
"7045","E01027800",2001,717,57,660,108
"7046","E01027779",2001,476,64,412,111
"7047","E01027796",2001,749,108,641,123
"7048","E01027803",2001,611,92,519,121
"7049","E01027798",2001,768,134,634,80
"7050","E01027785",2001,832,187,645,224
"7051","E01027786",2001,692,22,670,49
"7052","E01027787",2001,747,226,521,71
"7053","E01027788",2001,653,143,510,14
"7054","E01027789",2001,780,256,524,67
"7055","E01027790",2001,760,53,707,123
"7056","E01027791",2001,639,6,633,31
"7057","E01027778",2001,935,96,839,185
"7058","E01027774",2001,732,66,666,105
"7059","E01027799",2001,706,65,641,63
"7060","E01027797",2001,650,51,599,127
"7061","E01027782",2001,747,70,677,162
"7062","E01027837",2001,655,327,328,13
"7063","E01027839",2001,617,35,582,60
"7064","E01027869",2001,741,90,651,304
"7065","E01027870",2001,664,48,616,165
"7066","E01027871",2001,625,80,545,38
"7067","E01027840",2001,984,149,835,116
"7068","E01027841",2001,600,21,579,153
"7069","E01027813",2001,786,42,744,124
"7070","E01027822",2001,578,38,540,109
"7071","E01027838",2001,657,19,638,35
"7072","E01027864",2001,606,263,343,20
"7073","E01027865",2001,786,97,689,145
"7074","E01027866",2001,623,127,496,23
"7075","E01027821",2001,626,18,608,43
"7076","E01027836",2001,914,65,849,78
"7077","E01027857",2001,539,11,528,72
"7078","E01027831",2001,444,31,413,41
"7079","E01027832",2001,468,41,427,50
"7080","E01027823",2001,640,131,509,31
"7081","E01027855",2001,622,6,616,20
"7082","E01027856",2001,607,76,531,13
"7083","E01027842",2001,727,101,626,24
"7084","E01027843",2001,628,144,484,29
"7085","E01027844",2001,648,15,633,14
"7086","E01027845",2001,707,0,707,34
"7087","E01027846",2001,735,10,725,166
"7088","E01027847",2001,764,99,665,327
"7089","E01027848",2001,460,26,434,32
"7090","E01027805",2001,743,189,554,122
"7091","E01027806",2001,746,181,565,325
"7092","E01027849",2001,501,0,501,29
"7093","E01027850",2001,621,223,398,43
"7094","E01027872",2001,597,239,358,21
"7095","E01027874",2001,639,415,224,43
"7096","E01027862",2001,642,45,597,155
"7097","E01027851",2001,629,7,622,60
"7098","E01027810",2001,623,11,612,118
"7099","E01027811",2001,650,18,632,108
"7100","E01027812",2001,718,49,669,213
"7101","E01027824",2001,618,254,364,18
"7102","E01027825",2001,568,161,407,67
"7103","E01027826",2001,632,39,593,95
"7104","E01027863",2001,636,49,587,24
"7105","E01027861",2001,634,48,586,106
"7106","E01027873",2001,622,91,531,44
"7107","E01027868",2001,1021,30,991,193
"7108","E01027804",2001,767,70,697,399
"7109","E01027852",2001,790,25,765,442
"7110","E01027853",2001,590,33,557,151
"7111","E01027854",2001,756,29,727,367
"7112","E01027818",2001,608,77,531,43
"7113","E01027807",2001,648,86,562,47
"7114","E01027808",2001,638,8,630,31
"7115","E01027809",2001,596,3,593,23
"7116","E01027867",2001,603,3,600,27
"7117","E01027860",2001,487,72,415,19
"7118","E01027819",2001,576,357,219,14
"7119","E01027820",2001,516,255,261,20
"7120","E01027817",2001,627,336,291,23
"7121","E01027858",2001,609,6,603,15
"7122","E01027859",2001,632,3,629,38
"7123","E01027814",2001,655,34,621,138
"7124","E01027815",2001,588,57,531,46
"7125","E01027816",2001,680,51,629,18
"7126","E01027827",2001,827,49,778,198
"7127","E01027828",2001,765,103,662,16
"7128","E01027829",2001,775,27,748,44
"7129","E01027830",2001,625,191,434,30
"7130","E01027833",2001,659,93,566,56
"7131","E01027834",2001,734,12,722,24
"7132","E01027835",2001,670,86,584,42
"7133","E01027918",2001,649,138,511,71
"7134","E01027919",2001,472,31,441,65
"7135","E01027920",2001,501,56,445,23
"7136","E01027921",2001,865,261,604,35
"7137","E01027922",2001,655,26,629,27
"7138","E01027904",2001,802,70,732,74
"7139","E01027875",2001,673,25,648,112
"7140","E01027886",2001,483,57,426,45
"7141","E01027887",2001,559,28,531,22
"7142","E01027888",2001,515,60,455,45
"7143","E01027876",2001,619,29,590,13
"7144","E01027877",2001,468,86,382,33
"7145","E01027900",2001,681,33,648,49
"7146","E01027901",2001,604,9,595,27
"7147","E01027902",2001,547,105,442,30
"7148","E01027903",2001,405,11,394,56
"7149","E01027914",2001,615,4,611,23
"7150","E01027915",2001,639,178,461,18
"7151","E01027916",2001,639,219,420,31
"7152","E01027917",2001,531,7,524,20
"7153","E01027898",2001,799,91,708,63
"7154","E01027878",2001,517,63,454,37
"7155","E01027905",2001,662,70,592,78
"7156","E01027907",2001,581,372,209,13
"7157","E01027908",2001,735,261,474,116
"7158","E01027909",2001,734,210,524,88
"7159","E01027910",2001,735,317,418,23
"7160","E01027911",2001,597,52,545,32
"7161","E01027912",2001,423,6,417,5
"7162","E01027913",2001,505,3,502,9
"7163","E01027906",2001,594,196,398,32
"7164","E01027881",2001,470,141,329,6
"7165","E01027882",2001,561,10,551,16
"7166","E01027894",2001,743,47,696,18
"7167","E01027895",2001,651,28,623,23
"7168","E01027879",2001,556,3,553,18
"7169","E01027880",2001,513,12,501,11
"7170","E01027896",2001,685,68,617,30
"7171","E01027897",2001,720,4,716,58
"7172","E01027883",2001,404,37,367,24
"7173","E01027884",2001,561,30,531,21
"7174","E01027885",2001,601,43,558,37
"7175","E01027899",2001,613,59,554,22
"7176","E01027891",2001,712,48,664,28
"7177","E01027892",2001,774,194,580,44
"7178","E01027893",2001,659,43,616,24
"7179","E01027889",2001,637,115,522,15
"7180","E01027890",2001,683,26,657,28
"7181","E01027923",2001,866,124,742,32
"7182","E01027924",2001,634,29,605,30
"7183","E01007434",2001,634,141,493,75
"7184","E01007435",2001,645,307,338,14
"7185","E01007438",2001,617,130,487,14
"7186","E01007439",2001,493,53,440,12
"7187","E01007440",2001,645,117,528,89
"7188","E01007436",2001,534,103,431,3
"7189","E01007437",2001,606,151,455,51
"7190","E01007433",2001,635,209,426,20
"7191","E01007331",2001,662,66,596,50
"7192","E01007329",2001,521,176,345,21
"7193","E01007342",2001,519,32,487,36
"7194","E01007343",2001,628,243,385,26
"7195","E01007361",2001,633,22,611,80
"7196","E01007362",2001,655,9,646,17
"7197","E01007363",2001,760,353,407,20
"7198","E01007356",2001,608,32,576,24
"7199","E01007357",2001,590,176,414,26
"7200","E01007358",2001,591,31,560,60
"7201","E01007359",2001,616,155,461,27
"7202","E01007360",2001,656,178,478,22
"7203","E01007355",2001,599,25,574,12
"7204","E01007386",2001,751,10,741,34
"7205","E01007330",2001,647,137,510,32
"7206","E01007328",2001,643,372,271,30
"7207","E01007332",2001,630,249,381,67
"7208","E01007333",2001,499,54,445,84
"7209","E01007323",2001,604,227,377,21
"7210","E01007324",2001,745,282,463,47
"7211","E01007325",2001,604,398,206,13
"7212","E01007326",2001,643,309,334,17
"7213","E01007327",2001,757,395,362,15
"7214","E01007411",2001,590,447,143,13
"7215","E01007345",2001,576,49,527,50
"7216","E01007346",2001,605,123,482,55
"7217","E01007347",2001,631,71,560,35
"7218","E01007341",2001,519,354,165,17
"7219","E01007334",2001,563,6,557,41
"7220","E01007335",2001,574,59,515,6
"7221","E01007406",2001,793,422,371,19
"7222","E01007400",2001,641,97,544,35
"7223","E01007404",2001,606,36,570,16
"7224","E01007401",2001,628,204,424,39
"7225","E01007407",2001,637,168,469,28
"7226","E01007408",2001,602,81,521,40
"7227","E01007409",2001,616,26,590,69
"7228","E01007410",2001,767,313,454,47
"7229","E01007412",2001,599,143,456,21
"7230","E01007402",2001,600,352,248,9
"7231","E01007403",2001,606,339,267,5
"7232","E01007405",2001,590,137,453,24
"7233","E01007344",2001,619,134,485,36
"7234","E01007379",2001,653,60,593,22
"7235","E01007380",2001,616,32,584,26
"7236","E01007381",2001,609,75,534,8
"7237","E01007387",2001,587,116,471,15
"7238","E01007446",2001,668,80,588,68
"7239","E01007442",2001,608,26,582,11
"7240","E01007444",2001,712,176,536,35
"7241","E01007445",2001,720,103,617,115
"7242","E01007443",2001,729,164,565,183
"7243","E01007441",2001,658,45,613,84
"7244","E01007415",2001,627,137,490,45
"7245","E01007417",2001,755,51,704,137
"7246","E01007340",2001,675,33,642,123
"7247","E01007336",2001,710,81,629,210
"7248","E01007377",2001,498,120,378,71
"7249","E01007378",2001,727,464,263,39
"7250","E01007372",2001,653,414,239,15
"7251","E01007373",2001,628,176,452,104
"7252","E01007374",2001,620,57,563,25
"7253","E01007375",2001,615,105,510,27
"7254","E01007337",2001,635,52,583,126
"7255","E01007319",2001,607,23,584,19
"7256","E01007321",2001,604,46,558,20
"7257","E01007322",2001,615,90,525,107
"7258","E01007418",2001,565,55,510,102
"7259","E01007419",2001,604,34,570,40
"7260","E01007420",2001,620,105,515,10
"7261","E01007425",2001,578,23,555,37
"7262","E01007413",2001,635,330,305,41
"7263","E01007414",2001,621,224,397,52
"7264","E01007338",2001,886,492,394,98
"7265","E01007339",2001,691,104,587,158
"7266","E01007320",2001,617,256,361,49
"7267","E01007317",2001,615,332,283,5
"7268","E01007318",2001,510,320,190,21
"7269","E01007416",2001,487,313,174,14
"7270","E01007382",2001,639,155,484,42
"7271","E01007383",2001,498,39,459,16
"7272","E01007384",2001,618,62,556,34
"7273","E01007385",2001,615,251,364,20
"7274","E01007348",2001,621,253,368,6
"7275","E01007349",2001,656,213,443,71
"7276","E01007350",2001,519,58,461,22
"7277","E01007351",2001,645,141,504,66
"7278","E01007352",2001,633,334,299,41
"7279","E01007353",2001,618,62,556,65
"7280","E01007354",2001,594,82,512,65
"7281","E01007458",2001,618,97,521,64
"7282","E01007459",2001,746,84,662,34
"7283","E01007460",2001,605,133,472,11
"7284","E01007461",2001,741,327,414,38
"7285","E01007462",2001,614,315,299,17
"7286","E01007463",2001,753,475,278,17
"7287","E01007369",2001,660,75,585,166
"7288","E01007370",2001,610,213,397,45
"7289","E01007371",2001,629,184,445,49
"7290","E01007376",2001,657,149,508,116
"7291","E01007447",2001,649,297,352,24
"7292","E01007448",2001,715,50,665,185
"7293","E01007449",2001,637,25,612,73
"7294","E01007450",2001,752,402,350,24
"7295","E01007427",2001,569,79,490,54
"7296","E01007428",2001,606,32,574,48
"7297","E01007429",2001,720,315,405,22
"7298","E01007430",2001,586,7,579,49
"7299","E01007431",2001,513,72,441,9
"7300","E01007432",2001,553,77,476,18
"7301","E01007364",2001,595,268,327,13
"7302","E01007365",2001,520,240,280,24
"7303","E01007366",2001,589,37,552,35
"7304","E01007367",2001,493,14,479,119
"7305","E01007368",2001,613,71,542,89
"7306","E01007451",2001,614,248,366,42
"7307","E01007452",2001,526,29,497,39
"7308","E01007453",2001,661,431,230,10
"7309","E01007454",2001,635,104,531,46
"7310","E01007455",2001,585,78,507,7
"7311","E01007426",2001,609,65,544,49
"7312","E01007421",2001,526,17,509,106
"7313","E01007422",2001,553,57,496,31
"7314","E01007423",2001,630,147,483,32
"7315","E01007424",2001,618,161,457,20
"7316","E01007396",2001,660,103,557,62
"7317","E01007397",2001,672,265,407,41
"7318","E01007398",2001,735,161,574,12
"7319","E01007399",2001,707,81,626,49
"7320","E01007388",2001,623,94,529,70
"7321","E01007393",2001,637,169,468,79
"7322","E01007394",2001,525,218,307,44
"7323","E01007456",2001,658,43,615,39
"7324","E01007457",2001,594,290,304,27
"7325","E01007395",2001,777,403,374,20
"7326","E01007389",2001,661,47,614,48
"7327","E01007390",2001,618,104,514,41
"7328","E01007391",2001,660,343,317,40
"7329","E01007392",2001,591,312,279,20
"7330","E01007632",2001,580,101,479,38
"7331","E01007633",2001,514,137,377,23
"7332","E01007634",2001,610,232,378,55
"7333","E01007635",2001,617,200,417,18
"7334","E01007487",2001,711,258,453,20
"7335","E01007488",2001,611,13,598,51
"7336","E01007489",2001,644,31,613,68
"7337","E01007490",2001,594,92,502,37
"7338","E01007491",2001,620,115,505,129
"7339","E01007492",2001,630,337,293,19
"7340","E01007493",2001,618,34,584,34
"7341","E01007636",2001,648,238,410,67
"7342","E01007637",2001,610,40,570,44
"7343","E01007638",2001,627,246,381,19
"7344","E01007639",2001,743,161,582,93
"7345","E01007640",2001,651,13,638,17
"7346","E01007641",2001,525,73,452,27
"7347","E01007642",2001,634,263,371,18
"7348","E01007625",2001,575,27,548,27
"7349","E01007626",2001,626,200,426,76
"7350","E01007627",2001,624,274,350,22
"7351","E01007628",2001,504,236,268,30
"7352","E01007629",2001,639,330,309,34
"7353","E01007468",2001,597,5,592,9
"7354","E01007469",2001,504,83,421,18
"7355","E01007470",2001,545,150,395,36
"7356","E01007472",2001,628,331,297,23
"7357","E01007473",2001,595,128,467,58
"7358","E01007474",2001,621,357,264,46
"7359","E01007554",2001,609,19,590,40
"7360","E01007555",2001,618,297,321,24
"7361","E01007556",2001,515,177,338,14
"7362","E01007561",2001,563,9,554,17
"7363","E01007562",2001,602,62,540,32
"7364","E01007563",2001,487,158,329,60
"7365","E01007630",2001,637,77,560,18
"7366","E01007631",2001,532,6,526,3
"7367","E01007621",2001,528,10,518,29
"7368","E01007622",2001,622,7,615,11
"7369","E01007623",2001,610,151,459,9
"7370","E01007624",2001,595,14,581,9
"7371","E01007553",2001,626,33,593,35
"7372","E01007557",2001,399,10,389,51
"7373","E01007558",2001,613,76,537,20
"7374","E01007559",2001,412,18,394,11
"7375","E01007560",2001,633,21,612,22
"7376","E01007471",2001,603,69,534,20
"7377","E01007504",2001,599,157,442,25
"7378","E01007507",2001,425,173,252,33
"7379","E01007464",2001,586,242,344,20
"7380","E01007465",2001,622,187,435,9
"7381","E01007466",2001,588,192,396,69
"7382","E01007467",2001,618,231,387,25
"7383","E01007508",2001,636,218,418,68
"7384","E01007509",2001,771,249,522,87
"7385","E01007510",2001,643,128,515,79
"7386","E01007511",2001,527,206,321,32
"7387","E01007506",2001,520,236,284,24
"7388","E01007475",2001,586,8,578,25
"7389","E01007476",2001,638,142,496,22
"7390","E01007477",2001,611,32,579,21
"7391","E01007478",2001,598,93,505,18
"7392","E01007512",2001,617,115,502,14
"7393","E01007513",2001,618,166,452,15
"7394","E01007515",2001,635,207,428,17
"7395","E01007518",2001,600,94,506,10
"7396","E01007519",2001,519,91,428,17
"7397","E01007516",2001,544,70,474,18
"7398","E01007517",2001,707,90,617,133
"7399","E01007514",2001,675,9,666,100
"7400","E01007505",2001,668,82,586,63
"7401","E01007479",2001,638,161,477,18
"7402","E01007480",2001,530,133,397,27
"7403","E01007481",2001,540,66,474,40
"7404","E01007482",2001,631,237,394,38
"7405","E01007570",2001,645,57,588,15
"7406","E01007650",2001,785,188,597,20
"7407","E01007651",2001,637,220,417,38
"7408","E01007652",2001,718,365,353,23
"7409","E01007653",2001,636,16,620,45
"7410","E01007656",2001,610,215,395,23
"7411","E01007581",2001,625,11,614,12
"7412","E01007582",2001,637,16,621,55
"7413","E01007588",2001,646,115,531,52
"7414","E01007589",2001,734,78,656,21
"7415","E01007483",2001,612,33,579,18
"7416","E01007484",2001,620,108,512,29
"7417","E01007485",2001,589,4,585,10
"7418","E01007486",2001,619,23,596,16
"7419","E01007564",2001,590,255,335,11
"7420","E01007565",2001,629,16,613,35
"7421","E01007566",2001,751,383,368,11
"7422","E01007567",2001,508,76,432,33
"7423","E01007568",2001,589,329,260,17
"7424","E01007569",2001,618,252,366,9
"7425","E01007644",2001,538,10,528,30
"7426","E01007654",2001,619,35,584,117
"7427","E01007646",2001,619,19,600,171
"7428","E01007647",2001,656,64,592,104
"7429","E01007648",2001,746,64,682,272
"7430","E01007649",2001,608,6,602,44
"7431","E01007620",2001,699,13,686,31
"7432","E01007586",2001,647,48,599,23
"7433","E01007587",2001,691,192,499,105
"7434","E01007583",2001,572,32,540,52
"7435","E01007584",2001,627,17,610,52
"7436","E01007585",2001,645,55,590,53
"7437","E01007617",2001,641,5,636,23
"7438","E01007618",2001,514,15,499,19
"7439","E01007619",2001,621,4,617,19
"7440","E01007529",2001,604,88,516,174
"7441","E01007530",2001,625,54,571,175
"7442","E01007531",2001,747,216,531,72
"7443","E01007645",2001,634,24,610,180
"7444","E01007655",2001,790,91,699,262
"7445","E01007643",2001,601,262,339,35
"7446","E01007532",2001,946,724,222,46
"7447","E01007533",2001,610,148,462,42
"7448","E01007535",2001,597,26,571,96
"7449","E01007494",2001,604,39,565,83
"7450","E01007522",2001,717,348,369,18
"7451","E01007525",2001,629,245,384,14
"7452","E01007604",2001,582,14,568,11
"7453","E01007528",2001,634,234,400,12
"7454","E01007521",2001,590,57,533,24
"7455","E01007607",2001,503,160,343,7
"7456","E01007526",2001,639,39,600,17
"7457","E01007523",2001,640,10,630,33
"7458","E01007524",2001,671,27,644,29
"7459","E01007599",2001,582,24,558,14
"7460","E01007600",2001,597,8,589,16
"7461","E01007601",2001,606,36,570,18
"7462","E01007602",2001,564,14,550,29
"7463","E01007603",2001,609,6,603,38
"7464","E01007605",2001,634,47,587,20
"7465","E01007606",2001,560,3,557,8
"7466","E01007527",2001,616,20,596,44
"7467","E01007520",2001,610,4,606,13
"7468","E01007534",2001,752,80,672,208
"7469","E01007495",2001,652,211,441,93
"7470","E01007500",2001,570,275,295,11
"7471","E01007502",2001,463,7,456,16
"7472","E01007503",2001,574,4,570,9
"7473","E01007501",2001,636,18,618,19
"7474","E01007496",2001,512,327,185,25
"7475","E01007497",2001,528,166,362,25
"7476","E01007498",2001,612,110,502,62
"7477","E01007499",2001,651,369,282,21
"7478","E01007575",2001,644,447,197,12
"7479","E01007578",2001,640,201,439,75
"7480","E01007579",2001,645,154,491,39
"7481","E01007580",2001,639,108,531,5
"7482","E01007576",2001,621,97,524,49
"7483","E01007577",2001,638,135,503,99
"7484","E01007571",2001,624,75,549,47
"7485","E01007572",2001,571,139,432,12
"7486","E01007573",2001,641,421,220,14
"7487","E01007574",2001,628,169,459,62
"7488","E01007536",2001,657,20,637,84
"7489","E01007542",2001,711,314,397,26
"7490","E01007543",2001,654,395,259,18
"7491","E01007544",2001,749,550,199,11
"7492","E01007546",2001,606,88,518,60
"7493","E01007551",2001,625,41,584,13
"7494","E01007552",2001,597,31,566,27
"7495","E01007613",2001,632,53,579,37
"7496","E01007547",2001,631,92,539,74
"7497","E01007548",2001,611,302,309,19
"7498","E01007549",2001,623,313,310,24
"7499","E01007550",2001,657,227,430,19
"7500","E01007545",2001,594,62,532,48
"7501","E01007537",2001,691,129,562,25
"7502","E01007538",2001,590,186,404,21
"7503","E01007539",2001,538,153,385,50
"7504","E01007540",2001,629,131,498,23
"7505","E01007541",2001,640,219,421,24
"7506","E01007598",2001,631,21,610,18
"7507","E01007596",2001,507,3,504,15
"7508","E01007591",2001,604,84,520,24
"7509","E01007594",2001,644,23,621,27
"7510","E01007595",2001,604,210,394,22
"7511","E01007592",2001,632,212,420,48
"7512","E01007593",2001,510,120,390,27
"7513","E01007597",2001,645,373,272,15
"7514","E01007590",2001,485,124,361,23
"7515","E01007608",2001,508,97,411,50
"7516","E01007609",2001,874,193,681,50
"7517","E01007610",2001,768,21,747,44
"7518","E01007611",2001,572,108,464,25
"7519","E01007612",2001,625,32,593,47
"7520","E01007614",2001,525,14,511,16
"7521","E01007615",2001,610,101,509,31
"7522","E01007616",2001,576,49,527,19
"7523","E01007693",2001,649,164,485,32
"7524","E01007694",2001,656,293,363,37
"7525","E01007695",2001,612,122,490,24
"7526","E01007697",2001,639,339,300,9
"7527","E01007698",2001,618,38,580,29
"7528","E01007816",2001,630,235,395,6
"7529","E01007817",2001,616,249,367,8
"7530","E01007819",2001,616,97,519,9
"7531","E01007820",2001,619,68,551,100
"7532","E01007821",2001,642,223,419,28
"7533","E01007822",2001,730,380,350,58
"7534","E01007818",2001,677,25,652,26
"7535","E01007796",2001,550,307,243,12
"7536","E01007797",2001,575,131,444,19
"7537","E01007798",2001,516,29,487,4
"7538","E01007799",2001,634,293,341,6
"7539","E01007800",2001,682,124,558,79
"7540","E01007777",2001,629,249,380,19
"7541","E01007793",2001,632,256,376,12
"7542","E01007794",2001,520,242,278,17
"7543","E01007795",2001,630,20,610,5
"7544","E01007778",2001,549,81,468,5
"7545","E01007779",2001,590,298,292,17
"7546","E01007780",2001,620,176,444,3
"7547","E01007781",2001,647,301,346,10
"7548","E01007782",2001,571,243,328,21
"7549","E01007771",2001,600,33,567,35
"7550","E01007772",2001,500,199,301,36
"7551","E01007773",2001,646,156,490,63
"7552","E01007774",2001,510,149,361,30
"7553","E01007696",2001,638,114,524,182
"7554","E01007801",2001,496,29,467,15
"7555","E01007802",2001,551,44,507,23
"7556","E01007803",2001,535,154,381,21
"7557","E01007808",2001,596,13,583,9
"7558","E01007775",2001,519,319,200,25
"7559","E01007776",2001,590,207,383,49
"7560","E01007783",2001,810,332,478,45
"7561","E01007784",2001,650,108,542,125
"7562","E01007728",2001,485,114,371,11
"7563","E01007729",2001,805,552,253,16
"7564","E01007730",2001,710,425,285,24
"7565","E01007731",2001,547,97,450,58
"7566","E01007732",2001,763,468,295,8
"7567","E01007733",2001,635,357,278,4
"7568","E01007719",2001,637,400,237,8
"7569","E01007720",2001,680,160,520,23
"7570","E01007721",2001,672,301,371,36
"7571","E01007727",2001,644,344,300,13
"7572","E01007740",2001,619,330,289,7
"7573","E01007804",2001,657,366,291,8
"7574","E01007805",2001,636,380,256,14
"7575","E01007806",2001,497,293,204,9
"7576","E01007807",2001,606,188,418,10
"7577","E01007722",2001,636,41,595,70
"7578","E01007681",2001,580,39,541,17
"7579","E01007691",2001,611,55,556,10
"7580","E01007692",2001,631,99,532,26
"7581","E01007723",2001,602,294,308,11
"7582","E01007735",2001,586,416,170,21
"7583","E01007737",2001,564,414,150,15
"7584","E01007738",2001,544,293,251,22
"7585","E01007739",2001,629,399,230,16
"7586","E01007736",2001,659,383,276,58
"7587","E01007770",2001,624,233,391,20
"7588","E01007765",2001,640,51,589,70
"7589","E01007766",2001,511,274,237,17
"7590","E01007768",2001,772,339,433,78
"7591","E01007741",2001,669,23,646,9
"7592","E01007742",2001,602,156,446,13
"7593","E01007743",2001,505,40,465,9
"7594","E01007744",2001,660,166,494,34
"7595","E01007745",2001,653,287,366,17
"7596","E01007746",2001,585,127,458,12
"7597","E01007715",2001,602,151,451,113
"7598","E01007716",2001,704,300,404,105
"7599","E01007717",2001,742,199,543,71
"7600","E01007718",2001,685,272,413,55
"7601","E01007714",2001,788,342,446,121
"7602","E01007769",2001,608,135,473,136
"7603","E01007767",2001,653,148,505,73
"7604","E01007677",2001,628,366,262,19
"7605","E01007685",2001,588,7,581,15
"7606","E01007754",2001,521,38,483,29
"7607","E01007755",2001,576,8,568,18
"7608","E01007756",2001,598,27,571,13
"7609","E01007761",2001,705,220,485,36
"7610","E01007762",2001,597,152,445,19
"7611","E01007725",2001,494,26,468,22
"7612","E01007726",2001,717,390,327,31
"7613","E01007686",2001,636,64,572,13
"7614","E01007688",2001,643,16,627,296
"7615","E01007682",2001,554,108,446,8
"7616","E01007683",2001,583,64,519,13
"7617","E01007763",2001,612,132,480,90
"7618","E01007764",2001,621,338,283,56
"7619","E01007757",2001,674,58,616,21
"7620","E01007758",2001,637,180,457,116
"7621","E01007759",2001,674,251,423,24
"7622","E01007760",2001,743,153,590,131
"7623","E01007734",2001,729,457,272,16
"7624","E01007724",2001,600,16,584,152
"7625","E01007708",2001,746,415,331,24
"7626","E01007709",2001,614,10,604,5
"7627","E01007710",2001,640,16,624,14
"7628","E01007711",2001,647,21,626,9
"7629","E01007684",2001,597,19,578,30
"7630","E01007689",2001,559,131,428,6
"7631","E01007690",2001,627,14,613,30
"7632","E01007687",2001,624,110,514,11
"7633","E01007675",2001,625,111,514,22
"7634","E01007678",2001,631,64,567,39
"7635","E01007679",2001,725,235,490,16
"7636","E01007680",2001,634,108,526,77
"7637","E01007712",2001,665,11,654,7
"7638","E01007713",2001,595,6,589,10
"7639","E01007811",2001,574,17,557,15
"7640","E01007812",2001,550,257,293,13
"7641","E01007813",2001,593,111,482,28
"7642","E01007814",2001,441,75,366,16
"7643","E01007702",2001,581,73,508,123
"7644","E01007703",2001,507,55,452,3
"7645","E01007704",2001,672,163,509,16
"7646","E01007705",2001,593,13,580,22
"7647","E01007676",2001,735,273,462,40
"7648","E01007707",2001,644,70,574,5
"7649","E01007666",2001,565,50,515,20
"7650","E01007815",2001,645,116,529,99
"7651","E01007809",2001,717,280,437,36
"7652","E01007810",2001,667,165,502,20
"7653","E01007665",2001,545,77,468,24
"7654","E01007706",2001,556,27,529,11
"7655","E01007699",2001,623,207,416,22
"7656","E01007700",2001,520,58,462,49
"7657","E01007701",2001,655,246,409,82
"7658","E01007787",2001,663,65,598,51
"7659","E01007788",2001,635,73,562,43
"7660","E01007789",2001,718,244,474,47
"7661","E01007792",2001,483,5,478,10
"7662","E01007790",2001,655,207,448,154
"7663","E01007791",2001,574,157,417,63
"7664","E01007785",2001,505,74,431,19
"7665","E01007786",2001,480,30,450,14
"7666","E01007657",2001,587,12,575,17
"7667","E01007659",2001,480,12,468,17
"7668","E01007672",2001,539,10,529,15
"7669","E01007673",2001,636,254,382,21
"7670","E01007667",2001,565,176,389,14
"7671","E01007668",2001,675,410,265,51
"7672","E01007669",2001,637,61,576,20
"7673","E01007670",2001,603,7,596,15
"7674","E01007671",2001,581,9,572,43
"7675","E01007674",2001,645,19,626,13
"7676","E01007747",2001,540,206,334,29
"7677","E01007750",2001,632,58,574,22
"7678","E01007660",2001,479,25,454,9
"7679","E01007661",2001,533,68,465,10
"7680","E01007662",2001,469,265,204,6
"7681","E01007663",2001,638,10,628,21
"7682","E01007664",2001,815,63,752,27
"7683","E01007658",2001,555,39,516,27
"7684","E01007751",2001,654,124,530,129
"7685","E01007752",2001,610,10,600,21
"7686","E01007753",2001,653,176,477,27
"7687","E01007748",2001,645,117,528,6
"7688","E01007749",2001,641,36,605,36
"7689","E01008144",2001,649,42,607,52
"7690","E01008145",2001,723,369,354,15
"7691","E01008148",2001,639,165,474,21
"7692","E01008149",2001,651,12,639,34
"7693","E01008150",2001,656,158,498,38
"7694","E01008146",2001,524,5,519,4
"7695","E01008147",2001,608,74,534,30
"7696","E01008142",2001,620,158,462,26
"7697","E01008143",2001,749,140,609,33
"7698","E01007888",2001,564,22,542,14
"7699","E01007892",2001,652,426,226,24
"7700","E01007893",2001,626,22,604,18
"7701","E01007898",2001,588,11,577,33
"7702","E01007899",2001,622,23,599,19
"7703","E01007900",2001,746,302,444,26
"7704","E01007901",2001,716,447,269,20
"7705","E01007894",2001,598,26,572,43
"7706","E01007895",2001,646,261,385,3
"7707","E01007896",2001,549,10,539,14
"7708","E01007889",2001,667,33,634,40
"7709","E01007890",2001,577,18,559,7
"7710","E01007891",2001,658,9,649,10
"7711","E01007887",2001,615,172,443,21
"7712","E01007897",2001,612,11,601,12
"7713","E01008141",2001,618,32,586,19
"7714","E01008134",2001,605,100,505,25
"7715","E01008135",2001,590,31,559,59
"7716","E01008137",2001,617,13,604,13
"7717","E01008138",2001,615,315,300,5
"7718","E01008139",2001,631,119,512,31
"7719","E01008053",2001,595,356,239,12
"7720","E01008058",2001,611,127,484,16
"7721","E01008056",2001,594,246,348,13
"7722","E01008057",2001,622,397,225,11
"7723","E01008054",2001,538,345,193,8
"7724","E01008055",2001,630,423,207,15
"7725","E01007856",2001,552,336,216,11
"7726","E01008140",2001,659,204,455,24
"7727","E01008136",2001,584,170,414,35
"7728","E01008126",2001,624,54,570,12
"7729","E01008127",2001,579,74,505,17
"7730","E01008128",2001,582,41,541,70
"7731","E01008116",2001,614,408,206,15
"7732","E01008117",2001,630,418,212,18
"7733","E01008118",2001,653,362,291,17
"7734","E01008119",2001,510,314,196,7
"7735","E01008125",2001,616,246,370,11
"7736","E01008085",2001,603,361,242,8
"7737","E01008086",2001,617,358,259,10
"7738","E01008059",2001,647,406,241,15
"7739","E01008060",2001,639,456,183,6
"7740","E01007857",2001,645,419,226,9
"7741","E01007849",2001,625,266,359,47
"7742","E01008061",2001,630,362,268,11
"7743","E01008063",2001,724,235,489,11
"7744","E01008120",2001,616,400,216,25
"7745","E01008121",2001,623,439,184,25
"7746","E01008122",2001,580,412,168,23
"7747","E01008124",2001,664,511,153,23
"7748","E01008087",2001,674,45,629,38
"7749","E01008088",2001,654,131,523,33
"7750","E01008090",2001,732,459,273,16
"7751","E01008092",2001,764,555,209,24
"7752","E01008062",2001,607,423,184,11
"7753","E01007947",2001,833,639,194,18
"7754","E01007948",2001,590,367,223,24
"7755","E01007851",2001,519,165,354,25
"7756","E01007848",2001,629,376,253,24
"7757","E01007852",2001,642,120,522,57
"7758","E01007853",2001,608,30,578,22
"7759","E01007854",2001,516,185,331,47
"7760","E01007855",2001,620,68,552,99
"7761","E01007850",2001,616,47,569,16
"7762","E01007847",2001,631,227,404,38
"7763","E01007941",2001,642,328,314,23
"7764","E01007950",2001,648,381,267,15
"7765","E01007945",2001,708,389,319,23
"7766","E01007946",2001,596,363,233,23
"7767","E01008123",2001,580,354,226,20
"7768","E01007987",2001,583,12,571,48
"7769","E01007988",2001,632,70,562,19
"7770","E01007989",2001,593,16,577,55
"7771","E01007991",2001,619,315,304,24
"7772","E01007995",2001,675,25,650,127
"7773","E01008093",2001,763,92,671,172
"7774","E01008091",2001,627,26,601,67
"7775","E01008089",2001,611,335,276,27
"7776","E01007913",2001,487,65,422,109
"7777","E01007914",2001,489,75,414,88
"7778","E01007903",2001,591,165,426,35
"7779","E01007904",2001,653,453,200,28
"7780","E01007943",2001,744,507,237,24
"7781","E01007870",2001,645,159,486,87
"7782","E01007871",2001,802,480,322,41
"7783","E01008094",2001,586,351,235,18
"7784","E01007949",2001,486,41,445,60
"7785","E01007872",2001,636,67,569,72
"7786","E01007873",2001,713,403,310,60
"7787","E01007942",2001,487,76,411,70
"7788","E01007869",2001,481,93,388,60
"7789","E01007990",2001,654,204,450,16
"7790","E01007996",2001,620,103,517,33
"7791","E01007992",2001,704,79,625,53
"7792","E01007993",2001,696,292,404,11
"7793","E01007994",2001,595,24,571,39
"7794","E01007940",2001,647,264,383,78
"7795","E01007944",2001,581,92,489,130
"7796","E01007874",2001,620,412,208,43
"7797","E01007875",2001,631,320,311,90
"7798","E01007876",2001,768,468,300,139
"7799","E01007877",2001,491,49,442,75
"7800","E01008129",2001,550,78,472,41
"7801","E01008130",2001,639,101,538,20
"7802","E01008131",2001,657,81,576,10
"7803","E01008132",2001,564,11,553,15
"7804","E01008133",2001,730,194,536,32
"7805","E01008151",2001,699,42,657,220
"7806","E01008153",2001,784,147,637,130
"7807","E01008154",2001,688,164,524,78
"7808","E01008155",2001,711,156,555,144
"7809","E01008156",2001,695,16,679,47
"7810","E01008160",2001,661,90,571,34
"7811","E01008158",2001,714,317,397,15
"7812","E01008152",2001,670,122,548,23
"7813","E01007997",2001,655,67,588,10
"7814","E01007998",2001,891,529,362,18
"7815","E01008068",2001,767,572,195,68
"7816","E01008065",2001,859,689,170,56
"7817","E01008072",2001,613,299,314,83
"7818","E01008157",2001,831,551,280,40
"7819","E01008161",2001,750,36,714,114
"7820","E01007883",2001,477,247,230,62
"7821","E01007905",2001,412,172,240,66
"7822","E01007906",2001,525,129,396,92
"7823","E01007902",2001,794,516,278,48
"7824","E01008066",2001,457,36,421,240
"7825","E01008069",2001,581,57,524,227
"7826","E01008074",2001,587,39,548,177
"7827","E01008064",2001,660,39,621,236
"7828","E01007960",2001,696,33,663,161
"7829","E01007962",2001,617,163,454,176
"7830","E01007951",2001,669,66,603,107
"7831","E01008159",2001,768,31,737,157
"7832","E01007866",2001,594,91,503,251
"7833","E01007867",2001,583,85,498,312
"7834","E01007868",2001,482,56,426,128
"7835","E01008067",2001,473,75,398,278
"7836","E01008073",2001,670,254,416,112
"7837","E01008070",2001,704,260,444,262
"7838","E01008071",2001,620,280,340,249
"7839","E01008114",2001,645,350,295,177
"7840","E01008115",2001,530,138,392,277
"7841","E01008014",2001,657,257,400,22
"7842","E01008016",2001,633,201,432,15
"7843","E01007911",2001,600,26,574,18
"7844","E01007907",2001,602,34,568,38
"7845","E01007908",2001,647,17,630,36
"7846","E01007909",2001,737,108,629,38
"7847","E01007952",2001,591,6,585,15
"7848","E01007953",2001,829,310,519,28
"7849","E01007954",2001,656,21,635,33
"7850","E01007961",2001,607,25,582,28
"7851","E01007885",2001,703,542,161,52
"7852","E01007886",2001,648,489,159,16
"7853","E01007881",2001,591,205,386,53
"7854","E01007878",2001,731,561,170,11
"7855","E01007879",2001,713,113,600,169
"7856","E01007880",2001,972,815,157,35
"7857","E01007882",2001,585,27,558,99
"7858","E01007884",2001,814,597,217,77
"7859","E01007863",2001,619,49,570,174
"7860","E01007864",2001,530,11,519,291
"7861","E01007859",2001,425,48,377,190
"7862","E01007860",2001,602,88,514,234
"7863","E01008104",2001,466,119,347,157
"7864","E01007910",2001,712,368,344,21
"7865","E01007912",2001,706,160,546,17
"7866","E01007971",2001,620,213,407,10
"7867","E01007973",2001,639,42,597,16
"7868","E01007861",2001,671,19,652,35
"7869","E01007862",2001,483,47,436,125
"7870","E01007865",2001,739,66,673,115
"7871","E01007858",2001,631,54,577,120
"7872","E01008017",2001,688,520,168,7
"7873","E01008018",2001,710,509,201,23
"7874","E01008011",2001,619,481,138,12
"7875","E01008012",2001,619,475,144,23
"7876","E01008013",2001,623,513,110,14
"7877","E01008015",2001,771,499,272,7
"7878","E01008105",2001,586,77,509,260
"7879","E01008106",2001,934,724,210,87
"7880","E01008107",2001,618,276,342,119
"7881","E01008111",2001,585,68,517,297
"7882","E01007955",2001,539,32,507,10
"7883","E01007956",2001,639,33,606,39
"7884","E01007957",2001,661,6,655,28
"7885","E01007958",2001,621,6,615,27
"7886","E01007959",2001,595,5,590,14
"7887","E01008112",2001,474,78,396,166
"7888","E01008113",2001,623,56,567,154
"7889","E01008108",2001,479,77,402,177
"7890","E01008109",2001,602,188,414,180
"7891","E01008110",2001,529,119,410,257
"7892","E01008095",2001,646,345,301,134
"7893","E01008096",2001,627,399,228,32
"7894","E01008097",2001,632,407,225,23
"7895","E01008101",2001,646,436,210,21
"7896","E01007974",2001,562,61,501,16
"7897","E01007972",2001,621,7,614,11
"7898","E01007969",2001,615,141,474,23
"7899","E01007965",2001,622,304,318,13
"7900","E01007967",2001,781,390,391,12
"7901","E01007963",2001,730,232,498,39
"7902","E01008008",2001,716,418,298,14
"7903","E01008009",2001,599,466,133,7
"7904","E01007999",2001,569,78,491,19
"7905","E01008050",2001,603,18,585,226
"7906","E01008047",2001,636,20,616,286
"7907","E01008048",2001,534,29,505,181
"7908","E01008043",2001,598,8,590,25
"7909","E01008044",2001,631,10,621,23
"7910","E01007934",2001,588,37,551,41
"7911","E01007935",2001,576,10,566,160
"7912","E01007936",2001,702,28,674,197
"7913","E01007937",2001,608,12,596,36
"7914","E01007938",2001,602,6,596,22
"7915","E01007931",2001,602,5,597,25
"7916","E01008102",2001,726,534,192,33
"7917","E01008103",2001,601,436,165,33
"7918","E01008098",2001,641,427,214,43
"7919","E01008100",2001,612,432,180,31
"7920","E01007964",2001,730,249,481,50
"7921","E01007968",2001,626,309,317,32
"7922","E01007966",2001,616,226,390,23
"7923","E01007970",2001,995,787,208,24
"7924","E01008045",2001,527,34,493,86
"7925","E01008046",2001,685,15,670,186
"7926","E01008049",2001,718,160,558,109
"7927","E01008042",2001,596,15,581,138
"7928","E01008051",2001,628,27,601,190
"7929","E01008052",2001,637,33,604,152
"7930","E01008099",2001,586,60,526,120
"7931","E01007975",2001,757,328,429,78
"7932","E01007976",2001,630,211,419,28
"7933","E01007977",2001,838,584,254,18
"7934","E01007979",2001,702,483,219,21
"7935","E01008000",2001,658,100,558,61
"7936","E01008001",2001,658,167,491,34
"7937","E01008004",2001,741,238,503,18
"7938","E01008005",2001,693,101,592,24
"7939","E01008010",2001,591,267,324,15
"7940","E01007980",2001,635,61,574,108
"7941","E01007981",2001,553,33,520,109
"7942","E01007978",2001,609,63,546,138
"7943","E01007983",2001,642,32,610,95
"7944","E01007985",2001,642,19,623,56
"7945","E01007982",2001,656,360,296,14
"7946","E01008006",2001,651,100,551,19
"7947","E01008002",2001,599,41,558,3
"7948","E01008003",2001,628,94,534,12
"7949","E01007932",2001,571,30,541,27
"7950","E01007927",2001,643,10,633,11
"7951","E01007928",2001,616,12,604,15
"7952","E01007929",2001,635,19,616,50
"7953","E01007930",2001,516,6,510,17
"7954","E01007939",2001,644,46,598,29
"7955","E01008028",2001,669,185,484,70
"7956","E01008029",2001,599,292,307,6
"7957","E01008032",2001,628,195,433,46
"7958","E01008034",2001,607,215,392,6
"7959","E01007838",2001,616,106,510,15
"7960","E01007839",2001,672,15,657,23
"7961","E01007841",2001,618,29,589,12
"7962","E01007842",2001,686,207,479,12
"7963","E01007840",2001,750,363,387,16
"7964","E01007837",2001,655,474,181,20
"7965","E01007844",2001,710,358,352,27
"7966","E01007845",2001,621,393,228,18
"7967","E01007831",2001,628,13,615,106
"7968","E01007832",2001,664,46,618,69
"7969","E01007828",2001,695,174,521,33
"7970","E01007829",2001,643,32,611,85
"7971","E01007986",2001,646,14,632,107
"7972","E01008007",2001,779,462,317,16
"7973","E01008075",2001,732,515,217,21
"7974","E01008076",2001,646,390,256,16
"7975","E01008077",2001,708,335,373,13
"7976","E01008033",2001,597,89,508,11
"7977","E01008038",2001,748,9,739,11
"7978","E01008040",2001,582,129,453,13
"7979","E01008031",2001,604,231,373,18
"7980","E01007835",2001,606,101,505,12
"7981","E01007836",2001,672,72,600,21
"7982","E01007846",2001,639,38,601,23
"7983","E01007843",2001,771,419,352,10
"7984","E01008041",2001,546,18,528,15
"7985","E01008030",2001,535,42,493,33
"7986","E01008035",2001,475,5,470,15
"7987","E01008036",2001,600,15,585,28
"7988","E01008078",2001,643,132,511,14
"7989","E01008079",2001,499,13,486,12
"7990","E01007984",2001,596,3,593,9
"7991","E01007830",2001,645,120,525,22
"7992","E01007833",2001,779,188,591,13
"7993","E01007827",2001,698,26,672,47
"7994","E01008019",2001,601,223,378,14
"7995","E01008020",2001,617,46,571,12
"7996","E01008027",2001,657,298,359,13
"7997","E01008022",2001,757,521,236,26
"7998","E01008037",2001,718,317,401,5
"7999","E01008039",2001,602,38,564,10
"8000","E01007824",2001,562,4,558,8
"8001","E01007825",2001,597,8,589,16
"8002","E01007826",2001,586,3,583,15
"8003","E01007834",2001,732,146,586,36
"8004","E01008023",2001,694,22,672,13
"8005","E01008024",2001,690,140,550,16
"8006","E01008025",2001,726,131,595,55
"8007","E01008026",2001,629,5,624,14
"8008","E01008021",2001,519,3,516,7
"8009","E01007933",2001,584,9,575,10
"8010","E01007925",2001,690,134,556,30
"8011","E01007926",2001,638,25,613,13
"8012","E01007920",2001,662,12,650,28
"8013","E01007921",2001,734,92,642,34
"8014","E01007923",2001,766,71,695,28
"8015","E01007919",2001,820,552,268,19
"8016","E01007916",2001,739,500,239,16
"8017","E01007823",2001,814,211,603,34
"8018","E01008080",2001,657,185,472,26
"8019","E01008081",2001,803,501,302,15
"8020","E01008082",2001,815,553,262,15
"8021","E01008083",2001,679,443,236,13
"8022","E01008084",2001,804,571,233,21
"8023","E01007917",2001,690,132,558,24
"8024","E01007918",2001,723,117,606,29
"8025","E01007924",2001,699,194,505,25
"8026","E01007922",2001,593,6,587,4
"8027","E01007915",2001,604,8,596,14
"8028","E01010646",2001,536,27,509,33
"8029","E01010647",2001,507,108,399,27
"8030","E01010648",2001,606,16,590,31
"8031","E01010692",2001,684,33,651,91
"8032","E01010693",2001,529,0,529,14
"8033","E01010694",2001,587,6,581,27
"8034","E01010695",2001,736,39,697,147
"8035","E01010696",2001,589,6,583,26
"8036","E01010697",2001,634,26,608,40
"8037","E01010698",2001,777,64,713,100
"8038","E01010699",2001,736,229,507,31
"8039","E01010691",2001,604,3,601,21
"8040","E01010767",2001,588,140,448,6
"8041","E01010768",2001,563,8,555,29
"8042","E01010769",2001,642,55,587,78
"8043","E01010771",2001,463,5,458,10
"8044","E01010638",2001,615,44,571,30
"8045","E01010639",2001,749,42,707,91
"8046","E01010640",2001,767,10,757,144
"8047","E01010641",2001,610,70,540,15
"8048","E01010642",2001,693,8,685,25
"8049","E01010643",2001,551,12,539,73
"8050","E01010644",2001,589,63,526,51
"8051","E01010645",2001,528,0,528,16
"8052","E01010770",2001,482,3,479,19
"8053","E01010772",2001,482,0,482,7
"8054","E01010773",2001,649,42,607,43
"8055","E01010774",2001,688,38,650,43
"8056","E01010706",2001,619,19,600,48
"8057","E01010707",2001,637,6,631,37
"8058","E01010708",2001,626,6,620,27
"8059","E01010709",2001,653,30,623,13
"8060","E01010719",2001,466,51,415,44
"8061","E01010727",2001,680,70,610,55
"8062","E01010728",2001,509,13,496,85
"8063","E01010729",2001,482,3,479,12
"8064","E01010710",2001,741,192,549,236
"8065","E01010700",2001,441,9,432,94
"8066","E01010701",2001,399,71,328,88
"8067","E01010702",2001,488,82,406,74
"8068","E01010703",2001,604,68,536,35
"8069","E01010704",2001,572,72,500,79
"8070","E01010705",2001,635,22,613,15
"8071","E01010720",2001,608,249,359,41
"8072","E01010721",2001,668,280,388,31
"8073","E01010723",2001,465,25,440,98
"8074","E01010724",2001,610,190,420,33
"8075","E01010725",2001,645,33,612,91
"8076","E01010712",2001,454,8,446,97
"8077","E01010764",2001,614,3,611,22
"8078","E01010765",2001,905,176,729,44
"8079","E01010766",2001,479,0,479,6
"8080","E01010579",2001,615,11,604,29
"8081","E01010580",2001,634,14,620,44
"8082","E01010713",2001,619,223,396,34
"8083","E01010714",2001,601,43,558,59
"8084","E01010716",2001,675,100,575,78
"8085","E01010711",2001,815,482,333,89
"8086","E01010717",2001,597,57,540,57
"8087","E01010718",2001,609,288,321,29
"8088","E01010715",2001,467,146,321,28
"8089","E01010726",2001,607,3,604,7
"8090","E01010859",2001,618,3,615,12
"8091","E01010577",2001,622,10,612,23
"8092","E01010573",2001,589,34,555,19
"8093","E01010574",2001,603,58,545,12
"8094","E01010575",2001,736,86,650,52
"8095","E01010860",2001,597,10,587,64
"8096","E01010862",2001,646,50,596,52
"8097","E01010863",2001,583,0,583,20
"8098","E01010722",2001,550,147,403,41
"8099","E01010578",2001,607,17,590,86
"8100","E01010581",2001,630,43,587,43
"8101","E01010582",2001,626,13,613,72
"8102","E01010584",2001,703,258,445,37
"8103","E01010585",2001,734,171,563,54
"8104","E01010571",2001,734,140,594,67
"8105","E01010572",2001,650,28,622,17
"8106","E01010576",2001,606,20,586,33
"8107","E01010568",2001,760,114,646,29
"8108","E01010569",2001,780,244,536,27
"8109","E01010683",2001,548,33,515,38
"8110","E01010684",2001,632,48,584,33
"8111","E01010685",2001,635,55,580,48
"8112","E01010686",2001,600,36,564,14
"8113","E01010784",2001,747,120,627,110
"8114","E01010785",2001,776,75,701,156
"8115","E01010786",2001,486,4,482,15
"8116","E01010790",2001,598,7,591,5
"8117","E01010570",2001,537,0,537,5
"8118","E01010583",2001,737,275,462,46
"8119","E01010687",2001,604,6,598,21
"8120","E01010688",2001,642,17,625,99
"8121","E01010689",2001,670,34,636,53
"8122","E01010690",2001,658,109,549,40
"8123","E01010680",2001,790,559,231,29
"8124","E01010681",2001,484,0,484,9
"8125","E01010682",2001,620,263,357,26
"8126","E01010787",2001,666,48,618,26
"8127","E01010788",2001,520,11,509,59
"8128","E01010780",2001,764,182,582,103
"8129","E01010782",2001,745,334,411,55
"8130","E01010783",2001,635,83,552,32
"8131","E01010781",2001,519,109,410,44
"8132","E01010776",2001,613,161,452,34
"8133","E01010777",2001,732,374,358,42
"8134","E01010779",2001,661,202,459,36
"8135","E01010596",2001,615,8,607,19
"8136","E01010586",2001,682,10,672,43
"8137","E01010587",2001,643,49,594,54
"8138","E01010588",2001,641,51,590,38
"8139","E01010589",2001,586,3,583,32
"8140","E01010591",2001,641,200,441,34
"8141","E01010593",2001,678,61,617,34
"8142","E01010861",2001,666,8,658,41
"8143","E01010854",2001,736,48,688,102
"8144","E01010855",2001,676,51,625,61
"8145","E01010856",2001,642,14,628,162
"8146","E01010857",2001,645,15,630,43
"8147","E01010858",2001,652,29,623,50
"8148","E01010778",2001,614,163,451,79
"8149","E01010775",2001,598,9,589,13
"8150","E01010603",2001,629,35,594,29
"8151","E01010604",2001,677,17,660,27
"8152","E01010605",2001,634,216,418,23
"8153","E01010789",2001,621,52,569,62
"8154","E01010791",2001,517,13,504,60
"8155","E01010792",2001,483,41,442,87
"8156","E01010793",2001,502,20,482,80
"8157","E01010652",2001,631,87,544,61
"8158","E01010653",2001,631,264,367,52
"8159","E01010655",2001,521,173,348,35
"8160","E01010656",2001,606,41,565,24
"8161","E01010657",2001,640,9,631,88
"8162","E01010654",2001,635,330,305,37
"8163","E01010649",2001,614,122,492,51
"8164","E01010650",2001,577,284,293,51
"8165","E01010826",2001,496,251,245,33
"8166","E01010597",2001,596,114,482,24
"8167","E01010598",2001,638,7,631,20
"8168","E01010599",2001,471,11,460,35
"8169","E01010600",2001,484,3,481,66
"8170","E01010602",2001,601,5,596,43
"8171","E01010670",2001,455,5,450,76
"8172","E01010671",2001,491,38,453,23
"8173","E01010673",2001,458,9,449,105
"8174","E01010675",2001,599,57,542,59
"8175","E01010674",2001,524,165,359,42
"8176","E01010669",2001,643,7,636,36
"8177","E01010677",2001,604,190,414,44
"8178","E01010805",2001,433,0,433,49
"8179","E01010594",2001,604,63,541,44
"8180","E01010595",2001,625,91,534,70
"8181","E01010592",2001,654,119,535,30
"8182","E01010590",2001,612,27,585,58
"8183","E01010827",2001,538,18,520,42
"8184","E01010825",2001,475,27,448,33
"8185","E01010601",2001,672,11,661,59
"8186","E01010651",2001,608,0,608,24
"8187","E01010804",2001,461,9,452,59
"8188","E01010806",2001,499,59,440,103
"8189","E01010807",2001,477,180,297,43
"8190","E01010808",2001,521,23,498,74
"8191","E01010809",2001,467,3,464,66
"8192","E01010824",2001,612,362,250,86
"8193","E01010840",2001,487,158,329,56
"8194","E01010841",2001,405,110,295,62
"8195","E01010676",2001,498,20,478,101
"8196","E01010679",2001,471,132,339,140
"8197","E01010828",2001,723,176,547,93
"8198","E01010829",2001,570,80,490,81
"8199","E01010830",2001,599,64,535,88
"8200","E01010831",2001,439,22,417,111
"8201","E01010832",2001,451,38,413,49
"8202","E01010799",2001,632,95,537,51
"8203","E01010800",2001,608,332,276,29
"8204","E01010801",2001,616,15,601,75
"8205","E01010802",2001,601,230,371,26
"8206","E01010678",2001,551,69,482,42
"8207","E01010672",2001,472,3,469,40
"8208","E01010803",2001,520,41,479,116
"8209","E01010813",2001,492,143,349,63
"8210","E01010810",2001,513,28,485,46
"8211","E01010811",2001,475,16,459,89
"8212","E01010618",2001,493,117,376,78
"8213","E01010619",2001,519,12,507,71
"8214","E01010625",2001,476,232,244,27
"8215","E01010626",2001,508,89,419,58
"8216","E01010627",2001,521,42,479,63
"8217","E01010617",2001,630,409,221,47
"8218","E01010823",2001,680,310,370,106
"8219","E01010842",2001,555,227,328,74
"8220","E01010844",2001,542,288,254,77
"8221","E01010606",2001,468,139,329,88
"8222","E01010607",2001,470,56,414,86
"8223","E01010628",2001,633,39,594,67
"8224","E01010629",2001,492,12,480,34
"8225","E01010630",2001,611,130,481,20
"8226","E01010631",2001,520,195,325,37
"8227","E01010632",2001,513,205,308,43
"8228","E01010658",2001,575,23,552,98
"8229","E01010843",2001,407,61,346,64
"8230","E01010833",2001,482,148,334,115
"8231","E01010812",2001,562,117,445,122
"8232","E01010620",2001,494,50,444,112
"8233","E01010621",2001,472,8,464,86
"8234","E01010622",2001,531,42,489,120
"8235","E01010623",2001,485,152,333,81
"8236","E01010624",2001,507,65,442,96
"8237","E01010794",2001,629,85,544,22
"8238","E01010795",2001,617,5,612,75
"8239","E01010796",2001,631,175,456,52
"8240","E01010797",2001,467,3,464,24
"8241","E01010798",2001,646,54,592,100
"8242","E01010834",2001,443,35,408,263
"8243","E01010835",2001,674,10,664,149
"8244","E01010836",2001,421,10,411,160
"8245","E01010837",2001,485,9,476,71
"8246","E01010838",2001,433,16,417,104
"8247","E01010839",2001,439,62,377,138
"8248","E01010613",2001,617,101,516,116
"8249","E01010730",2001,785,609,176,46
"8250","E01010734",2001,494,18,476,102
"8251","E01010608",2001,437,95,342,69
"8252","E01010609",2001,641,114,527,59
"8253","E01010610",2001,633,464,169,60
"8254","E01010611",2001,630,193,437,58
"8255","E01010614",2001,520,86,434,75
"8256","E01010633",2001,605,35,570,54
"8257","E01010634",2001,566,5,561,24
"8258","E01010635",2001,655,333,322,39
"8259","E01010636",2001,586,0,586,53
"8260","E01010637",2001,500,15,485,80
"8261","E01010731",2001,411,137,274,158
"8262","E01010732",2001,526,256,270,65
"8263","E01010733",2001,502,192,310,75
"8264","E01010736",2001,613,100,513,200
"8265","E01010737",2001,486,160,326,76
"8266","E01010761",2001,630,106,524,56
"8267","E01010757",2001,617,37,580,54
"8268","E01010659",2001,598,237,361,42
"8269","E01010660",2001,410,18,392,77
"8270","E01010661",2001,405,12,393,62
"8271","E01010662",2001,498,15,483,31
"8272","E01010664",2001,531,44,487,26
"8273","E01010665",2001,572,8,564,52
"8274","E01010666",2001,686,226,460,115
"8275","E01010667",2001,612,48,564,74
"8276","E01010663",2001,632,66,566,159
"8277","E01010744",2001,436,21,415,60
"8278","E01010738",2001,499,65,434,76
"8279","E01010739",2001,607,313,294,67
"8280","E01010740",2001,496,67,429,60
"8281","E01010735",2001,486,302,184,27
"8282","E01010819",2001,671,429,242,44
"8283","E01010820",2001,611,394,217,23
"8284","E01010821",2001,654,420,234,35
"8285","E01010822",2001,516,233,283,26
"8286","E01010612",2001,564,326,238,42
"8287","E01010742",2001,516,102,414,95
"8288","E01010743",2001,580,168,412,72
"8289","E01010615",2001,530,9,521,32
"8290","E01010616",2001,556,163,393,35
"8291","E01010847",2001,636,19,617,51
"8292","E01010848",2001,640,27,613,59
"8293","E01010852",2001,665,40,625,52
"8294","E01010853",2001,505,6,499,24
"8295","E01010846",2001,626,121,505,34
"8296","E01010668",2001,518,6,512,13
"8297","E01010762",2001,571,11,560,52
"8298","E01010763",2001,612,30,582,58
"8299","E01010755",2001,609,303,306,139
"8300","E01010745",2001,595,100,495,68
"8301","E01010747",2001,618,85,533,64
"8302","E01010748",2001,643,273,370,37
"8303","E01010749",2001,614,143,471,77
"8304","E01010814",2001,734,116,618,124
"8305","E01010815",2001,608,85,523,80
"8306","E01010816",2001,593,31,562,33
"8307","E01010817",2001,628,370,258,25
"8308","E01010818",2001,596,12,584,33
"8309","E01010752",2001,691,21,670,173
"8310","E01010753",2001,581,13,568,29
"8311","E01010754",2001,628,25,603,71
"8312","E01010758",2001,473,11,462,17
"8313","E01010759",2001,634,137,497,47
"8314","E01010760",2001,549,9,540,41
"8315","E01010756",2001,572,57,515,53
"8316","E01010741",2001,637,43,594,56
"8317","E01010845",2001,617,373,244,26
"8318","E01010864",2001,501,129,372,47
"8319","E01010849",2001,611,23,588,38
"8320","E01010850",2001,501,252,249,26
"8321","E01010851",2001,624,18,606,56
"8322","E01010867",2001,539,133,406,30
"8323","E01010874",2001,472,199,273,52
"8324","E01010865",2001,664,22,642,66
"8325","E01010866",2001,568,5,563,51
"8326","E01010750",2001,667,58,609,46
"8327","E01010751",2001,673,196,477,21
"8328","E01010746",2001,651,5,646,25
"8329","E01010868",2001,644,214,430,43
"8330","E01010869",2001,684,72,612,61
"8331","E01010870",2001,647,65,582,40
"8332","E01010871",2001,656,31,625,85
"8333","E01010872",2001,635,257,378,35
"8334","E01010873",2001,512,33,479,15
"8335","E01010915",2001,560,53,507,40
"8336","E01010911",2001,587,17,570,47
"8337","E01010912",2001,691,277,414,38
"8338","E01010913",2001,564,16,548,13
"8339","E01010914",2001,643,203,440,40
"8340","E01010924",2001,738,459,279,95
"8341","E01010925",2001,541,207,334,55
"8342","E01010926",2001,446,258,188,58
"8343","E01010931",2001,578,93,485,27
"8344","E01010932",2001,625,6,619,33
"8345","E01010933",2001,687,31,656,61
"8346","E01010935",2001,648,0,648,42
"8347","E01010936",2001,632,55,577,40
"8348","E01010937",2001,656,39,617,20
"8349","E01010923",2001,660,109,551,137
"8350","E01010881",2001,657,108,549,45
"8351","E01010882",2001,637,117,520,54
"8352","E01010883",2001,593,9,584,40
"8353","E01010887",2001,635,18,617,87
"8354","E01010888",2001,761,38,723,166
"8355","E01010916",2001,619,214,405,60
"8356","E01010939",2001,611,6,605,30
"8357","E01010941",2001,543,192,351,31
"8358","E01010942",2001,680,221,459,63
"8359","E01010944",2001,626,292,334,34
"8360","E01010961",2001,523,27,496,63
"8361","E01010943",2001,598,335,263,42
"8362","E01010940",2001,610,100,510,52
"8363","E01010938",2001,624,331,293,47
"8364","E01010917",2001,766,16,750,77
"8365","E01010918",2001,652,54,598,46
"8366","E01010919",2001,713,242,471,42
"8367","E01010920",2001,617,22,595,72
"8368","E01010921",2001,668,162,506,55
"8369","E01010934",2001,751,38,713,56
"8370","E01010962",2001,669,103,566,84
"8371","E01010963",2001,701,445,256,37
"8372","E01010967",2001,711,319,392,70
"8373","E01010994",2001,819,379,440,208
"8374","E01010999",2001,635,6,629,9
"8375","E01010997",2001,617,0,617,25
"8376","E01010927",2001,581,6,575,32
"8377","E01010928",2001,591,279,312,32
"8378","E01010929",2001,732,59,673,99
"8379","E01010930",2001,718,183,535,76
"8380","E01010998",2001,719,121,598,50
"8381","E01011000",2001,600,20,580,57
"8382","E01010909",2001,612,75,537,70
"8383","E01010904",2001,574,4,570,38
"8384","E01010906",2001,601,28,573,22
"8385","E01010907",2001,559,16,543,44
"8386","E01010995",2001,415,68,347,130
"8387","E01010964",2001,527,232,295,80
"8388","E01010965",2001,450,214,236,32
"8389","E01010966",2001,452,134,318,67
"8390","E01010960",2001,465,67,398,96
"8391","E01010982",2001,636,28,608,77
"8392","E01010983",2001,639,62,577,126
"8393","E01010985",2001,587,131,456,62
"8394","E01010986",2001,676,108,568,94
"8395","E01010987",2001,657,100,557,55
"8396","E01010988",2001,614,205,409,36
"8397","E01010996",2001,421,17,404,87
"8398","E01011001",2001,450,27,423,71
"8399","E01011002",2001,614,14,600,72
"8400","E01011003",2001,584,73,511,115
"8401","E01010908",2001,664,42,622,55
"8402","E01010905",2001,610,11,599,38
"8403","E01010878",2001,746,101,645,128
"8404","E01010879",2001,769,95,674,42
"8405","E01010910",2001,565,207,358,29
"8406","E01010977",2001,634,19,615,47
"8407","E01010974",2001,629,144,485,127
"8408","E01010969",2001,522,9,513,34
"8409","E01010970",2001,758,21,737,99
"8410","E01010975",2001,718,197,521,16
"8411","E01010976",2001,647,52,595,26
"8412","E01010978",2001,518,60,458,42
"8413","E01010979",2001,650,338,312,59
"8414","E01010980",2001,635,72,563,78
"8415","E01010981",2001,581,42,539,113
"8416","E01010989",2001,630,70,560,79
"8417","E01010990",2001,674,106,568,44
"8418","E01010991",2001,625,37,588,39
"8419","E01010992",2001,683,92,591,86
"8420","E01010993",2001,624,168,456,55
"8421","E01010949",2001,598,54,544,112
"8422","E01010880",2001,691,341,350,61
"8423","E01010875",2001,748,14,734,41
"8424","E01010876",2001,660,3,657,36
"8425","E01010877",2001,747,66,681,134
"8426","E01010922",2001,641,21,620,63
"8427","E01010956",2001,634,66,568,77
"8428","E01010958",2001,638,333,305,22
"8429","E01010959",2001,626,158,468,27
"8430","E01010968",2001,619,25,594,86
"8431","E01010971",2001,726,11,715,47
"8432","E01010972",2001,631,28,603,42
"8433","E01010973",2001,700,117,583,51
"8434","E01010984",2001,579,17,562,93
"8435","E01010884",2001,685,162,523,49
"8436","E01010885",2001,610,23,587,95
"8437","E01010886",2001,462,119,343,34
"8438","E01010950",2001,648,142,506,98
"8439","E01010951",2001,643,26,617,81
"8440","E01010946",2001,541,24,517,9
"8441","E01010947",2001,633,3,630,37
"8442","E01010948",2001,626,132,494,24
"8443","E01010945",2001,604,74,530,29
"8444","E01010891",2001,675,266,409,27
"8445","E01010892",2001,605,47,558,25
"8446","E01010895",2001,653,195,458,9
"8447","E01010893",2001,616,83,533,70
"8448","E01010894",2001,681,43,638,100
"8449","E01010901",2001,639,31,608,28
"8450","E01010903",2001,658,105,553,31
"8451","E01010889",2001,739,410,329,36
"8452","E01010890",2001,638,145,493,66
"8453","E01010902",2001,579,174,405,47
"8454","E01010896",2001,593,16,577,33
"8455","E01010897",2001,636,64,572,62
"8456","E01010898",2001,697,68,629,110
"8457","E01010899",2001,563,78,485,21
"8458","E01010900",2001,628,8,620,31
"8459","E01010952",2001,654,88,566,62
"8460","E01010953",2001,538,32,506,53
"8461","E01010954",2001,563,6,557,17
"8462","E01010955",2001,591,60,531,51
"8463","E01010957",2001,603,9,594,50
"8464","E01011051",2001,640,25,615,45
"8465","E01011055",2001,503,9,494,28
"8466","E01011056",2001,618,22,596,36
"8467","E01011057",2001,530,52,478,55
"8468","E01011058",2001,493,72,421,29
"8469","E01011059",2001,686,401,285,29
"8470","E01011048",2001,796,245,551,97
"8471","E01011049",2001,652,120,532,24
"8472","E01011050",2001,615,25,590,22
"8473","E01011052",2001,680,183,497,34
"8474","E01011053",2001,626,15,611,30
"8475","E01011062",2001,588,28,560,59
"8476","E01011064",2001,607,176,431,34
"8477","E01011068",2001,702,18,684,39
"8478","E01011069",2001,587,45,542,38
"8479","E01011241",2001,586,29,557,47
"8480","E01011242",2001,638,215,423,24
"8481","E01011243",2001,690,36,654,56
"8482","E01011244",2001,513,57,456,24
"8483","E01011065",2001,642,35,607,101
"8484","E01011066",2001,579,13,566,17
"8485","E01011063",2001,786,88,698,94
"8486","E01011060",2001,745,252,493,26
"8487","E01011061",2001,715,222,493,102
"8488","E01011054",2001,566,13,553,27
"8489","E01011027",2001,482,91,391,35
"8490","E01011028",2001,645,103,542,79
"8491","E01011030",2001,515,221,294,33
"8492","E01011031",2001,628,5,623,29
"8493","E01011013",2001,639,10,629,28
"8494","E01011014",2001,579,109,470,99
"8495","E01011023",2001,602,16,586,83
"8496","E01011024",2001,633,189,444,41
"8497","E01011067",2001,605,58,547,37
"8498","E01011247",2001,617,18,599,62
"8499","E01011251",2001,635,367,268,30
"8500","E01011249",2001,598,195,403,37
"8501","E01011250",2001,780,211,569,125
"8502","E01011248",2001,588,178,410,20
"8503","E01011245",2001,574,100,474,40
"8504","E01011246",2001,602,261,341,38
"8505","E01011015",2001,502,200,302,56
"8506","E01011032",2001,522,231,291,44
"8507","E01011029",2001,654,371,283,32
"8508","E01011034",2001,449,134,315,34
"8509","E01011157",2001,516,63,453,28
"8510","E01011163",2001,577,228,349,11
"8511","E01011164",2001,648,84,564,14
"8512","E01011165",2001,482,3,479,36
"8513","E01011166",2001,624,84,540,95
"8514","E01011167",2001,611,149,462,60
"8515","E01011161",2001,534,7,527,41
"8516","E01011035",2001,458,131,327,25
"8517","E01011036",2001,570,232,338,42
"8518","E01011037",2001,638,32,606,92
"8519","E01011033",2001,639,33,606,38
"8520","E01011016",2001,492,56,436,81
"8521","E01011017",2001,513,128,385,65
"8522","E01011018",2001,444,99,345,39
"8523","E01011019",2001,497,34,463,50
"8524","E01011020",2001,499,254,245,55
"8525","E01011021",2001,654,4,650,28
"8526","E01011022",2001,592,10,582,65
"8527","E01011126",2001,740,279,461,20
"8528","E01011127",2001,571,14,557,31
"8529","E01011162",2001,659,14,645,38
"8530","E01011158",2001,619,25,594,69
"8531","E01011159",2001,632,26,606,52
"8532","E01011160",2001,516,12,504,24
"8533","E01011156",2001,658,134,524,19
"8534","E01011136",2001,566,209,357,33
"8535","E01011137",2001,644,191,453,48
"8536","E01011025",2001,527,174,353,36
"8537","E01011026",2001,495,69,426,64
"8538","E01011128",2001,508,149,359,69
"8539","E01011130",2001,744,376,368,97
"8540","E01011131",2001,399,9,390,76
"8541","E01011135",2001,541,69,472,95
"8542","E01011129",2001,485,91,394,12
"8543","E01011121",2001,606,215,391,41
"8544","E01011122",2001,478,299,179,19
"8545","E01011123",2001,638,142,496,91
"8546","E01011124",2001,655,137,518,45
"8547","E01011125",2001,647,157,490,19
"8548","E01011138",2001,622,318,304,30
"8549","E01011139",2001,470,58,412,34
"8550","E01011140",2001,474,292,182,20
"8551","E01011141",2001,503,54,449,56
"8552","E01011142",2001,629,11,618,61
"8553","E01011132",2001,519,3,516,8
"8554","E01011217",2001,711,61,650,19
"8555","E01011218",2001,689,130,559,43
"8556","E01011219",2001,658,32,626,47
"8557","E01011220",2001,647,290,357,30
"8558","E01011221",2001,671,17,654,28
"8559","E01011216",2001,530,11,519,24
"8560","E01011102",2001,495,39,456,29
"8561","E01011108",2001,600,26,574,65
"8562","E01011100",2001,630,196,434,36
"8563","E01011046",2001,504,9,495,14
"8564","E01011133",2001,486,144,342,41
"8565","E01011134",2001,493,174,319,72
"8566","E01011143",2001,483,138,345,77
"8567","E01011144",2001,489,157,332,102
"8568","E01011260",2001,522,121,401,39
"8569","E01011261",2001,404,127,277,16
"8570","E01011262",2001,535,269,266,47
"8571","E01011263",2001,599,65,534,33
"8572","E01011257",2001,491,20,471,63
"8573","E01011258",2001,397,18,379,44
"8574","E01011259",2001,500,157,343,49
"8575","E01011101",2001,599,320,279,55
"8576","E01011103",2001,629,222,407,37
"8577","E01011104",2001,737,261,476,34
"8578","E01011105",2001,642,425,217,55
"8579","E01011212",2001,779,256,523,45
"8580","E01011213",2001,626,13,613,17
"8581","E01011214",2001,635,53,582,67
"8582","E01011215",2001,680,61,619,86
"8583","E01011210",2001,634,30,604,71
"8584","E01011047",2001,642,6,636,42
"8585","E01011039",2001,631,49,582,56
"8586","E01011042",2001,610,18,592,45
"8587","E01011252",2001,444,29,415,20
"8588","E01011253",2001,510,232,278,11
"8589","E01011254",2001,645,16,629,34
"8590","E01011255",2001,614,317,297,14
"8591","E01011256",2001,601,261,340,15
"8592","E01011038",2001,642,289,353,67
"8593","E01011106",2001,653,270,383,99
"8594","E01011107",2001,656,296,360,165
"8595","E01011041",2001,615,36,579,147
"8596","E01011211",2001,630,22,608,15
"8597","E01011203",2001,593,33,560,20
"8598","E01011201",2001,698,122,576,90
"8599","E01011209",2001,634,7,627,21
"8600","E01011043",2001,629,61,568,206
"8601","E01011044",2001,497,7,490,74
"8602","E01011045",2001,623,179,444,140
"8603","E01011040",2001,605,20,585,146
"8604","E01011200",2001,496,7,489,67
"8605","E01011089",2001,600,122,478,35
"8606","E01011091",2001,558,8,550,25
"8607","E01011092",2001,566,6,560,32
"8608","E01011208",2001,710,65,645,183
"8609","E01011204",2001,520,8,512,17
"8610","E01011206",2001,654,141,513,40
"8611","E01011240",2001,710,111,599,84
"8612","E01011238",2001,788,97,691,280
"8613","E01011239",2001,631,59,572,81
"8614","E01011231",2001,752,33,719,112
"8615","E01011236",2001,671,145,526,328
"8616","E01011093",2001,653,339,314,29
"8617","E01011094",2001,643,386,257,27
"8618","E01011096",2001,602,24,578,39
"8619","E01011098",2001,607,47,560,164
"8620","E01011146",2001,615,6,609,38
"8621","E01011151",2001,597,5,592,40
"8622","E01011205",2001,594,3,591,62
"8623","E01011202",2001,661,122,539,19
"8624","E01011099",2001,606,110,496,27
"8625","E01011097",2001,660,147,513,54
"8626","E01011095",2001,617,69,548,22
"8627","E01011090",2001,632,125,507,34
"8628","E01011150",2001,634,47,587,95
"8629","E01011155",2001,644,10,634,61
"8630","E01011207",2001,616,15,601,37
"8631","E01011234",2001,691,246,445,55
"8632","E01011235",2001,706,294,412,142
"8633","E01011237",2001,623,79,544,115
"8634","E01011232",2001,631,184,447,105
"8635","E01011233",2001,609,31,578,46
"8636","E01011012",2001,529,107,422,37
"8637","E01011008",2001,612,25,587,115
"8638","E01011004",2001,690,376,314,17
"8639","E01011006",2001,634,93,541,39
"8640","E01011152",2001,611,9,602,71
"8641","E01011147",2001,617,52,565,43
"8642","E01011148",2001,734,397,337,27
"8643","E01011145",2001,617,43,574,51
"8644","E01011223",2001,602,206,396,40
"8645","E01011225",2001,687,201,486,132
"8646","E01011007",2001,607,50,557,101
"8647","E01011229",2001,727,368,359,185
"8648","E01011230",2001,481,36,445,140
"8649","E01011080",2001,739,59,680,162
"8650","E01011081",2001,674,117,557,152
"8651","E01011082",2001,425,30,395,94
"8652","E01011009",2001,616,92,524,48
"8653","E01011010",2001,637,254,383,59
"8654","E01011011",2001,615,14,601,29
"8655","E01011005",2001,639,39,600,20
"8656","E01011149",2001,781,176,605,168
"8657","E01011153",2001,741,51,690,89
"8658","E01011154",2001,623,117,506,29
"8659","E01011077",2001,646,44,602,87
"8660","E01011191",2001,653,41,612,26
"8661","E01011192",2001,672,174,498,53
"8662","E01011193",2001,609,111,498,29
"8663","E01011194",2001,591,9,582,11
"8664","E01011079",2001,820,75,745,161
"8665","E01011083",2001,652,17,635,31
"8666","E01011084",2001,601,269,332,63
"8667","E01011085",2001,691,142,549,33
"8668","E01011226",2001,649,48,601,28
"8669","E01011227",2001,797,435,362,27
"8670","E01011228",2001,618,81,537,32
"8671","E01011224",2001,731,280,451,81
"8672","E01011078",2001,754,17,737,152
"8673","E01011071",2001,675,30,645,48
"8674","E01011072",2001,613,64,549,41
"8675","E01011073",2001,644,97,547,85
"8676","E01011086",2001,676,11,665,22
"8677","E01011087",2001,687,189,498,56
"8678","E01011088",2001,586,3,583,3
"8679","E01011222",2001,795,158,637,97
"8680","E01011190",2001,637,3,634,59
"8681","E01011195",2001,449,29,420,44
"8682","E01011196",2001,599,5,594,25
"8683","E01011197",2001,615,138,477,53
"8684","E01011070",2001,630,39,591,47
"8685","E01011074",2001,676,46,630,112
"8686","E01011075",2001,642,63,579,105
"8687","E01011076",2001,615,99,516,44
"8688","E01011169",2001,578,11,567,29
"8689","E01011170",2001,626,16,610,26
"8690","E01011171",2001,589,26,563,62
"8691","E01011172",2001,500,231,269,28
"8692","E01011173",2001,518,28,490,8
"8693","E01011176",2001,542,42,500,31
"8694","E01011109",2001,594,0,594,47
"8695","E01011119",2001,617,113,504,30
"8696","E01011113",2001,657,8,649,47
"8697","E01011114",2001,652,164,488,30
"8698","E01011177",2001,595,20,575,31
"8699","E01011178",2001,775,186,589,107
"8700","E01011174",2001,649,5,644,29
"8701","E01011175",2001,587,199,388,23
"8702","E01011168",2001,641,19,622,22
"8703","E01011198",2001,614,7,607,43
"8704","E01011199",2001,556,49,507,34
"8705","E01011120",2001,584,5,579,23
"8706","E01011118",2001,609,54,555,44
"8707","E01011115",2001,666,23,643,73
"8708","E01011116",2001,606,54,552,26
"8709","E01011117",2001,617,24,593,26
"8710","E01011110",2001,527,14,513,85
"8711","E01011111",2001,569,31,538,23
"8712","E01011112",2001,606,76,530,46
"8713","E01011180",2001,683,33,650,45
"8714","E01011182",2001,704,51,653,82
"8715","E01011186",2001,613,12,601,57
"8716","E01011188",2001,653,107,546,25
"8717","E01011189",2001,613,6,607,39
"8718","E01011187",2001,621,66,555,25
"8719","E01011183",2001,678,11,667,41
"8720","E01011184",2001,565,178,387,13
"8721","E01011185",2001,639,59,580,32
"8722","E01011181",2001,729,13,716,128
"8723","E01011179",2001,631,18,613,51
"8724","E01011701",2001,522,27,495,11
"8725","E01011702",2001,476,10,466,7
"8726","E01011703",2001,569,8,561,10
"8727","E01011698",2001,638,66,572,22
"8728","E01011699",2001,591,3,588,22
"8729","E01011700",2001,478,18,460,16
"8730","E01011704",2001,782,252,530,76
"8731","E01011705",2001,644,244,400,25
"8732","E01011697",2001,489,76,413,33
"8733","E01011581",2001,586,115,471,13
"8734","E01011582",2001,782,363,419,14
"8735","E01011583",2001,593,71,522,24
"8736","E01011584",2001,544,38,506,27
"8737","E01011571",2001,740,122,618,55
"8738","E01011572",2001,797,37,760,56
"8739","E01011573",2001,560,56,504,15
"8740","E01011574",2001,682,162,520,39
"8741","E01011569",2001,745,70,675,116
"8742","E01011707",2001,619,99,520,6
"8743","E01011709",2001,635,62,573,34
"8744","E01011710",2001,582,51,531,35
"8745","E01011711",2001,621,72,549,52
"8746","E01011712",2001,570,78,492,72
"8747","E01011713",2001,640,21,619,35
"8748","E01011708",2001,615,60,555,21
"8749","E01011706",2001,600,23,577,26
"8750","E01011561",2001,527,31,496,68
"8751","E01011696",2001,636,52,584,10
"8752","E01011575",2001,596,17,579,38
"8753","E01011576",2001,589,39,550,41
"8754","E01011577",2001,619,9,610,15
"8755","E01011570",2001,770,103,667,38
"8756","E01011266",2001,507,5,502,18
"8757","E01011279",2001,565,89,476,19
"8758","E01011280",2001,614,9,605,13
"8759","E01011270",2001,630,9,621,13
"8760","E01011271",2001,683,35,648,16
"8761","E01011272",2001,547,6,541,9
"8762","E01011265",2001,686,87,599,103
"8763","E01011267",2001,641,222,419,18
"8764","E01011268",2001,648,289,359,22
"8765","E01011273",2001,712,73,639,44
"8766","E01011274",2001,676,375,301,60
"8767","E01011275",2001,621,112,509,21
"8768","E01011276",2001,616,37,579,36
"8769","E01011269",2001,660,179,481,52
"8770","E01011264",2001,589,127,462,12
"8771","E01011578",2001,620,76,544,32
"8772","E01011554",2001,606,18,588,42
"8773","E01011567",2001,568,7,561,30
"8774","E01011562",2001,623,3,620,18
"8775","E01011563",2001,597,6,591,40
"8776","E01011564",2001,605,4,601,36
"8777","E01011376",2001,627,10,617,12
"8778","E01011377",2001,611,11,600,8
"8779","E01011378",2001,699,387,312,16
"8780","E01011382",2001,673,8,665,12
"8781","E01011277",2001,572,32,540,24
"8782","E01011278",2001,688,20,668,48
"8783","E01011579",2001,502,71,431,28
"8784","E01011580",2001,613,52,561,34
"8785","E01011568",2001,733,17,716,46
"8786","E01011565",2001,617,18,599,26
"8787","E01011566",2001,574,31,543,44
"8788","E01011556",2001,756,72,684,153
"8789","E01011557",2001,619,68,551,28
"8790","E01011380",2001,657,52,605,23
"8791","E01011381",2001,528,6,522,12
"8792","E01011385",2001,671,124,547,54
"8793","E01011386",2001,623,23,600,60
"8794","E01011387",2001,630,79,551,26
"8795","E01011379",2001,773,342,431,25
"8796","E01011389",2001,670,358,312,30
"8797","E01011384",2001,653,159,494,21
"8798","E01011558",2001,741,408,333,37
"8799","E01011559",2001,584,305,279,29
"8800","E01011560",2001,782,448,334,33
"8801","E01011555",2001,565,24,541,30
"8802","E01011695",2001,668,376,292,28
"8803","E01011684",2001,634,111,523,28
"8804","E01011383",2001,744,143,601,75
"8805","E01011388",2001,640,124,516,19
"8806","E01011650",2001,551,43,508,25
"8807","E01011651",2001,614,145,469,47
"8808","E01011655",2001,678,46,632,117
"8809","E01011653",2001,564,18,546,149
"8810","E01011455",2001,473,9,464,7
"8811","E01011456",2001,612,28,584,15
"8812","E01011459",2001,678,24,654,92
"8813","E01011461",2001,598,9,589,14
"8814","E01011311",2001,442,3,439,30
"8815","E01011649",2001,611,8,603,29
"8816","E01011715",2001,532,24,508,20
"8817","E01011719",2001,621,77,544,14
"8818","E01011509",2001,623,36,587,27
"8819","E01011511",2001,533,57,476,45
"8820","E01011512",2001,654,45,609,102
"8821","E01011515",2001,619,12,607,143
"8822","E01011516",2001,654,13,641,35
"8823","E01011517",2001,714,147,567,55
"8824","E01011508",2001,472,8,464,37
"8825","E01011654",2001,544,19,525,33
"8826","E01011652",2001,526,48,478,55
"8827","E01011514",2001,560,7,553,27
"8828","E01011510",2001,838,514,324,22
"8829","E01011505",2001,641,100,541,23
"8830","E01011506",2001,511,11,500,39
"8831","E01011507",2001,677,16,661,40
"8832","E01011685",2001,630,49,581,213
"8833","E01011682",2001,594,128,466,365
"8834","E01011683",2001,665,58,607,271
"8835","E01011687",2001,582,37,545,39
"8836","E01011454",2001,672,16,656,70
"8837","E01011465",2001,764,206,558,68
"8838","E01011452",2001,591,8,583,31
"8839","E01011457",2001,579,33,546,32
"8840","E01011458",2001,552,10,542,9
"8841","E01011453",2001,634,33,601,44
"8842","E01011460",2001,638,120,518,47
"8843","E01011462",2001,669,231,438,36
"8844","E01011463",2001,755,355,400,27
"8845","E01011464",2001,651,38,613,84
"8846","E01011720",2001,706,365,341,17
"8847","E01011716",2001,587,20,567,12
"8848","E01011717",2001,645,195,450,19
"8849","E01011718",2001,605,247,358,17
"8850","E01011714",2001,615,88,527,17
"8851","E01011309",2001,627,81,546,36
"8852","E01011310",2001,671,101,570,50
"8853","E01011296",2001,748,50,698,15
"8854","E01011297",2001,591,82,509,40
"8855","E01011513",2001,647,77,570,33
"8856","E01011688",2001,597,98,499,37
"8857","E01011689",2001,744,150,594,41
"8858","E01011691",2001,598,286,312,57
"8859","E01011645",2001,604,40,564,133
"8860","E01011641",2001,592,14,578,56
"8861","E01011642",2001,488,12,476,31
"8862","E01011504",2001,711,407,304,20
"8863","E01011484",2001,642,433,209,11
"8864","E01011485",2001,734,299,435,58
"8865","E01011486",2001,687,145,542,41
"8866","E01011487",2001,563,196,367,22
"8867","E01011686",2001,814,472,342,31
"8868","E01011350",2001,633,25,608,59
"8869","E01011351",2001,785,88,697,100
"8870","E01011352",2001,734,120,614,182
"8871","E01011353",2001,694,17,677,75
"8872","E01011661",2001,773,529,244,11
"8873","E01011659",2001,644,384,260,11
"8874","E01011656",2001,588,303,285,20
"8875","E01011657",2001,619,397,222,15
"8876","E01011690",2001,780,63,717,288
"8877","E01011692",2001,679,46,633,157
"8878","E01011693",2001,694,58,636,221
"8879","E01011694",2001,618,18,600,125
"8880","E01011646",2001,648,31,617,38
"8881","E01011647",2001,477,29,448,66
"8882","E01011648",2001,584,33,551,43
"8883","E01011643",2001,638,29,609,90
"8884","E01011644",2001,515,192,323,32
"8885","E01011354",2001,730,459,271,46
"8886","E01011355",2001,559,295,264,28
"8887","E01011357",2001,660,430,230,54
"8888","E01011450",2001,537,214,323,37
"8889","E01011588",2001,605,80,525,28
"8890","E01011589",2001,660,43,617,59
"8891","E01011590",2001,620,23,597,13
"8892","E01011592",2001,685,127,558,56
"8893","E01011593",2001,597,5,592,24
"8894","E01011658",2001,666,513,153,18
"8895","E01011660",2001,639,389,250,17
"8896","E01011662",2001,607,464,143,16
"8897","E01011421",2001,663,297,366,53
"8898","E01011425",2001,609,45,564,18
"8899","E01011721",2001,611,321,290,7
"8900","E01011722",2001,740,420,320,19
"8901","E01011723",2001,634,411,223,16
"8902","E01011724",2001,815,456,359,15
"8903","E01011358",2001,643,319,324,30
"8904","E01011359",2001,608,140,468,110
"8905","E01011360",2001,521,105,416,74
"8906","E01011361",2001,678,403,275,49
"8907","E01011356",2001,700,94,606,141
"8908","E01011451",2001,1025,201,824,584
"8909","E01011439",2001,715,180,535,352
"8910","E01011437",2001,854,115,739,634
"8911","E01011442",2001,501,55,446,323
"8912","E01011438",2001,431,26,405,251
"8913","E01011435",2001,496,24,472,322
"8914","E01011436",2001,411,25,386,284
"8915","E01011440",2001,540,99,441,268
"8916","E01011441",2001,596,81,515,258
"8917","E01011488",2001,685,181,504,149
"8918","E01011489",2001,726,304,422,101
"8919","E01011477",2001,811,320,491,123
"8920","E01011480",2001,620,11,609,60
"8921","E01011324",2001,462,357,105,13
"8922","E01011325",2001,625,203,422,15
"8923","E01011326",2001,605,317,288,18
"8924","E01011332",2001,578,271,307,12
"8925","E01011427",2001,519,276,243,44
"8926","E01011431",2001,653,462,191,37
"8927","E01011423",2001,607,265,342,24
"8928","E01011424",2001,511,219,292,26
"8929","E01011426",2001,420,131,289,81
"8930","E01011422",2001,469,86,383,141
"8931","E01011428",2001,647,139,508,167
"8932","E01011429",2001,492,208,284,94
"8933","E01011443",2001,477,45,432,332
"8934","E01011444",2001,617,81,536,432
"8935","E01011668",2001,524,124,400,263
"8936","E01011669",2001,813,181,632,423
"8937","E01011663",2001,525,405,120,15
"8938","E01011664",2001,626,385,241,15
"8939","E01011665",2001,621,219,402,19
"8940","E01011667",2001,523,426,97,14
"8941","E01011333",2001,588,172,416,26
"8942","E01011323",2001,590,161,429,24
"8943","E01011329",2001,660,26,634,23
"8944","E01011330",2001,587,141,446,24
"8945","E01011335",2001,650,123,527,33
"8946","E01011327",2001,624,223,401,40
"8947","E01011328",2001,652,248,404,27
"8948","E01011591",2001,661,53,608,51
"8949","E01011430",2001,460,111,349,100
"8950","E01011432",2001,595,72,523,156
"8951","E01011433",2001,658,128,530,164
"8952","E01011434",2001,648,175,473,184
"8953","E01011445",2001,420,13,407,327
"8954","E01011446",2001,483,16,467,351
"8955","E01011447",2001,424,51,373,262
"8956","E01011448",2001,457,145,312,228
"8957","E01011449",2001,609,143,466,309
"8958","E01011676",2001,860,303,557,438
"8959","E01011679",2001,1197,864,333,132
"8960","E01011670",2001,740,463,277,83
"8961","E01011671",2001,634,398,236,60
"8962","E01011672",2001,918,434,484,378
"8963","E01011481",2001,574,170,404,206
"8964","E01011482",2001,813,88,725,241
"8965","E01011483",2001,605,265,340,179
"8966","E01011478",2001,734,195,539,199
"8967","E01011479",2001,539,36,503,236
"8968","E01011412",2001,626,16,610,8
"8969","E01011406",2001,588,20,568,22
"8970","E01011407",2001,661,84,577,32
"8971","E01011408",2001,747,44,703,23
"8972","E01011409",2001,621,23,598,82
"8973","E01011410",2001,627,17,610,20
"8974","E01011336",2001,698,299,399,28
"8975","E01011337",2001,491,361,130,13
"8976","E01011331",2001,580,74,506,41
"8977","E01011334",2001,629,142,487,68
"8978","E01011295",2001,693,238,455,44
"8979","E01011281",2001,643,222,421,57
"8980","E01011282",2001,628,203,425,48
"8981","E01011283",2001,570,303,267,18
"8982","E01011286",2001,527,55,472,26
"8983","E01011339",2001,749,497,252,27
"8984","E01011340",2001,659,381,278,14
"8985","E01011346",2001,738,505,233,23
"8986","E01011342",2001,610,401,209,35
"8987","E01011343",2001,621,245,376,18
"8988","E01011345",2001,613,321,292,28
"8989","E01011341",2001,607,245,362,24
"8990","E01011666",2001,603,42,561,17
"8991","E01011594",2001,616,271,345,12
"8992","E01011596",2001,672,11,661,43
"8993","E01011598",2001,701,65,636,42
"8994","E01011587",2001,702,33,669,63
"8995","E01011585",2001,661,206,455,17
"8996","E01011680",2001,650,168,482,395
"8997","E01011681",2001,603,267,336,202
"8998","E01011674",2001,661,146,515,486
"8999","E01011678",2001,750,269,481,343
"9000","E01011675",2001,904,688,216,36
"9001","E01011677",2001,864,445,419,159
"9002","E01011673",2001,731,307,424,253
"9003","E01011338",2001,675,581,94,27
"9004","E01011347",2001,747,248,499,121
"9005","E01011348",2001,581,324,257,49
"9006","E01011349",2001,902,531,371,76
"9007","E01011344",2001,758,192,566,152
"9008","E01011586",2001,602,23,579,16
"9009","E01011599",2001,637,73,564,29
"9010","E01011597",2001,574,32,542,35
"9011","E01011595",2001,632,7,625,16
"9012","E01011287",2001,617,103,514,22
"9013","E01011288",2001,592,251,341,29
"9014","E01011289",2001,602,43,559,24
"9015","E01011290",2001,653,110,543,175
"9016","E01011291",2001,643,166,477,115
"9017","E01011285",2001,507,24,483,16
"9018","E01011614",2001,599,47,552,38
"9019","E01011608",2001,567,232,335,15
"9020","E01011609",2001,646,283,363,19
"9021","E01011610",2001,602,41,561,33
"9022","E01011611",2001,603,344,259,19
"9023","E01011413",2001,588,15,573,25
"9024","E01011415",2001,686,34,652,43
"9025","E01011416",2001,603,76,527,28
"9026","E01011417",2001,719,101,618,36
"9027","E01011420",2001,640,13,627,7
"9028","E01011615",2001,620,43,577,37
"9029","E01011617",2001,675,333,342,19
"9030","E01011618",2001,683,142,541,89
"9031","E01011621",2001,533,301,232,26
"9032","E01011284",2001,742,199,543,185
"9033","E01011292",2001,729,412,317,75
"9034","E01011293",2001,705,227,478,100
"9035","E01011294",2001,443,200,243,37
"9036","E01011363",2001,683,457,226,29
"9037","E01011622",2001,612,449,163,32
"9038","E01011616",2001,682,389,293,23
"9039","E01011620",2001,497,269,228,16
"9040","E01011624",2001,615,462,153,37
"9041","E01011418",2001,621,8,613,17
"9042","E01011419",2001,499,11,488,6
"9043","E01011414",2001,622,15,607,40
"9044","E01011411",2001,660,22,638,32
"9045","E01011399",2001,611,62,549,33
"9046","E01011400",2001,600,131,469,23
"9047","E01011396",2001,715,95,620,59
"9048","E01011403",2001,601,64,537,30
"9049","E01011625",2001,692,162,530,103
"9050","E01011626",2001,702,482,220,47
"9051","E01011623",2001,628,240,388,96
"9052","E01011619",2001,799,472,327,112
"9053","E01011613",2001,591,184,407,38
"9054","E01011602",2001,687,183,504,38
"9055","E01011603",2001,624,53,571,71
"9056","E01011605",2001,631,32,599,22
"9057","E01011606",2001,650,9,641,38
"9058","E01011404",2001,535,8,527,20
"9059","E01011405",2001,637,37,600,15
"9060","E01011397",2001,601,65,536,10
"9061","E01011398",2001,510,7,503,9
"9062","E01011401",2001,613,9,604,14
"9063","E01011725",2001,690,479,211,18
"9064","E01011729",2001,704,260,444,101
"9065","E01011730",2001,630,262,368,40
"9066","E01011735",2001,739,433,306,10
"9067","E01011607",2001,656,149,507,26
"9068","E01011604",2001,541,63,478,26
"9069","E01011612",2001,640,220,420,48
"9070","E01011600",2001,629,68,561,38
"9071","E01011601",2001,596,245,351,31
"9072","E01011726",2001,619,314,305,5
"9073","E01011727",2001,659,60,599,14
"9074","E01011728",2001,619,58,561,33
"9075","E01011739",2001,734,444,290,6
"9076","E01011731",2001,600,56,544,15
"9077","E01011732",2001,605,68,537,31
"9078","E01011733",2001,679,80,599,33
"9079","E01011362",2001,797,361,436,76
"9080","E01011366",2001,738,314,424,118
"9081","E01011367",2001,866,546,320,66
"9082","E01011368",2001,723,294,429,182
"9083","E01011370",2001,645,121,524,155
"9084","E01011734",2001,616,35,581,15
"9085","E01011736",2001,611,83,528,26
"9086","E01011737",2001,726,234,492,58
"9087","E01011738",2001,619,68,551,13
"9088","E01011365",2001,1258,255,1003,746
"9089","E01011470",2001,590,149,441,44
"9090","E01011467",2001,578,259,319,43
"9091","E01011468",2001,742,508,234,16
"9092","E01011371",2001,730,488,242,53
"9093","E01011373",2001,564,318,246,67
"9094","E01011374",2001,571,50,521,97
"9095","E01011364",2001,676,444,232,28
"9096","E01011375",2001,575,150,425,172
"9097","E01011372",2001,518,170,348,133
"9098","E01011312",2001,609,197,412,147
"9099","E01011316",2001,589,114,475,198
"9100","E01011402",2001,737,101,636,26
"9101","E01011390",2001,602,193,409,15
"9102","E01011391",2001,727,186,541,17
"9103","E01011392",2001,602,155,447,18
"9104","E01011298",2001,623,222,401,46
"9105","E01011299",2001,644,81,563,74
"9106","E01011302",2001,623,8,615,15
"9107","E01011303",2001,495,106,389,5
"9108","E01011304",2001,677,228,449,36
"9109","E01011305",2001,631,31,600,19
"9110","E01011306",2001,543,14,529,14
"9111","E01011300",2001,614,228,386,7
"9112","E01011301",2001,515,10,505,8
"9113","E01011317",2001,769,474,295,39
"9114","E01011318",2001,666,436,230,26
"9115","E01011321",2001,615,351,264,27
"9116","E01011315",2001,630,91,539,37
"9117","E01011369",2001,703,179,524,75
"9118","E01011322",2001,633,136,497,10
"9119","E01011319",2001,607,49,558,60
"9120","E01011320",2001,672,21,651,46
"9121","E01011313",2001,617,42,575,83
"9122","E01011314",2001,645,32,613,63
"9123","E01011471",2001,630,344,286,18
"9124","E01011472",2001,711,441,270,24
"9125","E01011473",2001,622,444,178,24
"9126","E01011474",2001,625,453,172,11
"9127","E01011518",2001,671,131,540,37
"9128","E01011524",2001,535,31,504,39
"9129","E01011526",2001,489,6,483,14
"9130","E01011531",2001,678,32,646,18
"9131","E01011475",2001,673,398,275,28
"9132","E01011476",2001,510,248,262,12
"9133","E01011469",2001,609,63,546,23
"9134","E01011466",2001,647,277,370,9
"9135","E01011532",2001,678,277,401,25
"9136","E01011525",2001,618,38,580,42
"9137","E01011528",2001,582,33,549,8
"9138","E01011519",2001,635,199,436,25
"9139","E01011522",2001,582,13,569,18
"9140","E01011523",2001,651,148,503,37
"9141","E01011520",2001,623,16,607,30
"9142","E01011521",2001,711,76,635,51
"9143","E01011529",2001,560,149,411,16
"9144","E01011527",2001,705,13,692,39
"9145","E01011631",2001,625,248,377,11
"9146","E01011635",2001,657,73,584,86
"9147","E01011637",2001,654,97,557,35
"9148","E01011638",2001,615,73,542,20
"9149","E01011640",2001,570,28,542,13
"9150","E01011632",2001,615,314,301,19
"9151","E01011633",2001,618,91,527,32
"9152","E01011627",2001,609,198,411,18
"9153","E01011628",2001,595,10,585,10
"9154","E01011629",2001,612,183,429,21
"9155","E01011501",2001,650,306,344,33
"9156","E01011502",2001,578,240,338,9
"9157","E01011503",2001,663,55,608,15
"9158","E01011490",2001,705,109,596,42
"9159","E01011496",2001,557,13,544,23
"9160","E01011630",2001,599,13,586,20
"9161","E01011634",2001,638,168,470,29
"9162","E01011639",2001,633,207,426,22
"9163","E01011636",2001,686,69,617,48
"9164","E01011497",2001,649,437,212,17
"9165","E01011491",2001,603,385,218,14
"9166","E01011492",2001,579,401,178,11
"9167","E01011493",2001,620,364,256,20
"9168","E01011494",2001,528,227,301,29
"9169","E01011542",2001,701,159,542,31
"9170","E01011543",2001,571,24,547,24
"9171","E01011544",2001,683,242,441,77
"9172","E01011539",2001,645,41,604,87
"9173","E01011540",2001,629,283,346,15
"9174","E01011393",2001,570,97,473,31
"9175","E01011394",2001,487,56,431,19
"9176","E01011395",2001,458,79,379,12
"9177","E01011307",2001,589,164,425,18
"9178","E01011308",2001,633,122,511,16
"9179","E01011545",2001,628,80,548,77
"9180","E01011533",2001,599,119,480,72
"9181","E01011541",2001,828,297,531,123
"9182","E01011547",2001,749,275,474,57
"9183","E01011495",2001,589,137,452,12
"9184","E01011498",2001,663,100,563,39
"9185","E01011499",2001,567,152,415,58
"9186","E01011500",2001,668,100,568,23
"9187","E01011534",2001,604,39,565,66
"9188","E01011546",2001,650,88,562,97
"9189","E01011530",2001,503,18,485,24
"9190","E01011548",2001,645,67,578,29
"9191","E01011550",2001,519,10,509,27
"9192","E01011551",2001,632,91,541,37
"9193","E01011552",2001,584,263,321,13
"9194","E01011537",2001,901,124,777,96
"9195","E01011538",2001,655,228,427,39
"9196","E01011535",2001,583,18,565,38
"9197","E01011536",2001,618,69,549,15
"9198","E01011553",2001,601,42,559,33
"9199","E01011549",2001,495,4,491,8
"9200","E01011740",2001,645,415,230,14
"9201","E01011741",2001,622,116,506,8
"9202","E01011742",2001,710,378,332,14
"9203","E01011745",2001,680,451,229,24
"9204","E01011746",2001,593,395,198,17
"9205","E01011752",2001,712,57,655,83
"9206","E01011753",2001,634,34,600,68
"9207","E01011756",2001,765,417,348,30
"9208","E01011762",2001,744,17,727,100
"9209","E01011760",2001,750,37,713,114
"9210","E01011750",2001,605,405,200,13
"9211","E01011754",2001,635,265,370,7
"9212","E01011747",2001,747,466,281,22
"9213","E01011743",2001,596,7,589,10
"9214","E01011744",2001,601,11,590,16
"9215","E01011757",2001,608,204,404,13
"9216","E01011763",2001,748,312,436,40
"9217","E01011764",2001,673,288,385,46
"9218","E01011761",2001,617,93,524,36
"9219","E01011759",2001,723,441,282,21
"9220","E01011751",2001,525,7,518,34
"9221","E01011755",2001,524,9,515,25
"9222","E01011748",2001,616,79,537,27
"9223","E01011749",2001,700,60,640,104
"9224","E01011873",2001,606,8,598,39
"9225","E01011877",2001,537,11,526,20
"9226","E01011894",2001,539,11,528,15
"9227","E01011895",2001,586,127,459,19
"9228","E01011878",2001,655,21,634,33
"9229","E01011875",2001,664,250,414,55
"9230","E01011876",2001,639,216,423,54
"9231","E01011880",2001,534,11,523,18
"9232","E01011881",2001,643,93,550,53
"9233","E01011887",2001,496,5,491,20
"9234","E01011893",2001,565,4,561,37
"9235","E01011896",2001,631,158,473,27
"9236","E01011897",2001,687,330,357,23
"9237","E01011882",2001,626,104,522,9
"9238","E01011883",2001,644,218,426,30
"9239","E01011879",2001,639,18,621,46
"9240","E01011874",2001,653,48,605,25
"9241","E01011807",2001,631,205,426,79
"9242","E01011808",2001,667,139,528,38
"9243","E01011805",2001,684,349,335,26
"9244","E01011810",2001,561,147,414,18
"9245","E01011811",2001,588,402,186,19
"9246","E01011806",2001,626,164,462,22
"9247","E01011803",2001,601,330,271,14
"9248","E01011804",2001,623,195,428,48
"9249","E01011809",2001,737,389,348,13
"9250","E01011835",2001,625,16,609,33
"9251","E01011836",2001,511,65,446,34
"9252","E01011839",2001,679,152,527,22
"9253","E01011843",2001,621,151,470,17
"9254","E01011844",2001,556,15,541,17
"9255","E01011820",2001,616,81,535,27
"9256","E01011821",2001,613,193,420,11
"9257","E01011812",2001,603,35,568,8
"9258","E01011758",2001,602,203,399,42
"9259","E01011890",2001,497,90,407,14
"9260","E01011891",2001,724,297,427,16
"9261","E01011888",2001,610,10,600,19
"9262","E01011885",2001,592,43,549,28
"9263","E01011886",2001,625,51,574,13
"9264","E01011834",2001,575,181,394,18
"9265","E01011837",2001,638,212,426,64
"9266","E01011838",2001,866,455,411,79
"9267","E01011841",2001,617,134,483,28
"9268","E01011842",2001,686,474,212,11
"9269","E01011819",2001,622,63,559,61
"9270","E01011822",2001,608,81,527,16
"9271","E01011813",2001,600,350,250,13
"9272","E01011814",2001,740,408,332,27
"9273","E01011815",2001,646,235,411,37
"9274","E01011816",2001,647,386,261,9
"9275","E01011884",2001,560,7,553,67
"9276","E01011912",2001,750,226,524,194
"9277","E01011913",2001,518,118,400,80
"9278","E01011916",2001,961,624,337,147
"9279","E01011852",2001,637,342,295,25
"9280","E01011853",2001,587,273,314,5
"9281","E01011850",2001,639,363,276,8
"9282","E01011840",2001,617,300,317,26
"9283","E01011920",2001,499,65,434,104
"9284","E01011923",2001,638,11,627,91
"9285","E01011924",2001,670,58,612,59
"9286","E01011925",2001,648,405,243,16
"9287","E01011909",2001,601,116,485,26
"9288","E01011910",2001,757,553,204,11
"9289","E01011911",2001,625,417,208,9
"9290","E01011914",2001,681,385,296,27
"9291","E01011915",2001,626,259,367,76
"9292","E01011823",2001,598,98,500,47
"9293","E01011824",2001,621,321,300,24
"9294","E01011825",2001,631,77,554,61
"9295","E01011826",2001,583,57,526,22
"9296","E01011827",2001,531,44,487,11
"9297","E01011828",2001,627,27,600,96
"9298","E01011921",2001,628,139,489,30
"9299","E01011919",2001,724,282,442,44
"9300","E01011926",2001,634,311,323,38
"9301","E01011927",2001,592,283,309,24
"9302","E01011892",2001,614,265,349,19
"9303","E01011889",2001,506,20,486,19
"9304","E01011851",2001,654,194,460,44
"9305","E01011845",2001,624,4,620,6
"9306","E01011846",2001,617,88,529,23
"9307","E01011847",2001,621,18,603,10
"9308","E01011848",2001,612,47,565,12
"9309","E01011817",2001,570,274,296,15
"9310","E01011818",2001,596,106,490,20
"9311","E01011775",2001,603,135,468,27
"9312","E01011776",2001,542,204,338,23
"9313","E01011777",2001,641,97,544,33
"9314","E01011778",2001,641,90,551,25
"9315","E01011829",2001,610,56,554,24
"9316","E01011830",2001,618,191,427,36
"9317","E01011831",2001,658,221,437,30
"9318","E01011832",2001,630,199,431,32
"9319","E01011833",2001,641,95,546,34
"9320","E01011918",2001,629,342,287,24
"9321","E01011922",2001,621,432,189,15
"9322","E01011904",2001,508,370,138,15
"9323","E01011899",2001,532,398,134,7
"9324","E01011900",2001,753,423,330,13
"9325","E01011901",2001,591,496,95,8
"9326","E01011779",2001,595,215,380,0
"9327","E01011780",2001,863,616,247,22
"9328","E01011781",2001,726,304,422,39
"9329","E01011782",2001,657,140,517,28
"9330","E01011783",2001,653,60,593,133
"9331","E01011902",2001,642,101,541,58
"9332","E01011903",2001,622,162,460,11
"9333","E01011905",2001,620,8,612,8
"9334","E01011907",2001,762,221,541,79
"9335","E01011799",2001,743,392,351,20
"9336","E01011800",2001,683,56,627,59
"9337","E01011793",2001,705,127,578,30
"9338","E01011794",2001,611,217,394,25
"9339","E01011795",2001,604,255,349,21
"9340","E01011796",2001,580,72,508,25
"9341","E01011908",2001,758,64,694,93
"9342","E01011906",2001,671,512,159,25
"9343","E01011898",2001,503,116,387,59
"9344","E01011917",2001,735,316,419,115
"9345","E01011944",2001,604,73,531,77
"9346","E01011797",2001,627,8,619,4
"9347","E01011798",2001,662,57,605,97
"9348","E01011801",2001,631,146,485,40
"9349","E01011802",2001,630,102,528,36
"9350","E01011773",2001,607,11,596,17
"9351","E01011774",2001,606,140,466,24
"9352","E01011765",2001,603,148,455,23
"9353","E01011766",2001,580,126,454,37
"9354","E01011945",2001,638,82,556,21
"9355","E01011947",2001,656,7,649,17
"9356","E01011948",2001,659,6,653,10
"9357","E01011939",2001,643,5,638,12
"9358","E01011767",2001,703,72,631,29
"9359","E01011768",2001,596,32,564,32
"9360","E01011769",2001,611,54,557,77
"9361","E01011770",2001,776,243,533,28
"9362","E01011849",2001,663,31,632,49
"9363","E01011857",2001,667,35,632,16
"9364","E01011931",2001,631,111,520,14
"9365","E01011932",2001,506,3,503,21
"9366","E01011938",2001,535,13,522,33
"9367","E01011928",2001,617,223,394,19
"9368","E01011929",2001,740,6,734,33
"9369","E01011930",2001,650,11,639,43
"9370","E01011937",2001,604,5,599,39
"9371","E01011933",2001,648,60,588,40
"9372","E01011934",2001,619,12,607,30
"9373","E01011940",2001,612,329,283,9
"9374","E01011936",2001,630,351,279,9
"9375","E01011943",2001,731,403,328,9
"9376","E01011946",2001,610,13,597,26
"9377","E01011941",2001,639,176,463,12
"9378","E01011942",2001,539,48,491,29
"9379","E01011935",2001,432,23,409,25
"9380","E01011785",2001,603,121,482,95
"9381","E01011789",2001,645,220,425,101
"9382","E01011791",2001,615,232,383,25
"9383","E01011792",2001,625,450,175,24
"9384","E01011786",2001,517,101,416,47
"9385","E01011771",2001,502,299,203,11
"9386","E01011772",2001,628,63,565,68
"9387","E01011784",2001,709,195,514,42
"9388","E01011858",2001,614,147,467,17
"9389","E01011854",2001,518,47,471,106
"9390","E01011855",2001,638,116,522,56
"9391","E01011856",2001,638,28,610,101
"9392","E01011865",2001,656,371,285,25
"9393","E01011867",2001,648,307,341,32
"9394","E01011787",2001,638,47,591,43
"9395","E01011788",2001,643,56,587,39
"9396","E01011790",2001,738,242,496,88
"9397","E01011859",2001,695,316,379,46
"9398","E01011869",2001,684,116,568,197
"9399","E01011870",2001,629,92,537,15
"9400","E01011871",2001,646,119,527,57
"9401","E01011860",2001,603,91,512,21
"9402","E01011861",2001,598,108,490,29
"9403","E01011862",2001,620,216,404,105
"9404","E01011863",2001,630,365,265,47
"9405","E01011864",2001,639,384,255,15
"9406","E01011872",2001,637,227,410,48
"9407","E01011868",2001,641,283,358,27
"9408","E01011866",2001,635,209,426,18
"9409","E01013461",2001,655,7,648,13
"9410","E01013462",2001,615,58,557,13
"9411","E01013463",2001,610,5,605,18
"9412","E01013464",2001,632,39,593,29
"9413","E01013465",2001,625,14,611,20
"9414","E01013466",2001,630,6,624,9
"9415","E01013467",2001,597,8,589,10
"9416","E01013468",2001,628,11,617,12
"9417","E01013469",2001,729,65,664,69
"9418","E01013574",2001,547,8,539,15
"9419","E01013575",2001,622,5,617,45
"9420","E01013576",2001,555,7,548,24
"9421","E01013577",2001,593,4,589,19
"9422","E01013578",2001,549,6,543,17
"9423","E01013579",2001,647,11,636,45
"9424","E01013580",2001,722,3,719,65
"9425","E01013581",2001,579,250,329,8
"9426","E01013530",2001,618,110,508,105
"9427","E01013531",2001,609,168,441,18
"9428","E01013532",2001,624,194,430,17
"9429","E01013526",2001,683,62,621,51
"9430","E01013527",2001,601,10,591,36
"9431","E01013528",2001,628,130,498,81
"9432","E01013529",2001,790,150,640,154
"9433","E01013505",2001,606,24,582,19
"9434","E01013506",2001,655,103,552,23
"9435","E01013534",2001,656,94,562,16
"9436","E01013513",2001,505,168,337,12
"9437","E01013582",2001,698,128,570,37
"9438","E01013535",2001,525,356,169,21
"9439","E01013536",2001,658,363,295,31
"9440","E01013537",2001,714,98,616,46
"9441","E01013538",2001,620,88,532,72
"9442","E01013533",2001,663,409,254,21
"9443","E01013522",2001,757,272,485,130
"9444","E01013523",2001,743,314,429,162
"9445","E01013524",2001,402,215,187,67
"9446","E01013525",2001,785,127,658,86
"9447","E01013548",2001,628,160,468,15
"9448","E01013549",2001,608,189,419,10
"9449","E01013555",2001,581,156,425,12
"9450","E01013552",2001,708,295,413,19
"9451","E01013553",2001,629,195,434,12
"9452","E01013592",2001,651,17,634,62
"9453","E01013599",2001,622,7,615,24
"9454","E01013594",2001,632,28,604,8
"9455","E01013596",2001,647,41,606,20
"9456","E01013547",2001,677,84,593,204
"9457","E01013554",2001,769,306,463,171
"9458","E01013550",2001,512,244,268,16
"9459","E01013551",2001,542,81,461,160
"9460","E01013507",2001,630,38,592,18
"9461","E01013508",2001,484,208,276,11
"9462","E01013509",2001,686,57,629,35
"9463","E01013510",2001,612,213,399,8
"9464","E01013511",2001,631,3,628,18
"9465","E01013512",2001,602,204,398,19
"9466","E01013460",2001,736,107,629,307
"9467","E01013456",2001,863,397,466,162
"9468","E01013457",2001,734,89,645,155
"9469","E01013479",2001,837,444,393,234
"9470","E01013453",2001,690,177,513,190
"9471","E01013454",2001,502,144,358,70
"9472","E01013593",2001,589,4,585,15
"9473","E01013597",2001,720,275,445,19
"9474","E01013598",2001,610,162,448,23
"9475","E01013595",2001,631,77,554,34
"9476","E01013556",2001,629,6,623,30
"9477","E01013557",2001,609,6,603,12
"9478","E01013558",2001,598,0,598,13
"9479","E01013559",2001,587,10,577,27
"9480","E01013564",2001,628,6,622,10
"9481","E01013565",2001,472,31,441,73
"9482","E01013566",2001,627,125,502,120
"9483","E01013483",2001,537,41,496,96
"9484","E01013480",2001,859,332,527,270
"9485","E01013485",2001,561,111,450,92
"9486","E01013458",2001,476,66,410,32
"9487","E01013455",2001,654,159,495,37
"9488","E01013542",2001,620,119,501,45
"9489","E01013546",2001,600,5,595,35
"9490","E01013484",2001,571,193,378,91
"9491","E01013486",2001,454,81,373,79
"9492","E01013487",2001,583,144,439,134
"9493","E01013481",2001,480,107,373,100
"9494","E01013482",2001,841,490,351,127
"9495","E01013540",2001,652,42,610,20
"9496","E01013560",2001,582,3,579,18
"9497","E01013561",2001,633,6,627,30
"9498","E01013562",2001,677,165,512,40
"9499","E01013563",2001,634,3,631,29
"9500","E01013567",2001,495,80,415,77
"9501","E01013568",2001,625,108,517,92
"9502","E01013569",2001,499,27,472,74
"9503","E01013459",2001,551,17,534,51
"9504","E01013541",2001,647,143,504,34
"9505","E01013539",2001,470,0,470,5
"9506","E01013543",2001,610,5,605,20
"9507","E01013544",2001,500,0,500,11
"9508","E01013545",2001,619,147,472,40
"9509","E01013488",2001,568,3,565,23
"9510","E01013489",2001,625,7,618,16
"9511","E01013490",2001,600,109,491,10
"9512","E01013491",2001,616,35,581,22
"9513","E01013570",2001,602,162,440,84
"9514","E01013571",2001,610,155,455,73
"9515","E01013572",2001,636,142,494,24
"9516","E01013573",2001,690,399,291,34
"9517","E01013476",2001,734,60,674,48
"9518","E01013478",2001,774,72,702,195
"9519","E01013474",2001,770,265,505,45
"9520","E01013470",2001,621,120,501,24
"9521","E01013471",2001,669,93,576,83
"9522","E01013475",2001,542,293,249,32
"9523","E01013473",2001,633,202,431,73
"9524","E01013477",2001,667,88,579,77
"9525","E01013502",2001,602,191,411,14
"9526","E01013503",2001,611,27,584,37
"9527","E01013504",2001,638,223,415,57
"9528","E01013497",2001,605,218,387,31
"9529","E01013472",2001,741,427,314,45
"9530","E01013590",2001,600,365,235,39
"9531","E01013591",2001,667,219,448,116
"9532","E01013583",2001,530,258,272,39
"9533","E01013492",2001,597,21,576,25
"9534","E01013493",2001,638,132,506,33
"9535","E01013494",2001,755,273,482,33
"9536","E01013495",2001,682,94,588,21
"9537","E01013496",2001,688,359,329,25
"9538","E01013498",2001,609,95,514,10
"9539","E01013499",2001,646,229,417,15
"9540","E01013500",2001,710,110,600,17
"9541","E01013501",2001,624,58,566,22
"9542","E01013584",2001,590,400,190,24
"9543","E01013585",2001,604,262,342,32
"9544","E01013586",2001,627,334,293,26
"9545","E01013587",2001,589,45,544,33
"9546","E01013588",2001,627,228,399,36
"9547","E01013589",2001,547,37,510,23
"9548","E01013521",2001,696,303,393,27
"9549","E01013516",2001,665,17,648,26
"9550","E01013517",2001,660,137,523,19
"9551","E01013518",2001,565,38,527,22
"9552","E01013519",2001,580,132,448,16
"9553","E01013520",2001,602,3,599,18
"9554","E01013514",2001,675,48,627,18
"9555","E01013515",2001,657,249,408,23
"9556","E01013615",2001,561,17,544,32
"9557","E01013616",2001,724,188,536,66
"9558","E01013618",2001,679,165,514,59
"9559","E01013619",2001,596,362,234,27
"9560","E01013733",2001,608,11,597,49
"9561","E01013734",2001,522,46,476,48
"9562","E01013735",2001,475,14,461,34
"9563","E01013736",2001,645,24,621,56
"9564","E01013737",2001,467,8,459,51
"9565","E01013600",2001,748,426,322,24
"9566","E01013601",2001,630,282,348,19
"9567","E01013602",2001,761,328,433,111
"9568","E01013603",2001,735,458,277,27
"9569","E01013604",2001,631,328,303,30
"9570","E01013605",2001,642,105,537,76
"9571","E01013620",2001,596,427,169,26
"9572","E01013621",2001,634,489,145,36
"9573","E01013622",2001,641,360,281,49
"9574","E01013623",2001,677,73,604,44
"9575","E01013617",2001,516,179,337,49
"9576","E01013739",2001,594,153,441,50
"9577","E01013740",2001,492,22,470,33
"9578","E01013741",2001,518,9,509,62
"9579","E01013732",2001,711,21,690,87
"9580","E01013738",2001,494,6,488,27
"9581","E01013628",2001,649,321,328,63
"9582","E01013625",2001,597,169,428,103
"9583","E01013715",2001,434,47,387,56
"9584","E01013716",2001,522,85,437,90
"9585","E01013626",2001,507,156,351,73
"9586","E01013627",2001,402,17,385,25
"9587","E01013624",2001,501,235,266,41
"9588","E01013629",2001,488,76,412,68
"9589","E01013630",2001,497,81,416,86
"9590","E01013606",2001,700,25,675,34
"9591","E01013607",2001,619,52,567,57
"9592","E01013680",2001,620,10,610,47
"9593","E01013685",2001,605,7,598,25
"9594","E01013686",2001,595,9,586,21
"9595","E01013696",2001,525,98,427,33
"9596","E01013697",2001,529,29,500,33
"9597","E01013699",2001,611,83,528,53
"9598","E01013701",2001,572,12,560,23
"9599","E01013717",2001,487,88,399,62
"9600","E01013718",2001,548,141,407,83
"9601","E01013719",2001,457,70,387,89
"9602","E01013720",2001,595,436,159,39
"9603","E01013713",2001,466,87,379,79
"9604","E01013714",2001,493,33,460,65
"9605","E01013655",2001,615,161,454,83
"9606","E01013651",2001,647,273,374,73
"9607","E01013652",2001,559,315,244,38
"9608","E01013653",2001,634,366,268,36
"9609","E01013721",2001,624,159,465,18
"9610","E01013723",2001,483,271,212,20
"9611","E01013725",2001,583,359,224,21
"9612","E01013726",2001,857,678,179,19
"9613","E01013728",2001,546,299,247,14
"9614","E01013770",2001,526,96,430,24
"9615","E01013771",2001,482,10,472,26
"9616","E01013773",2001,570,228,342,14
"9617","E01013700",2001,609,138,471,20
"9618","E01013694",2001,653,322,331,42
"9619","E01013695",2001,625,306,319,11
"9620","E01013698",2001,578,189,389,14
"9621","E01013772",2001,629,259,370,20
"9622","E01013767",2001,562,92,470,12
"9623","E01013768",2001,666,294,372,19
"9624","E01013769",2001,664,377,287,24
"9625","E01013730",2001,725,419,306,45
"9626","E01013731",2001,588,240,348,25
"9627","E01013727",2001,620,266,354,33
"9628","E01013724",2001,586,303,283,23
"9629","E01013722",2001,579,304,275,16
"9630","E01013681",2001,671,116,555,156
"9631","E01013682",2001,745,122,623,126
"9632","E01013683",2001,800,110,690,206
"9633","E01013684",2001,793,208,585,231
"9634","E01013654",2001,760,391,369,127
"9635","E01013656",2001,475,73,402,102
"9636","E01013657",2001,495,185,310,88
"9637","E01013658",2001,494,66,428,116
"9638","E01013659",2001,499,104,395,113
"9639","E01013743",2001,406,66,340,67
"9640","E01013745",2001,408,45,363,68
"9641","E01013746",2001,635,496,139,47
"9642","E01013744",2001,457,45,412,79
"9643","E01013748",2001,599,421,178,52
"9644","E01013754",2001,675,535,140,48
"9645","E01013755",2001,699,560,139,46
"9646","E01013742",2001,426,114,312,75
"9647","E01013660",2001,612,134,478,89
"9648","E01013661",2001,627,351,276,33
"9649","E01013664",2001,755,434,321,56
"9650","E01013665",2001,580,99,481,83
"9651","E01013667",2001,663,334,329,21
"9652","E01013668",2001,613,109,504,162
"9653","E01013729",2001,534,100,434,20
"9654","E01013780",2001,615,25,590,52
"9655","E01013783",2001,606,19,587,48
"9656","E01013785",2001,546,12,534,19
"9657","E01013786",2001,696,93,603,60
"9658","E01013758",2001,427,15,412,83
"9659","E01013749",2001,421,44,377,34
"9660","E01013750",2001,406,24,382,56
"9661","E01013747",2001,516,51,465,90
"9662","E01013662",2001,493,23,470,81
"9663","E01013663",2001,503,50,453,37
"9664","E01013751",2001,510,53,457,111
"9665","E01013752",2001,425,43,382,55
"9666","E01013753",2001,478,136,342,119
"9667","E01013760",2001,598,154,444,240
"9668","E01013761",2001,567,247,320,129
"9669","E01013762",2001,495,87,408,118
"9670","E01013774",2001,616,39,577,259
"9671","E01013784",2001,510,29,481,134
"9672","E01013781",2001,669,98,571,265
"9673","E01013782",2001,616,89,527,97
"9674","E01013776",2001,631,44,587,323
"9675","E01013778",2001,680,378,302,148
"9676","E01013779",2001,775,60,715,352
"9677","E01013644",2001,791,360,431,227
"9678","E01013645",2001,404,159,245,177
"9679","E01013646",2001,737,170,567,313
"9680","E01013647",2001,797,546,251,162
"9681","E01013648",2001,590,126,464,269
"9682","E01013666",2001,593,9,584,17
"9683","E01013669",2001,479,11,468,10
"9684","E01013670",2001,635,94,541,24
"9685","E01013671",2001,537,74,463,17
"9686","E01013672",2001,510,29,481,11
"9687","E01013638",2001,628,491,137,17
"9688","E01013640",2001,568,455,113,17
"9689","E01013631",2001,537,261,276,20
"9690","E01013632",2001,694,539,155,10
"9691","E01013759",2001,513,10,503,29
"9692","E01013763",2001,729,203,526,301
"9693","E01013764",2001,455,19,436,39
"9694","E01013765",2001,544,74,470,188
"9695","E01013766",2001,468,34,434,45
"9696","E01013756",2001,611,62,549,132
"9697","E01013757",2001,475,9,466,33
"9698","E01013633",2001,676,390,286,22
"9699","E01013634",2001,611,366,245,16
"9700","E01013641",2001,608,71,537,160
"9701","E01013637",2001,734,431,303,20
"9702","E01013639",2001,507,215,292,27
"9703","E01013635",2001,561,44,517,58
"9704","E01013636",2001,493,9,484,28
"9705","E01013775",2001,633,70,563,224
"9706","E01013777",2001,721,34,687,190
"9707","E01013642",2001,751,36,715,278
"9708","E01013643",2001,659,18,641,189
"9709","E01013649",2001,568,56,512,180
"9710","E01013650",2001,708,17,691,243
"9711","E01013702",2001,564,19,545,60
"9712","E01013710",2001,694,52,642,180
"9713","E01013711",2001,698,93,605,188
"9714","E01013687",2001,625,64,561,197
"9715","E01013688",2001,642,158,484,133
"9716","E01013613",2001,722,57,665,144
"9717","E01013614",2001,688,48,640,84
"9718","E01013712",2001,559,22,537,64
"9719","E01013706",2001,605,19,586,39
"9720","E01013707",2001,603,17,586,32
"9721","E01013703",2001,502,15,487,42
"9722","E01013704",2001,497,0,497,66
"9723","E01013705",2001,619,157,462,35
"9724","E01013708",2001,577,7,570,31
"9725","E01013709",2001,557,5,552,34
"9726","E01013689",2001,471,65,406,148
"9727","E01013690",2001,621,191,430,58
"9728","E01013608",2001,606,15,591,41
"9729","E01013609",2001,738,82,656,51
"9730","E01013610",2001,750,252,498,42
"9731","E01013611",2001,617,181,436,30
"9732","E01013612",2001,643,43,600,68
"9733","E01013691",2001,591,410,181,15
"9734","E01013692",2001,489,358,131,16
"9735","E01013693",2001,509,400,109,10
"9736","E01013678",2001,664,198,466,29
"9737","E01013679",2001,521,322,199,35
"9738","E01013673",2001,634,289,345,18
"9739","E01013674",2001,768,441,327,14
"9740","E01013675",2001,698,290,408,17
"9741","E01013676",2001,715,360,355,36
"9742","E01013677",2001,674,353,321,19
"9743","E01013887",2001,639,30,609,16
"9744","E01013892",2001,600,13,587,19
"9745","E01013893",2001,638,381,257,36
"9746","E01013894",2001,646,33,613,15
"9747","E01013885",2001,729,281,448,96
"9748","E01013879",2001,523,295,228,26
"9749","E01013880",2001,652,321,331,28
"9750","E01013881",2001,607,339,268,12
"9751","E01013882",2001,629,178,451,64
"9752","E01013848",2001,701,273,428,15
"9753","E01013849",2001,695,360,335,22
"9754","E01013850",2001,699,341,358,15
"9755","E01013851",2001,765,475,290,24
"9756","E01013852",2001,743,315,428,20
"9757","E01013886",2001,683,219,464,46
"9758","E01013888",2001,716,141,575,75
"9759","E01013889",2001,701,104,597,45
"9760","E01013890",2001,658,43,615,81
"9761","E01013891",2001,700,255,445,50
"9762","E01013883",2001,659,294,365,18
"9763","E01013884",2001,645,316,329,24
"9764","E01013875",2001,520,24,496,12
"9765","E01013876",2001,571,274,297,68
"9766","E01013877",2001,678,423,255,30
"9767","E01013878",2001,539,300,239,11
"9768","E01013853",2001,634,194,440,13
"9769","E01013854",2001,622,275,347,23
"9770","E01013855",2001,629,380,249,33
"9771","E01013856",2001,635,250,385,34
"9772","E01013857",2001,766,443,323,38
"9773","E01013963",2001,744,288,456,34
"9774","E01013964",2001,604,129,475,46
"9775","E01013965",2001,608,187,421,39
"9776","E01013966",2001,560,184,376,46
"9777","E01013967",2001,473,52,421,69
"9778","E01013827",2001,608,264,344,43
"9779","E01013828",2001,697,91,606,105
"9780","E01013834",2001,614,326,288,25
"9781","E01013835",2001,699,275,424,47
"9782","E01013836",2001,760,244,516,118
"9783","E01013829",2001,766,207,559,85
"9784","E01013830",2001,632,107,525,40
"9785","E01013831",2001,623,61,562,17
"9786","E01013832",2001,641,208,433,81
"9787","E01013833",2001,559,250,309,40
"9788","E01013968",2001,698,174,524,65
"9789","E01013969",2001,776,63,713,201
"9790","E01013970",2001,668,55,613,142
"9791","E01013971",2001,832,117,715,296
"9792","E01013935",2001,739,43,696,84
"9793","E01013822",2001,625,368,257,36
"9794","E01013825",2001,628,249,379,33
"9795","E01013826",2001,678,418,260,46
"9796","E01013817",2001,625,401,224,39
"9797","E01013818",2001,495,332,163,25
"9798","E01013837",2001,433,23,410,24
"9799","E01013838",2001,635,24,611,49
"9800","E01013839",2001,842,334,508,181
"9801","E01013840",2001,594,22,572,89
"9802","E01013841",2001,706,217,489,197
"9803","E01013823",2001,665,284,381,36
"9804","E01013824",2001,595,302,293,20
"9805","E01013819",2001,749,404,345,28
"9806","E01013820",2001,624,345,279,27
"9807","E01013821",2001,584,298,286,20
"9808","E01013864",2001,656,401,255,21
"9809","E01013865",2001,760,308,452,22
"9810","E01013866",2001,580,222,358,7
"9811","E01013867",2001,592,306,286,20
"9812","E01013941",2001,900,62,838,406
"9813","E01013937",2001,716,92,624,140
"9814","E01013938",2001,704,60,644,197
"9815","E01013943",2001,714,151,563,329
"9816","E01013972",2001,702,123,579,214
"9817","E01013939",2001,725,68,657,97
"9818","E01013940",2001,798,460,338,82
"9819","E01013942",2001,713,390,323,77
"9820","E01013936",2001,814,142,672,108
"9821","E01013847",2001,482,59,423,157
"9822","E01013843",2001,598,49,549,277
"9823","E01013844",2001,710,167,543,285
"9824","E01013845",2001,673,128,545,229
"9825","E01013846",2001,654,258,396,161
"9826","E01013810",2001,665,222,443,165
"9827","E01013811",2001,594,225,369,236
"9828","E01013812",2001,615,225,390,212
"9829","E01013842",2001,629,130,499,207
"9830","E01013930",2001,623,127,496,68
"9831","E01013931",2001,617,55,562,21
"9832","E01013932",2001,654,58,596,76
"9833","E01013933",2001,744,350,394,56
"9834","E01013934",2001,652,185,467,42
"9835","E01013929",2001,693,126,567,47
"9836","E01013861",2001,697,434,263,14
"9837","E01013859",2001,751,320,431,38
"9838","E01013868",2001,638,367,271,24
"9839","E01013954",2001,795,474,321,63
"9840","E01013959",2001,763,461,302,59
"9841","E01013960",2001,780,544,236,29
"9842","E01013962",2001,708,316,392,63
"9843","E01013813",2001,605,422,183,121
"9844","E01013814",2001,617,205,412,271
"9845","E01013815",2001,672,179,493,366
"9846","E01013816",2001,613,244,369,232
"9847","E01013961",2001,688,324,364,234
"9848","E01013958",2001,750,524,226,65
"9849","E01013955",2001,898,707,191,67
"9850","E01013956",2001,864,531,333,115
"9851","E01013913",2001,682,103,579,35
"9852","E01013914",2001,589,16,573,36
"9853","E01013915",2001,634,80,554,33
"9854","E01013916",2001,610,306,304,32
"9855","E01013917",2001,718,222,496,86
"9856","E01013862",2001,587,339,248,17
"9857","E01013863",2001,606,137,469,18
"9858","E01013860",2001,735,293,442,18
"9859","E01013858",2001,593,204,389,10
"9860","E01013944",2001,660,73,587,147
"9861","E01013945",2001,487,182,305,193
"9862","E01013946",2001,716,345,371,189
"9863","E01013947",2001,624,266,358,202
"9864","E01013948",2001,861,756,105,46
"9865","E01013953",2001,596,46,550,310
"9866","E01013977",2001,706,97,609,40
"9867","E01013978",2001,663,115,548,59
"9868","E01013979",2001,609,25,584,44
"9869","E01013981",2001,647,23,624,33
"9870","E01013949",2001,945,300,645,250
"9871","E01013950",2001,476,39,437,346
"9872","E01013951",2001,409,27,382,241
"9873","E01013952",2001,730,31,699,276
"9874","E01013918",2001,753,108,645,254
"9875","E01013919",2001,684,126,558,208
"9876","E01013920",2001,879,528,351,115
"9877","E01013921",2001,720,276,444,152
"9878","E01013957",2001,652,268,384,77
"9879","E01013982",2001,662,37,625,25
"9880","E01013983",2001,674,292,382,33
"9881","E01013984",2001,675,12,663,24
"9882","E01013985",2001,730,42,688,25
"9883","E01013980",2001,650,14,636,32
"9884","E01013922",2001,611,126,485,303
"9885","E01013923",2001,471,37,434,227
"9886","E01013924",2001,729,428,301,218
"9887","E01013925",2001,405,22,383,185
"9888","E01013926",2001,624,192,432,254
"9889","E01013927",2001,455,47,408,270
"9890","E01013928",2001,614,81,533,355
"9891","E01013973",2001,489,215,274,155
"9892","E01013974",2001,642,111,531,47
"9893","E01013975",2001,417,56,361,49
"9894","E01013976",2001,738,337,401,116
"9895","E01013869",2001,795,428,367,122
"9896","E01013870",2001,870,451,419,142
"9897","E01013871",2001,846,501,345,54
"9898","E01013872",2001,765,311,454,116
"9899","E01013873",2001,611,145,466,200
"9900","E01013874",2001,722,94,628,226
"9901","E01013895",2001,633,11,622,21
"9902","E01013896",2001,606,316,290,36
"9903","E01013901",2001,597,25,572,41
"9904","E01013902",2001,582,38,544,33
"9905","E01013903",2001,504,80,424,26
"9906","E01013907",2001,748,337,411,22
"9907","E01013897",2001,651,222,429,24
"9908","E01013898",2001,463,161,302,34
"9909","E01013899",2001,513,158,355,16
"9910","E01013900",2001,693,270,423,25
"9911","E01013908",2001,589,230,359,22
"9912","E01013909",2001,660,368,292,27
"9913","E01013912",2001,641,85,556,34
"9914","E01013905",2001,620,232,388,21
"9915","E01013906",2001,667,212,455,13
"9916","E01013910",2001,635,186,449,25
"9917","E01013911",2001,705,241,464,20
"9918","E01013904",2001,631,190,441,16
"9919","E01013788",2001,1049,170,879,318
"9920","E01013789",2001,597,55,542,121
"9921","E01013790",2001,454,32,422,76
"9922","E01013796",2001,486,65,421,122
"9923","E01013809",2001,466,41,425,29
"9924","E01013793",2001,480,26,454,57
"9925","E01013800",2001,619,85,534,18
"9926","E01013801",2001,627,104,523,68
"9927","E01013802",2001,936,118,818,72
"9928","E01013803",2001,923,106,817,34
"9929","E01013798",2001,528,17,511,33
"9930","E01013799",2001,520,132,388,91
"9931","E01013797",2001,644,54,590,109
"9932","E01013804",2001,607,25,582,34
"9933","E01013805",2001,473,85,388,46
"9934","E01013791",2001,436,80,356,59
"9935","E01013792",2001,602,29,573,66
"9936","E01013794",2001,535,25,510,49
"9937","E01013795",2001,485,43,442,80
"9938","E01013787",2001,503,41,462,52
"9939","E01013806",2001,493,63,430,68
"9940","E01013807",2001,480,48,432,43
"9941","E01013808",2001,509,160,349,26
"9942","E01019400",2001,629,121,508,60
"9943","E01019401",2001,739,246,493,57
"9944","E01019402",2001,611,130,481,19
"9945","E01019404",2001,763,116,647,87
"9946","E01019406",2001,480,56,424,31
"9947","E01019423",2001,521,16,505,47
"9948","E01019424",2001,489,119,370,32
"9949","E01019477",2001,948,100,848,51
"9950","E01019468",2001,612,126,486,37
"9951","E01019469",2001,609,280,329,37
"9952","E01019471",2001,611,179,432,71
"9953","E01019444",2001,584,342,242,40
"9954","E01019403",2001,657,274,383,34
"9955","E01019443",2001,631,72,559,29
"9956","E01019470",2001,616,24,592,41
"9957","E01019473",2001,504,6,498,4
"9958","E01019474",2001,522,7,515,11
"9959","E01019475",2001,528,69,459,45
"9960","E01019476",2001,621,13,608,21
"9961","E01019442",2001,562,68,494,51
"9962","E01019445",2001,610,41,569,91
"9963","E01019455",2001,614,10,604,67
"9964","E01019456",2001,613,58,555,42
"9965","E01019457",2001,539,19,520,26
"9966","E01019420",2001,600,72,528,69
"9967","E01019460",2001,579,45,534,33
"9968","E01019461",2001,645,81,564,34
"9969","E01019462",2001,527,3,524,12
"9970","E01019429",2001,670,10,660,41
"9971","E01019454",2001,628,93,535,7
"9972","E01019430",2001,722,26,696,39
"9973","E01019428",2001,599,111,488,28
"9974","E01019414",2001,706,21,685,37
"9975","E01019405",2001,552,6,546,74
"9976","E01019421",2001,806,118,688,23
"9977","E01019422",2001,632,20,612,28
"9978","E01019432",2001,842,135,707,28
"9979","E01019463",2001,636,323,313,24
"9980","E01019458",2001,567,38,529,84
"9981","E01019459",2001,618,209,409,29
"9982","E01019416",2001,626,23,603,36
"9983","E01019412",2001,567,5,562,17
"9984","E01019413",2001,547,8,539,23
"9985","E01019408",2001,629,53,576,47
"9986","E01019409",2001,728,50,678,12
"9987","E01019407",2001,860,68,792,183
"9988","E01019415",2001,752,71,681,64
"9989","E01019417",2001,723,185,538,39
"9990","E01019419",2001,774,26,748,79
"9991","E01019447",2001,656,42,614,42
"9992","E01019449",2001,662,9,653,38
"9993","E01019418",2001,616,60,556,42
"9994","E01019410",2001,633,6,627,43
"9995","E01019411",2001,638,93,545,26
"9996","E01019464",2001,614,25,589,11
"9997","E01019431",2001,592,83,509,40
"9998","E01019433",2001,736,15,721,65
"9999","E01019438",2001,628,49,579,58
"10000","E01019451",2001,635,61,574,53
"10001","E01019439",2001,497,11,486,21
"10002","E01019440",2001,533,77,456,48
"10003","E01019434",2001,531,46,485,18
"10004","E01019435",2001,543,59,484,38
"10005","E01019436",2001,500,27,473,32
"10006","E01019437",2001,606,222,384,16
"10007","E01019441",2001,640,182,458,71
"10008","E01019452",2001,727,337,390,12
"10009","E01019453",2001,733,118,615,120
"10010","E01019466",2001,487,100,387,21
"10011","E01019467",2001,626,28,598,25
"10012","E01019465",2001,517,122,395,20
"10013","E01019450",2001,625,185,440,25
"10014","E01019448",2001,601,71,530,33
"10015","E01019446",2001,508,34,474,11
"10016","E01019425",2001,610,29,581,18
"10017","E01019426",2001,636,72,564,57
"10018","E01019427",2001,623,25,598,51
"10019","E01019472",2001,1040,58,982,167
"10020","E01019478",2001,631,30,601,33
"10021","E01019479",2001,627,121,506,32
"10022","E01019493",2001,652,34,618,18
"10023","E01019494",2001,878,163,715,52
"10024","E01019491",2001,880,67,813,108
"10025","E01019492",2001,737,220,517,33
"10026","E01019524",2001,573,66,507,40
"10027","E01019525",2001,624,151,473,17
"10028","E01019495",2001,651,204,447,25
"10029","E01019496",2001,429,112,317,50
"10030","E01019497",2001,597,131,466,64
"10031","E01019498",2001,584,132,452,155
"10032","E01019523",2001,511,205,306,35
"10033","E01019488",2001,610,168,442,82
"10034","E01019483",2001,753,169,584,99
"10035","E01019484",2001,805,112,693,80
"10036","E01019485",2001,566,130,436,52
"10037","E01019486",2001,432,15,417,8
"10038","E01019487",2001,694,309,385,10
"10039","E01019489",2001,489,50,439,12
"10040","E01019490",2001,472,83,389,10
"10041","E01019502",2001,671,149,522,13
"10042","E01019504",2001,563,70,493,54
"10043","E01019508",2001,840,288,552,32
"10044","E01019509",2001,469,288,181,11
"10045","E01019510",2001,509,206,303,10
"10046","E01019512",2001,904,174,730,48
"10047","E01019511",2001,778,103,675,132
"10048","E01019505",2001,548,93,455,108
"10049","E01019506",2001,541,151,390,65
"10050","E01019507",2001,778,274,504,102
"10051","E01019503",2001,932,133,799,111
"10052","E01019520",2001,610,181,429,47
"10053","E01019521",2001,655,96,559,25
"10054","E01019522",2001,556,150,406,50
"10055","E01019482",2001,662,99,563,31
"10056","E01019480",2001,647,68,579,34
"10057","E01019481",2001,474,205,269,19
"10058","E01019514",2001,600,76,524,55
"10059","E01019515",2001,624,263,361,28
"10060","E01019516",2001,614,71,543,71
"10061","E01019519",2001,616,111,505,45
"10062","E01019517",2001,618,21,597,28
"10063","E01019518",2001,596,3,593,28
"10064","E01019513",2001,525,6,519,35
"10065","E01019499",2001,500,66,434,54
"10066","E01019500",2001,585,211,374,29
"10067","E01019501",2001,611,58,553,31
"10068","E01019526",2001,607,96,511,70
"10069","E01019528",2001,663,106,557,29
"10070","E01019572",2001,642,367,275,17
"10071","E01019573",2001,618,108,510,69
"10072","E01019574",2001,623,152,471,27
"10073","E01019563",2001,550,323,227,13
"10074","E01019564",2001,613,41,572,47
"10075","E01019565",2001,640,322,318,22
"10076","E01019566",2001,707,464,243,26
"10077","E01019568",2001,524,398,126,7
"10078","E01019553",2001,606,45,561,61
"10079","E01019529",2001,626,72,554,71
"10080","E01019530",2001,631,143,488,58
"10081","E01019531",2001,607,91,516,100
"10082","E01019527",2001,664,362,302,39
"10083","E01019541",2001,651,258,393,5
"10084","E01019542",2001,742,360,382,59
"10085","E01019543",2001,773,451,322,12
"10086","E01019544",2001,732,254,478,20
"10087","E01019571",2001,619,302,317,43
"10088","E01019532",2001,539,97,442,20
"10089","E01019533",2001,635,19,616,21
"10090","E01019534",2001,595,83,512,13
"10091","E01019535",2001,618,54,564,20
"10092","E01019536",2001,729,338,391,18
"10093","E01019549",2001,502,246,256,18
"10094","E01019550",2001,648,228,420,14
"10095","E01019551",2001,663,49,614,8
"10096","E01019552",2001,517,122,395,29
"10097","E01019567",2001,610,239,371,29
"10098","E01019569",2001,762,127,635,121
"10099","E01019570",2001,617,133,484,10
"10100","E01019580",2001,652,285,367,18
"10101","E01019581",2001,638,281,357,80
"10102","E01019537",2001,614,69,545,10
"10103","E01019557",2001,546,159,387,8
"10104","E01019558",2001,578,5,573,9
"10105","E01019559",2001,465,7,458,8
"10106","E01019560",2001,615,228,387,11
"10107","E01019561",2001,734,520,214,11
"10108","E01019562",2001,633,284,349,11
"10109","E01019555",2001,747,301,446,42
"10110","E01019539",2001,732,44,688,48
"10111","E01019540",2001,626,10,616,37
"10112","E01019590",2001,845,32,813,41
"10113","E01019591",2001,628,43,585,48
"10114","E01019579",2001,631,123,508,167
"10115","E01019584",2001,748,181,567,122
"10116","E01019556",2001,585,252,333,64
"10117","E01019554",2001,670,50,620,154
"10118","E01019538",2001,639,25,614,168
"10119","E01019592",2001,602,10,592,15
"10120","E01019593",2001,491,3,488,9
"10121","E01019586",2001,618,21,597,19
"10122","E01019587",2001,635,6,629,30
"10123","E01019588",2001,626,4,622,6
"10124","E01019589",2001,606,15,591,13
"10125","E01019582",2001,637,83,554,36
"10126","E01019583",2001,594,4,590,46
"10127","E01019585",2001,638,15,623,71
"10128","E01019545",2001,609,49,560,42
"10129","E01019546",2001,622,69,553,41
"10130","E01019547",2001,643,244,399,56
"10131","E01019548",2001,660,32,628,59
"10132","E01019575",2001,640,382,258,28
"10133","E01019576",2001,728,348,380,14
"10134","E01019577",2001,739,228,511,40
"10135","E01019578",2001,756,606,150,16
"10136","E01019602",2001,817,92,725,101
"10137","E01019614",2001,689,24,665,57
"10138","E01019615",2001,914,190,724,67
"10139","E01019631",2001,793,110,683,62
"10140","E01019618",2001,694,31,663,80
"10141","E01019604",2001,815,92,723,48
"10142","E01019606",2001,772,46,726,122
"10143","E01019600",2001,738,51,687,113
"10144","E01019601",2001,739,230,509,28
"10145","E01019599",2001,617,30,587,40
"10146","E01019613",2001,644,42,602,67
"10147","E01019617",2001,696,96,600,97
"10148","E01019630",2001,778,74,704,104
"10149","E01019610",2001,652,4,648,41
"10150","E01019608",2001,760,248,512,22
"10151","E01019609",2001,791,32,759,97
"10152","E01019627",2001,481,42,439,37
"10153","E01019628",2001,501,73,428,33
"10154","E01019621",2001,487,17,470,34
"10155","E01019622",2001,647,19,628,47
"10156","E01019624",2001,497,11,486,25
"10157","E01019625",2001,677,425,252,8
"10158","E01019626",2001,613,50,563,41
"10159","E01019623",2001,641,145,496,101
"10160","E01019619",2001,676,106,570,37
"10161","E01019620",2001,673,40,633,81
"10162","E01019632",2001,748,78,670,47
"10163","E01019633",2001,605,195,410,13
"10164","E01019634",2001,625,90,535,37
"10165","E01019635",2001,549,7,542,31
"10166","E01019636",2001,626,70,556,78
"10167","E01019616",2001,712,21,691,45
"10168","E01019611",2001,690,86,604,115
"10169","E01019605",2001,733,48,685,85
"10170","E01019595",2001,834,56,778,126
"10171","E01019596",2001,521,144,377,17
"10172","E01019597",2001,506,9,497,8
"10173","E01019598",2001,599,158,441,59
"10174","E01019594",2001,726,287,439,21
"10175","E01019603",2001,634,29,605,79
"10176","E01019607",2001,725,23,702,131
"10177","E01019612",2001,795,50,745,123
"10178","E01019629",2001,636,31,605,63
"10179","E01019644",2001,676,184,492,55
"10180","E01019646",2001,603,168,435,47
"10181","E01019663",2001,645,504,141,15
"10182","E01019664",2001,481,203,278,20
"10183","E01019665",2001,591,39,552,53
"10184","E01019645",2001,652,33,619,62
"10185","E01019637",2001,486,10,476,12
"10186","E01019638",2001,515,17,498,15
"10187","E01019639",2001,411,104,307,10
"10188","E01019640",2001,588,5,583,11
"10189","E01019657",2001,767,168,599,87
"10190","E01019660",2001,629,21,608,49
"10191","E01019661",2001,616,13,603,146
"10192","E01019662",2001,764,208,556,90
"10193","E01019672",2001,647,35,612,103
"10194","E01019690",2001,479,18,461,65
"10195","E01019670",2001,758,54,704,34
"10196","E01019671",2001,755,58,697,53
"10197","E01019701",2001,912,176,736,23
"10198","E01019702",2001,738,3,735,9
"10199","E01019703",2001,610,18,592,21
"10200","E01019704",2001,614,17,597,29
"10201","E01019673",2001,505,19,486,9
"10202","E01019674",2001,514,4,510,41
"10203","E01019658",2001,639,36,603,61
"10204","E01019659",2001,654,9,645,19
"10205","E01019688",2001,624,145,479,65
"10206","E01019689",2001,647,94,553,32
"10207","E01019666",2001,630,204,426,14
"10208","E01019667",2001,699,175,524,42
"10209","E01019668",2001,646,353,293,9
"10210","E01019669",2001,671,76,595,34
"10211","E01019656",2001,474,28,446,28
"10212","E01019691",2001,614,64,550,12
"10213","E01019692",2001,653,250,403,31
"10214","E01019693",2001,659,179,480,59
"10215","E01019694",2001,499,15,484,5
"10216","E01019696",2001,600,11,589,24
"10217","E01019683",2001,515,36,479,40
"10218","E01019684",2001,593,25,568,24
"10219","E01019685",2001,656,13,643,33
"10220","E01019686",2001,612,38,574,47
"10221","E01019687",2001,630,259,371,8
"10222","E01019695",2001,623,11,612,83
"10223","E01019648",2001,636,70,566,41
"10224","E01019649",2001,738,32,706,109
"10225","E01019650",2001,746,380,366,16
"10226","E01019651",2001,627,65,562,24
"10227","E01019652",2001,636,12,624,48
"10228","E01019653",2001,589,4,585,12
"10229","E01019641",2001,610,6,604,18
"10230","E01019707",2001,616,10,606,32
"10231","E01019708",2001,523,6,517,13
"10232","E01019682",2001,781,235,546,112
"10233","E01019679",2001,729,30,699,129
"10234","E01019675",2001,731,172,559,95
"10235","E01019647",2001,817,127,690,155
"10236","E01019642",2001,636,108,528,21
"10237","E01019643",2001,701,44,657,25
"10238","E01019654",2001,642,121,521,31
"10239","E01019655",2001,523,54,469,56
"10240","E01019676",2001,649,66,583,53
"10241","E01019677",2001,607,23,584,15
"10242","E01019678",2001,604,7,597,13
"10243","E01019680",2001,626,19,607,66
"10244","E01019681",2001,666,17,649,30
"10245","E01019698",2001,623,13,610,44
"10246","E01019699",2001,692,369,323,23
"10247","E01019700",2001,966,135,831,48
"10248","E01019697",2001,603,65,538,27
"10249","E01019705",2001,612,29,583,36
"10250","E01019706",2001,516,6,510,9
"10251","E01019709",2001,490,128,362,28
"10252","E01019733",2001,632,95,537,41
"10253","E01019752",2001,505,101,404,39
"10254","E01019753",2001,596,12,584,57
"10255","E01019763",2001,925,133,792,61
"10256","E01019728",2001,513,377,136,6
"10257","E01019729",2001,513,330,183,7
"10258","E01019730",2001,816,239,577,47
"10259","E01019731",2001,502,9,493,18
"10260","E01019732",2001,603,74,529,27
"10261","E01019738",2001,615,6,609,63
"10262","E01019739",2001,717,86,631,158
"10263","E01019740",2001,531,5,526,58
"10264","E01019750",2001,551,176,375,31
"10265","E01019751",2001,597,12,585,52
"10266","E01019768",2001,985,352,633,48
"10267","E01019749",2001,498,3,495,4
"10268","E01019754",2001,784,34,750,41
"10269","E01019756",2001,452,3,449,9
"10270","E01019757",2001,570,28,542,25
"10271","E01019758",2001,531,0,531,18
"10272","E01019727",2001,730,21,709,19
"10273","E01019755",2001,865,12,853,71
"10274","E01019766",2001,611,59,552,27
"10275","E01019746",2001,607,21,586,76
"10276","E01019747",2001,524,3,521,20
"10277","E01019748",2001,640,9,631,81
"10278","E01019743",2001,603,256,347,26
"10279","E01019744",2001,641,84,557,40
"10280","E01019745",2001,464,142,322,20
"10281","E01019734",2001,910,117,793,63
"10282","E01019711",2001,593,69,524,39
"10283","E01019735",2001,640,83,557,53
"10284","E01019736",2001,472,22,450,48
"10285","E01019737",2001,547,103,444,36
"10286","E01019742",2001,462,49,413,53
"10287","E01019767",2001,615,48,567,27
"10288","E01019764",2001,612,131,481,15
"10289","E01019765",2001,795,3,792,118
"10290","E01019712",2001,605,7,598,32
"10291","E01019713",2001,418,6,412,18
"10292","E01019718",2001,846,110,736,44
"10293","E01019719",2001,646,92,554,52
"10294","E01019720",2001,651,48,603,30
"10295","E01019721",2001,478,8,470,9
"10296","E01019741",2001,441,44,397,18
"10297","E01019722",2001,660,3,657,73
"10298","E01019723",2001,898,187,711,110
"10299","E01019717",2001,630,135,495,216
"10300","E01019715",2001,652,43,609,130
"10301","E01019710",2001,876,102,774,127
"10302","E01019716",2001,525,16,509,41
"10303","E01019724",2001,507,162,345,40
"10304","E01019759",2001,634,203,431,17
"10305","E01019760",2001,629,84,545,24
"10306","E01019761",2001,498,278,220,16
"10307","E01019762",2001,804,18,786,46
"10308","E01019725",2001,593,39,554,28
"10309","E01019726",2001,500,51,449,25
"10310","E01019714",2001,791,4,787,70
"10311","E01019801",2001,447,49,398,29
"10312","E01019802",2001,522,50,472,34
"10313","E01019803",2001,521,216,305,13
"10314","E01019804",2001,528,6,522,17
"10315","E01019805",2001,503,34,469,12
"10316","E01019806",2001,597,134,463,15
"10317","E01019807",2001,602,378,224,13
"10318","E01019790",2001,858,21,837,40
"10319","E01019778",2001,752,59,693,15
"10320","E01019779",2001,758,4,754,26
"10321","E01019816",2001,712,183,529,40
"10322","E01019789",2001,709,280,429,30
"10323","E01019815",2001,794,328,466,35
"10324","E01019791",2001,710,233,477,59
"10325","E01019792",2001,872,482,390,11
"10326","E01019780",2001,610,253,357,13
"10327","E01019781",2001,620,58,562,27
"10328","E01019782",2001,501,245,256,28
"10329","E01019786",2001,712,172,540,44
"10330","E01019827",2001,779,251,528,29
"10331","E01019787",2001,765,62,703,16
"10332","E01019788",2001,687,8,679,8
"10333","E01019794",2001,601,0,601,7
"10334","E01019770",2001,821,171,650,46
"10335","E01019795",2001,848,98,750,19
"10336","E01019793",2001,642,23,619,10
"10337","E01019783",2001,507,3,504,9
"10338","E01019784",2001,502,12,490,15
"10339","E01019785",2001,505,8,497,9
"10340","E01019798",2001,541,31,510,13
"10341","E01019821",2001,596,31,565,23
"10342","E01019822",2001,641,138,503,23
"10343","E01019823",2001,519,222,297,11
"10344","E01019828",2001,689,4,685,17
"10345","E01019829",2001,584,41,543,14
"10346","E01019771",2001,864,127,737,54
"10347","E01019772",2001,619,28,591,19
"10348","E01019799",2001,840,484,356,48
"10349","E01019800",2001,689,158,531,24
"10350","E01019796",2001,471,339,132,10
"10351","E01019797",2001,605,178,427,47
"10352","E01019808",2001,612,398,214,24
"10353","E01019826",2001,609,297,312,17
"10354","E01019769",2001,737,83,654,55
"10355","E01019774",2001,722,44,678,28
"10356","E01019830",2001,522,0,522,10
"10357","E01019831",2001,586,11,575,8
"10358","E01019824",2001,473,129,344,21
"10359","E01019825",2001,478,43,435,6
"10360","E01019809",2001,520,123,397,21
"10361","E01019810",2001,638,207,431,42
"10362","E01019811",2001,600,7,593,17
"10363","E01019812",2001,696,19,677,49
"10364","E01019813",2001,624,247,377,35
"10365","E01019775",2001,741,376,365,26
"10366","E01019776",2001,610,122,488,41
"10367","E01019777",2001,973,527,446,28
"10368","E01019773",2001,841,292,549,74
"10369","E01019814",2001,727,85,642,31
"10370","E01019817",2001,530,338,192,8
"10371","E01019818",2001,632,311,321,16
"10372","E01019819",2001,561,95,466,57
"10373","E01019820",2001,629,63,566,22
"10374","E01019839",2001,531,0,531,61
"10375","E01019845",2001,500,5,495,34
"10376","E01019846",2001,545,114,431,25
"10377","E01019866",2001,804,18,786,87
"10378","E01019847",2001,572,75,497,15
"10379","E01019848",2001,481,0,481,4
"10380","E01019849",2001,410,4,406,21
"10381","E01019840",2001,584,138,446,24
"10382","E01019841",2001,624,13,611,27
"10383","E01019873",2001,552,7,545,43
"10384","E01019874",2001,580,0,580,25
"10385","E01019875",2001,486,11,475,22
"10386","E01019881",2001,548,10,538,13
"10387","E01019882",2001,613,98,515,24
"10388","E01019832",2001,683,65,618,31
"10389","E01019833",2001,642,14,628,28
"10390","E01019834",2001,596,29,567,36
"10391","E01019835",2001,570,16,554,5
"10392","E01019880",2001,597,3,594,10
"10393","E01019867",2001,548,12,536,24
"10394","E01019868",2001,615,85,530,55
"10395","E01019869",2001,496,3,493,83
"10396","E01019853",2001,611,67,544,37
"10397","E01019854",2001,795,134,661,135
"10398","E01019855",2001,613,28,585,56
"10399","E01019843",2001,661,70,591,108
"10400","E01019844",2001,641,147,494,9
"10401","E01019856",2001,618,217,401,17
"10402","E01019857",2001,473,5,468,7
"10403","E01019858",2001,606,226,380,58
"10404","E01019859",2001,658,34,624,28
"10405","E01019860",2001,505,6,499,6
"10406","E01019861",2001,604,75,529,34
"10407","E01019862",2001,611,32,579,95
"10408","E01019863",2001,676,282,394,29
"10409","E01019864",2001,487,98,389,35
"10410","E01019865",2001,500,45,455,18
"10411","E01019876",2001,669,120,549,24
"10412","E01019877",2001,738,188,550,91
"10413","E01019878",2001,635,79,556,27
"10414","E01019879",2001,729,39,690,27
"10415","E01019883",2001,727,151,576,77
"10416","E01019884",2001,713,40,673,56
"10417","E01019885",2001,623,45,578,24
"10418","E01019836",2001,638,53,585,77
"10419","E01019837",2001,712,38,674,73
"10420","E01019838",2001,676,172,504,55
"10421","E01019842",2001,618,282,336,29
"10422","E01019850",2001,620,26,594,19
"10423","E01019851",2001,620,156,464,20
"10424","E01019852",2001,633,58,575,27
"10425","E01019870",2001,621,126,495,64
"10426","E01019871",2001,695,110,585,45
"10427","E01019872",2001,680,28,652,31
"10428","E01025622",2001,728,77,651,49
"10429","E01025623",2001,686,71,615,13
"10430","E01025624",2001,665,4,661,9
"10431","E01025628",2001,636,4,632,15
"10432","E01025629",2001,647,97,550,16
"10433","E01025630",2001,643,4,639,13
"10434","E01025631",2001,496,3,493,17
"10435","E01025632",2001,468,3,465,12
"10436","E01025633",2001,604,0,604,17
"10437","E01025635",2001,492,14,478,18
"10438","E01025645",2001,436,44,392,32
"10439","E01025634",2001,513,3,510,18
"10440","E01025638",2001,641,17,624,24
"10441","E01025639",2001,511,32,479,26
"10442","E01025640",2001,599,70,529,54
"10443","E01025666",2001,613,150,463,18
"10444","E01025667",2001,490,56,434,34
"10445","E01025668",2001,645,11,634,31
"10446","E01025669",2001,602,5,597,29
"10447","E01025636",2001,553,43,510,25
"10448","E01025637",2001,407,0,407,18
"10449","E01025652",2001,492,0,492,25
"10450","E01025653",2001,652,108,544,45
"10451","E01025654",2001,520,7,513,20
"10452","E01025655",2001,615,10,605,46
"10453","E01025656",2001,487,3,484,20
"10454","E01025657",2001,613,98,515,23
"10455","E01025625",2001,524,195,329,26
"10456","E01025626",2001,528,20,508,75
"10457","E01025627",2001,689,84,605,17
"10458","E01025660",2001,655,6,649,8
"10459","E01025651",2001,618,15,603,12
"10460","E01025641",2001,725,58,667,31
"10461","E01025642",2001,782,74,708,53
"10462","E01025643",2001,617,52,565,18
"10463","E01025649",2001,661,6,655,10
"10464","E01025650",2001,565,16,549,12
"10465","E01025658",2001,681,7,674,39
"10466","E01025659",2001,749,73,676,47
"10467","E01025610",2001,637,141,496,33
"10468","E01025611",2001,592,36,556,11
"10469","E01025612",2001,676,125,551,7
"10470","E01025615",2001,544,3,541,19
"10471","E01025646",2001,611,172,439,22
"10472","E01025647",2001,639,86,553,37
"10473","E01025648",2001,703,3,700,15
"10474","E01025644",2001,552,69,483,11
"10475","E01025620",2001,467,81,386,17
"10476","E01025621",2001,431,16,415,25
"10477","E01025613",2001,624,103,521,39
"10478","E01025614",2001,676,47,629,16
"10479","E01025616",2001,618,10,608,10
"10480","E01025617",2001,682,30,652,31
"10481","E01025618",2001,688,130,558,35
"10482","E01025619",2001,662,19,643,10
"10483","E01025661",2001,566,16,550,22
"10484","E01025662",2001,614,162,452,32
"10485","E01025663",2001,566,64,502,11
"10486","E01025664",2001,518,69,449,8
"10487","E01025665",2001,603,25,578,24
"10488","E01025691",2001,436,125,311,40
"10489","E01025692",2001,538,47,491,24
"10490","E01025693",2001,829,34,795,85
"10491","E01025694",2001,513,39,474,32
"10492","E01025699",2001,826,462,364,112
"10493","E01025700",2001,535,160,375,83
"10494","E01025701",2001,625,209,416,79
"10495","E01025703",2001,659,46,613,164
"10496","E01025704",2001,452,22,430,67
"10497","E01025705",2001,508,54,454,149
"10498","E01025706",2001,675,262,413,66
"10499","E01025720",2001,512,82,430,217
"10500","E01025721",2001,497,95,402,123
"10501","E01025722",2001,414,31,383,30
"10502","E01025723",2001,488,74,414,176
"10503","E01025724",2001,577,33,544,321
"10504","E01025725",2001,588,295,293,52
"10505","E01025695",2001,642,16,626,55
"10506","E01025696",2001,544,6,538,27
"10507","E01025697",2001,684,265,419,74
"10508","E01025698",2001,660,25,635,64
"10509","E01025744",2001,657,4,653,14
"10510","E01025745",2001,622,37,585,18
"10511","E01025746",2001,631,112,519,63
"10512","E01025747",2001,713,118,595,37
"10513","E01025740",2001,661,46,615,70
"10514","E01025741",2001,649,3,646,29
"10515","E01025742",2001,644,194,450,28
"10516","E01025743",2001,724,55,669,51
"10517","E01025707",2001,568,39,529,40
"10518","E01025709",2001,472,0,472,42
"10519","E01025689",2001,728,223,505,100
"10520","E01025690",2001,555,252,303,70
"10521","E01025760",2001,522,19,503,36
"10522","E01025761",2001,579,24,555,30
"10523","E01025768",2001,541,30,511,30
"10524","E01025769",2001,537,30,507,48
"10525","E01025702",2001,532,32,500,39
"10526","E01025715",2001,619,218,401,50
"10527","E01025716",2001,620,144,476,44
"10528","E01025717",2001,580,268,312,34
"10529","E01025718",2001,492,201,291,75
"10530","E01025719",2001,639,36,603,84
"10531","E01025710",2001,529,7,522,57
"10532","E01025711",2001,615,0,615,6
"10533","E01025712",2001,613,3,610,16
"10534","E01025713",2001,468,8,460,37
"10535","E01025714",2001,572,24,548,22
"10536","E01025708",2001,528,6,522,22
"10537","E01025674",2001,614,46,568,43
"10538","E01025675",2001,611,27,584,46
"10539","E01025676",2001,497,3,494,15
"10540","E01025677",2001,608,143,465,45
"10541","E01025732",2001,606,18,588,48
"10542","E01025733",2001,624,77,547,40
"10543","E01025734",2001,626,5,621,21
"10544","E01025735",2001,734,86,648,99
"10545","E01025748",2001,652,39,613,50
"10546","E01025749",2001,608,155,453,24
"10547","E01025750",2001,587,8,579,21
"10548","E01025751",2001,719,82,637,55
"10549","E01025737",2001,604,45,559,24
"10550","E01025739",2001,650,95,555,32
"10551","E01025726",2001,731,27,704,52
"10552","E01025727",2001,702,291,411,34
"10553","E01025728",2001,703,69,634,23
"10554","E01025729",2001,651,14,637,19
"10555","E01025730",2001,621,22,599,99
"10556","E01025731",2001,604,25,579,12
"10557","E01025685",2001,550,22,528,24
"10558","E01025686",2001,473,3,470,6
"10559","E01025687",2001,670,10,660,55
"10560","E01025688",2001,607,97,510,70
"10561","E01025736",2001,621,20,601,13
"10562","E01025738",2001,575,12,563,33
"10563","E01025756",2001,755,39,716,75
"10564","E01025757",2001,546,18,528,33
"10565","E01025758",2001,516,16,500,29
"10566","E01025759",2001,595,145,450,59
"10567","E01025752",2001,606,40,566,16
"10568","E01025753",2001,653,183,470,35
"10569","E01025754",2001,519,17,502,6
"10570","E01025755",2001,600,21,579,17
"10571","E01025679",2001,691,13,678,18
"10572","E01025680",2001,645,5,640,11
"10573","E01025681",2001,614,30,584,28
"10574","E01025682",2001,629,35,594,8
"10575","E01025683",2001,643,103,540,30
"10576","E01025684",2001,743,13,730,48
"10577","E01025678",2001,631,32,599,19
"10578","E01025762",2001,606,58,548,30
"10579","E01025763",2001,634,19,615,73
"10580","E01025764",2001,507,12,495,17
"10581","E01025765",2001,577,6,571,29
"10582","E01025766",2001,649,161,488,34
"10583","E01025767",2001,628,51,577,40
"10584","E01025670",2001,519,117,402,11
"10585","E01025671",2001,635,18,617,50
"10586","E01025672",2001,593,55,538,17
"10587","E01025673",2001,673,129,544,52
"10588","E01025811",2001,664,25,639,18
"10589","E01025812",2001,704,39,665,41
"10590","E01025813",2001,556,0,556,8
"10591","E01025814",2001,601,14,587,16
"10592","E01025815",2001,746,49,697,81
"10593","E01025770",2001,690,65,625,92
"10594","E01025809",2001,786,53,733,82
"10595","E01025781",2001,449,16,433,65
"10596","E01025782",2001,616,79,537,21
"10597","E01025783",2001,578,7,571,38
"10598","E01025785",2001,680,19,661,39
"10599","E01025786",2001,631,172,459,22
"10600","E01025787",2001,647,16,631,42
"10601","E01025772",2001,874,23,851,47
"10602","E01025773",2001,399,3,396,11
"10603","E01025774",2001,405,3,402,10
"10604","E01025775",2001,754,96,658,24
"10605","E01025776",2001,718,21,697,33
"10606","E01025771",2001,852,84,768,69
"10607","E01025788",2001,441,40,401,32
"10608","E01025784",2001,491,30,461,38
"10609","E01025778",2001,662,77,585,48
"10610","E01025779",2001,600,16,584,12
"10611","E01025780",2001,526,11,515,18
"10612","E01025816",2001,786,68,718,44
"10613","E01025777",2001,875,71,804,60
"10614","E01025810",2001,851,42,809,56
"10615","E01025808",2001,929,73,856,62
"10616","E01025802",2001,584,12,572,28
"10617","E01025803",2001,553,3,550,10
"10618","E01025805",2001,612,19,593,24
"10619","E01025794",2001,611,11,600,23
"10620","E01025797",2001,690,39,651,39
"10621","E01025789",2001,411,49,362,35
"10622","E01025795",2001,762,49,713,67
"10623","E01025796",2001,736,241,495,32
"10624","E01025801",2001,560,129,431,57
"10625","E01025806",2001,637,277,360,23
"10626","E01025807",2001,505,9,496,53
"10627","E01025804",2001,635,59,576,19
"10628","E01025798",2001,632,25,607,67
"10629","E01025799",2001,499,0,499,17
"10630","E01025800",2001,451,3,448,32
"10631","E01025790",2001,856,3,853,16
"10632","E01025791",2001,909,102,807,41
"10633","E01025792",2001,967,178,789,79
"10634","E01025793",2001,730,168,562,20
"10635","E01025868",2001,629,66,563,48
"10636","E01025869",2001,722,40,682,18
"10637","E01025870",2001,595,16,579,19
"10638","E01025871",2001,500,66,434,20
"10639","E01025878",2001,724,143,581,29
"10640","E01025846",2001,688,3,685,13
"10641","E01025847",2001,648,0,648,22
"10642","E01025848",2001,692,100,592,46
"10643","E01025879",2001,474,132,342,26
"10644","E01025880",2001,501,7,494,11
"10645","E01025877",2001,611,38,573,55
"10646","E01025845",2001,641,15,626,10
"10647","E01025837",2001,668,47,621,58
"10648","E01025838",2001,649,63,586,33
"10649","E01025819",2001,670,146,524,62
"10650","E01025820",2001,616,5,611,16
"10651","E01025882",2001,641,58,583,86
"10652","E01025872",2001,646,24,622,15
"10653","E01025873",2001,623,20,603,35
"10654","E01025874",2001,670,127,543,13
"10655","E01025875",2001,631,212,419,20
"10656","E01025876",2001,561,3,558,20
"10657","E01025839",2001,599,25,574,49
"10658","E01025840",2001,627,63,564,41
"10659","E01025841",2001,625,6,619,11
"10660","E01025842",2001,602,194,408,18
"10661","E01025843",2001,646,65,581,60
"10662","E01025844",2001,617,222,395,70
"10663","E01025821",2001,687,11,676,109
"10664","E01025822",2001,648,223,425,11
"10665","E01025823",2001,548,110,438,17
"10666","E01025824",2001,527,78,449,17
"10667","E01025825",2001,583,45,538,14
"10668","E01025826",2001,586,40,546,21
"10669","E01025881",2001,604,40,564,39
"10670","E01025864",2001,623,27,596,24
"10671","E01025817",2001,788,34,754,31
"10672","E01025818",2001,550,52,498,85
"10673","E01025859",2001,571,0,571,17
"10674","E01025860",2001,520,3,517,0
"10675","E01025861",2001,629,21,608,19
"10676","E01025862",2001,637,0,637,34
"10677","E01025863",2001,672,128,544,27
"10678","E01025865",2001,733,143,590,34
"10679","E01025852",2001,694,22,672,141
"10680","E01025858",2001,746,18,728,122
"10681","E01025850",2001,643,56,587,61
"10682","E01025853",2001,598,17,581,24
"10683","E01025854",2001,583,21,562,26
"10684","E01025855",2001,603,38,565,29
"10685","E01025866",2001,617,193,424,16
"10686","E01025867",2001,663,27,636,32
"10687","E01025856",2001,666,295,371,35
"10688","E01025857",2001,533,9,524,37
"10689","E01025849",2001,719,73,646,91
"10690","E01025851",2001,510,0,510,9
"10691","E01025827",2001,712,202,510,9
"10692","E01025828",2001,616,46,570,15
"10693","E01025829",2001,648,249,399,11
"10694","E01025830",2001,592,109,483,23
"10695","E01025831",2001,590,58,532,38
"10696","E01025832",2001,504,6,498,15
"10697","E01025833",2001,614,43,571,46
"10698","E01025834",2001,556,8,548,10
"10699","E01025835",2001,668,6,662,13
"10700","E01025836",2001,555,5,550,19
"10701","E01025885",2001,683,15,668,40
"10702","E01025886",2001,763,105,658,64
"10703","E01025887",2001,701,55,646,180
"10704","E01025890",2001,505,125,380,17
"10705","E01025891",2001,473,19,454,41
"10706","E01025892",2001,608,40,568,73
"10707","E01025901",2001,798,45,753,55
"10708","E01025902",2001,637,12,625,14
"10709","E01025903",2001,679,56,623,105
"10710","E01025904",2001,635,3,632,22
"10711","E01025906",2001,642,11,631,21
"10712","E01025883",2001,655,42,613,26
"10713","E01025884",2001,661,162,499,51
"10714","E01025909",2001,768,94,674,65
"10715","E01025888",2001,715,28,687,94
"10716","E01025905",2001,626,272,354,13
"10717","E01025896",2001,612,4,608,20
"10718","E01025897",2001,642,139,503,58
"10719","E01025898",2001,478,75,403,61
"10720","E01025899",2001,413,49,364,60
"10721","E01025900",2001,614,243,371,16
"10722","E01025893",2001,862,16,846,26
"10723","E01025894",2001,758,282,476,124
"10724","E01025895",2001,724,48,676,53
"10725","E01025907",2001,663,215,448,18
"10726","E01025908",2001,679,16,663,64
"10727","E01025910",2001,716,53,663,79
"10728","E01025911",2001,609,35,574,58
"10729","E01025912",2001,628,38,590,238
"10730","E01025889",2001,674,52,622,82
"10731","E01025924",2001,430,34,396,80
"10732","E01025925",2001,899,166,733,158
"10733","E01025926",2001,631,44,587,41
"10734","E01025927",2001,634,176,458,20
"10735","E01025928",2001,605,0,605,37
"10736","E01025944",2001,560,37,523,67
"10737","E01025945",2001,638,69,569,54
"10738","E01025946",2001,645,92,553,77
"10739","E01025923",2001,567,72,495,44
"10740","E01025915",2001,525,41,484,40
"10741","E01025916",2001,637,30,607,60
"10742","E01025917",2001,630,21,609,56
"10743","E01025918",2001,640,249,391,31
"10744","E01025960",2001,609,43,566,11
"10745","E01025961",2001,593,40,553,25
"10746","E01025962",2001,587,206,381,12
"10747","E01025965",2001,479,39,440,18
"10748","E01025963",2001,582,102,480,22
"10749","E01025964",2001,573,44,529,37
"10750","E01025955",2001,493,22,471,13
"10751","E01025956",2001,486,89,397,23
"10752","E01025919",2001,570,160,410,8
"10753","E01025920",2001,627,211,416,16
"10754","E01025921",2001,655,63,592,20
"10755","E01025914",2001,519,3,516,10
"10756","E01025966",2001,627,186,441,13
"10757","E01025967",2001,713,24,689,3
"10758","E01025968",2001,738,9,729,32
"10759","E01025969",2001,673,100,573,41
"10760","E01025950",2001,692,309,383,36
"10761","E01025951",2001,623,20,603,27
"10762","E01025952",2001,652,96,556,15
"10763","E01025953",2001,460,113,347,22
"10764","E01025954",2001,508,88,420,18
"10765","E01025932",2001,520,374,146,3
"10766","E01025933",2001,532,149,383,10
"10767","E01025934",2001,602,321,281,35
"10768","E01025935",2001,530,26,504,10
"10769","E01025936",2001,576,215,361,8
"10770","E01025929",2001,610,51,559,24
"10771","E01025930",2001,629,74,555,86
"10772","E01025931",2001,633,141,492,59
"10773","E01025957",2001,633,110,523,50
"10774","E01025958",2001,575,45,530,22
"10775","E01025959",2001,847,42,805,25
"10776","E01025937",2001,626,23,603,35
"10777","E01025922",2001,865,57,808,23
"10778","E01025913",2001,864,103,761,40
"10779","E01025947",2001,703,14,689,20
"10780","E01025948",2001,585,85,500,31
"10781","E01025949",2001,683,304,379,37
"10782","E01025938",2001,511,73,438,26
"10783","E01025939",2001,636,75,561,68
"10784","E01025940",2001,743,119,624,51
"10785","E01025941",2001,607,50,557,26
"10786","E01025942",2001,649,29,620,9
"10787","E01025943",2001,746,244,502,41
"10788","E01025980",2001,499,5,494,14
"10789","E01025973",2001,504,3,501,13
"10790","E01025974",2001,637,40,597,82
"10791","E01025975",2001,521,30,491,13
"10792","E01025979",2001,512,15,497,33
"10793","E01025981",2001,628,4,624,24
"10794","E01025982",2001,486,0,486,12
"10795","E01025983",2001,487,31,456,17
"10796","E01025984",2001,500,0,500,10
"10797","E01025970",2001,514,3,511,14
"10798","E01025971",2001,501,3,498,20
"10799","E01025972",2001,475,10,465,24
"10800","E01025976",2001,609,218,391,15
"10801","E01025977",2001,638,8,630,49
"10802","E01025978",2001,617,82,535,47
"10803","E01025995",2001,622,9,613,41
"10804","E01025996",2001,836,5,831,24
"10805","E01026002",2001,589,4,585,21
"10806","E01026003",2001,621,52,569,35
"10807","E01026004",2001,670,7,663,7
"10808","E01026005",2001,668,64,604,21
"10809","E01025997",2001,629,220,409,16
"10810","E01025994",2001,613,171,442,29
"10811","E01025999",2001,630,138,492,28
"10812","E01025992",2001,758,206,552,66
"10813","E01025985",2001,620,6,614,18
"10814","E01025986",2001,642,3,639,18
"10815","E01025987",2001,657,104,553,122
"10816","E01025988",2001,635,121,514,122
"10817","E01025989",2001,741,110,631,112
"10818","E01025990",2001,647,10,637,23
"10819","E01025991",2001,606,4,602,12
"10820","E01025993",2001,592,22,570,13
"10821","E01026000",2001,574,0,574,13
"10822","E01026001",2001,630,19,611,15
"10823","E01025998",2001,791,11,780,29
"10824","E01026007",2001,469,28,441,6
"10825","E01026008",2001,543,124,419,25
"10826","E01026009",2001,489,103,386,29
"10827","E01026023",2001,528,109,419,31
"10828","E01026024",2001,747,135,612,41
"10829","E01026030",2001,960,490,470,64
"10830","E01026037",2001,580,209,371,71
"10831","E01026010",2001,512,370,142,14
"10832","E01026011",2001,1025,309,716,103
"10833","E01026032",2001,734,78,656,73
"10834","E01026036",2001,615,18,597,145
"10835","E01026006",2001,884,177,707,204
"10836","E01026021",2001,747,33,714,108
"10837","E01026025",2001,827,198,629,171
"10838","E01026026",2001,749,373,376,16
"10839","E01026027",2001,635,95,540,36
"10840","E01026028",2001,827,205,622,53
"10841","E01026015",2001,629,36,593,30
"10842","E01026012",2001,537,220,317,5
"10843","E01026013",2001,621,20,601,20
"10844","E01026014",2001,511,54,457,14
"10845","E01026029",2001,732,33,699,30
"10846","E01026022",2001,722,5,717,37
"10847","E01026031",2001,622,29,593,22
"10848","E01026038",2001,547,15,532,30
"10849","E01026039",2001,487,25,462,14
"10850","E01026040",2001,494,35,459,23
"10851","E01026035",2001,668,8,660,12
"10852","E01026033",2001,693,63,630,75
"10853","E01026034",2001,667,143,524,19
"10854","E01026016",2001,823,128,695,55
"10855","E01026017",2001,573,197,376,18
"10856","E01026018",2001,666,41,625,50
"10857","E01026019",2001,866,377,489,38
"10858","E01026020",2001,628,47,581,50
"10859","E01026041",2001,609,279,330,18
"10860","E01026045",2001,832,95,737,102
"10861","E01026061",2001,501,6,495,17
"10862","E01026062",2001,506,44,462,33
"10863","E01026063",2001,550,0,550,6
"10864","E01026080",2001,838,47,791,80
"10865","E01026106",2001,481,44,437,23
"10866","E01026107",2001,477,10,467,50
"10867","E01026079",2001,768,50,718,54
"10868","E01026076",2001,898,67,831,79
"10869","E01026058",2001,853,41,812,67
"10870","E01026077",2001,468,141,327,18
"10871","E01026078",2001,472,115,357,35
"10872","E01026090",2001,534,87,447,27
"10873","E01026091",2001,472,56,416,24
"10874","E01026108",2001,898,310,588,73
"10875","E01026087",2001,497,184,313,41
"10876","E01026088",2001,513,13,500,22
"10877","E01026089",2001,938,44,894,107
"10878","E01026081",2001,1065,74,991,242
"10879","E01026086",2001,1006,107,899,183
"10880","E01026072",2001,839,125,714,127
"10881","E01026073",2001,861,161,700,138
"10882","E01026074",2001,894,110,784,83
"10883","E01026099",2001,869,30,839,70
"10884","E01026103",2001,853,28,825,104
"10885","E01026104",2001,943,50,893,62
"10886","E01026109",2001,915,44,871,145
"10887","E01026071",2001,896,55,841,166
"10888","E01026082",2001,922,30,892,102
"10889","E01026121",2001,882,104,778,63
"10890","E01026113",2001,823,54,769,105
"10891","E01026117",2001,772,48,724,87
"10892","E01026042",2001,631,111,520,142
"10893","E01026043",2001,643,93,550,39
"10894","E01026044",2001,570,21,549,49
"10895","E01026105",2001,888,35,853,133
"10896","E01026060",2001,532,36,496,44
"10897","E01026070",2001,800,29,771,182
"10898","E01026068",2001,919,52,867,163
"10899","E01026069",2001,849,94,755,126
"10900","E01026048",2001,656,55,601,174
"10901","E01026049",2001,671,29,642,70
"10902","E01026050",2001,777,19,758,56
"10903","E01026064",2001,661,211,450,44
"10904","E01026065",2001,745,24,721,64
"10905","E01026066",2001,702,19,683,60
"10906","E01026067",2001,786,119,667,180
"10907","E01026115",2001,740,107,633,239
"10908","E01026116",2001,643,31,612,92
"10909","E01026084",2001,659,71,588,138
"10910","E01026085",2001,780,10,770,49
"10911","E01026100",2001,527,31,496,115
"10912","E01026101",2001,504,168,336,62
"10913","E01026046",2001,483,65,418,69
"10914","E01026047",2001,587,17,570,38
"10915","E01026055",2001,461,25,436,23
"10916","E01026059",2001,425,39,386,37
"10917","E01026095",2001,507,15,492,155
"10918","E01026092",2001,624,73,551,190
"10919","E01026093",2001,855,71,784,440
"10920","E01026114",2001,769,56,713,299
"10921","E01026094",2001,727,200,527,55
"10922","E01026096",2001,618,8,610,57
"10923","E01026097",2001,763,190,573,61
"10924","E01026083",2001,768,429,339,29
"10925","E01026051",2001,502,18,484,46
"10926","E01026052",2001,443,82,361,158
"10927","E01026053",2001,502,47,455,199
"10928","E01026054",2001,620,133,487,82
"10929","E01026118",2001,587,6,581,34
"10930","E01026119",2001,491,14,477,23
"10931","E01026120",2001,590,90,500,77
"10932","E01026110",2001,583,71,512,54
"10933","E01026111",2001,607,96,511,57
"10934","E01026112",2001,471,148,323,103
"10935","E01026056",2001,450,41,409,45
"10936","E01026057",2001,813,44,769,83
"10937","E01026075",2001,880,86,794,117
"10938","E01026098",2001,822,66,756,26
"10939","E01026102",2001,864,97,767,60
"10940","E01026149",2001,732,362,370,14
"10941","E01026150",2001,751,461,290,17
"10942","E01026166",2001,534,230,304,15
"10943","E01026168",2001,626,355,271,14
"10944","E01026157",2001,589,172,417,36
"10945","E01026165",2001,737,319,418,13
"10946","E01026153",2001,629,55,574,25
"10947","E01026155",2001,663,7,656,59
"10948","E01026151",2001,715,135,580,67
"10949","E01026144",2001,612,63,549,127
"10950","E01026147",2001,613,8,605,95
"10951","E01026148",2001,993,174,819,261
"10952","E01026125",2001,503,8,495,75
"10953","E01026164",2001,494,54,440,12
"10954","E01026167",2001,715,55,660,131
"10955","E01026126",2001,770,382,388,117
"10956","E01026122",2001,642,85,557,209
"10957","E01026123",2001,516,211,305,25
"10958","E01026124",2001,634,27,607,163
"10959","E01026152",2001,502,379,123,16
"10960","E01026156",2001,472,220,252,19
"10961","E01026154",2001,518,171,347,33
"10962","E01026145",2001,623,32,591,126
"10963","E01026146",2001,757,227,530,179
"10964","E01026132",2001,612,198,414,219
"10965","E01026143",2001,621,23,598,195
"10966","E01026176",2001,889,272,617,270
"10967","E01026177",2001,785,20,765,245
"10968","E01026178",2001,734,59,675,163
"10969","E01026134",2001,729,134,595,161
"10970","E01026127",2001,622,347,275,32
"10971","E01026128",2001,745,79,666,47
"10972","E01026129",2001,668,487,181,19
"10973","E01026131",2001,597,199,398,15
"10974","E01026133",2001,792,22,770,198
"10975","E01026135",2001,688,51,637,17
"10976","E01026136",2001,621,32,589,15
"10977","E01026174",2001,601,46,555,161
"10978","E01026162",2001,622,110,512,24
"10979","E01026163",2001,600,0,600,42
"10980","E01026158",2001,641,20,621,33
"10981","E01026159",2001,645,13,632,48
"10982","E01026160",2001,613,6,607,43
"10983","E01026130",2001,610,25,585,32
"10984","E01026161",2001,663,284,379,22
"10985","E01026170",2001,576,216,360,16
"10986","E01026172",2001,572,216,356,16
"10987","E01026173",2001,672,499,173,6
"10988","E01026175",2001,741,200,541,118
"10989","E01026171",2001,656,7,649,22
"10990","E01026169",2001,752,186,566,21
"10991","E01026137",2001,477,4,473,25
"10992","E01026138",2001,618,11,607,28
"10993","E01026139",2001,478,3,475,10
"10994","E01026140",2001,635,193,442,35
"10995","E01026141",2001,498,41,457,14
"10996","E01026142",2001,509,164,345,20
"10997","E01026189",2001,739,6,733,41
"10998","E01026186",2001,646,14,632,21
"10999","E01026187",2001,608,11,597,45
"11000","E01026203",2001,753,29,724,44
"11001","E01026204",2001,703,3,700,22
"11002","E01026206",2001,733,11,722,56
"11003","E01026214",2001,509,53,456,10
"11004","E01026215",2001,464,3,461,6
"11005","E01026216",2001,1014,68,946,53
"11006","E01026217",2001,968,188,780,34
"11007","E01026218",2001,507,32,475,25
"11008","E01026219",2001,508,7,501,19
"11009","E01026220",2001,941,90,851,16
"11010","E01026225",2001,631,87,544,41
"11011","E01026226",2001,774,3,771,26
"11012","E01026193",2001,541,51,490,36
"11013","E01026199",2001,838,62,776,74
"11014","E01026181",2001,533,47,486,119
"11015","E01026182",2001,489,49,440,45
"11016","E01026184",2001,492,72,420,287
"11017","E01026185",2001,752,118,634,50
"11018","E01026190",2001,611,200,411,42
"11019","E01026188",2001,759,222,537,41
"11020","E01026237",2001,515,12,503,27
"11021","E01026238",2001,484,6,478,25
"11022","E01026205",2001,622,164,458,11
"11023","E01026211",2001,616,45,571,48
"11024","E01026212",2001,619,28,591,30
"11025","E01026213",2001,735,191,544,44
"11026","E01026191",2001,595,85,510,29
"11027","E01026192",2001,433,54,379,47
"11028","E01026194",2001,617,102,515,28
"11029","E01026195",2001,675,46,629,42
"11030","E01026196",2001,579,60,519,67
"11031","E01026210",2001,834,155,679,75
"11032","E01026224",2001,699,272,427,25
"11033","E01026183",2001,904,222,682,74
"11034","E01026180",2001,536,87,449,46
"11035","E01026179",2001,402,78,324,166
"11036","E01026223",2001,823,23,800,60
"11037","E01026197",2001,559,33,526,60
"11038","E01026198",2001,414,35,379,280
"11039","E01026209",2001,918,76,842,59
"11040","E01026221",2001,931,143,788,141
"11041","E01026222",2001,658,20,638,63
"11042","E01026227",2001,621,152,469,131
"11043","E01026230",2001,527,208,319,33
"11044","E01026231",2001,911,38,873,90
"11045","E01026232",2001,847,148,699,81
"11046","E01026235",2001,618,175,443,62
"11047","E01026236",2001,471,11,460,16
"11048","E01026233",2001,531,3,528,39
"11049","E01026234",2001,536,4,532,32
"11050","E01026228",2001,587,53,534,63
"11051","E01026229",2001,526,23,503,42
"11052","E01026207",2001,444,72,372,39
"11053","E01026208",2001,569,41,528,47
"11054","E01026200",2001,617,21,596,42
"11055","E01026201",2001,679,151,528,32
"11056","E01026202",2001,712,128,584,26
"11057","E01026242",2001,618,41,577,23
"11058","E01026243",2001,492,144,348,16
"11059","E01026244",2001,482,63,419,25
"11060","E01026247",2001,779,85,694,35
"11061","E01026276",2001,897,97,800,48
"11062","E01026248",2001,825,119,706,97
"11063","E01026257",2001,752,32,720,18
"11064","E01026246",2001,899,149,750,54
"11065","E01026250",2001,750,141,609,120
"11066","E01026251",2001,715,41,674,22
"11067","E01026252",2001,773,87,686,48
"11068","E01026253",2001,734,178,556,45
"11069","E01026281",2001,512,24,488,33
"11070","E01026282",2001,630,167,463,24
"11071","E01026283",2001,664,50,614,39
"11072","E01026285",2001,595,61,534,35
"11073","E01026286",2001,425,72,353,37
"11074","E01026258",2001,741,13,728,27
"11075","E01026259",2001,671,112,559,45
"11076","E01026260",2001,814,153,661,45
"11077","E01026241",2001,502,145,357,49
"11078","E01026261",2001,984,131,853,123
"11079","E01026266",2001,746,46,700,132
"11080","E01026273",2001,643,15,628,22
"11081","E01026274",2001,639,4,635,43
"11082","E01026275",2001,644,109,535,28
"11083","E01026268",2001,731,272,459,27
"11084","E01026269",2001,878,19,859,52
"11085","E01026270",2001,625,242,383,35
"11086","E01026271",2001,654,329,325,14
"11087","E01026272",2001,523,66,457,49
"11088","E01026277",2001,588,210,378,63
"11089","E01026278",2001,578,38,540,64
"11090","E01026279",2001,546,54,492,40
"11091","E01026254",2001,727,180,547,28
"11092","E01026255",2001,723,26,697,60
"11093","E01026256",2001,644,152,492,45
"11094","E01026267",2001,702,12,690,36
"11095","E01026262",2001,610,25,585,35
"11096","E01026263",2001,575,27,548,24
"11097","E01026264",2001,625,79,546,36
"11098","E01026265",2001,503,66,437,27
"11099","E01026249",2001,714,55,659,45
"11100","E01026245",2001,868,58,810,33
"11101","E01026280",2001,873,133,740,30
"11102","E01026284",2001,620,91,529,25
"11103","E01026239",2001,632,83,549,96
"11104","E01026240",2001,885,141,744,27
"11105","E01026313",2001,589,63,526,49
"11106","E01026314",2001,469,59,410,38
"11107","E01026329",2001,753,99,654,79
"11108","E01026333",2001,854,102,752,50
"11109","E01026340",2001,914,203,711,37
"11110","E01026291",2001,793,77,716,41
"11111","E01026355",2001,872,60,812,51
"11112","E01026365",2001,858,45,813,73
"11113","E01026352",2001,505,3,502,18
"11114","E01026353",2001,868,183,685,196
"11115","E01026354",2001,487,4,483,11
"11116","E01026325",2001,637,277,360,19
"11117","E01026326",2001,606,99,507,16
"11118","E01026327",2001,628,213,415,16
"11119","E01026328",2001,617,348,269,11
"11120","E01026320",2001,514,3,511,22
"11121","E01026321",2001,505,0,505,18
"11122","E01026322",2001,508,0,508,51
"11123","E01026323",2001,811,227,584,148
"11124","E01026324",2001,863,31,832,42
"11125","E01026308",2001,563,345,218,26
"11126","E01026309",2001,641,86,555,57
"11127","E01026310",2001,446,141,305,18
"11128","E01026311",2001,570,190,380,52
"11129","E01026312",2001,451,333,118,12
"11130","E01026317",2001,658,58,600,165
"11131","E01026318",2001,652,84,568,169
"11132","E01026319",2001,628,12,616,63
"11133","E01026343",2001,775,112,663,197
"11134","E01026344",2001,615,14,601,141
"11135","E01026345",2001,620,182,438,51
"11136","E01026316",2001,911,122,789,151
"11137","E01026332",2001,906,92,814,79
"11138","E01026292",2001,628,7,621,40
"11139","E01026293",2001,616,14,602,111
"11140","E01026294",2001,501,19,482,19
"11141","E01026341",2001,580,94,486,27
"11142","E01026342",2001,520,25,495,38
"11143","E01026290",2001,803,128,675,77
"11144","E01026361",2001,926,156,770,92
"11145","E01026315",2001,859,120,739,174
"11146","E01026338",2001,487,56,431,29
"11147","E01026339",2001,467,104,363,28
"11148","E01026331",2001,924,179,745,155
"11149","E01026299",2001,603,126,477,31
"11150","E01026300",2001,629,6,623,19
"11151","E01026301",2001,620,10,610,42
"11152","E01026302",2001,502,6,496,18
"11153","E01026295",2001,619,21,598,33
"11154","E01026296",2001,630,30,600,34
"11155","E01026297",2001,610,179,431,24
"11156","E01026298",2001,752,230,522,75
"11157","E01026330",2001,793,86,707,70
"11158","E01026362",2001,632,16,616,28
"11159","E01026363",2001,477,39,438,50
"11160","E01026364",2001,676,58,618,29
"11161","E01026360",2001,829,72,757,36
"11162","E01026334",2001,623,39,584,19
"11163","E01026335",2001,652,37,615,41
"11164","E01026336",2001,642,272,370,30
"11165","E01026337",2001,622,61,561,10
"11166","E01026303",2001,504,0,504,34
"11167","E01026304",2001,561,7,554,26
"11168","E01026305",2001,607,11,596,41
"11169","E01026306",2001,586,140,446,25
"11170","E01026307",2001,516,12,504,45
"11171","E01026287",2001,628,130,498,33
"11172","E01026288",2001,756,374,382,43
"11173","E01026289",2001,602,102,500,19
"11174","E01026346",2001,517,38,479,39
"11175","E01026347",2001,721,142,579,74
"11176","E01026348",2001,471,151,320,15
"11177","E01026349",2001,742,233,509,55
"11178","E01026350",2001,755,124,631,164
"11179","E01026351",2001,761,101,660,181
"11180","E01026356",2001,610,3,607,48
"11181","E01026357",2001,607,49,558,54
"11182","E01026358",2001,626,13,613,37
"11183","E01026359",2001,627,5,622,16
"11184","E01026367",2001,675,138,537,116
"11185","E01026368",2001,646,46,600,30
"11186","E01026416",2001,479,91,388,84
"11187","E01026417",2001,574,10,564,45
"11188","E01026418",2001,438,74,364,31
"11189","E01026387",2001,914,67,847,56
"11190","E01026401",2001,550,7,543,19
"11191","E01026402",2001,642,32,610,51
"11192","E01026403",2001,455,55,400,33
"11193","E01026380",2001,560,125,435,10
"11194","E01026407",2001,481,71,410,52
"11195","E01026408",2001,478,69,409,23
"11196","E01026415",2001,424,13,411,120
"11197","E01026389",2001,643,17,626,144
"11198","E01026390",2001,724,179,545,62
"11199","E01026391",2001,651,32,619,86
"11200","E01026392",2001,933,81,852,72
"11201","E01026381",2001,762,182,580,94
"11202","E01026382",2001,622,22,600,78
"11203","E01026383",2001,626,66,560,202
"11204","E01026384",2001,632,91,541,155
"11205","E01026378",2001,730,132,598,112
"11206","E01026379",2001,727,37,690,115
"11207","E01026385",2001,441,35,406,106
"11208","E01026386",2001,439,26,413,180
"11209","E01026399",2001,536,41,495,68
"11210","E01026411",2001,887,71,816,108
"11211","E01026374",2001,619,403,216,24
"11212","E01026375",2001,593,250,343,32
"11213","E01026376",2001,640,243,397,28
"11214","E01026377",2001,603,244,359,19
"11215","E01026409",2001,416,37,379,50
"11216","E01026410",2001,616,50,566,33
"11217","E01026404",2001,864,84,780,56
"11218","E01026388",2001,867,32,835,46
"11219","E01026412",2001,643,79,564,40
"11220","E01026413",2001,764,16,748,28
"11221","E01026414",2001,582,22,560,81
"11222","E01026372",2001,865,97,768,26
"11223","E01026400",2001,418,19,399,159
"11224","E01026396",2001,557,4,553,16
"11225","E01026397",2001,557,5,552,79
"11226","E01026398",2001,631,117,514,44
"11227","E01026405",2001,475,28,447,17
"11228","E01026406",2001,504,3,501,10
"11229","E01026393",2001,637,7,630,18
"11230","E01026394",2001,585,75,510,42
"11231","E01026395",2001,639,59,580,34
"11232","E01026373",2001,741,79,662,53
"11233","E01026369",2001,451,99,352,24
"11234","E01026370",2001,685,6,679,41
"11235","E01026371",2001,477,10,467,26
"11236","E01026366",2001,783,118,665,42
"11237","E01026971",2001,638,193,445,18
"11238","E01026982",2001,618,245,373,20
"11239","E01026979",2001,530,47,483,38
"11240","E01026980",2001,605,44,561,30
"11241","E01026981",2001,492,43,449,23
"11242","E01026983",2001,469,130,339,11
"11243","E01026972",2001,761,259,502,29
"11244","E01026969",2001,746,293,453,21
"11245","E01026970",2001,600,182,418,3
"11246","E01026976",2001,655,305,350,23
"11247","E01026977",2001,623,30,593,30
"11248","E01026978",2001,451,104,347,21
"11249","E01026957",2001,742,275,467,68
"11250","E01026958",2001,742,310,432,39
"11251","E01026973",2001,591,131,460,15
"11252","E01026974",2001,486,65,421,5
"11253","E01026975",2001,634,307,327,18
"11254","E01026962",2001,616,182,434,10
"11255","E01026984",2001,760,231,529,20
"11256","E01026985",2001,649,125,524,16
"11257","E01026949",2001,614,245,369,24
"11258","E01026950",2001,612,297,315,32
"11259","E01026951",2001,527,228,299,24
"11260","E01026952",2001,496,102,394,23
"11261","E01026959",2001,627,178,449,17
"11262","E01026960",2001,623,328,295,31
"11263","E01026961",2001,497,204,293,32
"11264","E01026965",2001,513,249,264,35
"11265","E01026966",2001,556,157,399,19
"11266","E01026967",2001,586,208,378,17
"11267","E01026968",2001,641,350,291,41
"11268","E01026963",2001,430,230,200,22
"11269","E01026964",2001,516,22,494,31
"11270","E01026953",2001,603,56,547,26
"11271","E01026954",2001,596,260,336,32
"11272","E01026955",2001,546,8,538,25
"11273","E01026956",2001,611,198,413,17
"11274","E01027005",2001,742,67,675,92
"11275","E01027026",2001,725,76,649,38
"11276","E01027030",2001,699,48,651,62
"11277","E01027022",2001,708,67,641,61
"11278","E01027000",2001,605,130,475,28
"11279","E01027001",2001,495,8,487,13
"11280","E01027002",2001,573,27,546,46
"11281","E01027003",2001,573,35,538,29
"11282","E01027006",2001,633,57,576,40
"11283","E01026999",2001,720,107,613,35
"11284","E01026994",2001,442,74,368,23
"11285","E01026995",2001,500,30,470,25
"11286","E01026996",2001,403,39,364,7
"11287","E01026998",2001,696,31,665,121
"11288","E01027015",2001,495,15,480,8
"11289","E01027016",2001,587,15,572,68
"11290","E01027027",2001,808,83,725,41
"11291","E01027021",2001,713,60,653,61
"11292","E01027018",2001,533,8,525,25
"11293","E01027019",2001,623,137,486,44
"11294","E01027020",2001,509,13,496,19
"11295","E01027023",2001,718,126,592,42
"11296","E01026997",2001,636,32,604,45
"11297","E01026989",2001,590,111,479,40
"11298","E01026990",2001,474,28,446,29
"11299","E01026987",2001,514,62,452,17
"11300","E01027014",2001,513,44,469,14
"11301","E01027012",2001,727,170,557,30
"11302","E01027010",2001,488,35,453,3
"11303","E01026988",2001,498,217,281,14
"11304","E01026986",2001,647,297,350,27
"11305","E01026991",2001,742,38,704,31
"11306","E01026992",2001,876,296,580,120
"11307","E01027013",2001,723,445,278,24
"11308","E01027007",2001,538,149,389,21
"11309","E01027008",2001,886,33,853,97
"11310","E01027009",2001,618,265,353,33
"11311","E01027011",2001,776,59,717,62
"11312","E01027024",2001,624,26,598,45
"11313","E01027025",2001,660,164,496,52
"11314","E01027017",2001,666,227,439,28
"11315","E01027028",2001,871,28,843,54
"11316","E01027029",2001,638,184,454,39
"11317","E01027004",2001,739,65,674,59
"11318","E01026993",2001,796,72,724,33
"11319","E01027033",2001,725,131,594,73
"11320","E01027043",2001,769,119,650,126
"11321","E01027050",2001,712,88,624,67
"11322","E01027046",2001,490,22,468,46
"11323","E01027047",2001,527,143,384,31
"11324","E01027048",2001,491,66,425,73
"11325","E01027049",2001,434,29,405,59
"11326","E01027044",2001,785,56,729,97
"11327","E01027031",2001,766,70,696,101
"11328","E01027032",2001,763,115,648,112
"11329","E01027045",2001,780,130,650,78
"11330","E01027075",2001,708,26,682,30
"11331","E01027076",2001,667,170,497,52
"11332","E01027077",2001,554,26,528,33
"11333","E01027078",2001,774,127,647,50
"11334","E01027074",2001,832,94,738,24
"11335","E01027057",2001,671,86,585,34
"11336","E01027051",2001,616,159,457,45
"11337","E01027052",2001,530,6,524,25
"11338","E01027053",2001,580,17,563,33
"11339","E01027054",2001,502,4,498,16
"11340","E01027055",2001,476,12,464,23
"11341","E01027056",2001,610,202,408,30
"11342","E01027038",2001,601,184,417,43
"11343","E01027039",2001,544,66,478,45
"11344","E01027040",2001,643,30,613,41
"11345","E01027041",2001,643,290,353,46
"11346","E01027042",2001,481,16,465,9
"11347","E01027034",2001,648,207,441,16
"11348","E01027035",2001,588,177,411,40
"11349","E01027036",2001,887,21,866,48
"11350","E01027037",2001,617,13,604,13
"11351","E01027072",2001,634,343,291,21
"11352","E01027073",2001,859,106,753,51
"11353","E01027061",2001,658,156,502,17
"11354","E01027062",2001,651,133,518,40
"11355","E01027063",2001,580,28,552,31
"11356","E01027064",2001,609,7,602,16
"11357","E01027065",2001,761,106,655,106
"11358","E01027069",2001,685,165,520,77
"11359","E01027058",2001,624,261,363,20
"11360","E01027059",2001,741,68,673,86
"11361","E01027060",2001,755,121,634,132
"11362","E01027070",2001,625,19,606,35
"11363","E01027071",2001,590,32,558,25
"11364","E01027066",2001,585,4,581,19
"11365","E01027067",2001,659,3,656,6
"11366","E01027068",2001,836,10,826,20
"11367","E01027090",2001,567,40,527,143
"11368","E01027103",2001,658,92,566,68
"11369","E01027129",2001,877,84,793,38
"11370","E01027107",2001,503,31,472,34
"11371","E01027108",2001,511,4,507,8
"11372","E01027109",2001,498,69,429,19
"11373","E01027093",2001,670,103,567,77
"11374","E01027094",2001,600,47,553,24
"11375","E01027095",2001,504,76,428,14
"11376","E01027123",2001,654,82,572,20
"11377","E01027124",2001,879,213,666,82
"11378","E01027125",2001,682,6,676,17
"11379","E01027126",2001,756,110,646,60
"11380","E01027079",2001,627,29,598,58
"11381","E01027080",2001,741,12,729,27
"11382","E01027087",2001,488,19,469,38
"11383","E01027088",2001,485,3,482,28
"11384","E01027089",2001,617,7,610,14
"11385","E01027081",2001,609,200,409,20
"11386","E01027082",2001,611,121,490,68
"11387","E01027083",2001,616,326,290,24
"11388","E01027127",2001,783,451,332,15
"11389","E01027128",2001,641,236,405,20
"11390","E01027105",2001,771,33,738,208
"11391","E01027106",2001,744,96,648,148
"11392","E01027111",2001,747,29,718,133
"11393","E01027112",2001,861,90,771,142
"11394","E01027113",2001,769,100,669,91
"11395","E01027110",2001,910,431,479,110
"11396","E01027104",2001,968,204,764,114
"11397","E01027115",2001,489,3,486,12
"11398","E01027116",2001,618,4,614,44
"11399","E01027117",2001,482,7,475,39
"11400","E01027122",2001,504,0,504,16
"11401","E01027096",2001,437,0,437,16
"11402","E01027097",2001,580,3,577,29
"11403","E01027098",2001,474,25,449,17
"11404","E01027099",2001,635,0,635,18
"11405","E01027100",2001,606,82,524,33
"11406","E01027114",2001,640,69,571,33
"11407","E01027130",2001,751,96,655,25
"11408","E01027131",2001,803,415,388,24
"11409","E01027120",2001,504,4,500,27
"11410","E01027121",2001,510,3,507,7
"11411","E01027084",2001,642,7,635,11
"11412","E01027085",2001,499,62,437,16
"11413","E01027086",2001,609,0,609,17
"11414","E01027101",2001,802,80,722,39
"11415","E01027102",2001,616,62,554,20
"11416","E01027091",2001,730,200,530,31
"11417","E01027092",2001,624,28,596,30
"11418","E01027118",2001,816,60,756,36
"11419","E01027119",2001,708,127,581,67
"11420","E01027145",2001,573,61,512,33
"11421","E01027148",2001,579,3,576,16
"11422","E01027149",2001,609,63,546,23
"11423","E01027232",2001,617,98,519,52
"11424","E01027221",2001,660,11,649,34
"11425","E01027222",2001,484,3,481,4
"11426","E01027218",2001,701,4,697,16
"11427","E01027219",2001,776,10,766,21
"11428","E01027146",2001,642,11,631,23
"11429","E01027147",2001,774,208,566,57
"11430","E01027143",2001,528,54,474,17
"11431","E01027144",2001,648,7,641,16
"11432","E01027195",2001,658,270,388,53
"11433","E01027247",2001,607,65,542,29
"11434","E01027248",2001,559,218,341,29
"11435","E01027249",2001,622,248,374,28
"11436","E01027245",2001,648,110,538,36
"11437","E01027246",2001,756,282,474,57
"11438","E01027200",2001,602,195,407,50
"11439","E01027174",2001,520,6,514,14
"11440","E01027175",2001,598,133,465,37
"11441","E01027178",2001,614,254,360,23
"11442","E01027182",2001,600,18,582,22
"11443","E01027183",2001,615,3,612,17
"11444","E01027171",2001,602,168,434,15
"11445","E01027172",2001,653,34,619,22
"11446","E01027196",2001,516,109,407,13
"11447","E01027197",2001,626,235,391,31
"11448","E01027198",2001,637,303,334,41
"11449","E01027199",2001,506,310,196,17
"11450","E01027190",2001,736,86,650,36
"11451","E01027191",2001,624,76,548,80
"11452","E01027193",2001,599,5,594,19
"11453","E01027194",2001,621,5,616,21
"11454","E01027192",2001,529,15,514,110
"11455","E01027229",2001,611,239,372,59
"11456","E01027230",2001,616,225,391,61
"11457","E01027231",2001,755,422,333,37
"11458","E01027179",2001,775,96,679,24
"11459","E01027180",2001,714,206,508,16
"11460","E01027181",2001,788,63,725,20
"11461","E01027176",2001,605,96,509,18
"11462","E01027177",2001,634,322,312,29
"11463","E01027142",2001,586,140,446,18
"11464","E01027140",2001,474,229,245,35
"11465","E01027173",2001,584,184,400,32
"11466","E01027168",2001,698,407,291,18
"11467","E01027169",2001,568,49,519,41
"11468","E01027170",2001,612,279,333,14
"11469","E01027186",2001,660,13,647,60
"11470","E01027188",2001,705,208,497,33
"11471","E01027220",2001,614,31,583,24
"11472","E01027136",2001,670,50,620,150
"11473","E01027208",2001,611,26,585,32
"11474","E01027209",2001,536,3,533,53
"11475","E01027211",2001,622,10,612,21
"11476","E01027212",2001,561,8,553,59
"11477","E01027189",2001,710,89,621,54
"11478","E01027187",2001,532,33,499,169
"11479","E01027184",2001,652,60,592,158
"11480","E01027185",2001,503,180,323,48
"11481","E01027137",2001,654,232,422,39
"11482","E01027138",2001,623,37,586,35
"11483","E01027139",2001,635,69,566,73
"11484","E01027141",2001,495,16,479,8
"11485","E01027259",2001,589,12,577,47
"11486","E01027241",2001,590,199,391,74
"11487","E01027242",2001,597,249,348,28
"11488","E01027243",2001,637,283,354,19
"11489","E01027244",2001,641,392,249,16
"11490","E01027239",2001,591,292,299,18
"11491","E01027240",2001,516,219,297,7
"11492","E01027213",2001,605,120,485,41
"11493","E01027214",2001,755,272,483,28
"11494","E01027216",2001,760,25,735,41
"11495","E01027217",2001,764,16,748,20
"11496","E01027210",2001,447,45,402,8
"11497","E01027215",2001,591,70,521,20
"11498","E01027207",2001,616,7,609,19
"11499","E01027258",2001,517,3,514,11
"11500","E01027255",2001,548,3,545,14
"11501","E01027256",2001,621,12,609,15
"11502","E01027260",2001,590,23,567,16
"11503","E01027152",2001,647,92,555,119
"11504","E01027153",2001,879,385,494,197
"11505","E01027154",2001,739,86,653,118
"11506","E01027150",2001,982,718,264,57
"11507","E01027132",2001,847,149,698,204
"11508","E01027133",2001,767,28,739,125
"11509","E01027134",2001,659,24,635,142
"11510","E01027135",2001,727,36,691,86
"11511","E01027155",2001,669,101,568,154
"11512","E01027225",2001,663,63,600,264
"11513","E01027227",2001,580,57,523,120
"11514","E01027228",2001,772,123,649,193
"11515","E01027151",2001,728,147,581,91
"11516","E01027236",2001,607,36,571,31
"11517","E01027237",2001,601,40,561,29
"11518","E01027238",2001,784,197,587,93
"11519","E01027257",2001,499,29,470,22
"11520","E01027226",2001,703,190,513,139
"11521","E01027223",2001,629,206,423,132
"11522","E01027224",2001,742,279,463,108
"11523","E01027252",2001,642,139,503,48
"11524","E01027233",2001,499,187,312,26
"11525","E01027234",2001,624,54,570,18
"11526","E01027235",2001,542,296,246,11
"11527","E01027156",2001,497,204,293,19
"11528","E01027159",2001,511,26,485,12
"11529","E01027160",2001,610,20,590,22
"11530","E01027161",2001,640,304,336,21
"11531","E01027157",2001,650,58,592,93
"11532","E01027158",2001,620,30,590,65
"11533","E01027201",2001,644,29,615,11
"11534","E01027202",2001,651,111,540,28
"11535","E01027250",2001,603,5,598,57
"11536","E01027251",2001,411,16,395,63
"11537","E01027253",2001,637,3,634,25
"11538","E01027254",2001,633,3,630,28
"11539","E01027162",2001,686,60,626,79
"11540","E01027163",2001,578,4,574,30
"11541","E01027164",2001,606,13,593,77
"11542","E01027165",2001,509,9,500,23
"11543","E01027166",2001,619,15,604,62
"11544","E01027167",2001,621,12,609,32
"11545","E01027203",2001,544,7,537,19
"11546","E01027204",2001,511,89,422,11
"11547","E01027205",2001,485,12,473,16
"11548","E01027206",2001,619,32,587,19
"11549","E01027285",2001,685,95,590,20
"11550","E01027286",2001,638,66,572,20
"11551","E01027287",2001,658,62,596,24
"11552","E01027282",2001,645,120,525,22
"11553","E01027283",2001,580,25,555,54
"11554","E01027273",2001,752,140,612,70
"11555","E01027274",2001,590,22,568,30
"11556","E01027275",2001,595,60,535,29
"11557","E01027308",2001,714,69,645,158
"11558","E01027278",2001,693,65,628,57
"11559","E01027279",2001,721,144,577,25
"11560","E01027284",2001,744,63,681,45
"11561","E01027294",2001,694,59,635,18
"11562","E01027263",2001,773,86,687,63
"11563","E01027289",2001,702,129,573,47
"11564","E01027300",2001,517,18,499,20
"11565","E01027303",2001,603,15,588,77
"11566","E01027262",2001,650,60,590,49
"11567","E01027277",2001,734,52,682,59
"11568","E01027301",2001,654,77,577,71
"11569","E01027302",2001,590,248,342,25
"11570","E01027297",2001,677,85,592,48
"11571","E01027298",2001,530,10,520,22
"11572","E01027299",2001,627,152,475,30
"11573","E01027304",2001,706,40,666,56
"11574","E01027305",2001,765,96,669,89
"11575","E01027291",2001,600,15,585,34
"11576","E01027292",2001,491,167,324,21
"11577","E01027293",2001,481,9,472,23
"11578","E01027295",2001,772,94,678,38
"11579","E01027306",2001,694,72,622,65
"11580","E01027261",2001,790,73,717,79
"11581","E01027307",2001,814,73,741,50
"11582","E01027276",2001,848,62,786,48
"11583","E01027280",2001,580,25,555,41
"11584","E01027281",2001,631,131,500,22
"11585","E01027270",2001,594,6,588,21
"11586","E01027271",2001,620,4,616,57
"11587","E01027272",2001,603,16,587,37
"11588","E01027265",2001,629,21,608,41
"11589","E01027266",2001,487,0,487,15
"11590","E01027267",2001,511,84,427,50
"11591","E01027268",2001,513,20,493,47
"11592","E01027269",2001,660,234,426,50
"11593","E01027264",2001,599,45,554,64
"11594","E01027288",2001,888,198,690,49
"11595","E01027296",2001,758,81,677,66
"11596","E01027290",2001,927,73,854,84
"11597","E01027326",2001,644,46,598,23
"11598","E01027327",2001,611,186,425,46
"11599","E01027328",2001,589,157,432,36
"11600","E01027338",2001,918,128,790,49
"11601","E01027330",2001,491,170,321,17
"11602","E01027331",2001,627,225,402,37
"11603","E01027332",2001,600,9,591,15
"11604","E01027333",2001,513,3,510,21
"11605","E01027334",2001,479,346,133,11
"11606","E01027343",2001,640,9,631,26
"11607","E01027344",2001,620,41,579,28
"11608","E01027345",2001,491,0,491,14
"11609","E01027346",2001,583,8,575,22
"11610","E01027347",2001,751,3,748,18
"11611","E01027313",2001,618,24,594,90
"11612","E01027314",2001,776,66,710,143
"11613","E01027315",2001,781,43,738,131
"11614","E01027316",2001,611,36,575,69
"11615","E01027339",2001,615,376,239,22
"11616","E01027340",2001,654,212,442,15
"11617","E01027341",2001,609,241,368,34
"11618","E01027342",2001,672,290,382,33
"11619","E01027349",2001,757,285,472,131
"11620","E01027350",2001,652,111,541,40
"11621","E01027351",2001,750,334,416,17
"11622","E01027352",2001,646,118,528,56
"11623","E01027309",2001,647,15,632,12
"11624","E01027310",2001,624,364,260,37
"11625","E01027311",2001,476,33,443,18
"11626","E01027312",2001,629,183,446,20
"11627","E01027317",2001,640,205,435,26
"11628","E01027318",2001,608,404,204,14
"11629","E01027319",2001,634,179,455,19
"11630","E01027320",2001,515,155,360,17
"11631","E01027321",2001,522,41,481,9
"11632","E01027322",2001,503,51,452,42
"11633","E01027323",2001,592,114,478,29
"11634","E01027324",2001,500,17,483,12
"11635","E01027325",2001,621,37,584,51
"11636","E01027329",2001,746,60,686,42
"11637","E01027353",2001,754,48,706,60
"11638","E01027354",2001,853,167,686,73
"11639","E01027355",2001,649,12,637,25
"11640","E01027348",2001,837,73,764,44
"11641","E01027335",2001,631,41,590,13
"11642","E01027336",2001,635,171,464,27
"11643","E01027337",2001,755,46,709,35
"11644","E01027979",2001,680,25,655,62
"11645","E01027980",2001,641,288,353,20
"11646","E01027981",2001,640,61,579,29
"11647","E01027983",2001,613,85,528,92
"11648","E01027984",2001,632,47,585,28
"11649","E01027982",2001,647,113,534,38
"11650","E01027970",2001,593,8,585,36
"11651","E01027971",2001,607,7,600,15
"11652","E01027966",2001,642,364,278,14
"11653","E01027986",2001,636,183,453,52
"11654","E01027987",2001,593,251,342,47
"11655","E01027990",2001,657,31,626,47
"11656","E01027977",2001,736,178,558,55
"11657","E01027978",2001,704,150,554,141
"11658","E01027985",2001,648,121,527,60
"11659","E01027967",2001,694,70,624,149
"11660","E01027972",2001,663,128,535,20
"11661","E01027964",2001,537,194,343,26
"11662","E01027965",2001,547,226,321,45
"11663","E01027974",2001,644,427,217,5
"11664","E01027968",2001,566,251,315,44
"11665","E01027976",2001,760,288,472,66
"11666","E01027991",2001,503,135,368,18
"11667","E01027992",2001,607,19,588,15
"11668","E01027988",2001,610,7,603,55
"11669","E01027989",2001,623,37,586,25
"11670","E01027969",2001,550,90,460,45
"11671","E01027975",2001,647,104,543,64
"11672","E01027973",2001,542,0,542,8
"11673","E01027949",2001,632,18,614,46
"11674","E01027951",2001,659,357,302,27
"11675","E01027953",2001,619,72,547,16
"11676","E01027954",2001,602,104,498,70
"11677","E01027955",2001,498,49,449,65
"11678","E01027956",2001,657,334,323,15
"11679","E01027952",2001,718,284,434,71
"11680","E01027958",2001,599,238,361,24
"11681","E01027959",2001,518,5,513,20
"11682","E01027950",2001,732,160,572,22
"11683","E01027957",2001,537,83,454,12
"11684","E01027947",2001,623,48,575,47
"11685","E01027948",2001,634,14,620,53
"11686","E01027995",2001,610,25,585,39
"11687","E01027996",2001,735,266,469,45
"11688","E01027997",2001,698,32,666,36
"11689","E01027998",2001,783,48,735,78
"11690","E01027960",2001,685,146,539,35
"11691","E01027961",2001,698,32,666,28
"11692","E01027962",2001,611,39,572,23
"11693","E01027963",2001,570,215,355,13
"11694","E01027945",2001,712,47,665,65
"11695","E01027946",2001,609,89,520,16
"11696","E01027993",2001,640,12,628,34
"11697","E01027994",2001,611,71,540,31
"11698","E01027929",2001,733,127,606,22
"11699","E01027931",2001,707,194,513,39
"11700","E01027934",2001,522,12,510,16
"11701","E01027935",2001,486,62,424,28
"11702","E01027936",2001,621,4,617,14
"11703","E01027937",2001,655,196,459,53
"11704","E01027932",2001,642,78,564,56
"11705","E01027933",2001,627,64,563,76
"11706","E01027927",2001,748,232,516,39
"11707","E01027928",2001,799,61,738,110
"11708","E01027938",2001,492,5,487,8
"11709","E01027925",2001,621,55,566,4
"11710","E01027940",2001,559,10,549,11
"11711","E01027943",2001,589,27,562,42
"11712","E01027944",2001,658,13,645,16
"11713","E01027941",2001,604,141,463,6
"11714","E01027942",2001,491,149,342,10
"11715","E01027926",2001,628,16,612,22
"11716","E01027939",2001,607,341,266,6
"11717","E01027930",2001,624,303,321,12
"11718","E01028000",2001,902,71,831,71
"11719","E01028024",2001,648,115,533,27
"11720","E01028025",2001,609,106,503,54
"11721","E01028026",2001,624,228,396,30
"11722","E01028027",2001,597,84,513,55
"11723","E01028028",2001,611,223,388,13
"11724","E01028031",2001,474,131,343,10
"11725","E01028032",2001,500,35,465,29
"11726","E01028035",2001,871,111,760,61
"11727","E01027999",2001,919,104,815,33
"11728","E01028005",2001,800,67,733,44
"11729","E01028036",2001,819,59,760,86
"11730","E01028023",2001,874,88,786,63
"11731","E01028034",2001,903,167,736,36
"11732","E01028029",2001,517,161,356,56
"11733","E01028030",2001,514,93,421,28
"11734","E01028001",2001,621,400,221,26
"11735","E01028002",2001,596,42,554,19
"11736","E01028003",2001,592,113,479,20
"11737","E01028004",2001,687,26,661,41
"11738","E01028013",2001,631,134,497,31
"11739","E01028014",2001,766,430,336,16
"11740","E01028015",2001,607,50,557,30
"11741","E01028016",2001,631,89,542,18
"11742","E01028046",2001,704,30,674,56
"11743","E01028047",2001,509,7,502,11
"11744","E01028048",2001,567,40,527,22
"11745","E01028049",2001,632,221,411,10
"11746","E01028050",2001,590,27,563,30
"11747","E01028051",2001,747,170,577,26
"11748","E01028052",2001,701,13,688,19
"11749","E01028053",2001,804,356,448,20
"11750","E01028054",2001,569,5,564,15
"11751","E01028022",2001,517,68,449,61
"11752","E01028008",2001,497,250,247,37
"11753","E01028009",2001,619,4,615,13
"11754","E01028010",2001,504,6,498,24
"11755","E01028011",2001,750,277,473,121
"11756","E01028012",2001,577,70,507,54
"11757","E01028055",2001,810,322,488,123
"11758","E01028056",2001,439,124,315,29
"11759","E01028058",2001,600,49,551,16
"11760","E01028059",2001,524,13,511,49
"11761","E01028017",2001,636,274,362,30
"11762","E01028018",2001,601,47,554,30
"11763","E01028019",2001,621,258,363,18
"11764","E01028020",2001,652,63,589,197
"11765","E01028021",2001,640,71,569,43
"11766","E01028042",2001,577,60,517,13
"11767","E01028044",2001,749,414,335,37
"11768","E01028045",2001,873,274,599,53
"11769","E01028065",2001,699,443,256,38
"11770","E01028066",2001,612,382,230,30
"11771","E01028068",2001,729,165,564,148
"11772","E01028057",2001,581,28,553,177
"11773","E01028067",2001,640,252,388,14
"11774","E01028060",2001,671,9,662,38
"11775","E01028061",2001,614,18,596,28
"11776","E01028062",2001,742,84,658,169
"11777","E01028063",2001,625,6,619,29
"11778","E01028064",2001,549,163,386,35
"11779","E01028043",2001,630,51,579,33
"11780","E01028040",2001,429,79,350,61
"11781","E01028041",2001,464,50,414,161
"11782","E01028037",2001,574,29,545,95
"11783","E01028038",2001,639,210,429,33
"11784","E01028039",2001,458,33,425,43
"11785","E01028033",2001,826,63,763,100
"11786","E01028006",2001,517,64,453,43
"11787","E01028007",2001,416,19,397,24
"11788","E01028092",2001,512,96,416,23
"11789","E01028093",2001,456,3,453,11
"11790","E01028107",2001,644,33,611,27
"11791","E01028108",2001,655,27,628,43
"11792","E01028114",2001,662,33,629,88
"11793","E01028110",2001,620,274,346,48
"11794","E01028111",2001,616,116,500,27
"11795","E01028112",2001,710,174,536,88
"11796","E01028113",2001,611,258,353,19
"11797","E01028115",2001,642,4,638,9
"11798","E01028116",2001,647,25,622,32
"11799","E01028117",2001,521,8,513,10
"11800","E01028118",2001,724,29,695,32
"11801","E01028109",2001,736,75,661,33
"11802","E01028102",2001,596,55,541,46
"11803","E01028103",2001,488,148,340,35
"11804","E01028104",2001,624,33,591,40
"11805","E01028122",2001,706,239,467,41
"11806","E01028123",2001,548,43,505,11
"11807","E01028124",2001,647,36,611,42
"11808","E01028105",2001,500,54,446,34
"11809","E01028106",2001,660,52,608,85
"11810","E01028071",2001,406,27,379,28
"11811","E01028072",2001,506,43,463,39
"11812","E01028119",2001,573,3,570,27
"11813","E01028120",2001,639,4,635,11
"11814","E01028121",2001,589,7,582,54
"11815","E01028140",2001,401,32,369,11
"11816","E01028141",2001,618,3,615,31
"11817","E01028087",2001,632,6,626,50
"11818","E01028088",2001,643,3,640,27
"11819","E01028089",2001,527,5,522,23
"11820","E01028090",2001,633,151,482,31
"11821","E01028091",2001,619,8,611,25
"11822","E01028125",2001,693,43,650,53
"11823","E01028126",2001,571,104,467,43
"11824","E01028127",2001,775,323,452,26
"11825","E01028134",2001,620,59,561,103
"11826","E01028084",2001,736,16,720,77
"11827","E01028076",2001,613,101,512,70
"11828","E01028077",2001,598,227,371,53
"11829","E01028078",2001,603,137,466,89
"11830","E01028079",2001,632,31,601,208
"11831","E01028128",2001,743,8,735,35
"11832","E01028129",2001,666,177,489,19
"11833","E01028130",2001,747,228,519,42
"11834","E01028131",2001,634,20,614,40
"11835","E01028132",2001,440,136,304,17
"11836","E01028133",2001,633,40,593,129
"11837","E01028085",2001,727,108,619,160
"11838","E01028086",2001,762,35,727,196
"11839","E01028073",2001,734,199,535,190
"11840","E01028074",2001,733,217,516,170
"11841","E01028075",2001,739,68,671,241
"11842","E01028080",2001,656,40,616,141
"11843","E01028081",2001,585,46,539,98
"11844","E01028082",2001,523,8,515,34
"11845","E01028083",2001,627,167,460,152
"11846","E01028097",2001,629,3,626,30
"11847","E01028098",2001,734,288,446,153
"11848","E01028099",2001,638,41,597,52
"11849","E01028100",2001,760,136,624,37
"11850","E01028101",2001,626,287,339,29
"11851","E01028069",2001,525,8,517,63
"11852","E01028070",2001,485,4,481,28
"11853","E01028094",2001,676,78,598,48
"11854","E01028095",2001,623,89,534,57
"11855","E01028096",2001,748,16,732,125
"11856","E01028135",2001,573,0,573,7
"11857","E01028136",2001,645,7,638,19
"11858","E01028137",2001,538,10,528,25
"11859","E01028138",2001,579,55,524,36
"11860","E01028139",2001,582,14,568,24
"11861","E01028189",2001,888,126,762,64
"11862","E01028198",2001,605,6,599,18
"11863","E01028199",2001,631,3,628,16
"11864","E01028200",2001,598,6,592,13
"11865","E01028201",2001,483,0,483,5
"11866","E01028213",2001,846,34,812,155
"11867","E01028150",2001,623,17,606,25
"11868","E01028151",2001,438,6,432,34
"11869","E01028152",2001,580,37,543,13
"11870","E01028153",2001,577,230,347,18
"11871","E01028154",2001,555,42,513,22
"11872","E01028142",2001,681,48,633,36
"11873","E01028145",2001,522,11,511,12
"11874","E01028146",2001,639,17,622,25
"11875","E01028147",2001,485,228,257,21
"11876","E01028143",2001,645,149,496,28
"11877","E01028205",2001,505,88,417,15
"11878","E01028206",2001,642,22,620,34
"11879","E01028207",2001,526,12,514,13
"11880","E01028208",2001,501,83,418,25
"11881","E01028209",2001,630,157,473,44
"11882","E01028173",2001,477,324,153,10
"11883","E01028174",2001,610,196,414,13
"11884","E01028175",2001,747,74,673,38
"11885","E01028165",2001,752,199,553,86
"11886","E01028166",2001,703,215,488,18
"11887","E01028167",2001,766,112,654,96
"11888","E01028144",2001,633,49,584,75
"11889","E01028179",2001,532,0,532,8
"11890","E01028180",2001,597,28,569,19
"11891","E01028181",2001,661,8,653,38
"11892","E01028182",2001,496,87,409,10
"11893","E01028183",2001,617,21,596,20
"11894","E01028178",2001,878,46,832,48
"11895","E01028148",2001,810,6,804,43
"11896","E01028149",2001,748,58,690,43
"11897","E01028176",2001,595,8,587,15
"11898","E01028177",2001,738,15,723,49
"11899","E01028214",2001,637,11,626,35
"11900","E01028215",2001,511,3,508,12
"11901","E01028216",2001,518,4,514,7
"11902","E01028217",2001,478,13,465,35
"11903","E01028218",2001,647,6,641,30
"11904","E01028193",2001,506,136,370,21
"11905","E01028194",2001,628,17,611,69
"11906","E01028195",2001,633,11,622,37
"11907","E01028196",2001,591,6,585,28
"11908","E01028197",2001,622,40,582,34
"11909","E01028204",2001,595,30,565,30
"11910","E01028212",2001,587,200,387,27
"11911","E01028190",2001,648,18,630,26
"11912","E01028202",2001,649,66,583,21
"11913","E01028203",2001,609,76,533,27
"11914","E01028172",2001,453,42,411,5
"11915","E01028168",2001,499,13,486,17
"11916","E01028169",2001,568,7,561,30
"11917","E01028170",2001,615,101,514,44
"11918","E01028171",2001,551,59,492,44
"11919","E01028191",2001,743,81,662,52
"11920","E01028192",2001,657,92,565,64
"11921","E01028211",2001,493,86,407,26
"11922","E01028160",2001,655,29,626,64
"11923","E01028161",2001,629,38,591,62
"11924","E01028162",2001,624,57,567,43
"11925","E01028163",2001,611,0,611,47
"11926","E01028164",2001,579,191,388,24
"11927","E01028155",2001,617,80,537,59
"11928","E01028156",2001,678,88,590,46
"11929","E01028157",2001,507,0,507,28
"11930","E01028158",2001,716,123,593,111
"11931","E01028159",2001,579,113,466,53
"11932","E01028210",2001,675,180,495,79
"11933","E01028184",2001,487,6,481,33
"11934","E01028185",2001,745,123,622,101
"11935","E01028186",2001,757,193,564,122
"11936","E01028187",2001,641,117,524,142
"11937","E01028188",2001,638,52,586,43
"11938","E01028224",2001,650,191,459,19
"11939","E01028257",2001,589,106,483,65
"11940","E01028258",2001,692,174,518,18
"11941","E01028259",2001,515,119,396,71
"11942","E01028260",2001,713,117,596,46
"11943","E01028225",2001,633,123,510,30
"11944","E01028226",2001,592,138,454,88
"11945","E01028223",2001,626,168,458,131
"11946","E01028277",2001,530,13,517,12
"11947","E01028278",2001,636,88,548,31
"11948","E01028251",2001,634,3,631,11
"11949","E01028252",2001,623,265,358,16
"11950","E01028253",2001,711,13,698,19
"11951","E01028279",2001,640,242,398,15
"11952","E01028280",2001,528,222,306,16
"11953","E01028281",2001,588,277,311,63
"11954","E01028271",2001,644,203,441,81
"11955","E01028283",2001,514,13,501,29
"11956","E01028272",2001,658,48,610,127
"11957","E01028273",2001,618,35,583,40
"11958","E01028250",2001,616,14,602,54
"11959","E01028242",2001,694,13,681,57
"11960","E01028229",2001,722,182,540,23
"11961","E01028232",2001,621,103,518,32
"11962","E01028265",2001,514,219,295,56
"11963","E01028266",2001,516,77,439,13
"11964","E01028267",2001,606,311,295,18
"11965","E01028282",2001,504,164,340,19
"11966","E01028237",2001,616,30,586,21
"11967","E01028238",2001,584,165,419,25
"11968","E01028239",2001,636,28,608,72
"11969","E01028240",2001,637,17,620,25
"11970","E01028241",2001,593,4,589,11
"11971","E01028243",2001,764,178,586,20
"11972","E01028247",2001,746,225,521,150
"11973","E01028227",2001,607,127,480,85
"11974","E01028228",2001,625,74,551,131
"11975","E01028268",2001,626,91,535,145
"11976","E01028269",2001,611,37,574,140
"11977","E01028284",2001,630,140,490,137
"11978","E01028274",2001,570,149,421,104
"11979","E01028275",2001,614,285,329,24
"11980","E01028276",2001,753,470,283,61
"11981","E01028233",2001,751,100,651,110
"11982","E01028234",2001,728,320,408,57
"11983","E01028248",2001,627,126,501,32
"11984","E01028249",2001,570,90,480,19
"11985","E01028230",2001,587,250,337,16
"11986","E01028231",2001,631,277,354,16
"11987","E01028244",2001,646,58,588,30
"11988","E01028245",2001,607,279,328,14
"11989","E01028246",2001,641,3,638,18
"11990","E01028235",2001,652,6,646,22
"11991","E01028236",2001,661,12,649,32
"11992","E01028262",2001,624,9,615,11
"11993","E01028264",2001,771,22,749,12
"11994","E01028256",2001,724,414,310,25
"11995","E01028263",2001,730,590,140,9
"11996","E01028254",2001,534,42,492,36
"11997","E01028261",2001,619,317,302,15
"11998","E01028255",2001,590,21,569,10
"11999","E01028219",2001,597,12,585,15
"12000","E01028220",2001,664,17,647,43
"12001","E01028221",2001,630,14,616,12
"12002","E01028222",2001,650,10,640,11
"12003","E01028270",2001,641,18,623,36
"12004","E01028301",2001,734,353,381,52
"12005","E01028302",2001,612,113,499,15
"12006","E01028338",2001,678,183,495,44
"12007","E01028339",2001,704,81,623,99
"12008","E01028340",2001,722,237,485,35
"12009","E01028341",2001,671,19,652,65
"12010","E01028313",2001,753,308,445,32
"12011","E01028314",2001,670,110,560,39
"12012","E01028321",2001,600,59,541,21
"12013","E01028322",2001,844,222,622,34
"12014","E01028323",2001,625,37,588,67
"12015","E01028303",2001,651,52,599,22
"12016","E01028312",2001,886,69,817,145
"12017","E01028349",2001,578,49,529,51
"12018","E01028350",2001,480,78,402,28
"12019","E01028337",2001,579,13,566,26
"12020","E01028353",2001,860,88,772,50
"12021","E01028315",2001,646,0,646,41
"12022","E01028316",2001,686,141,545,43
"12023","E01028317",2001,606,45,561,35
"12024","E01028295",2001,680,10,670,40
"12025","E01028327",2001,663,110,553,53
"12026","E01028328",2001,693,27,666,39
"12027","E01028329",2001,555,34,521,35
"12028","E01028297",2001,788,294,494,25
"12029","E01028298",2001,616,49,567,28
"12030","E01028299",2001,513,143,370,31
"12031","E01028300",2001,648,207,441,34
"12032","E01028296",2001,541,60,481,32
"12033","E01028342",2001,635,48,587,87
"12034","E01028343",2001,897,231,666,27
"12035","E01028344",2001,620,6,614,23
"12036","E01028294",2001,753,135,618,112
"12037","E01028310",2001,753,175,578,176
"12038","E01028311",2001,799,233,566,184
"12039","E01028304",2001,574,261,313,11
"12040","E01028305",2001,530,59,471,52
"12041","E01028306",2001,626,179,447,17
"12042","E01028307",2001,475,35,440,19
"12043","E01028345",2001,905,105,800,87
"12044","E01028346",2001,908,60,848,61
"12045","E01028347",2001,524,13,511,55
"12046","E01028348",2001,465,87,378,40
"12047","E01028333",2001,623,48,575,62
"12048","E01028334",2001,606,262,344,17
"12049","E01028335",2001,782,122,660,148
"12050","E01028292",2001,614,9,605,53
"12051","E01028293",2001,666,13,653,93
"12052","E01028308",2001,641,64,577,28
"12053","E01028309",2001,562,4,558,18
"12054","E01028318",2001,620,251,369,14
"12055","E01028319",2001,774,326,448,30
"12056","E01028320",2001,767,418,349,13
"12057","E01028285",2001,525,10,515,60
"12058","E01028286",2001,570,144,426,17
"12059","E01028287",2001,623,36,587,28
"12060","E01028288",2001,608,17,591,38
"12061","E01028289",2001,651,19,632,38
"12062","E01028290",2001,635,118,517,18
"12063","E01028291",2001,625,137,488,27
"12064","E01028336",2001,441,50,391,44
"12065","E01028324",2001,597,22,575,38
"12066","E01028325",2001,484,48,436,32
"12067","E01028326",2001,602,141,461,16
"12068","E01028352",2001,416,10,406,9
"12069","E01028351",2001,467,23,444,18
"12070","E01028330",2001,665,20,645,49
"12071","E01028331",2001,555,77,478,42
"12072","E01028332",2001,603,28,575,34
"12073","E01028371",2001,783,59,724,57
"12074","E01028403",2001,905,82,823,72
"12075","E01028411",2001,798,43,755,87
"12076","E01028357",2001,628,8,620,42
"12077","E01028358",2001,602,141,461,47
"12078","E01028359",2001,606,5,601,22
"12079","E01028360",2001,626,58,568,64
"12080","E01028361",2001,609,11,598,23
"12081","E01028362",2001,613,235,378,38
"12082","E01028413",2001,713,208,505,42
"12083","E01028414",2001,629,7,622,67
"12084","E01028415",2001,604,29,575,52
"12085","E01028393",2001,502,3,499,20
"12086","E01028394",2001,657,75,582,27
"12087","E01028395",2001,492,14,478,22
"12088","E01028384",2001,623,9,614,137
"12089","E01028385",2001,654,54,600,76
"12090","E01028386",2001,643,19,624,140
"12091","E01028354",2001,579,5,574,65
"12092","E01028355",2001,670,79,591,65
"12093","E01028396",2001,557,16,541,95
"12094","E01028416",2001,700,151,549,307
"12095","E01028417",2001,626,18,608,328
"12096","E01028418",2001,724,132,592,308
"12097","E01028398",2001,706,53,653,171
"12098","E01028399",2001,517,27,490,166
"12099","E01028397",2001,559,40,519,18
"12100","E01028356",2001,599,10,589,31
"12101","E01028375",2001,614,73,541,79
"12102","E01028376",2001,647,6,641,109
"12103","E01028377",2001,741,9,732,33
"12104","E01028363",2001,511,3,508,25
"12105","E01028364",2001,640,0,640,35
"12106","E01028365",2001,637,8,629,95
"12107","E01028391",2001,829,27,802,30
"12108","E01028392",2001,883,225,658,75
"12109","E01028372",2001,578,162,416,64
"12110","E01028373",2001,535,28,507,18
"12111","E01028374",2001,558,200,358,22
"12112","E01028400",2001,556,7,549,34
"12113","E01028401",2001,487,48,439,30
"12114","E01028366",2001,517,170,347,12
"12115","E01028367",2001,527,34,493,35
"12116","E01028368",2001,613,16,597,23
"12117","E01028369",2001,591,189,402,29
"12118","E01028370",2001,611,133,478,30
"12119","E01028419",2001,1015,141,874,67
"12120","E01028420",2001,521,26,495,92
"12121","E01028402",2001,731,20,711,52
"12122","E01028404",2001,637,8,629,69
"12123","E01028405",2001,737,269,468,37
"12124","E01028406",2001,686,136,550,45
"12125","E01028407",2001,752,27,725,60
"12126","E01028421",2001,800,22,778,46
"12127","E01028379",2001,709,5,704,22
"12128","E01028412",2001,758,6,752,35
"12129","E01028380",2001,516,210,306,27
"12130","E01028381",2001,597,3,594,14
"12131","E01028382",2001,621,6,615,44
"12132","E01028383",2001,494,33,461,24
"12133","E01028387",2001,599,173,426,15
"12134","E01028408",2001,802,59,743,145
"12135","E01028378",2001,865,87,778,75
"12136","E01028409",2001,461,12,449,28
"12137","E01028410",2001,469,36,433,83
"12138","E01028388",2001,555,3,552,17
"12139","E01028389",2001,644,19,625,39
"12140","E01028390",2001,688,72,616,20
"12141","E01013998",2001,591,30,561,29
"12142","E01014051",2001,661,72,589,78
"12143","E01014052",2001,616,10,606,170
"12144","E01014096",2001,636,33,603,48
"12145","E01014041",2001,734,61,673,88
"12146","E01014042",2001,608,256,352,60
"12147","E01014043",2001,526,13,513,32
"12148","E01014044",2001,609,82,527,46
"12149","E01014045",2001,544,29,515,70
"12150","E01014046",2001,601,54,547,21
"12151","E01014047",2001,599,199,400,37
"12152","E01014048",2001,658,222,436,142
"12153","E01014024",2001,535,42,493,85
"12154","E01014025",2001,591,63,528,43
"12155","E01014055",2001,649,85,564,76
"12156","E01014097",2001,559,54,505,69
"12157","E01013999",2001,583,32,551,77
"12158","E01014017",2001,652,23,629,116
"12159","E01014015",2001,610,59,551,75
"12160","E01014000",2001,543,29,514,46
"12161","E01014001",2001,594,58,536,57
"12162","E01014002",2001,615,11,604,31
"12163","E01014003",2001,575,117,458,41
"12164","E01014004",2001,569,63,506,68
"12165","E01014005",2001,743,296,447,106
"12166","E01014008",2001,691,87,604,57
"12167","E01014009",2001,634,77,557,68
"12168","E01014033",2001,753,84,669,115
"12169","E01014034",2001,639,169,470,141
"12170","E01014056",2001,612,20,592,94
"12171","E01014100",2001,640,60,580,65
"12172","E01014101",2001,457,32,425,145
"12173","E01014016",2001,642,128,514,86
"12174","E01014012",2001,681,37,644,75
"12175","E01014013",2001,611,142,469,71
"12176","E01014006",2001,608,64,544,42
"12177","E01014022",2001,730,25,705,59
"12178","E01014023",2001,600,88,512,53
"12179","E01014081",2001,574,46,528,43
"12180","E01014082",2001,693,82,611,38
"12181","E01014027",2001,548,72,476,61
"12182","E01014028",2001,648,32,616,72
"12183","E01014029",2001,641,137,504,58
"12184","E01014030",2001,559,72,487,26
"12185","E01014083",2001,653,10,643,43
"12186","E01014084",2001,766,162,604,89
"12187","E01014085",2001,580,157,423,43
"12188","E01014087",2001,760,22,738,120
"12189","E01014088",2001,769,98,671,100
"12190","E01014089",2001,589,99,490,29
"12191","E01014095",2001,597,124,473,50
"12192","E01014007",2001,644,10,634,38
"12193","E01013987",2001,584,39,545,28
"12194","E01013988",2001,781,54,727,85
"12195","E01013989",2001,580,222,358,28
"12196","E01013986",2001,657,281,376,37
"12197","E01014010",2001,640,136,504,215
"12198","E01014011",2001,639,147,492,106
"12199","E01014092",2001,808,64,744,131
"12200","E01014086",2001,785,295,490,144
"12201","E01014075",2001,634,26,608,62
"12202","E01014076",2001,761,64,697,147
"12203","E01014077",2001,739,48,691,55
"12204","E01014078",2001,623,142,481,23
"12205","E01014090",2001,619,13,606,28
"12206","E01014091",2001,643,16,627,30
"12207","E01014093",2001,607,121,486,24
"12208","E01014094",2001,594,33,561,28
"12209","E01014070",2001,641,71,570,25
"12210","E01014072",2001,611,210,401,30
"12211","E01014073",2001,622,295,327,136
"12212","E01014074",2001,750,344,406,69
"12213","E01014068",2001,623,127,496,26
"12214","E01014079",2001,585,99,486,47
"12215","E01014080",2001,552,99,453,21
"12216","E01013996",2001,666,21,645,69
"12217","E01013997",2001,710,55,655,78
"12218","E01013992",2001,622,216,406,45
"12219","E01013993",2001,612,246,366,20
"12220","E01013994",2001,648,330,318,17
"12221","E01013995",2001,730,474,256,16
"12222","E01014071",2001,627,302,325,30
"12223","E01014054",2001,534,61,473,68
"12224","E01013990",2001,715,61,654,58
"12225","E01013991",2001,502,79,423,60
"12226","E01014014",2001,671,43,628,93
"12227","E01014035",2001,801,275,526,99
"12228","E01014036",2001,725,34,691,141
"12229","E01014037",2001,737,58,679,38
"12230","E01014038",2001,627,147,480,31
"12231","E01014039",2001,660,20,640,60
"12232","E01014040",2001,671,73,598,57
"12233","E01014018",2001,593,25,568,95
"12234","E01014019",2001,631,81,550,70
"12235","E01014020",2001,607,18,589,75
"12236","E01014021",2001,593,59,534,66
"12237","E01014069",2001,688,101,587,72
"12238","E01014059",2001,728,30,698,99
"12239","E01014060",2001,606,33,573,62
"12240","E01014026",2001,813,81,732,102
"12241","E01014098",2001,550,166,384,53
"12242","E01014099",2001,712,32,680,126
"12243","E01014061",2001,655,55,600,32
"12244","E01014062",2001,715,87,628,130
"12245","E01014063",2001,648,138,510,29
"12246","E01014064",2001,732,299,433,49
"12247","E01014065",2001,618,64,554,39
"12248","E01014066",2001,498,94,404,70
"12249","E01014067",2001,605,3,602,18
"12250","E01014057",2001,618,127,491,48
"12251","E01014058",2001,665,10,655,45
"12252","E01014053",2001,695,53,642,132
"12253","E01014031",2001,604,46,558,52
"12254","E01014032",2001,615,39,576,51
"12255","E01014049",2001,597,36,561,86
"12256","E01014050",2001,670,37,633,78
"12257","E01014257",2001,652,166,486,24
"12258","E01014258",2001,498,5,493,22
"12259","E01014259",2001,647,81,566,22
"12260","E01014260",2001,622,219,403,16
"12261","E01014264",2001,592,80,512,32
"12262","E01014357",2001,702,207,495,41
"12263","E01014358",2001,596,285,311,44
"12264","E01014359",2001,709,191,518,28
"12265","E01014360",2001,598,23,575,57
"12266","E01014333",2001,607,28,579,11
"12267","E01014334",2001,762,257,505,7
"12268","E01014261",2001,600,355,245,36
"12269","E01014262",2001,533,223,310,8
"12270","E01014263",2001,597,276,321,13
"12271","E01014335",2001,614,56,558,33
"12272","E01014336",2001,709,359,350,29
"12273","E01014337",2001,742,254,488,25
"12274","E01014331",2001,633,290,343,19
"12275","E01014332",2001,772,133,639,8
"12276","E01014361",2001,627,85,542,103
"12277","E01014354",2001,801,299,502,95
"12278","E01014355",2001,629,57,572,67
"12279","E01014356",2001,663,55,608,92
"12280","E01014248",2001,639,54,585,79
"12281","E01014241",2001,637,139,498,26
"12282","E01014242",2001,621,272,349,10
"12283","E01014243",2001,600,38,562,25
"12284","E01014244",2001,580,375,205,19
"12285","E01014245",2001,672,30,642,51
"12286","E01014265",2001,611,20,591,17
"12287","E01014267",2001,676,117,559,36
"12288","E01014272",2001,552,15,537,22
"12289","E01014214",2001,629,5,624,19
"12290","E01014215",2001,606,30,576,32
"12291","E01014216",2001,630,41,589,22
"12292","E01014270",2001,638,24,614,19
"12293","E01014271",2001,616,59,557,25
"12294","E01014268",2001,672,315,357,28
"12295","E01014266",2001,574,122,452,48
"12296","E01014246",2001,717,201,516,59
"12297","E01014247",2001,756,107,649,85
"12298","E01014250",2001,676,206,470,74
"12299","E01014251",2001,734,192,542,121
"12300","E01014252",2001,628,65,563,76
"12301","E01014255",2001,575,324,251,24
"12302","E01014269",2001,677,354,323,17
"12303","E01014324",2001,683,13,670,27
"12304","E01014325",2001,545,7,538,14
"12305","E01014326",2001,584,7,577,13
"12306","E01014256",2001,742,263,479,67
"12307","E01014249",2001,700,162,538,118
"12308","E01014253",2001,640,121,519,20
"12309","E01014254",2001,641,94,547,136
"12310","E01014217",2001,622,404,218,13
"12311","E01014210",2001,612,284,328,19
"12312","E01014211",2001,616,430,186,19
"12313","E01014212",2001,625,343,282,16
"12314","E01014213",2001,528,202,326,16
"12315","E01014327",2001,682,33,649,69
"12316","E01014328",2001,652,95,557,90
"12317","E01014329",2001,749,154,595,65
"12318","E01014330",2001,868,463,405,100
"12319","E01014323",2001,608,47,561,82
"12320","E01014218",2001,636,348,288,20
"12321","E01014219",2001,583,83,500,32
"12322","E01014225",2001,662,18,644,21
"12323","E01014226",2001,753,318,435,20
"12324","E01014228",2001,578,11,567,5
"12325","E01014230",2001,711,184,527,36
"12326","E01014281",2001,520,119,401,139
"12327","E01014285",2001,670,168,502,91
"12328","E01014286",2001,526,75,451,108
"12329","E01014287",2001,568,198,370,94
"12330","E01014282",2001,478,200,278,80
"12331","E01014283",2001,632,36,596,306
"12332","E01014284",2001,535,32,503,295
"12333","E01014231",2001,897,366,531,141
"12334","E01014232",2001,694,61,633,78
"12335","E01014227",2001,714,161,553,99
"12336","E01014229",2001,673,446,227,12
"12337","E01014220",2001,702,397,305,24
"12338","E01014221",2001,642,349,293,28
"12339","E01014222",2001,659,407,252,25
"12340","E01014223",2001,755,435,320,19
"12341","E01014224",2001,668,395,273,9
"12342","E01014288",2001,726,34,692,99
"12343","E01014289",2001,670,26,644,83
"12344","E01014290",2001,622,70,552,74
"12345","E01014291",2001,695,160,535,77
"12346","E01014292",2001,632,23,609,87
"12347","E01014294",2001,631,180,451,55
"12348","E01014295",2001,801,163,638,62
"12349","E01014293",2001,639,65,574,144
"12350","E01014339",2001,787,60,727,173
"12351","E01014340",2001,687,162,525,97
"12352","E01014345",2001,828,231,597,162
"12353","E01014279",2001,687,69,618,128
"12354","E01014274",2001,779,278,501,58
"12355","E01014275",2001,751,324,427,82
"12356","E01014276",2001,758,102,656,83
"12357","E01014277",2001,683,74,609,61
"12358","E01014278",2001,595,90,505,41
"12359","E01014273",2001,639,47,592,120
"12360","E01014280",2001,612,25,587,28
"12361","E01014297",2001,483,3,480,14
"12362","E01014298",2001,627,295,332,14
"12363","E01014300",2001,644,214,430,29
"12364","E01014296",2001,601,103,498,22
"12365","E01014302",2001,765,297,468,40
"12366","E01014341",2001,644,255,389,38
"12367","E01014342",2001,624,359,265,15
"12368","E01014343",2001,745,116,629,133
"12369","E01014344",2001,617,204,413,35
"12370","E01014338",2001,626,60,566,49
"12371","E01014363",2001,638,51,587,7
"12372","E01014364",2001,623,117,506,22
"12373","E01014365",2001,635,86,549,10
"12374","E01014369",2001,621,67,554,114
"12375","E01014362",2001,582,8,574,6
"12376","E01014303",2001,677,9,668,23
"12377","E01014304",2001,651,16,635,27
"12378","E01014301",2001,557,56,501,12
"12379","E01014299",2001,615,12,603,19
"12380","E01014239",2001,613,60,553,17
"12381","E01014240",2001,602,165,437,14
"12382","E01014233",2001,626,75,551,18
"12383","E01014234",2001,539,314,225,21
"12384","E01014308",2001,764,91,673,27
"12385","E01014309",2001,577,180,397,66
"12386","E01014311",2001,625,127,498,41
"12387","E01014313",2001,797,374,423,22
"12388","E01014321",2001,633,29,604,98
"12389","E01014366",2001,750,395,355,16
"12390","E01014367",2001,722,425,297,25
"12391","E01014368",2001,591,193,398,48
"12392","E01014312",2001,626,59,567,58
"12393","E01014305",2001,492,32,460,57
"12394","E01014306",2001,545,91,454,85
"12395","E01014307",2001,483,63,420,59
"12396","E01014346",2001,724,19,705,16
"12397","E01014348",2001,628,4,624,12
"12398","E01014349",2001,647,3,644,17
"12399","E01014353",2001,649,266,383,12
"12400","E01014310",2001,643,25,618,14
"12401","E01014322",2001,627,183,444,38
"12402","E01014314",2001,516,9,507,15
"12403","E01014316",2001,614,404,210,22
"12404","E01014317",2001,666,431,235,10
"12405","E01014235",2001,757,315,442,32
"12406","E01014236",2001,650,339,311,16
"12407","E01014237",2001,736,390,346,29
"12408","E01014238",2001,630,391,239,17
"12409","E01014318",2001,600,5,595,8
"12410","E01014319",2001,604,128,476,21
"12411","E01014320",2001,487,11,476,18
"12412","E01014315",2001,595,9,586,5
"12413","E01014350",2001,554,10,544,9
"12414","E01014351",2001,557,13,544,16
"12415","E01014352",2001,567,34,533,14
"12416","E01014347",2001,584,5,579,14
"12417","E01014171",2001,597,149,448,34
"12418","E01014172",2001,490,9,481,17
"12419","E01014173",2001,641,154,487,55
"12420","E01014174",2001,523,4,519,12
"12421","E01014135",2001,448,38,410,56
"12422","E01014112",2001,595,35,560,49
"12423","E01014131",2001,601,54,547,76
"12424","E01014132",2001,448,30,418,22
"12425","E01014175",2001,512,104,408,26
"12426","E01014176",2001,586,10,576,46
"12427","E01014177",2001,601,45,556,32
"12428","E01014178",2001,607,136,471,122
"12429","E01014167",2001,537,94,443,27
"12430","E01014168",2001,530,8,522,26
"12431","E01014111",2001,565,74,491,80
"12432","E01014170",2001,615,9,606,23
"12433","E01014169",2001,607,230,377,49
"12434","E01014125",2001,637,275,362,17
"12435","E01014126",2001,616,175,441,20
"12436","E01014127",2001,607,348,259,27
"12437","E01014128",2001,603,187,416,106
"12438","E01014129",2001,589,228,361,25
"12439","E01014130",2001,606,34,572,35
"12440","E01014189",2001,587,81,506,38
"12441","E01014190",2001,615,12,603,23
"12442","E01014179",2001,487,10,477,13
"12443","E01014180",2001,602,124,478,15
"12444","E01014138",2001,588,153,435,25
"12445","E01014140",2001,655,195,460,65
"12446","E01014102",2001,607,5,602,39
"12447","E01014103",2001,488,36,452,26
"12448","E01014205",2001,622,10,612,16
"12449","E01014206",2001,513,97,416,28
"12450","E01014207",2001,499,16,483,36
"12451","E01014208",2001,499,164,335,15
"12452","E01014209",2001,603,110,493,35
"12453","E01014141",2001,542,150,392,25
"12454","E01014142",2001,473,222,251,48
"12455","E01014143",2001,685,279,406,53
"12456","E01014139",2001,556,146,410,42
"12457","E01014137",2001,531,29,502,35
"12458","E01014136",2001,699,114,585,88
"12459","E01014148",2001,650,51,599,84
"12460","E01014149",2001,404,55,349,30
"12461","E01014202",2001,609,18,591,63
"12462","E01014203",2001,610,41,569,43
"12463","E01014204",2001,704,52,652,80
"12464","E01014113",2001,651,237,414,66
"12465","E01014114",2001,658,91,567,64
"12466","E01014104",2001,644,181,463,21
"12467","E01014105",2001,641,263,378,46
"12468","E01014133",2001,631,74,557,31
"12469","E01014134",2001,616,14,602,19
"12470","E01014144",2001,623,229,394,31
"12471","E01014145",2001,640,252,388,56
"12472","E01014185",2001,730,361,369,27
"12473","E01014186",2001,611,88,523,52
"12474","E01014187",2001,675,131,544,31
"12475","E01014188",2001,522,13,509,31
"12476","E01014150",2001,624,26,598,34
"12477","E01014151",2001,641,288,353,21
"12478","E01014152",2001,607,199,408,18
"12479","E01014153",2001,747,187,560,48
"12480","E01014154",2001,625,120,505,22
"12481","E01014155",2001,615,177,438,26
"12482","E01014181",2001,502,3,499,19
"12483","E01014182",2001,497,11,486,27
"12484","E01014183",2001,621,27,594,29
"12485","E01014184",2001,549,123,426,91
"12486","E01014156",2001,640,215,425,47
"12487","E01014157",2001,521,5,516,19
"12488","E01014158",2001,620,154,466,31
"12489","E01014146",2001,541,61,480,35
"12490","E01014147",2001,577,37,540,21
"12491","E01014124",2001,712,282,430,47
"12492","E01014163",2001,516,267,249,39
"12493","E01014164",2001,642,441,201,13
"12494","E01014165",2001,608,278,330,42
"12495","E01014166",2001,641,120,521,35
"12496","E01014191",2001,739,214,525,125
"12497","E01014192",2001,485,86,399,44
"12498","E01014193",2001,621,163,458,36
"12499","E01014194",2001,634,179,455,40
"12500","E01014195",2001,513,18,495,16
"12501","E01014196",2001,629,256,373,40
"12502","E01014119",2001,614,112,502,23
"12503","E01014120",2001,780,458,322,14
"12504","E01014121",2001,629,121,508,23
"12505","E01014122",2001,752,76,676,92
"12506","E01014123",2001,621,7,614,31
"12507","E01014106",2001,619,107,512,47
"12508","E01014107",2001,500,25,475,14
"12509","E01014108",2001,649,278,371,95
"12510","E01014109",2001,495,66,429,47
"12511","E01014110",2001,498,153,345,63
"12512","E01014197",2001,542,130,412,63
"12513","E01014198",2001,603,296,307,88
"12514","E01014199",2001,548,136,412,51
"12515","E01014200",2001,524,217,307,61
"12516","E01014201",2001,465,123,342,54
"12517","E01014159",2001,626,192,434,27
"12518","E01014160",2001,500,26,474,24
"12519","E01014161",2001,496,140,356,30
"12520","E01014162",2001,792,347,445,60
"12521","E01014115",2001,604,143,461,68
"12522","E01014116",2001,609,297,312,41
"12523","E01014117",2001,513,16,497,19
"12524","E01014118",2001,494,109,385,83
"12525","E01028853",2001,598,292,306,14
"12526","E01028854",2001,593,60,533,29
"12527","E01028855",2001,609,9,600,55
"12528","E01028856",2001,492,87,405,48
"12529","E01028857",2001,716,118,598,76
"12530","E01028844",2001,458,46,412,288
"12531","E01028845",2001,828,22,806,59
"12532","E01028826",2001,709,129,580,59
"12533","E01028827",2001,586,151,435,51
"12534","E01028838",2001,630,212,418,52
"12535","E01028839",2001,527,3,524,17
"12536","E01028840",2001,510,62,448,18
"12537","E01028841",2001,646,136,510,134
"12538","E01028850",2001,596,21,575,122
"12539","E01028851",2001,623,58,565,74
"12540","E01028852",2001,631,102,529,89
"12541","E01028836",2001,645,244,401,17
"12542","E01028837",2001,649,26,623,45
"12543","E01028830",2001,617,19,598,139
"12544","E01028831",2001,613,32,581,25
"12545","E01028832",2001,757,92,665,120
"12546","E01028833",2001,589,74,515,62
"12547","E01028834",2001,597,100,497,21
"12548","E01028835",2001,612,79,533,32
"12549","E01028828",2001,605,84,521,105
"12550","E01028829",2001,561,43,518,10
"12551","E01028859",2001,595,56,539,129
"12552","E01028842",2001,603,36,567,86
"12553","E01028847",2001,571,55,516,146
"12554","E01028848",2001,583,6,577,18
"12555","E01028849",2001,740,227,513,59
"12556","E01028846",2001,625,47,578,79
"12557","E01028843",2001,604,42,562,124
"12558","E01028858",2001,618,30,588,101
"12559","E01028894",2001,624,195,429,25
"12560","E01028895",2001,617,113,504,88
"12561","E01028896",2001,728,40,688,110
"12562","E01028897",2001,605,129,476,16
"12563","E01028891",2001,690,135,555,171
"12564","E01028892",2001,551,9,542,34
"12565","E01028893",2001,541,48,493,37
"12566","E01028880",2001,585,79,506,38
"12567","E01028881",2001,507,12,495,37
"12568","E01028882",2001,540,40,500,129
"12569","E01028899",2001,564,57,507,33
"12570","E01028864",2001,590,69,521,63
"12571","E01028865",2001,608,13,595,44
"12572","E01028866",2001,535,26,509,168
"12573","E01028867",2001,597,189,408,42
"12574","E01028872",2001,510,25,485,102
"12575","E01028873",2001,726,285,441,95
"12576","E01028874",2001,603,38,565,33
"12577","E01028875",2001,654,39,615,29
"12578","E01028876",2001,757,196,561,77
"12579","E01028877",2001,525,6,519,34
"12580","E01028878",2001,623,64,559,77
"12581","E01028879",2001,628,176,452,33
"12582","E01028886",2001,613,146,467,56
"12583","E01028887",2001,507,29,478,22
"12584","E01028889",2001,607,44,563,29
"12585","E01028890",2001,587,110,477,82
"12586","E01028868",2001,504,52,452,36
"12587","E01028869",2001,483,72,411,38
"12588","E01028871",2001,467,72,395,78
"12589","E01028885",2001,711,47,664,193
"12590","E01028898",2001,543,29,514,53
"12591","E01028862",2001,561,48,513,42
"12592","E01028863",2001,443,50,393,32
"12593","E01028888",2001,518,24,494,67
"12594","E01028860",2001,573,45,528,35
"12595","E01028861",2001,493,38,455,128
"12596","E01028883",2001,497,33,464,183
"12597","E01028884",2001,609,133,476,42
"12598","E01028870",2001,553,38,515,61
"12599","E01028910",2001,525,27,498,69
"12600","E01028911",2001,515,37,478,15
"12601","E01028912",2001,479,211,268,36
"12602","E01028920",2001,488,149,339,23
"12603","E01028921",2001,583,42,541,37
"12604","E01028925",2001,501,7,494,37
"12605","E01028926",2001,530,169,361,28
"12606","E01028909",2001,616,202,414,32
"12607","E01028900",2001,491,31,460,25
"12608","E01028901",2001,470,6,464,26
"12609","E01028902",2001,501,18,483,30
"12610","E01028903",2001,638,222,416,20
"12611","E01028904",2001,495,132,363,14
"12612","E01028905",2001,603,230,373,33
"12613","E01028906",2001,655,152,503,235
"12614","E01028907",2001,643,17,626,78
"12615","E01028908",2001,725,217,508,172
"12616","E01028916",2001,662,32,630,21
"12617","E01028917",2001,521,26,495,104
"12618","E01028924",2001,414,109,305,22
"12619","E01028927",2001,405,12,393,64
"12620","E01028928",2001,612,110,502,32
"12621","E01028918",2001,548,60,488,90
"12622","E01028919",2001,437,39,398,48
"12623","E01028913",2001,545,33,512,42
"12624","E01028914",2001,450,55,395,31
"12625","E01028915",2001,500,38,462,23
"12626","E01028922",2001,476,21,455,78
"12627","E01028923",2001,607,32,575,55
"12628","E01028929",2001,601,14,587,45
"12629","E01028969",2001,493,48,445,75
"12630","E01028970",2001,456,21,435,64
"12631","E01028971",2001,851,95,756,134
"12632","E01028978",2001,572,81,491,77
"12633","E01028979",2001,476,62,414,50
"12634","E01028956",2001,630,35,595,13
"12635","E01028957",2001,647,408,239,17
"12636","E01028958",2001,750,190,560,36
"12637","E01028933",2001,611,79,532,31
"12638","E01028934",2001,593,241,352,10
"12639","E01028932",2001,662,0,662,30
"12640","E01028981",2001,642,18,624,39
"12641","E01028982",2001,636,149,487,19
"12642","E01028983",2001,779,360,419,12
"12643","E01028944",2001,744,150,594,53
"12644","E01028945",2001,866,185,681,133
"12645","E01028930",2001,655,35,620,76
"12646","E01028931",2001,674,102,572,104
"12647","E01028965",2001,623,179,444,36
"12648","E01028966",2001,496,0,496,14
"12649","E01028967",2001,629,361,268,14
"12650","E01028968",2001,498,155,343,18
"12651","E01028988",2001,717,97,620,75
"12652","E01028989",2001,602,199,403,12
"12653","E01028972",2001,714,0,714,52
"12654","E01028973",2001,871,126,745,238
"12655","E01028946",2001,729,73,656,306
"12656","E01028987",2001,885,167,718,188
"12657","E01028941",2001,748,112,636,54
"12658","E01028942",2001,483,9,474,25
"12659","E01028943",2001,1046,26,1020,167
"12660","E01028951",2001,609,91,518,18
"12661","E01028953",2001,612,7,605,43
"12662","E01028947",2001,631,15,616,16
"12663","E01028948",2001,633,176,457,12
"12664","E01028949",2001,624,26,598,42
"12665","E01028985",2001,617,13,604,51
"12666","E01028984",2001,624,158,466,31
"12667","E01028938",2001,736,77,659,143
"12668","E01028939",2001,721,32,689,149
"12669","E01028986",2001,608,30,578,20
"12670","E01028940",2001,633,74,559,39
"12671","E01028974",2001,500,25,475,56
"12672","E01028952",2001,724,6,718,86
"12673","E01028962",2001,638,375,263,16
"12674","E01028963",2001,629,7,622,36
"12675","E01028964",2001,644,3,641,40
"12676","E01028959",2001,959,165,794,156
"12677","E01028935",2001,629,5,624,17
"12678","E01028936",2001,846,6,840,49
"12679","E01028937",2001,622,74,548,20
"12680","E01028954",2001,498,27,471,35
"12681","E01028955",2001,456,121,335,13
"12682","E01028975",2001,642,99,543,18
"12683","E01028976",2001,647,15,632,43
"12684","E01028977",2001,724,103,621,60
"12685","E01028960",2001,505,18,487,70
"12686","E01028961",2001,450,26,424,100
"12687","E01028950",2001,866,79,787,87
"12688","E01028980",2001,874,94,780,141
"12689","E01028991",2001,482,36,446,72
"12690","E01028992",2001,589,129,460,91
"12691","E01029017",2001,1120,66,1054,195
"12692","E01028997",2001,950,115,835,49
"12693","E01028998",2001,987,63,924,82
"12694","E01028990",2001,424,37,387,44
"12695","E01028993",2001,548,25,523,125
"12696","E01029004",2001,423,15,408,116
"12697","E01029013",2001,588,36,552,108
"12698","E01029014",2001,476,188,288,29
"12699","E01029015",2001,543,28,515,129
"12700","E01029016",2001,532,11,521,78
"12701","E01029005",2001,505,25,480,120
"12702","E01028994",2001,481,57,424,47
"12703","E01029003",2001,908,55,853,113
"12704","E01029006",2001,611,114,497,20
"12705","E01029007",2001,485,225,260,32
"12706","E01029008",2001,1185,207,978,221
"12707","E01029009",2001,518,4,514,31
"12708","E01029010",2001,543,134,409,44
"12709","E01029011",2001,632,132,500,49
"12710","E01029012",2001,560,11,549,50
"12711","E01028995",2001,519,64,455,46
"12712","E01028996",2001,512,7,505,57
"12713","E01028999",2001,614,63,551,66
"12714","E01029000",2001,423,19,404,31
"12715","E01029001",2001,591,22,569,47
"12716","E01029002",2001,516,109,407,53
"12717","E01029368",2001,510,3,507,4
"12718","E01029369",2001,497,5,492,14
"12719","E01029370",2001,560,6,554,21
"12720","E01029371",2001,525,42,483,8
"12721","E01029402",2001,662,7,655,14
"12722","E01029403",2001,621,142,479,19
"12723","E01029404",2001,749,172,577,149
"12724","E01029401",2001,646,51,595,24
"12725","E01029372",2001,520,304,216,18
"12726","E01029373",2001,612,159,453,59
"12727","E01029374",2001,712,19,693,83
"12728","E01029345",2001,593,95,498,23
"12729","E01029346",2001,727,329,398,41
"12730","E01029347",2001,624,0,624,11
"12731","E01029348",2001,642,140,502,19
"12732","E01029383",2001,618,41,577,17
"12733","E01029385",2001,607,8,599,16
"12734","E01029388",2001,600,249,351,20
"12735","E01029390",2001,451,223,228,29
"12736","E01029389",2001,683,38,645,64
"12737","E01029386",2001,593,148,445,24
"12738","E01029387",2001,608,177,431,38
"12739","E01029384",2001,658,70,588,27
"12740","E01029398",2001,679,131,548,20
"12741","E01029399",2001,636,64,572,48
"12742","E01029400",2001,617,154,463,20
"12743","E01029379",2001,511,92,419,9
"12744","E01029354",2001,637,140,497,27
"12745","E01029355",2001,630,212,418,29
"12746","E01029356",2001,638,291,347,25
"12747","E01029357",2001,607,188,419,43
"12748","E01029358",2001,512,286,226,23
"12749","E01029349",2001,592,213,379,21
"12750","E01029350",2001,620,209,411,50
"12751","E01029351",2001,628,308,320,45
"12752","E01029352",2001,540,31,509,55
"12753","E01029393",2001,759,83,676,22
"12754","E01029391",2001,618,28,590,30
"12755","E01029392",2001,605,19,586,32
"12756","E01029380",2001,547,8,539,19
"12757","E01029381",2001,623,195,428,18
"12758","E01029382",2001,662,108,554,50
"12759","E01029375",2001,481,3,478,0
"12760","E01029376",2001,646,42,604,42
"12761","E01029377",2001,502,3,499,8
"12762","E01029378",2001,631,0,631,20
"12763","E01029364",2001,687,37,650,65
"12764","E01029365",2001,614,72,542,31
"12765","E01029366",2001,736,25,711,7
"12766","E01029367",2001,851,207,644,51
"12767","E01029353",2001,644,145,499,28
"12768","E01029359",2001,481,142,339,64
"12769","E01029360",2001,678,153,525,73
"12770","E01029361",2001,595,156,439,28
"12771","E01029362",2001,641,319,322,32
"12772","E01029363",2001,653,188,465,11
"12773","E01029394",2001,604,86,518,17
"12774","E01029395",2001,616,9,607,24
"12775","E01029396",2001,641,58,583,14
"12776","E01029397",2001,718,337,381,25
"12777","E01029405",2001,593,33,560,24
"12778","E01029406",2001,418,14,404,42
"12779","E01029422",2001,420,43,377,23
"12780","E01029423",2001,536,159,377,21
"12781","E01029467",2001,862,76,786,91
"12782","E01029430",2001,601,39,562,21
"12783","E01029431",2001,638,225,413,11
"12784","E01029432",2001,626,38,588,25
"12785","E01029433",2001,580,163,417,25
"12786","E01029459",2001,592,23,569,46
"12787","E01029460",2001,616,112,504,66
"12788","E01029461",2001,640,117,523,51
"12789","E01029462",2001,635,50,585,45
"12790","E01029463",2001,451,16,435,37
"12791","E01029464",2001,661,210,451,40
"12792","E01029465",2001,627,41,586,37
"12793","E01029466",2001,513,3,510,19
"12794","E01029443",2001,608,11,597,20
"12795","E01029444",2001,734,102,632,40
"12796","E01029454",2001,635,7,628,11
"12797","E01029455",2001,612,9,603,11
"12798","E01029456",2001,747,50,697,45
"12799","E01029457",2001,530,3,527,21
"12800","E01029458",2001,610,61,549,5
"12801","E01029473",2001,518,38,480,54
"12802","E01029474",2001,495,13,482,30
"12803","E01029424",2001,413,42,371,54
"12804","E01029425",2001,574,20,554,38
"12805","E01029411",2001,460,29,431,40
"12806","E01029412",2001,526,42,484,43
"12807","E01029434",2001,618,71,547,80
"12808","E01029435",2001,668,20,648,66
"12809","E01029436",2001,771,265,506,62
"12810","E01029437",2001,622,333,289,31
"12811","E01029438",2001,629,31,598,14
"12812","E01029426",2001,614,48,566,136
"12813","E01029427",2001,633,280,353,49
"12814","E01029428",2001,466,32,434,42
"12815","E01029429",2001,496,10,486,68
"12816","E01029445",2001,619,209,410,139
"12817","E01029446",2001,662,74,588,50
"12818","E01029447",2001,468,36,432,138
"12819","E01029448",2001,709,92,617,120
"12820","E01029468",2001,653,405,248,24
"12821","E01029469",2001,724,35,689,27
"12822","E01029470",2001,618,99,519,45
"12823","E01029471",2001,649,11,638,75
"12824","E01029472",2001,629,231,398,16
"12825","E01029421",2001,1085,270,815,255
"12826","E01029407",2001,522,25,497,69
"12827","E01029408",2001,577,107,470,97
"12828","E01029409",2001,627,44,583,161
"12829","E01029410",2001,536,22,514,84
"12830","E01029418",2001,658,9,649,13
"12831","E01029419",2001,631,6,625,24
"12832","E01029420",2001,720,19,701,35
"12833","E01029413",2001,649,109,540,27
"12834","E01029414",2001,658,23,635,49
"12835","E01029415",2001,620,15,605,25
"12836","E01029416",2001,524,9,515,24
"12837","E01029417",2001,518,50,468,27
"12838","E01029449",2001,658,35,623,42
"12839","E01029450",2001,598,294,304,29
"12840","E01029451",2001,778,126,652,80
"12841","E01029452",2001,738,286,452,24
"12842","E01029453",2001,665,351,314,27
"12843","E01029439",2001,637,3,634,29
"12844","E01029440",2001,487,21,466,80
"12845","E01029441",2001,618,78,540,42
"12846","E01029442",2001,497,18,479,10
"12847","E01029480",2001,756,13,743,59
"12848","E01029481",2001,744,126,618,49
"12849","E01029482",2001,639,114,525,40
"12850","E01029498",2001,654,79,575,43
"12851","E01029509",2001,635,50,585,48
"12852","E01029477",2001,603,13,590,49
"12853","E01029478",2001,629,98,531,38
"12854","E01029479",2001,629,110,519,13
"12855","E01029486",2001,626,43,583,18
"12856","E01029507",2001,628,7,621,8
"12857","E01029508",2001,576,33,543,10
"12858","E01029515",2001,747,50,697,45
"12859","E01029510",2001,636,164,472,78
"12860","E01029499",2001,741,400,341,17
"12861","E01029526",2001,816,232,584,117
"12862","E01029492",2001,752,461,291,22
"12863","E01029501",2001,612,169,443,21
"12864","E01029483",2001,625,0,625,16
"12865","E01029484",2001,748,33,715,68
"12866","E01029485",2001,646,0,646,30
"12867","E01029524",2001,735,138,597,75
"12868","E01029525",2001,748,86,662,10
"12869","E01029500",2001,728,87,641,11
"12870","E01029520",2001,600,0,600,10
"12871","E01029497",2001,777,88,689,54
"12872","E01029493",2001,748,52,696,26
"12873","E01029494",2001,629,74,555,57
"12874","E01029495",2001,630,27,603,17
"12875","E01029487",2001,713,303,410,28
"12876","E01029491",2001,740,120,620,46
"12877","E01029511",2001,601,7,594,23
"12878","E01029512",2001,500,34,466,45
"12879","E01029518",2001,770,24,746,49
"12880","E01029519",2001,722,168,554,26
"12881","E01029530",2001,624,85,539,121
"12882","E01029531",2001,664,13,651,28
"12883","E01029516",2001,696,85,611,73
"12884","E01029517",2001,618,67,551,51
"12885","E01029505",2001,626,35,591,48
"12886","E01029506",2001,712,8,704,13
"12887","E01029489",2001,659,6,653,9
"12888","E01029490",2001,611,38,573,23
"12889","E01029475",2001,810,19,791,11
"12890","E01029476",2001,619,37,582,28
"12891","E01029496",2001,694,311,383,17
"12892","E01029527",2001,536,233,303,12
"12893","E01029528",2001,516,46,470,29
"12894","E01029529",2001,505,28,477,19
"12895","E01029513",2001,496,3,493,11
"12896","E01029514",2001,576,11,565,14
"12897","E01029521",2001,673,20,653,40
"12898","E01029522",2001,594,103,491,25
"12899","E01029523",2001,623,33,590,19
"12900","E01029488",2001,652,53,599,73
"12901","E01029502",2001,615,196,419,18
"12902","E01029503",2001,638,74,564,27
"12903","E01029504",2001,659,158,501,87
"12904","E01029562",2001,525,29,496,11
"12905","E01029565",2001,479,11,468,10
"12906","E01029581",2001,628,24,604,27
"12907","E01029582",2001,751,59,692,29
"12908","E01029586",2001,547,3,544,10
"12909","E01029587",2001,442,5,437,7
"12910","E01029588",2001,695,175,520,52
"12911","E01029563",2001,608,73,535,8
"12912","E01029564",2001,539,45,494,146
"12913","E01029561",2001,601,232,369,19
"12914","E01029540",2001,622,150,472,6
"12915","E01029541",2001,611,216,395,28
"12916","E01029542",2001,604,48,556,52
"12917","E01029543",2001,478,262,216,11
"12918","E01029597",2001,603,275,328,30
"12919","E01029595",2001,601,50,551,22
"12920","E01029596",2001,516,36,480,8
"12921","E01029544",2001,512,50,462,15
"12922","E01029545",2001,520,67,453,32
"12923","E01029546",2001,486,3,483,20
"12924","E01029536",2001,643,8,635,12
"12925","E01029532",2001,595,64,531,41
"12926","E01029533",2001,616,93,523,7
"12927","E01029534",2001,654,16,638,30
"12928","E01029535",2001,598,227,371,27
"12929","E01029556",2001,1079,127,952,42
"12930","E01029558",2001,601,246,355,19
"12931","E01029552",2001,619,142,477,26
"12932","E01029537",2001,629,140,489,19
"12933","E01029538",2001,686,295,391,14
"12934","E01029539",2001,619,78,541,12
"12935","E01029559",2001,581,109,472,28
"12936","E01029560",2001,632,299,333,26
"12937","E01029547",2001,625,242,383,108
"12938","E01029548",2001,637,288,349,46
"12939","E01029568",2001,602,140,462,37
"12940","E01029611",2001,638,249,389,35
"12941","E01029609",2001,735,51,684,88
"12942","E01029583",2001,619,138,481,17
"12943","E01029584",2001,544,38,506,25
"12944","E01029585",2001,624,14,610,49
"12945","E01029610",2001,584,15,569,37
"12946","E01029612",2001,485,13,472,12
"12947","E01029577",2001,723,11,712,77
"12948","E01029579",2001,760,72,688,35
"12949","E01029580",2001,580,8,572,18
"12950","E01029566",2001,496,361,135,8
"12951","E01029567",2001,692,150,542,32
"12952","E01029553",2001,624,277,347,21
"12953","E01029554",2001,721,454,267,27
"12954","E01029598",2001,610,322,288,40
"12955","E01029599",2001,717,286,431,24
"12956","E01029602",2001,767,112,655,149
"12957","E01029603",2001,729,211,518,100
"12958","E01029604",2001,802,334,468,122
"12959","E01029555",2001,747,214,533,72
"12960","E01029578",2001,755,240,515,50
"12961","E01029576",2001,514,79,435,64
"12962","E01029593",2001,693,255,438,94
"12963","E01029594",2001,893,151,742,50
"12964","E01029573",2001,638,29,609,54
"12965","E01029574",2001,608,43,565,57
"12966","E01029575",2001,474,176,298,28
"12967","E01029557",2001,496,47,449,58
"12968","E01029549",2001,794,281,513,26
"12969","E01029551",2001,527,58,469,5
"12970","E01029591",2001,737,334,403,16
"12971","E01029600",2001,635,16,619,18
"12972","E01029605",2001,529,24,505,19
"12973","E01029607",2001,634,160,474,11
"12974","E01029608",2001,624,56,568,16
"12975","E01029606",2001,600,6,594,14
"12976","E01029601",2001,655,96,559,14
"12977","E01029592",2001,665,6,659,15
"12978","E01029589",2001,524,8,516,8
"12979","E01029590",2001,615,75,540,10
"12980","E01029550",2001,444,43,401,11
"12981","E01029569",2001,598,61,537,68
"12982","E01029570",2001,1011,41,970,79
"12983","E01029571",2001,553,55,498,22
"12984","E01029572",2001,538,4,534,14
"12985","E01029655",2001,856,147,709,57
"12986","E01029656",2001,643,15,628,64
"12987","E01029657",2001,515,20,495,11
"12988","E01029658",2001,554,92,462,43
"12989","E01029659",2001,583,20,563,15
"12990","E01029660",2001,839,112,727,61
"12991","E01029621",2001,538,51,487,12
"12992","E01029646",2001,550,140,410,33
"12993","E01029647",2001,582,144,438,31
"12994","E01029648",2001,574,136,438,20
"12995","E01029617",2001,632,15,617,74
"12996","E01029618",2001,722,158,564,52
"12997","E01029668",2001,488,7,481,50
"12998","E01029669",2001,527,99,428,18
"12999","E01029670",2001,557,34,523,101
"13000","E01029622",2001,611,66,545,45
"13001","E01029623",2001,497,138,359,10
"13002","E01029624",2001,511,55,456,0
"13003","E01029625",2001,485,15,470,17
"13004","E01029641",2001,594,10,584,24
"13005","E01029642",2001,630,48,582,26
"13006","E01029620",2001,509,54,455,25
"13007","E01029638",2001,896,190,706,52
"13008","E01029639",2001,492,85,407,10
"13009","E01029640",2001,517,31,486,25
"13010","E01029643",2001,642,271,371,9
"13011","E01029644",2001,590,52,538,16
"13012","E01029619",2001,781,125,656,16
"13013","E01029636",2001,577,33,544,29
"13014","E01029637",2001,654,52,602,20
"13015","E01029616",2001,642,13,629,48
"13016","E01029632",2001,586,13,573,25
"13017","E01029633",2001,612,62,550,6
"13018","E01029634",2001,612,222,390,27
"13019","E01029635",2001,692,256,436,19
"13020","E01029627",2001,626,237,389,23
"13021","E01029613",2001,619,36,583,33
"13022","E01029614",2001,596,181,415,11
"13023","E01029615",2001,564,251,313,16
"13024","E01029628",2001,499,12,487,7
"13025","E01029629",2001,481,0,481,3
"13026","E01029630",2001,491,10,481,15
"13027","E01029631",2001,541,34,507,12
"13028","E01029626",2001,596,64,532,32
"13029","E01029654",2001,898,103,795,53
"13030","E01029663",2001,597,3,594,9
"13031","E01029665",2001,774,12,762,42
"13032","E01029661",2001,759,20,739,38
"13033","E01029662",2001,821,5,816,18
"13034","E01029666",2001,746,428,318,20
"13035","E01029664",2001,674,63,611,34
"13036","E01029671",2001,656,143,513,24
"13037","E01029673",2001,630,116,514,46
"13038","E01029676",2001,508,116,392,52
"13039","E01029679",2001,627,315,312,9
"13040","E01029680",2001,624,73,551,19
"13041","E01029677",2001,523,42,481,12
"13042","E01029678",2001,620,3,617,14
"13043","E01029674",2001,581,8,573,10
"13044","E01029675",2001,627,49,578,9
"13045","E01029672",2001,571,24,547,18
"13046","E01029667",2001,829,86,743,125
"13047","E01029645",2001,787,108,679,44
"13048","E01029649",2001,592,158,434,50
"13049","E01029650",2001,598,16,582,28
"13050","E01029651",2001,549,18,531,40
"13051","E01029652",2001,572,7,565,38
"13052","E01029653",2001,518,92,426,23
"13053","E01029702",2001,651,165,486,34
"13054","E01029703",2001,471,22,449,21
"13055","E01029704",2001,600,50,550,8
"13056","E01029705",2001,612,10,602,5
"13057","E01029748",2001,570,4,566,21
"13058","E01029749",2001,616,51,565,66
"13059","E01029681",2001,459,145,314,25
"13060","E01029682",2001,692,91,601,33
"13061","E01029683",2001,514,35,479,47
"13062","E01029744",2001,620,34,586,70
"13063","E01029745",2001,709,197,512,106
"13064","E01029746",2001,615,144,471,26
"13065","E01029740",2001,633,183,450,20
"13066","E01029756",2001,643,38,605,96
"13067","E01029753",2001,623,112,511,35
"13068","E01029754",2001,500,0,500,21
"13069","E01029755",2001,610,19,591,13
"13070","E01029741",2001,641,28,613,23
"13071","E01029739",2001,600,0,600,18
"13072","E01029733",2001,686,40,646,103
"13073","E01029747",2001,546,43,503,21
"13074","E01029695",2001,837,160,677,78
"13075","E01029696",2001,572,58,514,92
"13076","E01029697",2001,494,39,455,60
"13077","E01029698",2001,633,28,605,37
"13078","E01029718",2001,733,9,724,28
"13079","E01029751",2001,712,72,640,11
"13080","E01029743",2001,576,34,542,36
"13081","E01029690",2001,626,20,606,50
"13082","E01029752",2001,519,198,321,21
"13083","E01029750",2001,527,108,419,58
"13084","E01029719",2001,729,105,624,52
"13085","E01029720",2001,633,325,308,46
"13086","E01029721",2001,628,25,603,63
"13087","E01029710",2001,632,13,619,34
"13088","E01029711",2001,563,38,525,18
"13089","E01029712",2001,678,65,613,25
"13090","E01029713",2001,650,96,554,23
"13091","E01029687",2001,708,30,678,67
"13092","E01029692",2001,632,288,344,35
"13093","E01029693",2001,497,115,382,183
"13094","E01029722",2001,664,135,529,63
"13095","E01029725",2001,598,230,368,69
"13096","E01029701",2001,761,166,595,223
"13097","E01029699",2001,728,121,607,143
"13098","E01029694",2001,530,23,507,126
"13099","E01029691",2001,597,241,356,113
"13100","E01029689",2001,731,41,690,191
"13101","E01029686",2001,521,10,511,18
"13102","E01029700",2001,488,7,481,25
"13103","E01029723",2001,617,8,609,37
"13104","E01029724",2001,663,6,657,33
"13105","E01029732",2001,471,15,456,111
"13106","E01029714",2001,616,3,613,20
"13107","E01029742",2001,810,45,765,71
"13108","E01029736",2001,514,7,507,36
"13109","E01029737",2001,603,111,492,24
"13110","E01029738",2001,590,10,580,58
"13111","E01029715",2001,785,283,502,39
"13112","E01029716",2001,637,279,358,17
"13113","E01029717",2001,746,421,325,22
"13114","E01029727",2001,627,329,298,24
"13115","E01029728",2001,619,119,500,14
"13116","E01029730",2001,431,0,431,13
"13117","E01029731",2001,504,7,497,10
"13118","E01029757",2001,616,0,616,25
"13119","E01029758",2001,646,0,646,8
"13120","E01029759",2001,704,4,700,27
"13121","E01029760",2001,656,3,653,5
"13122","E01029684",2001,506,6,500,12
"13123","E01029685",2001,581,0,581,6
"13124","E01029688",2001,816,83,733,51
"13125","E01029706",2001,615,27,588,32
"13126","E01029707",2001,656,149,507,31
"13127","E01029708",2001,672,46,626,82
"13128","E01029709",2001,620,26,594,14
"13129","E01029729",2001,756,274,482,24
"13130","E01029726",2001,659,97,562,27
"13131","E01029734",2001,735,383,352,33
"13132","E01029735",2001,721,109,612,28
"13133","E01029797",2001,604,39,565,51
"13134","E01029808",2001,644,111,533,49
"13135","E01029809",2001,610,273,337,9
"13136","E01029810",2001,541,203,338,17
"13137","E01029806",2001,655,31,624,20
"13138","E01029802",2001,685,11,674,48
"13139","E01029767",2001,691,30,661,25
"13140","E01029769",2001,682,9,673,22
"13141","E01029770",2001,832,3,829,21
"13142","E01029763",2001,653,260,393,38
"13143","E01029764",2001,561,95,466,43
"13144","E01029765",2001,535,170,365,76
"13145","E01029766",2001,617,178,439,29
"13146","E01029774",2001,749,95,654,84
"13147","E01029771",2001,703,17,686,16
"13148","E01029772",2001,773,46,727,40
"13149","E01029773",2001,651,10,641,18
"13150","E01029768",2001,605,33,572,16
"13151","E01029804",2001,832,24,808,183
"13152","E01029811",2001,613,151,462,25
"13153","E01029812",2001,862,86,776,150
"13154","E01029807",2001,504,135,369,49
"13155","E01029814",2001,712,66,646,70
"13156","E01029815",2001,666,63,603,19
"13157","E01029816",2001,611,20,591,11
"13158","E01029813",2001,765,35,730,31
"13159","E01029805",2001,648,82,566,42
"13160","E01029792",2001,599,14,585,21
"13161","E01029793",2001,633,45,588,25
"13162","E01029803",2001,725,25,700,43
"13163","E01029801",2001,666,33,633,66
"13164","E01029817",2001,734,56,678,106
"13165","E01029762",2001,598,13,585,22
"13166","E01029775",2001,648,3,645,15
"13167","E01029776",2001,726,3,723,15
"13168","E01029777",2001,624,56,568,36
"13169","E01029794",2001,537,7,530,29
"13170","E01029779",2001,719,3,716,11
"13171","E01029780",2001,643,47,596,19
"13172","E01029818",2001,610,3,607,11
"13173","E01029819",2001,731,0,731,17
"13174","E01029795",2001,711,55,656,56
"13175","E01029796",2001,606,61,545,24
"13176","E01029782",2001,784,179,605,50
"13177","E01029761",2001,564,38,526,36
"13178","E01029783",2001,624,169,455,34
"13179","E01029781",2001,652,38,614,21
"13180","E01029786",2001,557,15,542,28
"13181","E01029787",2001,732,108,624,94
"13182","E01029778",2001,648,12,636,32
"13183","E01029789",2001,447,25,422,23
"13184","E01029798",2001,685,74,611,49
"13185","E01029799",2001,785,8,777,21
"13186","E01029800",2001,611,6,605,22
"13187","E01029790",2001,660,93,567,14
"13188","E01029791",2001,497,8,489,44
"13189","E01029784",2001,888,3,885,22
"13190","E01029785",2001,650,0,650,15
"13191","E01029788",2001,519,11,508,37
"13192","E01029846",2001,520,78,442,14
"13193","E01029847",2001,511,4,507,12
"13194","E01029848",2001,510,23,487,9
"13195","E01029852",2001,746,238,508,12
"13196","E01029853",2001,636,140,496,22
"13197","E01029854",2001,646,8,638,21
"13198","E01029849",2001,644,241,403,16
"13199","E01029850",2001,581,178,403,18
"13200","E01029851",2001,730,108,622,130
"13201","E01029835",2001,927,474,453,110
"13202","E01029836",2001,539,125,414,25
"13203","E01029841",2001,611,69,542,20
"13204","E01029820",2001,579,148,431,4
"13205","E01029821",2001,681,44,637,41
"13206","E01029822",2001,503,26,477,9
"13207","E01029824",2001,660,392,268,10
"13208","E01029831",2001,635,159,476,27
"13209","E01029832",2001,622,96,526,10
"13210","E01029823",2001,669,29,640,16
"13211","E01029834",2001,661,230,431,10
"13212","E01029844",2001,483,0,483,8
"13213","E01029837",2001,604,144,460,31
"13214","E01029838",2001,681,29,652,81
"13215","E01029839",2001,458,5,453,15
"13216","E01029833",2001,505,26,479,21
"13217","E01029825",2001,504,6,498,12
"13218","E01029826",2001,614,40,574,23
"13219","E01029827",2001,527,261,266,15
"13220","E01029828",2001,486,265,221,14
"13221","E01029830",2001,490,111,379,27
"13222","E01029842",2001,512,279,233,6
"13223","E01029843",2001,550,221,329,15
"13224","E01029840",2001,461,230,231,16
"13225","E01029845",2001,458,387,71,6
"13226","E01029859",2001,724,382,342,12
"13227","E01029865",2001,562,9,553,13
"13228","E01029855",2001,543,125,418,11
"13229","E01029856",2001,580,38,542,15
"13230","E01029857",2001,530,165,365,14
"13231","E01029858",2001,627,26,601,22
"13232","E01029860",2001,550,3,547,15
"13233","E01029861",2001,604,113,491,23
"13234","E01029862",2001,433,3,430,8
"13235","E01029863",2001,689,21,668,49
"13236","E01029864",2001,514,4,510,11
"13237","E01029866",2001,659,35,624,61
"13238","E01029867",2001,697,206,491,30
"13239","E01029868",2001,502,3,499,15
"13240","E01029869",2001,662,190,472,11
"13241","E01029829",2001,569,86,483,15
"13242","E01031035",2001,745,100,645,39
"13243","E01031036",2001,627,55,572,39
"13244","E01031037",2001,628,177,451,26
"13245","E01031038",2001,745,96,649,16
"13246","E01031039",2001,666,9,657,15
"13247","E01031040",2001,749,68,681,54
"13248","E01031016",2001,621,200,421,20
"13249","E01031025",2001,671,90,581,64
"13250","E01031026",2001,610,178,432,73
"13251","E01031031",2001,870,210,660,40
"13252","E01031032",2001,535,111,424,103
"13253","E01031009",2001,858,139,719,67
"13254","E01031010",2001,720,377,343,106
"13255","E01031011",2001,773,50,723,33
"13256","E01031012",2001,646,237,409,13
"13257","E01031013",2001,450,18,432,35
"13258","E01031014",2001,495,19,476,16
"13259","E01031015",2001,600,326,274,21
"13260","E01031033",2001,763,158,605,26
"13261","E01031034",2001,756,23,733,18
"13262","E01031023",2001,645,15,630,49
"13263","E01031024",2001,683,32,651,58
"13264","E01031029",2001,556,27,529,14
"13265","E01031030",2001,991,205,786,88
"13266","E01031017",2001,505,19,486,42
"13267","E01031018",2001,477,31,446,73
"13268","E01031008",2001,560,186,374,37
"13269","E01031005",2001,597,171,426,43
"13270","E01031019",2001,616,15,601,15
"13271","E01031020",2001,687,3,684,55
"13272","E01031021",2001,765,193,572,65
"13273","E01031022",2001,664,41,623,56
"13274","E01031041",2001,721,16,705,44
"13275","E01031042",2001,730,103,627,21
"13276","E01031027",2001,599,25,574,48
"13277","E01031028",2001,751,86,665,155
"13278","E01031006",2001,625,92,533,72
"13279","E01031007",2001,484,16,468,29
"13280","E01031110",2001,625,8,617,30
"13281","E01031111",2001,417,3,414,3
"13282","E01031112",2001,663,14,649,21
"13283","E01031113",2001,605,5,600,17
"13284","E01031114",2001,735,271,464,17
"13285","E01031071",2001,616,342,274,29
"13286","E01031072",2001,483,159,324,44
"13287","E01031073",2001,657,68,589,28
"13288","E01031074",2001,644,125,519,95
"13289","E01031075",2001,661,273,388,37
"13290","E01031100",2001,510,5,505,3
"13291","E01031101",2001,487,0,487,4
"13292","E01031102",2001,525,14,511,52
"13293","E01031103",2001,495,5,490,9
"13294","E01031104",2001,647,7,640,3
"13295","E01031081",2001,607,105,502,22
"13296","E01031082",2001,496,10,486,12
"13297","E01031083",2001,626,29,597,28
"13298","E01031084",2001,557,16,541,34
"13299","E01031085",2001,503,3,500,10
"13300","E01031043",2001,741,328,413,76
"13301","E01031044",2001,620,49,571,85
"13302","E01031045",2001,631,39,592,63
"13303","E01031046",2001,627,35,592,156
"13304","E01031047",2001,676,38,638,114
"13305","E01031057",2001,617,409,208,18
"13306","E01031058",2001,607,118,489,28
"13307","E01031059",2001,622,56,566,47
"13308","E01031060",2001,636,76,560,25
"13309","E01031061",2001,603,79,524,42
"13310","E01031090",2001,607,288,319,25
"13311","E01031091",2001,502,11,491,28
"13312","E01031092",2001,616,138,478,48
"13313","E01031093",2001,517,38,479,12
"13314","E01031094",2001,496,36,460,50
"13315","E01031048",2001,517,6,511,40
"13316","E01031049",2001,597,55,542,72
"13317","E01031050",2001,407,53,354,36
"13318","E01031051",2001,596,24,572,28
"13319","E01031115",2001,642,27,615,79
"13320","E01031116",2001,679,353,326,32
"13321","E01031117",2001,532,178,354,12
"13322","E01031118",2001,492,159,333,16
"13323","E01031119",2001,706,191,515,73
"13324","E01031052",2001,630,31,599,90
"13325","E01031053",2001,709,237,472,55
"13326","E01031054",2001,662,135,527,21
"13327","E01031055",2001,626,58,568,27
"13328","E01031056",2001,583,133,450,21
"13329","E01031120",2001,587,3,584,23
"13330","E01031121",2001,457,0,457,5
"13331","E01031122",2001,626,10,616,14
"13332","E01031123",2001,511,3,508,5
"13333","E01031124",2001,638,4,634,16
"13334","E01031105",2001,589,12,577,33
"13335","E01031106",2001,606,80,526,20
"13336","E01031107",2001,457,12,445,23
"13337","E01031108",2001,513,4,509,18
"13338","E01031109",2001,659,211,448,16
"13339","E01031062",2001,486,36,450,6
"13340","E01031063",2001,600,219,381,28
"13341","E01031064",2001,531,116,415,30
"13342","E01031065",2001,613,152,461,29
"13343","E01031066",2001,657,309,348,19
"13344","E01031067",2001,724,216,508,49
"13345","E01031068",2001,741,32,709,20
"13346","E01031069",2001,657,9,648,25
"13347","E01031070",2001,615,4,611,11
"13348","E01031095",2001,489,114,375,20
"13349","E01031096",2001,479,20,459,43
"13350","E01031097",2001,623,279,344,16
"13351","E01031098",2001,542,10,532,42
"13352","E01031099",2001,605,32,573,24
"13353","E01031086",2001,723,36,687,46
"13354","E01031087",2001,638,190,448,45
"13355","E01031088",2001,580,114,466,43
"13356","E01031089",2001,634,8,626,8
"13357","E01031076",2001,555,9,546,25
"13358","E01031077",2001,588,118,470,56
"13359","E01031078",2001,616,19,597,61
"13360","E01031079",2001,642,118,524,17
"13361","E01031080",2001,643,141,502,45
"13362","E01031128",2001,580,75,505,53
"13363","E01031129",2001,499,61,438,24
"13364","E01031159",2001,643,52,591,31
"13365","E01031160",2001,829,114,715,96
"13366","E01031182",2001,776,75,701,127
"13367","E01031137",2001,552,64,488,61
"13368","E01031138",2001,449,33,416,30
"13369","E01031139",2001,608,5,603,33
"13370","E01031140",2001,534,53,481,14
"13371","E01031141",2001,500,119,381,39
"13372","E01031142",2001,646,353,293,42
"13373","E01031171",2001,606,123,483,43
"13374","E01031172",2001,692,268,424,19
"13375","E01031173",2001,856,381,475,83
"13376","E01031174",2001,650,112,538,110
"13377","E01031151",2001,588,3,585,10
"13378","E01031152",2001,480,17,463,12
"13379","E01031153",2001,584,150,434,23
"13380","E01031154",2001,596,23,573,34
"13381","E01031181",2001,682,90,592,21
"13382","E01031130",2001,665,27,638,116
"13383","E01031131",2001,641,23,618,122
"13384","E01031132",2001,728,64,664,138
"13385","E01031133",2001,696,185,511,66
"13386","E01031167",2001,524,29,495,34
"13387","E01031168",2001,613,154,459,36
"13388","E01031169",2001,613,26,587,86
"13389","E01031170",2001,739,179,560,62
"13390","E01031164",2001,693,17,676,41
"13391","E01031165",2001,666,233,433,35
"13392","E01031125",2001,656,8,648,39
"13393","E01031126",2001,593,12,581,37
"13394","E01031127",2001,618,257,361,40
"13395","E01031155",2001,513,0,513,8
"13396","E01031156",2001,615,4,611,18
"13397","E01031157",2001,632,7,625,33
"13398","E01031158",2001,464,0,464,11
"13399","E01031143",2001,628,0,628,35
"13400","E01031144",2001,560,72,488,101
"13401","E01031145",2001,457,146,311,56
"13402","E01031146",2001,603,198,405,49
"13403","E01031161",2001,835,65,770,39
"13404","E01031162",2001,658,87,571,31
"13405","E01031163",2001,740,282,458,24
"13406","E01031179",2001,684,3,681,29
"13407","E01031180",2001,835,96,739,48
"13408","E01031175",2001,556,8,548,15
"13409","E01031176",2001,517,209,308,21
"13410","E01031177",2001,601,251,350,19
"13411","E01031178",2001,643,98,545,27
"13412","E01031134",2001,724,6,718,22
"13413","E01031135",2001,782,49,733,8
"13414","E01031136",2001,661,69,592,33
"13415","E01031147",2001,504,7,497,19
"13416","E01031148",2001,664,123,541,42
"13417","E01031149",2001,611,38,573,39
"13418","E01031150",2001,483,49,434,8
"13419","E01031166",2001,726,39,687,38
"13420","E01031213",2001,723,63,660,69
"13421","E01031243",2001,769,16,753,34
"13422","E01031244",2001,726,61,665,53
"13423","E01031202",2001,745,17,728,80
"13424","E01031203",2001,651,215,436,27
"13425","E01031204",2001,616,12,604,57
"13426","E01031195",2001,889,96,793,42
"13427","E01031239",2001,623,10,613,71
"13428","E01031240",2001,573,118,455,23
"13429","E01031241",2001,595,55,540,21
"13430","E01031242",2001,646,174,472,40
"13431","E01031219",2001,622,143,479,19
"13432","E01031220",2001,595,68,527,9
"13433","E01031221",2001,630,205,425,18
"13434","E01031222",2001,799,31,768,77
"13435","E01031223",2001,531,68,463,31
"13436","E01031224",2001,429,19,410,59
"13437","E01031197",2001,473,22,451,76
"13438","E01031198",2001,531,78,453,47
"13439","E01031199",2001,578,107,471,35
"13440","E01031200",2001,581,24,557,50
"13441","E01031201",2001,652,20,632,36
"13442","E01031210",2001,477,32,445,25
"13443","E01031211",2001,452,97,355,29
"13444","E01031183",2001,723,29,694,133
"13445","E01031184",2001,593,46,547,38
"13446","E01031185",2001,634,253,381,32
"13447","E01031186",2001,658,216,442,22
"13448","E01031187",2001,820,65,755,82
"13449","E01031188",2001,777,25,752,63
"13450","E01031208",2001,864,32,832,42
"13451","E01031217",2001,465,50,415,18
"13452","E01031218",2001,421,30,391,48
"13453","E01031249",2001,504,168,336,25
"13454","E01031250",2001,635,15,620,74
"13455","E01031251",2001,502,3,499,7
"13456","E01031252",2001,504,91,413,44
"13457","E01031253",2001,651,160,491,53
"13458","E01031236",2001,618,102,516,39
"13459","E01031228",2001,683,8,675,53
"13460","E01031229",2001,904,67,837,276
"13461","E01031230",2001,596,111,485,38
"13462","E01031231",2001,760,258,502,87
"13463","E01031238",2001,609,229,380,55
"13464","E01031225",2001,652,7,645,41
"13465","E01031226",2001,723,11,712,45
"13466","E01031227",2001,843,95,748,71
"13467","E01031232",2001,714,7,707,88
"13468","E01031233",2001,629,102,527,64
"13469","E01031234",2001,865,126,739,239
"13470","E01031235",2001,891,58,833,120
"13471","E01031237",2001,601,65,536,21
"13472","E01031248",2001,843,86,757,58
"13473","E01031189",2001,596,94,502,84
"13474","E01031190",2001,616,167,449,16
"13475","E01031191",2001,636,29,607,29
"13476","E01031192",2001,756,28,728,56
"13477","E01031194",2001,819,90,729,146
"13478","E01031205",2001,611,34,577,82
"13479","E01031206",2001,595,160,435,32
"13480","E01031207",2001,516,85,431,73
"13481","E01031247",2001,923,126,797,83
"13482","E01031245",2001,536,74,462,38
"13483","E01031246",2001,461,39,422,45
"13484","E01031212",2001,921,161,760,120
"13485","E01031196",2001,845,64,781,93
"13486","E01031193",2001,879,85,794,104
"13487","E01031209",2001,906,113,793,106
"13488","E01031214",2001,604,16,588,20
"13489","E01031215",2001,733,109,624,75
"13490","E01031216",2001,652,184,468,54
"13491","E01031254",2001,627,28,599,27
"13492","E01031255",2001,632,4,628,28
"13493","E01031256",2001,727,25,702,76
"13494","E01031257",2001,668,115,553,78
"13495","E01031258",2001,755,86,669,93
"13496","E01031296",2001,725,4,721,80
"13497","E01031297",2001,794,130,664,64
"13498","E01031298",2001,742,16,726,39
"13499","E01031299",2001,560,3,557,23
"13500","E01031300",2001,648,3,645,25
"13501","E01031303",2001,645,142,503,41
"13502","E01031304",2001,593,52,541,12
"13503","E01031305",2001,645,7,638,11
"13504","E01031306",2001,619,78,541,27
"13505","E01031307",2001,677,3,674,48
"13506","E01031281",2001,581,25,556,27
"13507","E01031282",2001,637,90,547,76
"13508","E01031283",2001,493,7,486,75
"13509","E01031284",2001,484,21,463,25
"13510","E01031277",2001,624,34,590,47
"13511","E01031278",2001,568,6,562,43
"13512","E01031279",2001,624,83,541,21
"13513","E01031280",2001,492,48,444,29
"13514","E01031308",2001,841,77,764,182
"13515","E01031301",2001,584,4,580,70
"13516","E01031302",2001,438,74,364,20
"13517","E01031273",2001,652,401,251,31
"13518","E01031274",2001,621,183,438,41
"13519","E01031275",2001,523,40,483,15
"13520","E01031276",2001,624,242,382,23
"13521","E01031285",2001,1098,114,984,264
"13522","E01031286",2001,734,271,463,41
"13523","E01031287",2001,572,12,560,18
"13524","E01031288",2001,615,63,552,35
"13525","E01031289",2001,582,23,559,25
"13526","E01031270",2001,888,189,699,280
"13527","E01031272",2001,744,55,689,154
"13528","E01031309",2001,683,157,526,62
"13529","E01031310",2001,559,49,510,37
"13530","E01031311",2001,560,162,398,20
"13531","E01031312",2001,550,191,359,30
"13532","E01031313",2001,599,4,595,15
"13533","E01031314",2001,632,3,629,37
"13534","E01031290",2001,737,41,696,170
"13535","E01031291",2001,632,141,491,168
"13536","E01031292",2001,641,5,636,53
"13537","E01031293",2001,594,118,476,90
"13538","E01031294",2001,617,98,519,76
"13539","E01031295",2001,471,6,465,9
"13540","E01031271",2001,877,242,635,106
"13541","E01031332",2001,495,150,345,29
"13542","E01031333",2001,461,51,410,75
"13543","E01031334",2001,661,98,563,54
"13544","E01031335",2001,633,37,596,225
"13545","E01031336",2001,738,109,629,284
"13546","E01031337",2001,703,87,616,121
"13547","E01031321",2001,506,287,219,26
"13548","E01031322",2001,587,118,469,23
"13549","E01031323",2001,771,123,648,90
"13550","E01031324",2001,796,147,649,129
"13551","E01031325",2001,611,204,407,31
"13552","E01031326",2001,477,121,356,26
"13553","E01031315",2001,500,107,393,28
"13554","E01031316",2001,781,122,659,81
"13555","E01031317",2001,703,28,675,64
"13556","E01031318",2001,532,0,532,19
"13557","E01031319",2001,620,21,599,67
"13558","E01031320",2001,600,106,494,66
"13559","E01031261",2001,594,234,360,85
"13560","E01031262",2001,628,190,438,92
"13561","E01031263",2001,589,73,516,139
"13562","E01031264",2001,626,260,366,32
"13563","E01031265",2001,529,174,355,70
"13564","E01031266",2001,792,205,587,270
"13565","E01031267",2001,722,12,710,38
"13566","E01031268",2001,765,93,672,55
"13567","E01031269",2001,658,40,618,104
"13568","E01031259",2001,462,11,451,23
"13569","E01031260",2001,513,92,421,13
"13570","E01031327",2001,627,197,430,32
"13571","E01031328",2001,583,3,580,23
"13572","E01031329",2001,620,16,604,39
"13573","E01031330",2001,610,50,560,43
"13574","E01031331",2001,640,31,609,21
"13575","E01009417",2001,601,105,496,6
"13576","E01009418",2001,642,128,514,9
"13577","E01009419",2001,565,71,494,38
"13578","E01009433",2001,678,3,675,23
"13579","E01009425",2001,697,83,614,43
"13580","E01009415",2001,647,6,641,13
"13581","E01009422",2001,794,14,780,39
"13582","E01009423",2001,731,183,548,33
"13583","E01009416",2001,567,10,557,29
"13584","E01009420",2001,628,38,590,15
"13585","E01009426",2001,598,7,591,11
"13586","E01009429",2001,583,9,574,16
"13587","E01009431",2001,589,4,585,11
"13588","E01009430",2001,606,29,577,25
"13589","E01009427",2001,686,81,605,67
"13590","E01009428",2001,621,8,613,3
"13591","E01009468",2001,632,6,626,27
"13592","E01009421",2001,606,0,606,6
"13593","E01009424",2001,627,42,585,61
"13594","E01009445",2001,652,301,351,16
"13595","E01009446",2001,710,116,594,37
"13596","E01009447",2001,607,103,504,21
"13597","E01009448",2001,624,216,408,14
"13598","E01009452",2001,619,71,548,23
"13599","E01009455",2001,702,348,354,22
"13600","E01009454",2001,643,8,635,56
"13601","E01009437",2001,630,70,560,23
"13602","E01009444",2001,605,6,599,8
"13603","E01009432",2001,639,142,497,46
"13604","E01009435",2001,604,25,579,36
"13605","E01009464",2001,546,3,543,9
"13606","E01009465",2001,492,11,481,12
"13607","E01009467",2001,655,109,546,27
"13608","E01009221",2001,592,72,520,35
"13609","E01009222",2001,578,235,343,40
"13610","E01009224",2001,622,14,608,11
"13611","E01009220",2001,597,152,445,28
"13612","E01009233",2001,629,262,367,25
"13613","E01009466",2001,652,15,637,33
"13614","E01009471",2001,612,10,602,34
"13615","E01009449",2001,847,78,769,129
"13616","E01009451",2001,651,64,587,70
"13617","E01009453",2001,524,38,486,18
"13618","E01009472",2001,607,19,588,19
"13619","E01009473",2001,659,66,593,45
"13620","E01009474",2001,626,63,563,35
"13621","E01009469",2001,580,10,570,19
"13622","E01009470",2001,541,6,535,6
"13623","E01009135",2001,597,72,525,21
"13624","E01009133",2001,634,333,301,12
"13625","E01009134",2001,667,291,376,30
"13626","E01009137",2001,596,214,382,28
"13627","E01009127",2001,600,274,326,19
"13628","E01009128",2001,534,238,296,16
"13629","E01009130",2001,630,271,359,29
"13630","E01009131",2001,520,211,309,23
"13631","E01009450",2001,579,38,541,30
"13632","E01009438",2001,607,3,604,25
"13633","E01009436",2001,522,3,519,8
"13634","E01009434",2001,611,15,596,31
"13635","E01009440",2001,620,11,609,25
"13636","E01009225",2001,751,272,479,28
"13637","E01009223",2001,672,81,591,35
"13638","E01009227",2001,674,33,641,29
"13639","E01009228",2001,671,28,643,44
"13640","E01009132",2001,602,249,353,38
"13641","E01009129",2001,594,300,294,24
"13642","E01009121",2001,648,296,352,39
"13643","E01009122",2001,657,349,308,32
"13644","E01009136",2001,748,341,407,19
"13645","E01009457",2001,604,3,601,7
"13646","E01009463",2001,597,9,588,29
"13647","E01009459",2001,635,16,619,42
"13648","E01009461",2001,527,14,513,17
"13649","E01009235",2001,627,17,610,38
"13650","E01009245",2001,551,51,500,17
"13651","E01009246",2001,647,44,603,31
"13652","E01009247",2001,592,15,577,36
"13653","E01009243",2001,647,75,572,25
"13654","E01009229",2001,628,15,613,27
"13655","E01009230",2001,633,13,620,38
"13656","E01009231",2001,775,28,747,33
"13657","E01009226",2001,624,20,604,32
"13658","E01009001",2001,659,96,563,33
"13659","E01009003",2001,665,37,628,110
"13660","E01009462",2001,775,154,621,99
"13661","E01009460",2001,770,96,674,113
"13662","E01009458",2001,644,233,411,31
"13663","E01009456",2001,633,24,609,30
"13664","E01009236",2001,610,42,568,23
"13665","E01009244",2001,637,82,555,39
"13666","E01009248",2001,700,30,670,42
"13667","E01009234",2001,619,42,577,35
"13668","E01009403",2001,602,209,393,25
"13669","E01009404",2001,618,249,369,25
"13670","E01009405",2001,605,147,458,27
"13671","E01009406",2001,733,240,493,42
"13672","E01009407",2001,643,148,495,65
"13673","E01009439",2001,607,25,582,28
"13674","E01009441",2001,615,136,479,98
"13675","E01009442",2001,610,13,597,3
"13676","E01009443",2001,538,7,531,30
"13677","E01009232",2001,599,39,560,29
"13678","E01009123",2001,634,171,463,42
"13679","E01009124",2001,625,405,220,15
"13680","E01009125",2001,660,180,480,40
"13681","E01009004",2001,745,561,184,26
"13682","E01009002",2001,655,379,276,22
"13683","E01009010",2001,628,88,540,80
"13684","E01009006",2001,748,43,705,95
"13685","E01009007",2001,742,158,584,167
"13686","E01009237",2001,622,135,487,31
"13687","E01009238",2001,611,64,547,36
"13688","E01009240",2001,622,22,600,48
"13689","E01009241",2001,615,21,594,40
"13690","E01009242",2001,618,20,598,48
"13691","E01009105",2001,653,81,572,18
"13692","E01009009",2001,590,129,461,23
"13693","E01009098",2001,741,292,449,37
"13694","E01009100",2001,580,183,397,25
"13695","E01009005",2001,640,128,512,30
"13696","E01009126",2001,544,22,522,15
"13697","E01009408",2001,651,171,480,47
"13698","E01009409",2001,682,100,582,103
"13699","E01009410",2001,710,145,565,86
"13700","E01009262",2001,515,41,474,27
"13701","E01009267",2001,576,72,504,41
"13702","E01009276",2001,562,25,537,37
"13703","E01009277",2001,481,17,464,26
"13704","E01009278",2001,520,12,508,30
"13705","E01009279",2001,449,16,433,22
"13706","E01009104",2001,645,250,395,24
"13707","E01009102",2001,635,224,411,32
"13708","E01009011",2001,709,141,568,50
"13709","E01009012",2001,584,31,553,27
"13710","E01009008",2001,597,51,546,29
"13711","E01009103",2001,627,380,247,17
"13712","E01009101",2001,639,308,331,21
"13713","E01009099",2001,687,485,202,23
"13714","E01009096",2001,704,346,358,25
"13715","E01009097",2001,596,308,288,37
"13716","E01009106",2001,594,103,491,8
"13717","E01008915",2001,527,69,458,84
"13718","E01009411",2001,817,48,769,82
"13719","E01009412",2001,633,92,541,132
"13720","E01009413",2001,637,84,553,92
"13721","E01009414",2001,633,99,534,86
"13722","E01009400",2001,587,154,433,75
"13723","E01009401",2001,590,195,395,74
"13724","E01009402",2001,766,340,426,185
"13725","E01009013",2001,711,116,595,112
"13726","E01008998",2001,622,205,417,50
"13727","E01008999",2001,489,107,382,28
"13728","E01009000",2001,737,183,554,173
"13729","E01009049",2001,532,99,433,58
"13730","E01009056",2001,530,203,327,61
"13731","E01009263",2001,671,130,541,95
"13732","E01009264",2001,1365,424,941,657
"13733","E01009265",2001,578,80,498,85
"13734","E01009239",2001,495,122,373,91
"13735","E01009053",2001,496,171,325,84
"13736","E01009054",2001,436,45,391,45
"13737","E01009051",2001,479,101,378,112
"13738","E01009061",2001,443,103,340,63
"13739","E01009058",2001,531,53,478,106
"13740","E01009266",2001,622,61,561,97
"13741","E01009269",2001,544,72,472,72
"13742","E01009270",2001,614,230,384,61
"13743","E01009271",2001,536,121,415,49
"13744","E01009273",2001,486,78,408,40
"13745","E01009059",2001,509,259,250,44
"13746","E01009060",2001,436,166,270,62
"13747","E01009052",2001,529,223,306,51
"13748","E01009050",2001,632,238,394,67
"13749","E01009055",2001,563,279,284,50
"13750","E01009057",2001,566,210,356,70
"13751","E01009274",2001,539,137,402,74
"13752","E01009272",2001,490,184,306,29
"13753","E01009268",2001,437,25,412,31
"13754","E01009354",2001,503,191,312,40
"13755","E01009349",2001,592,205,387,67
"13756","E01009351",2001,540,152,388,57
"13757","E01008916",2001,471,139,332,85
"13758","E01008899",2001,703,441,262,43
"13759","E01008900",2001,505,165,340,81
"13760","E01008901",2001,620,327,293,41
"13761","E01008902",2001,401,57,344,57
"13762","E01009079",2001,688,324,364,16
"13763","E01009080",2001,619,396,223,24
"13764","E01009081",2001,667,348,319,30
"13765","E01009083",2001,706,357,349,10
"13766","E01009275",2001,468,140,328,47
"13767","E01009352",2001,437,121,316,49
"13768","E01009353",2001,460,67,393,60
"13769","E01009350",2001,451,137,314,62
"13770","E01009355",2001,521,225,296,74
"13771","E01009356",2001,577,74,503,94
"13772","E01009357",2001,505,129,376,59
"13773","E01009062",2001,487,209,278,63
"13774","E01009047",2001,485,225,260,52
"13775","E01009048",2001,517,230,287,47
"13776","E01008905",2001,462,153,309,63
"13777","E01008907",2001,585,385,200,41
"13778","E01008908",2001,541,349,192,31
"13779","E01008909",2001,477,282,195,25
"13780","E01008903",2001,401,162,239,33
"13781","E01008904",2001,602,351,251,42
"13782","E01009063",2001,516,258,258,67
"13783","E01009084",2001,520,43,477,7
"13784","E01009085",2001,513,12,501,14
"13785","E01009087",2001,608,29,579,29
"13786","E01009089",2001,506,8,498,8
"13787","E01009090",2001,538,42,496,26
"13788","E01009201",2001,705,413,292,29
"13789","E01009202",2001,588,394,194,37
"13790","E01009203",2001,1103,853,250,56
"13791","E01009086",2001,603,69,534,22
"13792","E01009082",2001,509,128,381,14
"13793","E01009480",2001,550,185,365,38
"13794","E01009481",2001,615,54,561,46
"13795","E01009486",2001,524,48,476,91
"13796","E01009487",2001,517,85,432,68
"13797","E01009091",2001,619,205,414,35
"13798","E01009088",2001,691,220,471,13
"13799","E01009305",2001,733,416,317,22
"13800","E01009307",2001,742,351,391,9
"13801","E01009309",2001,756,412,344,21
"13802","E01009310",2001,793,355,438,22
"13803","E01009308",2001,728,379,349,14
"13804","E01009306",2001,654,223,431,16
"13805","E01009304",2001,811,269,542,24
"13806","E01009358",2001,510,164,346,87
"13807","E01009359",2001,602,177,425,104
"13808","E01009360",2001,643,252,391,96
"13809","E01009361",2001,683,246,437,96
"13810","E01009348",2001,645,294,351,64
"13811","E01009482",2001,469,188,281,40
"13812","E01009484",2001,505,228,277,46
"13813","E01009485",2001,473,80,393,59
"13814","E01009478",2001,623,311,312,35
"13815","E01009479",2001,535,167,368,56
"13816","E01009347",2001,723,453,270,68
"13817","E01008906",2001,533,283,250,53
"13818","E01008911",2001,597,431,166,27
"13819","E01008912",2001,806,486,320,67
"13820","E01008913",2001,700,498,202,31
"13821","E01008914",2001,775,504,271,45
"13822","E01008910",2001,651,457,194,26
"13823","E01009191",2001,402,293,109,31
"13824","E01009194",2001,468,105,363,46
"13825","E01009491",2001,442,110,332,60
"13826","E01009483",2001,493,151,342,74
"13827","E01009488",2001,594,364,230,35
"13828","E01009489",2001,485,111,374,79
"13829","E01009192",2001,553,67,486,75
"13830","E01009193",2001,444,200,244,34
"13831","E01009204",2001,738,499,239,36
"13832","E01009199",2001,511,157,354,70
"13833","E01009190",2001,429,99,330,37
"13834","E01009151",2001,464,72,392,83
"13835","E01009152",2001,492,133,359,85
"13836","E01009153",2001,761,363,398,115
"13837","E01009345",2001,410,267,143,25
"13838","E01009346",2001,499,186,313,72
"13839","E01009511",2001,478,234,244,22
"13840","E01009092",2001,620,349,271,14
"13841","E01009093",2001,609,269,340,29
"13842","E01009094",2001,504,187,317,11
"13843","E01009311",2001,576,204,372,18
"13844","E01009298",2001,580,296,284,30
"13845","E01009490",2001,547,229,318,24
"13846","E01009492",2001,488,171,317,53
"13847","E01009475",2001,600,277,323,33
"13848","E01009476",2001,543,221,322,35
"13849","E01009477",2001,560,200,360,36
"13850","E01009507",2001,590,240,350,73
"13851","E01009508",2001,607,114,493,24
"13852","E01009509",2001,604,111,493,117
"13853","E01009510",2001,680,329,351,25
"13854","E01009095",2001,644,74,570,51
"13855","E01009299",2001,647,280,367,24
"13856","E01009300",2001,687,333,354,57
"13857","E01009301",2001,798,390,408,26
"13858","E01009297",2001,671,215,456,16
"13859","E01009303",2001,734,228,506,37
"13860","E01009195",2001,583,147,436,50
"13861","E01009196",2001,845,248,597,85
"13862","E01009197",2001,476,137,339,54
"13863","E01009198",2001,472,84,388,86
"13864","E01009141",2001,778,542,236,34
"13865","E01009143",2001,798,587,211,63
"13866","E01009144",2001,794,383,411,119
"13867","E01009146",2001,807,610,197,59
"13868","E01009148",2001,762,485,277,60
"13869","E01009150",2001,904,453,451,168
"13870","E01009147",2001,563,103,460,234
"13871","E01009145",2001,502,72,430,153
"13872","E01009138",2001,504,30,474,92
"13873","E01009139",2001,524,27,497,99
"13874","E01009140",2001,581,82,499,88
"13875","E01009200",2001,604,325,279,53
"13876","E01009332",2001,564,315,249,63
"13877","E01009333",2001,446,170,276,73
"13878","E01009344",2001,461,181,280,67
"13879","E01009512",2001,589,181,408,8
"13880","E01009516",2001,532,120,412,19
"13881","E01009517",2001,654,210,444,18
"13882","E01009514",2001,773,441,332,24
"13883","E01009342",2001,425,53,372,66
"13884","E01009343",2001,514,136,378,72
"13885","E01009330",2001,468,104,364,79
"13886","E01009336",2001,413,83,330,42
"13887","E01009325",2001,514,205,309,56
"13888","E01008986",2001,703,145,558,335
"13889","E01008987",2001,563,209,354,134
"13890","E01008988",2001,807,123,684,312
"13891","E01008989",2001,845,196,649,248
"13892","E01008990",2001,457,26,431,80
"13893","E01008991",2001,599,20,579,35
"13894","E01009327",2001,453,62,391,96
"13895","E01009328",2001,519,43,476,73
"13896","E01009331",2001,551,55,496,67
"13897","E01009335",2001,498,59,439,74
"13898","E01009341",2001,556,295,261,60
"13899","E01009513",2001,598,190,408,37
"13900","E01009326",2001,542,194,348,58
"13901","E01008898",2001,557,251,306,18
"13902","E01008882",2001,667,243,424,29
"13903","E01008896",2001,566,233,333,25
"13904","E01008897",2001,611,179,432,23
"13905","E01008881",2001,598,175,423,32
"13906","E01009518",2001,701,55,646,24
"13907","E01009515",2001,620,107,513,24
"13908","E01009521",2001,603,6,597,40
"13909","E01009378",2001,610,386,224,53
"13910","E01008995",2001,787,589,198,55
"13911","E01009142",2001,763,484,279,104
"13912","E01009149",2001,886,707,179,47
"13913","E01009321",2001,774,466,308,13
"13914","E01009322",2001,649,307,342,13
"13915","E01009323",2001,577,234,343,14
"13916","E01009314",2001,623,124,499,43
"13917","E01009302",2001,639,62,577,27
"13918","E01009329",2001,661,160,501,131
"13919","E01009334",2001,502,97,405,48
"13920","E01009337",2001,497,89,408,103
"13921","E01009338",2001,442,120,322,93
"13922","E01009380",2001,468,122,346,85
"13923","E01009379",2001,660,397,263,39
"13924","E01009362",2001,515,321,194,62
"13925","E01009363",2001,533,254,279,47
"13926","E01009364",2001,488,326,162,34
"13927","E01009365",2001,486,254,232,64
"13928","E01009519",2001,601,11,590,22
"13929","E01009520",2001,711,45,666,19
"13930","E01009324",2001,726,30,696,22
"13931","E01009312",2001,613,43,570,12
"13932","E01009260",2001,637,38,599,27
"13933","E01009261",2001,673,30,643,37
"13934","E01009252",2001,607,32,575,64
"13935","E01009070",2001,589,22,567,64
"13936","E01009066",2001,575,92,483,27
"13937","E01008996",2001,658,342,316,75
"13938","E01008997",2001,608,144,464,91
"13939","E01008984",2001,792,370,422,164
"13940","E01008994",2001,723,272,451,135
"13941","E01009067",2001,695,109,586,163
"13942","E01009068",2001,628,65,563,154
"13943","E01009069",2001,790,107,683,202
"13944","E01009072",2001,746,113,633,115
"13945","E01009065",2001,601,56,545,88
"13946","E01009313",2001,633,110,523,17
"13947","E01008885",2001,501,21,480,22
"13948","E01008886",2001,696,150,546,41
"13949","E01008888",2001,639,37,602,30
"13950","E01009368",2001,418,238,180,29
"13951","E01009369",2001,416,152,264,50
"13952","E01009370",2001,425,115,310,55
"13953","E01009371",2001,482,178,304,74
"13954","E01009397",2001,452,200,252,41
"13955","E01008889",2001,664,90,574,112
"13956","E01008887",2001,621,155,466,43
"13957","E01008883",2001,630,116,514,66
"13958","E01008884",2001,632,130,502,116
"13959","E01008992",2001,463,22,441,76
"13960","E01008993",2001,466,48,418,152
"13961","E01008982",2001,536,85,451,107
"13962","E01008983",2001,433,54,379,174
"13963","E01009283",2001,570,69,501,117
"13964","E01009253",2001,593,68,525,12
"13965","E01009255",2001,624,130,494,32
"13966","E01009257",2001,606,176,430,24
"13967","E01009249",2001,612,88,524,25
"13968","E01009250",2001,672,72,600,44
"13969","E01009251",2001,631,41,590,26
"13970","E01009315",2001,751,153,598,40
"13971","E01009316",2001,666,93,573,41
"13972","E01009317",2001,746,226,520,20
"13973","E01009318",2001,639,24,615,19
"13974","E01009319",2001,635,10,625,36
"13975","E01009320",2001,620,19,601,47
"13976","E01009398",2001,471,140,331,72
"13977","E01009381",2001,471,89,382,82
"13978","E01009372",2001,466,149,317,56
"13979","E01009373",2001,496,169,327,64
"13980","E01009396",2001,476,65,411,69
"13981","E01009367",2001,487,180,307,67
"13982","E01009377",2001,453,292,161,40
"13983","E01009375",2001,475,172,303,70
"13984","E01009383",2001,430,78,352,82
"13985","E01009399",2001,426,94,332,73
"13986","E01009386",2001,406,171,235,49
"13987","E01009387",2001,475,171,304,85
"13988","E01009376",2001,505,230,275,100
"13989","E01009374",2001,438,270,168,19
"13990","E01009366",2001,525,237,288,55
"13991","E01009258",2001,671,333,338,17
"13992","E01009256",2001,640,149,491,13
"13993","E01009254",2001,723,279,444,35
"13994","E01009073",2001,638,415,223,30
"13995","E01009074",2001,645,342,303,49
"13996","E01009339",2001,489,129,360,91
"13997","E01009340",2001,869,143,726,151
"13998","E01009027",2001,484,62,422,56
"13999","E01009388",2001,416,58,358,83
"14000","E01008985",2001,463,184,279,104
"14001","E01009075",2001,820,408,412,111
"14002","E01009076",2001,660,127,533,156
"14003","E01009071",2001,766,246,520,91
"14004","E01009078",2001,635,118,517,106
"14005","E01009183",2001,491,29,462,63
"14006","E01009180",2001,474,95,379,91
"14007","E01009181",2001,400,110,290,94
"14008","E01009186",2001,760,166,594,111
"14009","E01009015",2001,703,200,503,82
"14010","E01008890",2001,660,93,567,60
"14011","E01008891",2001,665,136,529,16
"14012","E01008892",2001,517,166,351,67
"14013","E01008893",2001,662,82,580,96
"14014","E01008894",2001,616,188,428,162
"14015","E01008895",2001,598,103,495,46
"14016","E01009018",2001,614,69,545,93
"14017","E01009028",2001,623,222,401,26
"14018","E01009029",2001,507,135,372,23
"14019","E01009014",2001,557,170,387,41
"14020","E01009026",2001,587,248,339,46
"14021","E01009382",2001,490,60,430,80
"14022","E01009391",2001,521,51,470,121
"14023","E01009392",2001,494,53,441,84
"14024","E01009393",2001,507,51,456,107
"14025","E01009384",2001,705,349,356,128
"14026","E01009385",2001,577,111,466,155
"14027","E01009187",2001,659,120,539,114
"14028","E01009188",2001,701,123,578,151
"14029","E01009182",2001,659,262,397,209
"14030","E01009184",2001,685,156,529,186
"14031","E01009185",2001,671,60,611,143
"14032","E01009389",2001,497,51,446,57
"14033","E01009390",2001,609,123,486,267
"14034","E01009394",2001,739,95,644,78
"14035","E01009259",2001,690,384,306,15
"14036","E01008918",2001,729,381,348,27
"14037","E01008920",2001,547,64,483,18
"14038","E01008921",2001,614,180,434,29
"14039","E01008931",2001,642,309,333,11
"14040","E01008919",2001,641,198,443,23
"14041","E01009291",2001,614,191,423,36
"14042","E01009064",2001,599,168,431,48
"14043","E01009077",2001,721,112,609,40
"14044","E01009500",2001,629,278,351,27
"14045","E01009289",2001,552,86,466,310
"14046","E01009290",2001,490,28,462,290
"14047","E01009284",2001,632,93,539,196
"14048","E01009285",2001,477,88,389,297
"14049","E01009286",2001,523,20,503,304
"14050","E01009287",2001,419,46,373,301
"14051","E01009017",2001,485,53,432,46
"14052","E01009043",2001,581,76,505,53
"14053","E01009044",2001,475,65,410,66
"14054","E01009045",2001,584,57,527,56
"14055","E01009046",2001,599,51,548,30
"14056","E01009395",2001,565,133,432,118
"14057","E01009030",2001,489,28,461,18
"14058","E01009022",2001,600,139,461,30
"14059","E01009023",2001,562,45,517,33
"14060","E01009016",2001,709,279,430,33
"14061","E01009281",2001,721,263,458,59
"14062","E01009292",2001,664,14,650,83
"14063","E01009294",2001,747,168,579,63
"14064","E01009295",2001,654,125,529,100
"14065","E01009296",2001,593,51,542,155
"14066","E01009293",2001,616,28,588,103
"14067","E01009282",2001,639,107,532,93
"14068","E01009288",2001,467,36,431,95
"14069","E01009280",2001,593,176,417,84
"14070","E01008924",2001,650,152,498,16
"14071","E01009501",2001,596,240,356,53
"14072","E01009502",2001,623,257,366,24
"14073","E01009503",2001,613,248,365,30
"14074","E01009505",2001,652,302,350,40
"14075","E01008925",2001,526,27,499,13
"14076","E01008917",2001,522,94,428,9
"14077","E01008927",2001,671,398,273,12
"14078","E01008928",2001,671,434,237,10
"14079","E01008923",2001,646,355,291,16
"14080","E01009019",2001,627,302,325,32
"14081","E01009020",2001,549,201,348,11
"14082","E01009021",2001,664,306,358,22
"14083","E01009024",2001,623,263,360,39
"14084","E01009025",2001,611,271,340,20
"14085","E01009033",2001,670,255,415,33
"14086","E01009175",2001,602,45,557,94
"14087","E01009177",2001,617,53,564,107
"14088","E01009178",2001,649,106,543,127
"14089","E01009179",2001,654,78,576,52
"14090","E01009189",2001,614,58,556,76
"14091","E01009176",2001,655,144,511,55
"14092","E01009037",2001,669,105,564,43
"14093","E01009031",2001,598,49,549,22
"14094","E01008933",2001,551,100,451,24
"14095","E01008934",2001,557,48,509,30
"14096","E01008929",2001,716,392,324,18
"14097","E01008930",2001,668,334,334,48
"14098","E01008926",2001,619,254,365,23
"14099","E01008922",2001,745,454,291,19
"14100","E01009495",2001,600,300,300,12
"14101","E01008953",2001,652,115,537,64
"14102","E01008963",2001,594,132,462,48
"14103","E01008964",2001,650,223,427,24
"14104","E01008965",2001,590,34,556,35
"14105","E01008966",2001,607,221,386,47
"14106","E01009032",2001,593,45,548,24
"14107","E01009034",2001,518,13,505,27
"14108","E01009035",2001,628,89,539,45
"14109","E01009036",2001,514,8,506,29
"14110","E01009496",2001,623,41,582,10
"14111","E01009497",2001,633,178,455,44
"14112","E01009506",2001,634,37,597,22
"14113","E01009504",2001,632,138,494,34
"14114","E01009494",2001,670,534,136,80
"14115","E01008981",2001,581,67,514,21
"14116","E01008967",2001,641,70,571,17
"14117","E01008968",2001,617,55,562,30
"14118","E01008970",2001,575,167,408,19
"14119","E01008932",2001,652,239,413,39
"14120","E01008938",2001,593,227,366,24
"14121","E01008939",2001,605,208,397,22
"14122","E01008935",2001,630,284,346,43
"14123","E01008936",2001,664,216,448,10
"14124","E01008951",2001,598,171,427,74
"14125","E01008952",2001,727,84,643,162
"14126","E01008955",2001,665,68,597,86
"14127","E01008956",2001,582,101,481,36
"14128","E01008957",2001,646,108,538,83
"14129","E01008958",2001,788,478,310,46
"14130","E01008954",2001,582,284,298,25
"14131","E01008950",2001,723,361,362,29
"14132","E01009493",2001,758,432,326,194
"14133","E01009038",2001,561,36,525,29
"14134","E01009039",2001,620,13,607,21
"14135","E01009040",2001,630,15,615,24
"14136","E01009041",2001,613,27,586,33
"14137","E01009042",2001,530,14,516,137
"14138","E01008940",2001,594,237,357,37
"14139","E01008941",2001,602,248,354,19
"14140","E01008944",2001,745,215,530,38
"14141","E01008937",2001,627,237,390,20
"14142","E01008959",2001,770,192,578,63
"14143","E01008960",2001,619,55,564,61
"14144","E01008961",2001,680,47,633,146
"14145","E01008962",2001,742,335,407,35
"14146","E01008971",2001,642,127,515,27
"14147","E01008969",2001,690,92,598,50
"14148","E01008942",2001,619,227,392,16
"14149","E01008943",2001,536,227,309,15
"14150","E01008972",2001,647,266,381,20
"14151","E01008973",2001,730,141,589,29
"14152","E01008974",2001,579,93,486,33
"14153","E01008975",2001,643,72,571,29
"14154","E01009172",2001,533,250,283,19
"14155","E01009173",2001,639,327,312,16
"14156","E01009174",2001,536,214,322,14
"14157","E01009498",2001,702,335,367,29
"14158","E01009499",2001,609,199,410,26
"14159","E01009211",2001,661,40,621,28
"14160","E01009205",2001,607,66,541,24
"14161","E01009206",2001,649,49,600,23
"14162","E01009218",2001,573,87,486,22
"14163","E01009219",2001,620,113,507,38
"14164","E01008976",2001,669,260,409,20
"14165","E01008978",2001,826,619,207,29
"14166","E01008979",2001,772,373,399,23
"14167","E01008980",2001,697,369,328,26
"14168","E01008945",2001,633,143,490,32
"14169","E01008946",2001,635,189,446,18
"14170","E01008947",2001,543,61,482,28
"14171","E01008948",2001,625,31,594,33
"14172","E01008949",2001,518,8,510,7
"14173","E01008977",2001,664,160,504,45
"14174","E01009109",2001,609,437,172,22
"14175","E01009119",2001,622,123,499,54
"14176","E01009120",2001,669,110,559,26
"14177","E01009162",2001,633,124,509,34
"14178","E01009207",2001,621,6,615,18
"14179","E01009208",2001,579,15,564,27
"14180","E01009209",2001,733,175,558,61
"14181","E01009213",2001,687,137,550,21
"14182","E01009160",2001,730,480,250,17
"14183","E01009161",2001,618,262,356,4
"14184","E01009154",2001,625,375,250,6
"14185","E01009155",2001,606,368,238,11
"14186","E01009156",2001,504,336,168,5
"14187","E01009157",2001,631,368,263,13
"14188","E01009117",2001,634,458,176,9
"14189","E01009214",2001,764,417,347,15
"14190","E01009215",2001,897,468,429,20
"14191","E01009212",2001,733,265,468,28
"14192","E01009210",2001,704,192,512,46
"14193","E01009118",2001,654,194,460,8
"14194","E01009108",2001,616,141,475,5
"14195","E01009116",2001,543,20,523,16
"14196","E01009111",2001,590,116,474,21
"14197","E01009112",2001,576,153,423,11
"14198","E01009113",2001,636,412,224,20
"14199","E01009114",2001,663,344,319,10
"14200","E01009115",2001,610,327,283,10
"14201","E01009107",2001,781,450,331,19
"14202","E01009110",2001,625,279,346,27
"14203","E01009158",2001,613,195,418,39
"14204","E01009163",2001,623,272,351,25
"14205","E01009165",2001,649,206,443,51
"14206","E01009169",2001,628,63,565,32
"14207","E01009171",2001,705,199,506,34
"14208","E01009167",2001,602,94,508,24
"14209","E01009164",2001,637,132,505,15
"14210","E01009159",2001,548,29,519,45
"14211","E01009168",2001,605,39,566,21
"14212","E01009166",2001,547,137,410,28
"14213","E01009170",2001,627,30,597,24
"14214","E01009216",2001,639,120,519,19
"14215","E01009217",2001,635,12,623,39
"14216","E01009589",2001,593,88,505,48
"14217","E01009600",2001,744,155,589,83
"14218","E01009601",2001,613,83,530,71
"14219","E01009602",2001,546,19,527,35
"14220","E01009603",2001,604,98,506,91
"14221","E01009593",2001,616,15,601,50
"14222","E01009598",2001,649,18,631,41
"14223","E01009590",2001,511,42,469,34
"14224","E01009591",2001,603,32,571,51
"14225","E01009592",2001,645,150,495,68
"14226","E01009595",2001,577,185,392,30
"14227","E01009596",2001,554,86,468,77
"14228","E01009597",2001,577,23,554,62
"14229","E01009588",2001,667,237,430,36
"14230","E01009604",2001,572,52,520,40
"14231","E01009605",2001,580,231,349,38
"14232","E01009607",2001,820,485,335,46
"14233","E01009608",2001,614,97,517,61
"14234","E01009610",2001,630,186,444,50
"14235","E01009609",2001,599,103,496,60
"14236","E01009606",2001,550,40,510,59
"14237","E01009575",2001,467,86,381,87
"14238","E01009564",2001,519,111,408,114
"14239","E01009524",2001,710,197,513,22
"14240","E01009525",2001,581,22,559,20
"14241","E01009527",2001,648,47,601,27
"14242","E01009594",2001,575,58,517,19
"14243","E01009577",2001,616,411,205,30
"14244","E01009579",2001,738,478,260,34
"14245","E01009581",2001,639,327,312,29
"14246","E01009584",2001,622,127,495,43
"14247","E01009585",2001,567,415,152,24
"14248","E01009709",2001,636,333,303,194
"14249","E01009586",2001,654,17,637,33
"14250","E01009582",2001,637,141,496,21
"14251","E01009583",2001,613,117,496,27
"14252","E01009578",2001,594,37,557,10
"14253","E01009576",2001,663,173,490,17
"14254","E01009565",2001,435,46,389,69
"14255","E01009566",2001,496,159,337,120
"14256","E01009567",2001,554,97,457,114
"14257","E01009568",2001,518,85,433,81
"14258","E01009528",2001,605,8,597,9
"14259","E01009531",2001,753,97,656,46
"14260","E01009526",2001,610,18,592,28
"14261","E01009523",2001,582,14,568,30
"14262","E01009587",2001,556,20,536,90
"14263","E01009624",2001,596,36,560,83
"14264","E01009625",2001,622,45,577,53
"14265","E01009626",2001,587,43,544,64
"14266","E01009627",2001,657,122,535,102
"14267","E01009628",2001,650,60,590,62
"14268","E01009622",2001,665,257,408,49
"14269","E01009623",2001,666,146,520,69
"14270","E01009599",2001,580,61,519,93
"14271","E01009710",2001,628,21,607,85
"14272","E01009711",2001,616,43,573,35
"14273","E01009663",2001,632,25,607,43
"14274","E01009645",2001,575,7,568,50
"14275","E01009522",2001,680,212,468,50
"14276","E01009529",2001,617,12,605,30
"14277","E01009530",2001,561,11,550,19
"14278","E01009569",2001,503,127,376,93
"14279","E01009570",2001,512,107,405,97
"14280","E01009571",2001,644,317,327,63
"14281","E01009572",2001,637,243,394,148
"14282","E01009573",2001,488,145,343,89
"14283","E01009574",2001,603,280,323,96
"14284","E01009655",2001,731,337,394,46
"14285","E01009656",2001,631,196,435,71
"14286","E01009664",2001,591,56,535,49
"14287","E01009662",2001,550,101,449,46
"14288","E01009659",2001,756,266,490,153
"14289","E01009652",2001,628,26,602,29
"14290","E01009653",2001,620,12,608,31
"14291","E01009647",2001,675,26,649,52
"14292","E01009648",2001,600,12,588,41
"14293","E01009643",2001,594,10,584,60
"14294","E01009644",2001,630,20,610,30
"14295","E01009657",2001,633,15,618,48
"14296","E01009613",2001,496,13,483,24
"14297","E01009712",2001,619,21,598,62
"14298","E01009714",2001,597,13,584,52
"14299","E01009716",2001,645,40,605,30
"14300","E01009717",2001,583,21,562,37
"14301","E01009718",2001,773,349,424,51
"14302","E01009715",2001,620,108,512,88
"14303","E01009713",2001,542,24,518,50
"14304","E01009580",2001,562,46,516,106
"14305","E01009650",2001,696,124,572,259
"14306","E01009629",2001,603,96,507,159
"14307","E01009630",2001,634,185,449,68
"14308","E01009631",2001,590,251,339,87
"14309","E01009632",2001,912,423,489,213
"14310","E01009654",2001,683,18,665,59
"14311","E01009658",2001,591,23,568,69
"14312","E01009614",2001,563,7,556,38
"14313","E01009660",2001,612,56,556,102
"14314","E01009692",2001,529,4,525,17
"14315","E01009693",2001,728,13,715,39
"14316","E01009694",2001,632,9,623,39
"14317","E01009646",2001,609,7,602,46
"14318","E01009695",2001,756,11,745,26
"14319","E01009696",2001,639,8,631,32
"14320","E01009704",2001,582,10,572,16
"14321","E01009705",2001,585,10,575,21
"14322","E01009636",2001,594,162,432,137
"14323","E01009637",2001,456,189,267,75
"14324","E01009638",2001,891,660,231,87
"14325","E01009639",2001,485,119,366,84
"14326","E01009640",2001,623,238,385,102
"14327","E01009641",2001,610,261,349,167
"14328","E01009706",2001,652,21,631,28
"14329","E01009697",2001,645,16,629,26
"14330","E01009698",2001,627,11,616,20
"14331","E01009703",2001,613,388,225,30
"14332","E01009684",2001,703,219,484,42
"14333","E01009685",2001,715,34,681,40
"14334","E01009686",2001,691,11,680,63
"14335","E01009687",2001,611,12,599,58
"14336","E01009649",2001,604,20,584,41
"14337","E01009620",2001,621,68,553,61
"14338","E01009621",2001,501,92,409,38
"14339","E01009615",2001,632,22,610,134
"14340","E01009616",2001,593,24,569,66
"14341","E01009617",2001,479,34,445,40
"14342","E01009618",2001,633,19,614,36
"14343","E01009633",2001,634,148,486,152
"14344","E01009634",2001,619,86,533,162
"14345","E01009635",2001,640,165,475,230
"14346","E01009661",2001,668,84,584,201
"14347","E01009674",2001,629,236,393,41
"14348","E01009699",2001,615,63,552,13
"14349","E01009700",2001,787,428,359,27
"14350","E01009701",2001,730,273,457,29
"14351","E01009702",2001,733,309,424,59
"14352","E01009688",2001,612,59,553,172
"14353","E01009689",2001,640,37,603,203
"14354","E01009690",2001,646,30,616,207
"14355","E01009691",2001,650,35,615,159
"14356","E01009642",2001,464,247,217,140
"14357","E01009651",2001,878,564,314,118
"14358","E01009553",2001,503,105,398,224
"14359","E01009548",2001,742,46,696,124
"14360","E01009676",2001,599,28,571,70
"14361","E01009681",2001,518,6,512,42
"14362","E01009682",2001,593,13,580,48
"14363","E01009683",2001,584,101,483,59
"14364","E01009707",2001,541,26,515,21
"14365","E01009708",2001,617,39,578,31
"14366","E01009543",2001,472,6,466,11
"14367","E01009535",2001,594,24,570,16
"14368","E01009536",2001,611,6,605,37
"14369","E01009532",2001,588,30,558,17
"14370","E01009554",2001,573,24,549,125
"14371","E01009555",2001,616,7,609,36
"14372","E01009556",2001,637,53,584,138
"14373","E01009557",2001,542,3,539,24
"14374","E01009558",2001,667,13,654,128
"14375","E01009559",2001,583,33,550,41
"14376","E01009537",2001,643,204,439,27
"14377","E01009538",2001,625,211,414,19
"14378","E01009533",2001,600,161,439,27
"14379","E01009534",2001,681,237,444,20
"14380","E01009611",2001,618,381,237,56
"14381","E01009612",2001,532,291,241,31
"14382","E01009677",2001,629,39,590,23
"14383","E01009679",2001,606,256,350,54
"14384","E01009680",2001,673,279,394,41
"14385","E01009675",2001,691,325,366,30
"14386","E01009545",2001,609,174,435,36
"14387","E01009549",2001,668,10,658,56
"14388","E01009550",2001,783,16,767,93
"14389","E01009551",2001,621,25,596,36
"14390","E01009552",2001,664,152,512,47
"14391","E01009546",2001,824,39,785,106
"14392","E01009547",2001,670,36,634,70
"14393","E01009544",2001,722,162,560,64
"14394","E01009619",2001,677,111,566,183
"14395","E01009539",2001,749,386,363,42
"14396","E01009540",2001,667,427,240,24
"14397","E01009541",2001,804,228,576,56
"14398","E01009542",2001,712,384,328,25
"14399","E01009560",2001,566,6,560,24
"14400","E01009561",2001,779,158,621,38
"14401","E01009562",2001,656,50,606,19
"14402","E01009563",2001,625,3,622,14
"14403","E01009672",2001,808,15,793,13
"14404","E01009670",2001,668,6,662,28
"14405","E01009666",2001,495,4,491,15
"14406","E01009667",2001,592,8,584,19
"14407","E01009668",2001,639,31,608,37
"14408","E01009669",2001,477,11,466,24
"14409","E01009671",2001,457,14,443,26
"14410","E01009665",2001,486,13,473,19
"14411","E01009673",2001,514,58,456,39
"14412","E01009678",2001,428,116,312,60
"14413","E01009763",2001,629,297,332,24
"14414","E01009764",2001,579,32,547,27
"14415","E01009769",2001,672,365,307,21
"14416","E01009770",2001,606,195,411,14
"14417","E01009767",2001,613,176,437,7
"14418","E01009773",2001,629,183,446,32
"14419","E01009777",2001,616,248,368,7
"14420","E01009778",2001,614,61,553,26
"14421","E01009895",2001,621,175,446,24
"14422","E01009896",2001,606,63,543,6
"14423","E01009897",2001,611,8,603,8
"14424","E01009898",2001,644,75,569,14
"14425","E01009901",2001,561,15,546,26
"14426","E01009902",2001,521,17,504,11
"14427","E01009775",2001,606,194,412,17
"14428","E01009776",2001,596,44,552,12
"14429","E01009768",2001,610,137,473,48
"14430","E01009771",2001,649,37,612,9
"14431","E01009765",2001,633,75,558,34
"14432","E01009766",2001,659,214,445,16
"14433","E01009758",2001,619,262,357,9
"14434","E01009760",2001,524,111,413,18
"14435","E01009772",2001,477,206,271,16
"14436","E01009774",2001,636,78,558,19
"14437","E01009788",2001,670,310,360,24
"14438","E01009761",2001,574,431,143,8
"14439","E01009762",2001,502,360,142,6
"14440","E01009759",2001,530,8,522,16
"14441","E01009755",2001,499,373,126,8
"14442","E01009756",2001,535,293,242,11
"14443","E01009757",2001,576,119,457,35
"14444","E01009789",2001,639,52,587,10
"14445","E01009790",2001,639,253,386,14
"14446","E01009786",2001,623,383,240,16
"14447","E01009781",2001,754,282,472,26
"14448","E01009782",2001,654,312,342,13
"14449","E01009783",2001,600,206,394,20
"14450","E01009779",2001,648,137,511,30
"14451","E01009899",2001,627,15,612,10
"14452","E01009900",2001,633,8,625,7
"14453","E01009785",2001,654,46,608,18
"14454","E01009880",2001,549,22,527,17
"14455","E01009882",2001,534,36,498,27
"14456","E01009780",2001,570,38,532,5
"14457","E01009784",2001,556,11,545,7
"14458","E01009787",2001,588,16,572,9
"14459","E01009891",2001,608,272,336,25
"14460","E01009892",2001,618,262,356,86
"14461","E01009893",2001,604,384,220,11
"14462","E01009894",2001,685,209,476,20
"14463","E01009885",2001,645,204,441,41
"14464","E01009881",2001,772,406,366,74
"14465","E01009844",2001,611,242,369,82
"14466","E01009879",2001,548,118,430,40
"14467","E01009816",2001,606,3,603,15
"14468","E01009817",2001,535,20,515,16
"14469","E01009819",2001,632,14,618,26
"14470","E01009820",2001,590,46,544,17
"14471","E01009839",2001,611,130,481,54
"14472","E01009886",2001,834,484,350,16
"14473","E01009883",2001,571,251,320,16
"14474","E01009884",2001,613,257,356,48
"14475","E01009748",2001,649,350,299,26
"14476","E01009821",2001,600,0,600,4
"14477","E01009822",2001,655,51,604,27
"14478","E01009818",2001,509,148,361,24
"14479","E01009814",2001,520,8,512,7
"14480","E01009815",2001,493,5,488,4
"14481","E01009887",2001,632,164,468,31
"14482","E01009888",2001,626,106,520,17
"14483","E01009889",2001,666,140,526,118
"14484","E01009890",2001,664,329,335,13
"14485","E01009823",2001,543,4,539,5
"14486","E01009824",2001,718,251,467,9
"14487","E01009749",2001,592,13,579,35
"14488","E01009750",2001,604,183,421,9
"14489","E01009751",2001,627,167,460,42
"14490","E01009752",2001,618,265,353,26
"14491","E01009753",2001,609,355,254,18
"14492","E01009754",2001,646,215,431,25
"14493","E01009841",2001,652,312,340,35
"14494","E01009842",2001,764,371,393,53
"14495","E01009843",2001,600,92,508,26
"14496","E01009840",2001,509,114,395,59
"14497","E01009875",2001,616,168,448,16
"14498","E01009871",2001,667,159,508,31
"14499","E01009825",2001,610,157,453,13
"14500","E01009826",2001,624,12,612,16
"14501","E01009827",2001,630,3,627,3
"14502","E01009828",2001,587,64,523,21
"14503","E01009829",2001,620,8,612,15
"14504","E01009830",2001,628,34,594,14
"14505","E01009872",2001,597,274,323,31
"14506","E01009873",2001,615,81,534,33
"14507","E01009874",2001,575,226,349,11
"14508","E01009876",2001,621,173,448,8
"14509","E01009877",2001,636,336,300,12
"14510","E01009911",2001,615,8,607,24
"14511","E01009912",2001,507,0,507,21
"14512","E01009913",2001,633,109,524,11
"14513","E01009914",2001,610,3,607,9
"14514","E01009915",2001,612,12,600,18
"14515","E01009916",2001,671,119,552,44
"14516","E01009746",2001,656,191,465,91
"14517","E01009747",2001,680,147,533,47
"14518","E01009741",2001,921,572,349,37
"14519","E01009744",2001,732,258,474,78
"14520","E01009745",2001,715,68,647,35
"14521","E01009742",2001,645,278,367,22
"14522","E01009743",2001,689,418,271,12
"14523","E01009740",2001,610,245,365,38
"14524","E01009731",2001,637,22,615,64
"14525","E01009917",2001,501,13,488,6
"14526","E01009918",2001,608,254,354,4
"14527","E01009919",2001,501,8,493,9
"14528","E01009920",2001,619,21,598,37
"14529","E01009878",2001,634,23,611,19
"14530","E01009864",2001,587,187,400,5
"14531","E01009865",2001,625,265,360,13
"14532","E01009866",2001,630,91,539,77
"14533","E01009867",2001,640,141,499,9
"14534","E01009791",2001,640,151,489,14
"14535","E01009792",2001,616,176,440,19
"14536","E01009795",2001,628,102,526,86
"14537","E01009796",2001,617,81,536,23
"14538","E01009798",2001,656,64,592,35
"14539","E01009719",2001,553,15,538,17
"14540","E01009722",2001,621,12,609,21
"14541","E01009727",2001,490,3,487,19
"14542","E01009728",2001,502,3,499,6
"14543","E01009729",2001,598,112,486,13
"14544","E01009730",2001,608,18,590,29
"14545","E01009723",2001,471,0,471,20
"14546","E01009724",2001,629,7,622,17
"14547","E01009720",2001,531,6,525,11
"14548","E01009909",2001,637,129,508,14
"14549","E01009910",2001,713,258,455,14
"14550","E01009903",2001,624,6,618,24
"14551","E01009904",2001,617,31,586,19
"14552","E01009797",2001,639,139,500,43
"14553","E01009801",2001,641,33,608,6
"14554","E01009793",2001,518,17,501,15
"14555","E01009794",2001,621,5,616,15
"14556","E01009721",2001,651,114,537,29
"14557","E01009725",2001,593,373,220,12
"14558","E01009726",2001,543,9,534,12
"14559","E01009834",2001,653,204,449,23
"14560","E01009835",2001,503,35,468,38
"14561","E01009833",2001,486,75,411,75
"14562","E01009869",2001,646,17,629,27
"14563","E01009870",2001,648,16,632,45
"14564","E01009868",2001,627,156,471,34
"14565","E01009861",2001,600,105,495,69
"14566","E01009862",2001,635,184,451,34
"14567","E01009863",2001,495,114,381,20
"14568","E01009813",2001,632,171,461,25
"14569","E01009809",2001,641,291,350,9
"14570","E01009734",2001,632,126,506,39
"14571","E01009735",2001,617,9,608,16
"14572","E01009736",2001,585,9,576,22
"14573","E01009737",2001,638,126,512,17
"14574","E01009738",2001,599,130,469,13
"14575","E01009856",2001,873,193,680,100
"14576","E01009905",2001,645,86,559,41
"14577","E01009906",2001,750,367,383,43
"14578","E01009907",2001,632,52,580,82
"14579","E01009908",2001,643,22,621,72
"14580","E01009800",2001,632,55,577,20
"14581","E01009802",2001,661,153,508,12
"14582","E01009803",2001,622,3,619,12
"14583","E01009804",2001,524,17,507,13
"14584","E01009831",2001,641,303,338,12
"14585","E01009836",2001,749,401,348,70
"14586","E01009837",2001,613,81,532,66
"14587","E01009838",2001,632,190,442,26
"14588","E01009851",2001,610,64,546,18
"14589","E01009847",2001,612,111,501,3
"14590","E01009848",2001,614,105,509,22
"14591","E01009849",2001,675,189,486,14
"14592","E01009805",2001,614,57,557,24
"14593","E01009806",2001,580,42,538,21
"14594","E01009799",2001,580,21,559,30
"14595","E01009732",2001,666,184,482,37
"14596","E01009733",2001,801,533,268,27
"14597","E01009739",2001,626,126,500,48
"14598","E01009857",2001,720,313,407,24
"14599","E01009858",2001,534,51,483,56
"14600","E01009859",2001,616,3,613,37
"14601","E01009854",2001,625,7,618,25
"14602","E01009850",2001,634,48,586,32
"14603","E01009852",2001,601,4,597,17
"14604","E01009845",2001,596,29,567,18
"14605","E01009846",2001,621,56,565,11
"14606","E01009853",2001,643,6,637,9
"14607","E01009832",2001,682,381,301,16
"14608","E01009855",2001,638,8,630,6
"14609","E01009860",2001,639,27,612,9
"14610","E01009810",2001,719,107,612,17
"14611","E01009811",2001,639,106,533,9
"14612","E01009812",2001,571,37,534,11
"14613","E01009807",2001,757,6,751,16
"14614","E01009808",2001,607,6,601,8
"14615","E01010085",2001,597,79,518,38
"14616","E01010086",2001,599,294,305,11
"14617","E01010087",2001,610,195,415,15
"14618","E01010088",2001,567,209,358,11
"14619","E01010089",2001,611,265,346,10
"14620","E01009973",2001,561,62,499,21
"14621","E01009969",2001,678,262,416,43
"14622","E01009970",2001,648,204,444,10
"14623","E01009971",2001,614,276,338,13
"14624","E01009966",2001,480,201,279,8
"14625","E01009967",2001,663,183,480,13
"14626","E01009960",2001,646,298,348,10
"14627","E01009961",2001,544,25,519,6
"14628","E01010092",2001,654,200,454,25
"14629","E01009962",2001,509,277,232,8
"14630","E01009963",2001,506,260,246,16
"14631","E01009964",2001,597,346,251,7
"14632","E01009965",2001,482,270,212,3
"14633","E01010090",2001,626,327,299,37
"14634","E01010091",2001,623,194,429,27
"14635","E01010096",2001,721,305,416,29
"14636","E01010097",2001,729,121,608,18
"14637","E01009974",2001,628,12,616,22
"14638","E01009975",2001,657,55,602,10
"14639","E01009968",2001,652,53,599,28
"14640","E01009972",2001,728,30,698,38
"14641","E01010030",2001,634,351,283,20
"14642","E01010034",2001,508,0,508,15
"14643","E01010035",2001,599,9,590,28
"14644","E01010036",2001,480,165,315,15
"14645","E01009945",2001,636,117,519,11
"14646","E01009946",2001,626,54,572,24
"14647","E01009948",2001,610,45,565,17
"14648","E01009949",2001,568,11,557,9
"14649","E01009950",2001,641,105,536,11
"14650","E01009951",2001,913,432,481,93
"14651","E01010037",2001,515,320,195,16
"14652","E01010029",2001,598,386,212,28
"14653","E01009982",2001,508,203,305,7
"14654","E01009983",2001,588,302,286,3
"14655","E01009991",2001,626,248,378,30
"14656","E01009994",2001,608,238,370,10
"14657","E01009995",2001,600,150,450,22
"14658","E01009996",2001,669,390,279,17
"14659","E01009997",2001,527,249,278,21
"14660","E01009998",2001,643,232,411,28
"14661","E01010010",2001,627,315,312,17
"14662","E01010011",2001,639,22,617,44
"14663","E01010012",2001,604,16,588,19
"14664","E01010008",2001,620,85,535,21
"14665","E01010009",2001,525,129,396,6
"14666","E01010007",2001,517,97,420,19
"14667","E01010013",2001,518,11,507,15
"14668","E01010014",2001,624,30,594,9
"14669","E01010098",2001,710,406,304,9
"14670","E01010099",2001,628,139,489,16
"14671","E01010100",2001,493,84,409,46
"14672","E01010093",2001,646,430,216,23
"14673","E01010094",2001,505,101,404,30
"14674","E01010095",2001,515,258,257,15
"14675","E01010074",2001,658,308,350,20
"14676","E01009978",2001,634,215,419,8
"14677","E01010031",2001,685,353,332,22
"14678","E01010032",2001,510,373,137,8
"14679","E01010033",2001,761,380,381,40
"14680","E01010075",2001,498,33,465,16
"14681","E01010076",2001,640,334,306,24
"14682","E01010066",2001,639,315,324,24
"14683","E01010067",2001,625,197,428,81
"14684","E01010068",2001,546,210,336,31
"14685","E01010070",2001,623,106,517,24
"14686","E01010071",2001,612,280,332,24
"14687","E01010069",2001,471,77,394,20
"14688","E01009979",2001,769,524,245,18
"14689","E01009980",2001,609,218,391,34
"14690","E01009976",2001,610,37,573,37
"14691","E01009977",2001,610,176,434,44
"14692","E01009992",2001,613,122,491,36
"14693","E01009993",2001,628,338,290,14
"14694","E01010103",2001,649,230,419,42
"14695","E01010104",2001,750,237,513,51
"14696","E01010105",2001,462,63,399,34
"14697","E01009947",2001,774,133,641,70
"14698","E01009990",2001,633,245,388,28
"14699","E01009984",2001,476,223,253,26
"14700","E01009985",2001,628,263,365,30
"14701","E01009981",2001,759,286,473,32
"14702","E01009986",2001,511,56,455,59
"14703","E01009987",2001,597,271,326,57
"14704","E01009989",2001,594,108,486,60
"14705","E01010106",2001,465,112,353,56
"14706","E01010107",2001,593,192,401,91
"14707","E01010101",2001,766,439,327,28
"14708","E01010102",2001,655,189,466,49
"14709","E01009988",2001,768,428,340,16
"14710","E01010015",2001,602,28,574,46
"14711","E01010016",2001,594,101,493,59
"14712","E01010018",2001,637,182,455,69
"14713","E01010072",2001,745,181,564,56
"14714","E01010073",2001,579,176,403,36
"14715","E01010077",2001,661,317,344,17
"14716","E01010079",2001,620,54,566,30
"14717","E01010080",2001,698,318,380,42
"14718","E01010081",2001,634,34,600,15
"14719","E01010082",2001,594,95,499,31
"14720","E01010083",2001,648,235,413,14
"14721","E01010084",2001,541,256,285,18
"14722","E01010052",2001,479,167,312,45
"14723","E01010053",2001,462,238,224,43
"14724","E01010046",2001,502,170,332,30
"14725","E01010047",2001,492,63,429,63
"14726","E01010048",2001,508,29,479,56
"14727","E01010049",2001,534,77,457,71
"14728","E01010050",2001,496,58,438,48
"14729","E01010019",2001,607,100,507,74
"14730","E01010020",2001,646,197,449,20
"14731","E01010021",2001,591,124,467,56
"14732","E01010017",2001,650,311,339,43
"14733","E01010043",2001,610,52,558,15
"14734","E01010044",2001,620,228,392,22
"14735","E01010039",2001,520,239,281,15
"14736","E01010078",2001,522,5,517,12
"14737","E01010061",2001,491,94,397,65
"14738","E01010062",2001,624,368,256,23
"14739","E01010063",2001,664,542,122,12
"14740","E01010064",2001,615,189,426,53
"14741","E01010065",2001,478,226,252,51
"14742","E01010059",2001,500,90,410,72
"14743","E01010004",2001,773,219,554,55
"14744","E01009934",2001,581,246,335,12
"14745","E01009935",2001,827,431,396,28
"14746","E01009936",2001,658,37,621,8
"14747","E01010060",2001,654,151,503,99
"14748","E01010054",2001,778,420,358,48
"14749","E01010055",2001,617,41,576,93
"14750","E01010056",2001,646,267,379,32
"14751","E01010057",2001,607,117,490,85
"14752","E01010040",2001,573,122,451,12
"14753","E01010041",2001,705,322,383,24
"14754","E01010038",2001,629,237,392,25
"14755","E01010045",2001,644,224,420,16
"14756","E01010005",2001,580,71,509,52
"14757","E01010006",2001,644,44,600,38
"14758","E01010000",2001,673,122,551,32
"14759","E01010002",2001,616,29,587,63
"14760","E01010003",2001,683,298,385,34
"14761","E01010051",2001,481,154,327,22
"14762","E01010058",2001,705,288,417,23
"14763","E01009938",2001,650,232,418,4
"14764","E01009943",2001,506,208,298,18
"14765","E01009944",2001,595,233,362,16
"14766","E01009939",2001,642,83,559,27
"14767","E01009940",2001,611,216,395,12
"14768","E01009941",2001,624,138,486,21
"14769","E01009942",2001,638,235,403,22
"14770","E01009937",2001,610,242,368,16
"14771","E01009929",2001,729,327,402,25
"14772","E01009930",2001,655,234,421,18
"14773","E01009931",2001,596,46,550,32
"14774","E01009932",2001,737,327,410,76
"14775","E01009999",2001,517,119,398,22
"14776","E01009924",2001,651,11,640,96
"14777","E01009925",2001,594,23,571,66
"14778","E01009926",2001,606,49,557,67
"14779","E01009927",2001,654,25,629,130
"14780","E01009928",2001,768,149,619,123
"14781","E01009921",2001,678,18,660,125
"14782","E01009922",2001,515,154,361,18
"14783","E01009933",2001,544,179,365,17
"14784","E01009952",2001,709,502,207,20
"14785","E01009959",2001,603,12,591,9
"14786","E01009955",2001,646,167,479,69
"14787","E01009956",2001,673,218,455,41
"14788","E01010042",2001,787,187,600,50
"14789","E01010024",2001,632,36,596,29
"14790","E01010026",2001,737,166,571,20
"14791","E01010027",2001,600,28,572,28
"14792","E01009923",2001,599,79,520,22
"14793","E01010028",2001,669,336,333,10
"14794","E01010025",2001,647,219,428,21
"14795","E01010022",2001,620,34,586,20
"14796","E01010023",2001,721,64,657,31
"14797","E01010001",2001,712,249,463,26
"14798","E01009957",2001,597,332,265,16
"14799","E01009958",2001,638,42,596,46
"14800","E01009953",2001,708,237,471,42
"14801","E01009954",2001,729,236,493,20
"14802","E01010120",2001,646,289,357,14
"14803","E01010121",2001,610,8,602,27
"14804","E01010122",2001,608,15,593,22
"14805","E01010118",2001,503,134,369,7
"14806","E01010239",2001,625,241,384,15
"14807","E01010240",2001,579,254,325,10
"14808","E01010235",2001,553,256,297,11
"14809","E01010236",2001,618,364,254,7
"14810","E01010119",2001,608,4,604,9
"14811","E01010117",2001,528,3,525,11
"14812","E01010123",2001,596,22,574,13
"14813","E01010124",2001,616,13,603,16
"14814","E01010146",2001,645,271,374,3
"14815","E01010237",2001,656,153,503,5
"14816","E01010238",2001,637,358,279,16
"14817","E01010234",2001,759,475,284,23
"14818","E01010147",2001,646,385,261,10
"14819","E01010148",2001,708,388,320,30
"14820","E01010149",2001,567,87,480,3
"14821","E01010145",2001,645,128,517,15
"14822","E01010141",2001,643,453,190,10
"14823","E01010139",2001,404,102,302,0
"14824","E01010125",2001,663,412,251,11
"14825","E01010129",2001,648,375,273,12
"14826","E01010140",2001,646,352,294,13
"14827","E01010142",2001,622,350,272,13
"14828","E01010143",2001,672,371,301,13
"14829","E01010144",2001,632,174,458,10
"14830","E01010130",2001,783,489,294,15
"14831","E01010131",2001,604,327,277,21
"14832","E01010126",2001,646,354,292,19
"14833","E01010127",2001,588,233,355,13
"14834","E01010128",2001,634,206,428,19
"14835","E01010111",2001,615,308,307,19
"14836","E01010112",2001,610,131,479,14
"14837","E01010113",2001,536,158,378,9
"14838","E01010114",2001,614,45,569,23
"14839","E01010109",2001,527,3,524,19
"14840","E01010110",2001,511,72,439,6
"14841","E01010157",2001,594,17,577,41
"14842","E01010162",2001,621,6,615,13
"14843","E01010163",2001,536,29,507,22
"14844","E01010159",2001,538,36,502,12
"14845","E01010138",2001,602,7,595,20
"14846","E01010132",2001,616,114,502,79
"14847","E01010133",2001,703,14,689,43
"14848","E01010134",2001,589,13,576,26
"14849","E01010135",2001,643,111,532,29
"14850","E01010136",2001,514,49,465,42
"14851","E01010137",2001,640,299,341,29
"14852","E01010160",2001,614,128,486,12
"14853","E01010161",2001,611,26,585,22
"14854","E01010158",2001,626,216,410,35
"14855","E01010174",2001,607,7,600,26
"14856","E01010175",2001,606,27,579,26
"14857","E01010177",2001,535,64,471,17
"14858","E01010178",2001,722,233,489,79
"14859","E01010179",2001,766,32,734,72
"14860","E01010176",2001,448,5,443,9
"14861","E01010172",2001,555,3,552,11
"14862","E01010173",2001,485,0,485,6
"14863","E01010232",2001,733,105,628,65
"14864","E01010227",2001,663,6,657,41
"14865","E01010228",2001,634,32,602,38
"14866","E01010115",2001,620,125,495,36
"14867","E01010116",2001,510,7,503,18
"14868","E01010229",2001,558,6,552,32
"14869","E01010230",2001,602,88,514,45
"14870","E01010231",2001,628,10,618,20
"14871","E01010226",2001,782,61,721,121
"14872","E01010233",2001,593,171,422,20
"14873","E01010195",2001,539,5,534,11
"14874","E01010167",2001,599,70,529,42
"14875","E01010164",2001,616,40,576,39
"14876","E01010165",2001,727,168,559,53
"14877","E01010108",2001,806,72,734,37
"14878","E01010199",2001,613,11,602,23
"14879","E01010200",2001,616,154,462,22
"14880","E01010201",2001,590,9,581,19
"14881","E01010204",2001,652,286,366,19
"14882","E01010205",2001,534,6,528,15
"14883","E01010206",2001,613,7,606,25
"14884","E01010192",2001,634,10,624,103
"14885","E01010196",2001,620,4,616,12
"14886","E01010197",2001,624,3,621,7
"14887","E01010198",2001,644,62,582,19
"14888","E01010223",2001,482,85,397,32
"14889","E01010224",2001,627,9,618,63
"14890","E01010225",2001,580,3,577,19
"14891","E01010220",2001,660,6,654,59
"14892","E01010221",2001,649,45,604,34
"14893","E01010222",2001,615,29,586,28
"14894","E01010218",2001,635,173,462,30
"14895","E01010219",2001,631,29,602,31
"14896","E01010213",2001,655,170,485,26
"14897","E01010191",2001,720,41,679,46
"14898","E01010209",2001,690,50,640,38
"14899","E01010202",2001,610,3,607,14
"14900","E01010203",2001,652,25,627,48
"14901","E01010210",2001,649,6,643,12
"14902","E01010211",2001,648,201,447,12
"14903","E01010208",2001,626,8,618,18
"14904","E01010217",2001,638,3,635,20
"14905","E01010193",2001,477,3,474,10
"14906","E01010194",2001,630,3,627,49
"14907","E01010207",2001,574,0,574,27
"14908","E01010190",2001,632,3,629,38
"14909","E01010166",2001,528,6,522,13
"14910","E01010168",2001,640,4,636,51
"14911","E01010169",2001,587,7,580,29
"14912","E01010170",2001,536,3,533,6
"14913","E01010171",2001,502,55,447,12
"14914","E01010151",2001,765,136,629,108
"14915","E01010152",2001,500,4,496,6
"14916","E01010153",2001,572,17,555,19
"14917","E01010154",2001,648,18,630,33
"14918","E01010155",2001,646,15,631,33
"14919","E01010156",2001,624,3,621,8
"14920","E01010212",2001,480,0,480,20
"14921","E01010214",2001,518,10,508,21
"14922","E01010215",2001,611,27,584,19
"14923","E01010216",2001,595,0,595,36
"14924","E01010184",2001,580,114,466,21
"14925","E01010185",2001,601,22,579,16
"14926","E01010186",2001,712,8,704,42
"14927","E01010187",2001,492,0,492,14
"14928","E01010188",2001,652,0,652,17
"14929","E01010150",2001,614,3,611,11
"14930","E01010189",2001,601,24,577,33
"14931","E01010180",2001,506,8,498,14
"14932","E01010181",2001,531,9,522,23
"14933","E01010182",2001,511,7,504,57
"14934","E01010183",2001,467,4,463,9
"14935","E01010301",2001,602,288,314,23
"14936","E01010306",2001,632,107,525,50
"14937","E01010307",2001,669,63,606,10
"14938","E01010303",2001,617,115,502,28
"14939","E01010304",2001,731,110,621,15
"14940","E01010305",2001,531,184,347,13
"14941","E01010308",2001,717,451,266,30
"14942","E01010302",2001,651,231,420,25
"14943","E01010350",2001,573,67,506,16
"14944","E01010345",2001,482,38,444,10
"14945","E01010346",2001,528,8,520,5
"14946","E01010347",2001,635,298,337,10
"14947","E01010249",2001,602,158,444,24
"14948","E01010250",2001,580,56,524,15
"14949","E01010254",2001,573,193,380,26
"14950","E01010252",2001,640,218,422,20
"14951","E01010348",2001,629,129,500,25
"14952","E01010349",2001,603,172,431,37
"14953","E01010351",2001,629,107,522,6
"14954","E01010352",2001,611,29,582,12
"14955","E01010290",2001,760,289,471,23
"14956","E01010284",2001,645,257,388,18
"14957","E01010285",2001,728,88,640,31
"14958","E01010286",2001,636,335,301,18
"14959","E01010253",2001,525,209,316,5
"14960","E01010255",2001,619,15,604,14
"14961","E01010256",2001,652,120,532,20
"14962","E01010257",2001,516,7,509,6
"14963","E01010251",2001,493,7,486,9
"14964","E01010292",2001,761,422,339,52
"14965","E01010296",2001,580,13,567,15
"14966","E01010297",2001,587,4,583,9
"14967","E01010294",2001,650,322,328,15
"14968","E01010298",2001,498,121,377,24
"14969","E01010299",2001,603,268,335,7
"14970","E01010300",2001,606,298,308,16
"14971","E01010293",2001,654,254,400,10
"14972","E01010291",2001,538,250,288,3
"14973","E01010321",2001,619,172,447,12
"14974","E01010353",2001,644,150,494,9
"14975","E01010354",2001,630,125,505,22
"14976","E01010319",2001,466,8,458,12
"14977","E01010397",2001,610,253,357,13
"14978","E01010398",2001,609,7,602,7
"14979","E01010399",2001,623,108,515,23
"14980","E01010395",2001,495,13,482,10
"14981","E01010287",2001,616,192,424,73
"14982","E01010288",2001,603,297,306,24
"14983","E01010289",2001,618,350,268,19
"14984","E01010282",2001,510,161,349,39
"14985","E01010283",2001,580,317,263,17
"14986","E01010276",2001,516,274,242,19
"14987","E01010277",2001,566,196,370,16
"14988","E01010281",2001,411,258,153,18
"14989","E01010396",2001,616,157,459,17
"14990","E01010400",2001,784,392,392,19
"14991","E01010393",2001,575,75,500,14
"14992","E01010394",2001,509,16,493,41
"14993","E01010241",2001,642,63,579,68
"14994","E01010242",2001,745,268,477,6
"14995","E01010243",2001,707,47,660,14
"14996","E01010244",2001,605,259,346,29
"14997","E01010322",2001,639,170,469,17
"14998","E01010323",2001,602,158,444,16
"14999","E01010324",2001,635,114,521,43
"15000","E01010320",2001,589,195,394,10
"15001","E01010295",2001,708,373,335,17
"15002","E01010271",2001,588,338,250,25
"15003","E01010272",2001,673,363,310,49
"15004","E01010273",2001,621,361,260,10
"15005","E01010278",2001,603,375,228,15
"15006","E01010279",2001,629,291,338,22
"15007","E01010280",2001,628,432,196,4
"15008","E01010374",2001,568,196,372,66
"15009","E01010375",2001,487,213,274,48
"15010","E01010378",2001,472,23,449,27
"15011","E01010379",2001,528,15,513,10
"15012","E01010382",2001,606,171,435,9
"15013","E01010383",2001,669,371,298,10
"15014","E01010380",2001,685,12,673,19
"15015","E01010381",2001,631,227,404,35
"15016","E01010376",2001,489,13,476,23
"15017","E01010377",2001,598,135,463,15
"15018","E01010274",2001,601,356,245,12
"15019","E01010275",2001,635,337,298,12
"15020","E01010267",2001,648,115,533,19
"15021","E01010268",2001,568,111,457,87
"15022","E01010245",2001,638,46,592,12
"15023","E01010246",2001,609,33,576,20
"15024","E01010247",2001,636,89,547,12
"15025","E01010248",2001,632,6,626,18
"15026","E01010388",2001,529,4,525,4
"15027","E01010258",2001,640,378,262,12
"15028","E01010259",2001,634,131,503,5
"15029","E01010260",2001,641,262,379,10
"15030","E01010266",2001,508,287,221,12
"15031","E01010369",2001,713,369,344,71
"15032","E01010325",2001,621,75,546,71
"15033","E01010317",2001,619,4,615,13
"15034","E01010318",2001,785,432,353,80
"15035","E01010401",2001,605,244,361,14
"15036","E01010403",2001,557,197,360,53
"15037","E01010404",2001,625,191,434,58
"15038","E01010407",2001,603,177,426,14
"15039","E01010408",2001,617,161,456,74
"15040","E01010362",2001,619,210,409,36
"15041","E01010363",2001,638,248,390,94
"15042","E01010269",2001,474,81,393,96
"15043","E01010270",2001,640,191,449,24
"15044","E01010409",2001,643,248,395,17
"15045","E01010405",2001,630,91,539,71
"15046","E01010406",2001,686,398,288,88
"15047","E01010402",2001,640,108,532,37
"15048","E01010385",2001,576,3,573,15
"15049","E01010386",2001,630,14,616,12
"15050","E01010387",2001,609,9,600,12
"15051","E01010392",2001,585,3,582,18
"15052","E01010330",2001,617,67,550,91
"15053","E01010326",2001,475,13,462,17
"15054","E01010327",2001,561,46,515,81
"15055","E01010328",2001,523,7,516,6
"15056","E01010370",2001,744,372,372,89
"15057","E01010371",2001,576,273,303,116
"15058","E01010372",2001,590,190,400,69
"15059","E01010373",2001,510,60,450,30
"15060","E01010368",2001,672,429,243,66
"15061","E01010361",2001,532,11,521,47
"15062","E01010364",2001,481,165,316,43
"15063","E01010365",2001,587,307,280,40
"15064","E01010366",2001,596,259,337,49
"15065","E01010367",2001,617,142,475,69
"15066","E01010384",2001,578,9,569,8
"15067","E01010389",2001,557,39,518,16
"15068","E01010390",2001,610,10,600,13
"15069","E01010391",2001,605,11,594,11
"15070","E01010263",2001,479,56,423,77
"15071","E01010264",2001,613,214,399,44
"15072","E01010265",2001,566,224,342,46
"15073","E01010261",2001,590,247,343,45
"15074","E01010336",2001,506,94,412,45
"15075","E01010340",2001,527,221,306,71
"15076","E01010341",2001,453,97,356,56
"15077","E01010342",2001,487,81,406,104
"15078","E01010343",2001,465,130,335,89
"15079","E01010344",2001,587,212,375,45
"15080","E01010331",2001,630,4,626,8
"15081","E01010332",2001,606,8,598,20
"15082","E01010333",2001,631,55,576,19
"15083","E01010334",2001,555,4,551,12
"15084","E01010316",2001,577,378,199,8
"15085","E01010311",2001,630,257,373,33
"15086","E01010309",2001,670,259,411,61
"15087","E01010262",2001,652,215,437,37
"15088","E01010335",2001,516,244,272,25
"15089","E01010337",2001,513,89,424,20
"15090","E01010338",2001,535,144,391,51
"15091","E01010339",2001,529,53,476,14
"15092","E01010310",2001,596,215,381,15
"15093","E01010312",2001,627,253,374,39
"15094","E01010313",2001,525,231,294,10
"15095","E01010314",2001,628,324,304,13
"15096","E01010315",2001,658,288,370,20
"15097","E01010329",2001,623,11,612,14
"15098","E01010355",2001,614,58,556,6
"15099","E01010356",2001,620,14,606,21
"15100","E01010357",2001,528,9,519,3
"15101","E01010358",2001,623,39,584,12
"15102","E01010359",2001,643,36,607,29
"15103","E01010360",2001,612,13,599,19
"15104","E01010434",2001,606,70,536,39
"15105","E01010436",2001,613,25,588,13
"15106","E01010437",2001,481,4,477,9
"15107","E01010438",2001,601,79,522,19
"15108","E01010439",2001,543,208,335,12
"15109","E01010440",2001,648,332,316,21
"15110","E01010441",2001,550,242,308,10
"15111","E01010495",2001,749,275,474,22
"15112","E01010499",2001,531,54,477,44
"15113","E01010500",2001,492,244,248,18
"15114","E01010497",2001,471,11,460,14
"15115","E01010498",2001,649,36,613,30
"15116","E01010496",2001,597,245,352,16
"15117","E01010543",2001,580,334,246,18
"15118","E01010541",2001,636,422,214,32
"15119","E01010456",2001,481,377,104,9
"15120","E01010457",2001,641,113,528,19
"15121","E01010462",2001,628,359,269,4
"15122","E01010481",2001,531,284,247,20
"15123","E01010555",2001,720,355,365,3
"15124","E01010556",2001,606,162,444,4
"15125","E01010557",2001,603,46,557,8
"15126","E01010559",2001,665,309,356,4
"15127","E01010560",2001,767,287,480,5
"15128","E01010501",2001,612,189,423,29
"15129","E01010502",2001,518,23,495,27
"15130","E01010503",2001,611,217,394,48
"15131","E01010435",2001,524,239,285,46
"15132","E01010482",2001,490,314,176,18
"15133","E01010483",2001,482,360,122,14
"15134","E01010484",2001,498,324,174,14
"15135","E01010485",2001,537,201,336,79
"15136","E01010458",2001,766,356,410,18
"15137","E01010459",2001,619,82,537,49
"15138","E01010460",2001,642,85,557,33
"15139","E01010461",2001,615,18,597,35
"15140","E01010566",2001,735,238,497,25
"15141","E01010542",2001,622,121,501,17
"15142","E01010539",2001,619,85,534,50
"15143","E01010540",2001,614,34,580,63
"15144","E01010544",2001,618,25,593,27
"15145","E01010545",2001,649,7,642,38
"15146","E01010558",2001,655,60,595,16
"15147","E01010562",2001,737,258,479,9
"15148","E01010563",2001,675,301,374,20
"15149","E01010567",2001,658,274,384,5
"15150","E01010554",2001,629,109,520,5
"15151","E01010486",2001,599,446,153,8
"15152","E01010478",2001,530,145,385,122
"15153","E01010479",2001,533,145,388,39
"15154","E01010480",2001,485,70,415,47
"15155","E01010474",2001,608,221,387,18
"15156","E01010564",2001,594,95,499,114
"15157","E01010565",2001,711,13,698,29
"15158","E01010561",2001,587,18,569,5
"15159","E01010522",2001,624,267,357,53
"15160","E01010523",2001,622,82,540,99
"15161","E01010524",2001,631,308,323,34
"15162","E01010525",2001,509,138,371,75
"15163","E01010553",2001,631,63,568,23
"15164","E01010546",2001,516,4,512,12
"15165","E01010547",2001,724,79,645,51
"15166","E01010548",2001,756,190,566,9
"15167","E01010549",2001,623,109,514,21
"15168","E01010471",2001,765,430,335,82
"15169","E01010472",2001,645,307,338,69
"15170","E01010473",2001,864,646,218,71
"15171","E01010475",2001,559,70,489,35
"15172","E01010476",2001,772,402,370,79
"15173","E01010477",2001,656,224,432,64
"15174","E01010526",2001,475,147,328,85
"15175","E01010527",2001,641,330,311,98
"15176","E01010528",2001,482,279,203,89
"15177","E01010529",2001,548,139,409,193
"15178","E01010510",2001,761,86,675,199
"15179","E01010511",2001,574,153,421,110
"15180","E01010512",2001,600,83,517,160
"15181","E01010508",2001,715,227,488,257
"15182","E01010506",2001,753,58,695,358
"15183","E01010447",2001,766,408,358,16
"15184","E01010448",2001,732,378,354,16
"15185","E01010442",2001,493,158,335,49
"15186","E01010443",2001,626,375,251,19
"15187","E01010444",2001,579,146,433,18
"15188","E01010445",2001,494,286,208,21
"15189","E01010509",2001,752,263,489,19
"15190","E01010550",2001,644,7,637,9
"15191","E01010551",2001,738,81,657,51
"15192","E01010552",2001,804,184,620,17
"15193","E01010521",2001,496,238,258,115
"15194","E01010463",2001,642,210,432,135
"15195","E01010464",2001,868,563,305,62
"15196","E01010465",2001,602,84,518,100
"15197","E01010466",2001,525,55,470,132
"15198","E01010470",2001,628,165,463,119
"15199","E01010487",2001,622,12,610,38
"15200","E01010488",2001,624,99,525,24
"15201","E01010507",2001,614,9,605,25
"15202","E01010504",2001,528,21,507,54
"15203","E01010505",2001,523,11,512,33
"15204","E01010493",2001,616,85,531,26
"15205","E01010421",2001,587,316,271,11
"15206","E01010418",2001,570,24,546,16
"15207","E01010423",2001,733,418,315,24
"15208","E01010424",2001,603,10,593,37
"15209","E01010425",2001,534,129,405,23
"15210","E01010419",2001,535,208,327,8
"15211","E01010420",2001,509,158,351,24
"15212","E01010417",2001,659,326,333,9
"15213","E01010446",2001,649,185,464,17
"15214","E01010430",2001,625,162,463,79
"15215","E01010530",2001,504,197,307,80
"15216","E01010453",2001,676,342,334,35
"15217","E01010454",2001,609,226,383,65
"15218","E01010433",2001,663,344,319,96
"15219","E01010428",2001,523,144,379,94
"15220","E01010429",2001,395,41,354,62
"15221","E01010426",2001,489,63,426,44
"15222","E01010467",2001,607,40,567,173
"15223","E01010468",2001,581,121,460,21
"15224","E01010469",2001,599,23,576,68
"15225","E01010516",2001,521,3,518,11
"15226","E01010518",2001,583,59,524,27
"15227","E01010414",2001,727,424,303,55
"15228","E01010415",2001,496,230,266,23
"15229","E01010416",2001,645,223,422,85
"15230","E01010422",2001,618,110,508,47
"15231","E01010494",2001,611,16,595,5
"15232","E01010489",2001,636,196,440,10
"15233","E01010490",2001,900,580,320,30
"15234","E01010491",2001,625,187,438,29
"15235","E01010492",2001,505,15,490,10
"15236","E01010455",2001,726,387,339,40
"15237","E01010449",2001,650,220,430,54
"15238","E01010450",2001,700,353,347,35
"15239","E01010451",2001,505,87,418,31
"15240","E01010452",2001,643,339,304,11
"15241","E01010519",2001,503,9,494,64
"15242","E01010520",2001,655,4,651,26
"15243","E01010431",2001,460,3,457,24
"15244","E01010432",2001,492,35,457,27
"15245","E01010427",2001,506,30,476,59
"15246","E01010517",2001,609,102,507,24
"15247","E01010513",2001,634,37,597,22
"15248","E01010514",2001,620,7,613,33
"15249","E01010515",2001,659,11,648,34
"15250","E01010533",2001,663,254,409,29
"15251","E01010535",2001,633,284,349,29
"15252","E01010536",2001,639,49,590,20
"15253","E01010537",2001,659,8,651,31
"15254","E01010410",2001,773,406,367,27
"15255","E01010411",2001,608,220,388,8
"15256","E01010412",2001,627,266,361,13
"15257","E01010413",2001,644,342,302,9
"15258","E01010538",2001,627,165,462,23
"15259","E01010534",2001,461,5,456,22
"15260","E01010531",2001,714,293,421,37
"15261","E01010532",2001,662,251,411,27
"15262","E01032138",2001,535,0,535,11
"15263","E01032139",2001,604,6,598,22
"15264","E01032140",2001,646,33,613,33
"15265","E01032141",2001,492,12,480,36
"15266","E01032136",2001,476,6,470,41
"15267","E01032137",2001,614,66,548,54
"15268","E01032168",2001,478,72,406,15
"15269","E01032169",2001,481,19,462,38
"15270","E01032176",2001,842,41,801,55
"15271","E01032170",2001,489,11,478,32
"15272","E01032171",2001,618,6,612,9
"15273","E01032172",2001,622,39,583,57
"15274","E01032126",2001,835,78,757,8
"15275","E01032133",2001,728,252,476,8
"15276","E01032145",2001,601,3,598,18
"15277","E01032147",2001,529,82,447,14
"15278","E01032135",2001,637,6,631,24
"15279","E01032177",2001,413,0,413,17
"15280","E01032178",2001,513,3,510,22
"15281","E01032146",2001,657,22,635,16
"15282","E01032134",2001,591,11,580,36
"15283","E01032142",2001,586,6,580,16
"15284","E01032143",2001,515,0,515,14
"15285","E01032144",2001,726,3,723,52
"15286","E01032149",2001,467,0,467,6
"15287","E01032152",2001,580,164,416,25
"15288","E01032127",2001,628,47,581,18
"15289","E01032128",2001,596,102,494,23
"15290","E01032129",2001,505,170,335,3
"15291","E01032153",2001,529,80,449,22
"15292","E01032150",2001,607,3,604,17
"15293","E01032151",2001,550,11,539,21
"15294","E01032148",2001,426,11,415,22
"15295","E01032155",2001,645,7,638,14
"15296","E01032122",2001,659,37,622,52
"15297","E01032123",2001,624,15,609,33
"15298","E01032124",2001,665,125,540,27
"15299","E01032125",2001,616,53,563,27
"15300","E01032154",2001,535,3,532,13
"15301","E01032159",2001,734,122,612,29
"15302","E01032160",2001,718,70,648,40
"15303","E01032161",2001,609,259,350,16
"15304","E01032156",2001,600,114,486,65
"15305","E01032157",2001,856,262,594,59
"15306","E01032173",2001,633,25,608,15
"15307","E01032175",2001,647,78,569,10
"15308","E01032158",2001,648,9,639,10
"15309","E01032162",2001,627,46,581,17
"15310","E01032163",2001,755,6,749,23
"15311","E01032130",2001,643,165,478,39
"15312","E01032131",2001,627,281,346,8
"15313","E01032132",2001,901,373,528,11
"15314","E01032174",2001,637,141,496,22
"15315","E01032164",2001,512,34,478,8
"15316","E01032165",2001,404,3,401,5
"15317","E01032166",2001,872,110,762,65
"15318","E01032167",2001,881,20,861,101
"15319","E01032193",2001,805,73,732,82
"15320","E01032212",2001,748,59,689,96
"15321","E01032213",2001,652,18,634,80
"15322","E01032214",2001,979,251,728,115
"15323","E01032223",2001,756,40,716,40
"15324","E01032190",2001,735,76,659,45
"15325","E01032199",2001,657,99,558,52
"15326","E01032181",2001,780,70,710,78
"15327","E01032182",2001,741,15,726,43
"15328","E01032183",2001,540,24,516,27
"15329","E01032179",2001,612,60,552,46
"15330","E01032180",2001,703,52,651,60
"15331","E01032194",2001,647,239,408,12
"15332","E01032195",2001,724,47,677,71
"15333","E01032196",2001,607,75,532,55
"15334","E01032197",2001,713,81,632,78
"15335","E01032205",2001,453,49,404,82
"15336","E01032206",2001,566,46,520,54
"15337","E01032207",2001,592,35,557,28
"15338","E01032217",2001,604,65,539,86
"15339","E01032220",2001,609,39,570,88
"15340","E01032221",2001,519,36,483,53
"15341","E01032222",2001,587,106,481,46
"15342","E01032188",2001,747,155,592,45
"15343","E01032189",2001,635,13,622,22
"15344","E01032201",2001,620,199,421,21
"15345","E01032202",2001,743,338,405,27
"15346","E01032203",2001,640,163,477,32
"15347","E01032204",2001,629,460,169,9
"15348","E01032191",2001,889,31,858,60
"15349","E01032192",2001,641,118,523,26
"15350","E01032211",2001,771,37,734,50
"15351","E01032184",2001,788,69,719,32
"15352","E01032185",2001,614,28,586,7
"15353","E01032186",2001,483,47,436,58
"15354","E01032187",2001,765,309,456,30
"15355","E01032218",2001,594,26,568,56
"15356","E01032219",2001,745,10,735,57
"15357","E01032208",2001,632,12,620,190
"15358","E01032209",2001,497,0,497,158
"15359","E01032210",2001,485,89,396,24
"15360","E01032215",2001,535,197,338,16
"15361","E01032216",2001,729,68,661,107
"15362","E01032200",2001,767,70,697,53
"15363","E01032198",2001,778,38,740,85
"15364","E01032226",2001,605,13,592,21
"15365","E01032227",2001,469,3,466,12
"15366","E01032243",2001,573,3,570,6
"15367","E01032244",2001,532,112,420,12
"15368","E01032245",2001,670,402,268,23
"15369","E01032240",2001,557,228,329,13
"15370","E01032241",2001,497,238,259,14
"15371","E01032242",2001,593,143,450,23
"15372","E01032232",2001,722,471,251,23
"15373","E01032233",2001,669,45,624,14
"15374","E01032234",2001,639,339,300,31
"15375","E01032235",2001,695,344,351,13
"15376","E01032239",2001,495,58,437,142
"15377","E01032224",2001,489,124,365,52
"15378","E01032225",2001,507,285,222,6
"15379","E01032262",2001,757,302,455,71
"15380","E01032277",2001,500,198,302,10
"15381","E01032278",2001,642,373,269,16
"15382","E01032273",2001,566,3,563,6
"15383","E01032275",2001,602,162,440,14
"15384","E01032264",2001,646,119,527,15
"15385","E01032236",2001,623,208,415,71
"15386","E01032237",2001,586,43,543,42
"15387","E01032238",2001,490,15,475,55
"15388","E01032263",2001,581,71,510,21
"15389","E01032255",2001,522,45,477,30
"15390","E01032274",2001,515,6,509,10
"15391","E01032266",2001,624,77,547,16
"15392","E01032259",2001,590,38,552,38
"15393","E01032269",2001,715,116,599,39
"15394","E01032270",2001,500,3,497,11
"15395","E01032271",2001,513,27,486,12
"15396","E01032272",2001,483,72,411,9
"15397","E01032265",2001,621,231,390,15
"15398","E01032253",2001,462,10,452,10
"15399","E01032267",2001,591,189,402,14
"15400","E01032268",2001,485,22,463,12
"15401","E01032276",2001,581,0,581,14
"15402","E01032254",2001,591,138,453,25
"15403","E01032250",2001,513,288,225,14
"15404","E01032251",2001,524,202,322,14
"15405","E01032252",2001,554,321,233,21
"15406","E01032260",2001,663,399,264,22
"15407","E01032256",2001,634,163,471,19
"15408","E01032257",2001,537,3,534,4
"15409","E01032258",2001,699,92,607,87
"15410","E01032261",2001,576,3,573,21
"15411","E01032246",2001,506,5,501,12
"15412","E01032247",2001,578,142,436,22
"15413","E01032248",2001,534,18,516,13
"15414","E01032249",2001,667,40,627,43
"15415","E01032228",2001,470,8,462,43
"15416","E01032229",2001,554,125,429,18
"15417","E01032230",2001,519,38,481,7
"15418","E01032231",2001,652,51,601,52
"15419","E01032296",2001,639,71,568,101
"15420","E01032297",2001,646,7,639,22
"15421","E01032298",2001,771,0,771,16
"15422","E01032299",2001,603,45,558,36
"15423","E01032300",2001,627,11,616,17
"15424","E01032303",2001,481,249,232,8
"15425","E01032304",2001,618,289,329,12
"15426","E01032331",2001,637,322,315,20
"15427","E01032332",2001,598,398,200,21
"15428","E01032330",2001,587,51,536,64
"15429","E01032334",2001,920,15,905,88
"15430","E01032335",2001,569,3,566,23
"15431","E01032336",2001,630,8,622,48
"15432","E01032312",2001,643,50,593,123
"15433","E01032279",2001,502,51,451,31
"15434","E01032327",2001,739,59,680,110
"15435","E01032328",2001,635,165,470,25
"15436","E01032329",2001,811,46,765,16
"15437","E01032333",2001,566,287,279,26
"15438","E01032313",2001,481,269,212,17
"15439","E01032310",2001,599,135,464,61
"15440","E01032311",2001,613,291,322,22
"15441","E01032301",2001,619,86,533,21
"15442","E01032302",2001,516,175,341,83
"15443","E01032314",2001,445,7,438,78
"15444","E01032315",2001,480,10,470,74
"15445","E01032316",2001,490,4,486,7
"15446","E01032317",2001,649,77,572,47
"15447","E01032291",2001,863,196,667,211
"15448","E01032280",2001,771,53,718,230
"15449","E01032281",2001,635,19,616,131
"15450","E01032282",2001,728,111,617,180
"15451","E01032337",2001,678,3,675,39
"15452","E01032338",2001,723,9,714,90
"15453","E01032339",2001,611,0,611,28
"15454","E01032318",2001,625,389,236,20
"15455","E01032319",2001,699,43,656,28
"15456","E01032320",2001,644,23,621,94
"15457","E01032321",2001,604,203,401,26
"15458","E01032322",2001,844,268,576,139
"15459","E01032305",2001,616,45,571,29
"15460","E01032306",2001,606,107,499,38
"15461","E01032307",2001,627,349,278,14
"15462","E01032309",2001,649,186,463,19
"15463","E01032292",2001,551,24,527,134
"15464","E01032293",2001,914,328,586,225
"15465","E01032294",2001,580,50,530,67
"15466","E01032285",2001,741,73,668,128
"15467","E01032286",2001,631,43,588,41
"15468","E01032287",2001,639,7,632,72
"15469","E01032288",2001,637,78,559,29
"15470","E01032289",2001,629,22,607,12
"15471","E01032290",2001,612,11,601,61
"15472","E01032283",2001,649,81,568,47
"15473","E01032284",2001,777,20,757,38
"15474","E01032295",2001,690,28,662,85
"15475","E01032308",2001,617,8,609,21
"15476","E01032323",2001,522,3,519,16
"15477","E01032324",2001,600,16,584,51
"15478","E01032325",2001,641,22,619,48
"15479","E01032326",2001,599,3,596,32
"15480","E01032354",2001,823,149,674,41
"15481","E01032386",2001,490,12,478,41
"15482","E01032387",2001,558,104,454,44
"15483","E01032401",2001,616,35,581,51
"15484","E01032368",2001,511,246,265,14
"15485","E01032369",2001,502,228,274,19
"15486","E01032370",2001,508,98,410,23
"15487","E01032371",2001,578,185,393,16
"15488","E01032359",2001,864,236,628,89
"15489","E01032360",2001,704,202,502,28
"15490","E01032361",2001,748,8,740,37
"15491","E01032357",2001,508,105,403,23
"15492","E01032358",2001,648,248,400,31
"15493","E01032365",2001,782,284,498,12
"15494","E01032367",2001,620,42,578,32
"15495","E01032366",2001,749,101,648,15
"15496","E01032362",2001,574,38,536,14
"15497","E01032363",2001,607,5,602,18
"15498","E01032364",2001,643,0,643,13
"15499","E01032399",2001,680,96,584,37
"15500","E01032400",2001,778,33,745,31
"15501","E01032404",2001,910,94,816,87
"15502","E01032395",2001,468,33,435,47
"15503","E01032345",2001,469,19,450,48
"15504","E01032346",2001,470,17,453,21
"15505","E01032417",2001,618,54,564,80
"15506","E01032416",2001,410,8,402,17
"15507","E01032392",2001,644,18,626,58
"15508","E01032393",2001,601,40,561,31
"15509","E01032394",2001,463,22,441,38
"15510","E01032355",2001,474,70,404,44
"15511","E01032356",2001,452,0,452,17
"15512","E01032402",2001,533,17,516,23
"15513","E01032403",2001,581,49,532,54
"15514","E01032410",2001,529,43,486,26
"15515","E01032411",2001,620,97,523,36
"15516","E01032375",2001,498,66,432,26
"15517","E01032382",2001,530,72,458,30
"15518","E01032383",2001,537,17,520,50
"15519","E01032390",2001,486,57,429,37
"15520","E01032391",2001,444,116,328,14
"15521","E01032414",2001,606,121,485,20
"15522","E01032415",2001,498,31,467,11
"15523","E01032405",2001,604,73,531,15
"15524","E01032406",2001,762,286,476,107
"15525","E01032407",2001,610,115,495,25
"15526","E01032408",2001,595,6,589,29
"15527","E01032409",2001,652,197,455,50
"15528","E01032388",2001,524,57,467,11
"15529","E01032389",2001,533,164,369,22
"15530","E01032349",2001,582,67,515,37
"15531","E01032350",2001,431,70,361,37
"15532","E01032340",2001,558,139,419,19
"15533","E01032341",2001,490,6,484,13
"15534","E01032343",2001,862,131,731,182
"15535","E01032377",2001,860,371,489,117
"15536","E01032378",2001,731,199,532,80
"15537","E01032384",2001,502,136,366,25
"15538","E01032385",2001,606,68,538,31
"15539","E01032376",2001,625,8,617,60
"15540","E01032396",2001,641,6,635,43
"15541","E01032379",2001,664,54,610,23
"15542","E01032380",2001,630,11,619,28
"15543","E01032344",2001,601,24,577,23
"15544","E01032342",2001,599,115,484,42
"15545","E01032381",2001,738,266,472,19
"15546","E01032397",2001,753,198,555,22
"15547","E01032398",2001,678,80,598,55
"15548","E01032351",2001,724,17,707,58
"15549","E01032352",2001,608,72,536,22
"15550","E01032353",2001,713,172,541,62
"15551","E01032374",2001,514,68,446,41
"15552","E01032372",2001,547,82,465,37
"15553","E01032373",2001,507,15,492,34
"15554","E01032347",2001,529,29,500,42
"15555","E01032348",2001,486,11,475,27
"15556","E01032412",2001,579,87,492,118
"15557","E01032413",2001,444,50,394,33
"15558","E01032439",2001,495,29,466,31
"15559","E01032440",2001,522,144,378,17
"15560","E01032431",2001,634,68,566,82
"15561","E01032432",2001,540,121,419,45
"15562","E01032433",2001,508,7,501,28
"15563","E01032479",2001,919,152,767,31
"15564","E01032441",2001,516,9,507,12
"15565","E01032442",2001,595,3,592,30
"15566","E01032443",2001,601,6,595,22
"15567","E01032444",2001,510,59,451,33
"15568","E01032445",2001,613,184,429,17
"15569","E01032446",2001,606,33,573,29
"15570","E01032447",2001,614,9,605,90
"15571","E01032448",2001,482,3,479,11
"15572","E01032436",2001,672,12,660,30
"15573","E01032438",2001,661,7,654,39
"15574","E01032437",2001,606,164,442,40
"15575","E01032434",2001,645,335,310,60
"15576","E01032435",2001,629,130,499,87
"15577","E01032450",2001,770,190,580,156
"15578","E01032430",2001,664,81,583,52
"15579","E01032480",2001,598,29,569,34
"15580","E01032481",2001,696,209,487,31
"15581","E01032482",2001,621,10,611,58
"15582","E01032451",2001,627,20,607,5
"15583","E01032452",2001,600,8,592,6
"15584","E01032453",2001,743,414,329,23
"15585","E01032454",2001,765,71,694,101
"15586","E01032449",2001,664,17,647,125
"15587","E01032464",2001,736,336,400,20
"15588","E01032465",2001,605,312,293,14
"15589","E01032466",2001,644,18,626,78
"15590","E01032467",2001,502,16,486,24
"15591","E01032468",2001,515,17,498,6
"15592","E01032474",2001,661,85,576,177
"15593","E01032475",2001,631,16,615,78
"15594","E01032476",2001,604,48,556,39
"15595","E01032477",2001,509,6,503,7
"15596","E01032478",2001,648,201,447,31
"15597","E01032469",2001,623,260,363,7
"15598","E01032470",2001,781,172,609,58
"15599","E01032471",2001,642,439,203,20
"15600","E01032418",2001,577,39,538,65
"15601","E01032419",2001,583,6,577,12
"15602","E01032420",2001,515,37,478,22
"15603","E01032421",2001,485,28,457,3
"15604","E01032422",2001,665,232,433,74
"15605","E01032427",2001,637,61,576,17
"15606","E01032428",2001,746,36,710,138
"15607","E01032429",2001,651,35,616,18
"15608","E01032472",2001,478,0,478,30
"15609","E01032473",2001,469,59,410,24
"15610","E01032455",2001,618,10,608,17
"15611","E01032456",2001,499,82,417,39
"15612","E01032457",2001,511,104,407,15
"15613","E01032458",2001,614,3,611,13
"15614","E01032459",2001,615,38,577,27
"15615","E01032460",2001,756,99,657,53
"15616","E01032461",2001,628,23,605,154
"15617","E01032462",2001,712,51,661,38
"15618","E01032463",2001,746,62,684,38
"15619","E01032423",2001,601,107,494,12
"15620","E01032424",2001,641,279,362,12
"15621","E01032425",2001,635,65,570,12
"15622","E01032426",2001,652,72,580,19
"15623","E01015706",2001,612,62,550,26
"15624","E01015707",2001,635,9,626,44
"15625","E01015708",2001,521,3,518,17
"15626","E01015709",2001,627,16,611,50
"15627","E01015710",2001,628,7,621,51
"15628","E01015770",2001,484,8,476,14
"15629","E01015801",2001,664,198,466,59
"15630","E01015803",2001,600,10,590,26
"15631","E01015804",2001,622,11,611,50
"15632","E01015805",2001,499,5,494,12
"15633","E01015802",2001,574,206,368,31
"15634","E01015769",2001,499,101,398,43
"15635","E01015771",2001,584,312,272,46
"15636","E01015772",2001,545,218,327,43
"15637","E01015773",2001,459,241,218,21
"15638","E01015774",2001,532,166,366,62
"15639","E01015744",2001,633,237,396,39
"15640","E01015746",2001,614,64,550,22
"15641","E01015747",2001,497,0,497,4
"15642","E01015748",2001,721,64,657,23
"15643","E01015749",2001,686,437,249,22
"15644","E01015751",2001,605,162,443,33
"15645","E01015752",2001,491,71,420,23
"15646","E01015753",2001,631,59,572,60
"15647","E01015754",2001,785,399,386,44
"15648","E01015755",2001,619,75,544,31
"15649","E01015764",2001,608,13,595,36
"15650","E01015765",2001,622,119,503,65
"15651","E01015766",2001,543,20,523,43
"15652","E01015767",2001,586,34,552,76
"15653","E01015768",2001,592,55,537,17
"15654","E01015783",2001,491,163,328,35
"15655","E01015785",2001,749,58,691,136
"15656","E01015745",2001,548,0,548,14
"15657","E01015693",2001,513,6,507,14
"15658","E01015694",2001,493,0,493,19
"15659","E01015695",2001,480,0,480,16
"15660","E01015696",2001,510,30,480,36
"15661","E01015697",2001,625,22,603,51
"15662","E01015797",2001,505,6,499,8
"15663","E01015798",2001,535,114,421,30
"15664","E01015799",2001,570,12,558,20
"15665","E01015800",2001,618,13,605,40
"15666","E01015812",2001,530,3,527,24
"15667","E01015813",2001,713,194,519,99
"15668","E01015756",2001,651,118,533,33
"15669","E01015757",2001,632,268,364,25
"15670","E01015758",2001,555,188,367,24
"15671","E01015759",2001,573,282,291,22
"15672","E01015760",2001,620,317,303,28
"15673","E01015761",2001,603,197,406,19
"15674","E01015782",2001,626,60,566,47
"15675","E01015784",2001,496,9,487,56
"15676","E01015786",2001,491,3,488,61
"15677","E01015700",2001,565,65,500,47
"15678","E01015701",2001,454,40,414,106
"15679","E01015704",2001,543,45,498,104
"15680","E01015715",2001,417,12,405,76
"15681","E01015716",2001,540,153,387,46
"15682","E01015717",2001,518,37,481,76
"15683","E01015711",2001,515,17,498,65
"15684","E01015712",2001,629,11,618,42
"15685","E01015750",2001,502,41,461,59
"15686","E01015740",2001,528,17,511,65
"15687","E01015775",2001,668,33,635,148
"15688","E01015776",2001,730,150,580,41
"15689","E01015777",2001,642,37,605,76
"15690","E01015778",2001,653,22,631,72
"15691","E01015796",2001,634,47,587,43
"15692","E01015762",2001,667,24,643,69
"15693","E01015763",2001,633,80,553,25
"15694","E01015713",2001,545,21,524,70
"15695","E01015714",2001,636,33,603,81
"15696","E01015718",2001,687,41,646,146
"15697","E01015721",2001,635,55,580,36
"15698","E01015722",2001,531,79,452,43
"15699","E01015806",2001,553,15,538,49
"15700","E01015808",2001,631,49,582,52
"15701","E01015809",2001,512,3,509,10
"15702","E01015810",2001,519,108,411,22
"15703","E01015811",2001,581,8,573,51
"15704","E01015703",2001,461,25,436,77
"15705","E01015726",2001,525,52,473,96
"15706","E01015731",2001,491,26,465,99
"15707","E01015787",2001,516,27,489,84
"15708","E01015788",2001,460,66,394,50
"15709","E01015779",2001,502,244,258,16
"15710","E01015780",2001,603,50,553,36
"15711","E01015781",2001,547,126,421,34
"15712","E01015723",2001,511,71,440,42
"15713","E01015719",2001,558,7,551,22
"15714","E01015720",2001,571,252,319,46
"15715","E01015807",2001,517,160,357,13
"15716","E01015702",2001,446,49,397,81
"15717","E01015725",2001,465,112,353,93
"15718","E01015705",2001,707,127,580,313
"15719","E01015698",2001,514,40,474,199
"15720","E01015699",2001,550,143,407,188
"15721","E01015727",2001,420,40,380,130
"15722","E01015741",2001,748,262,486,180
"15723","E01015742",2001,614,20,594,132
"15724","E01015743",2001,628,92,536,217
"15725","E01015789",2001,775,462,313,145
"15726","E01015794",2001,726,195,531,292
"15727","E01015739",2001,868,58,810,264
"15728","E01015728",2001,501,29,472,71
"15729","E01015729",2001,485,72,413,201
"15730","E01015730",2001,698,77,621,210
"15731","E01015724",2001,555,33,522,109
"15732","E01015732",2001,505,233,272,26
"15733","E01015733",2001,587,241,346,30
"15734","E01015734",2001,713,115,598,48
"15735","E01015735",2001,632,153,479,151
"15736","E01015736",2001,678,372,306,32
"15737","E01015737",2001,505,126,379,26
"15738","E01015738",2001,715,97,618,179
"15739","E01015795",2001,645,189,456,207
"15740","E01015790",2001,592,49,543,65
"15741","E01015791",2001,849,335,514,214
"15742","E01015792",2001,622,54,568,143
"15743","E01015793",2001,627,56,571,102
"15744","E01015629",2001,652,67,585,13
"15745","E01015635",2001,581,4,577,16
"15746","E01015636",2001,442,42,400,26
"15747","E01015679",2001,824,88,736,83
"15748","E01015680",2001,636,315,321,43
"15749","E01015681",2001,557,25,532,30
"15750","E01015682",2001,674,66,608,85
"15751","E01015678",2001,572,40,532,48
"15752","E01015684",2001,598,11,587,6
"15753","E01015685",2001,698,17,681,32
"15754","E01015659",2001,839,60,779,69
"15755","E01015630",2001,504,62,442,45
"15756","E01015631",2001,438,28,410,10
"15757","E01015628",2001,515,43,472,135
"15758","E01015626",2001,462,113,349,267
"15759","E01015589",2001,605,45,560,42
"15760","E01015590",2001,491,86,405,50
"15761","E01015617",2001,500,21,479,85
"15762","E01015618",2001,407,87,320,26
"15763","E01015619",2001,709,219,490,40
"15764","E01015620",2001,630,13,617,46
"15765","E01015686",2001,751,15,736,39
"15766","E01015683",2001,806,80,726,47
"15767","E01015674",2001,615,231,384,15
"15768","E01015675",2001,625,81,544,25
"15769","E01015676",2001,626,123,503,61
"15770","E01015660",2001,730,315,415,32
"15771","E01015656",2001,668,329,339,29
"15772","E01015657",2001,599,199,400,68
"15773","E01015658",2001,635,354,281,41
"15774","E01015609",2001,616,403,213,46
"15775","E01015607",2001,611,346,265,28
"15776","E01015608",2001,620,182,438,21
"15777","E01015605",2001,631,254,377,22
"15778","E01015610",2001,646,337,309,24
"15779","E01015633",2001,894,304,590,36
"15780","E01015634",2001,743,337,406,31
"15781","E01015593",2001,600,240,360,49
"15782","E01015596",2001,603,190,413,73
"15783","E01015662",2001,483,81,402,59
"15784","E01015663",2001,628,412,216,31
"15785","E01015664",2001,622,351,271,36
"15786","E01015661",2001,609,165,444,49
"15787","E01015677",2001,473,35,438,69
"15788","E01015603",2001,671,127,544,128
"15789","E01015604",2001,449,101,348,76
"15790","E01015632",2001,709,173,536,110
"15791","E01015597",2001,647,346,301,56
"15792","E01015594",2001,782,242,540,70
"15793","E01015595",2001,693,275,418,55
"15794","E01015591",2001,597,73,524,39
"15795","E01015592",2001,635,144,491,60
"15796","E01015601",2001,450,27,423,58
"15797","E01015651",2001,624,14,610,36
"15798","E01015652",2001,592,24,568,67
"15799","E01015653",2001,651,63,588,35
"15800","E01015654",2001,746,142,604,110
"15801","E01015606",2001,630,115,515,34
"15802","E01015611",2001,711,291,420,87
"15803","E01015613",2001,559,180,379,105
"15804","E01015614",2001,593,41,552,149
"15805","E01015615",2001,635,173,462,39
"15806","E01015616",2001,613,321,292,50
"15807","E01015612",2001,718,72,646,199
"15808","E01015602",2001,628,83,545,224
"15809","E01015599",2001,587,198,389,134
"15810","E01015600",2001,493,78,415,67
"15811","E01015655",2001,776,39,737,219
"15812","E01015687",2001,640,6,634,17
"15813","E01015689",2001,616,29,587,28
"15814","E01015690",2001,486,4,482,18
"15815","E01015691",2001,503,23,480,32
"15816","E01015598",2001,641,74,567,30
"15817","E01015622",2001,769,176,593,148
"15818","E01015625",2001,771,189,582,95
"15819","E01015692",2001,478,36,442,82
"15820","E01015688",2001,613,75,538,118
"15821","E01015665",2001,478,106,372,33
"15822","E01015666",2001,614,214,400,64
"15823","E01015668",2001,650,197,453,77
"15824","E01015623",2001,692,109,583,63
"15825","E01015624",2001,724,72,652,121
"15826","E01015621",2001,764,90,674,167
"15827","E01015627",2001,681,60,621,85
"15828","E01015644",2001,628,123,505,58
"15829","E01015645",2001,739,59,680,69
"15830","E01015646",2001,882,14,868,48
"15831","E01015648",2001,619,53,566,16
"15832","E01015667",2001,587,132,455,28
"15833","E01015669",2001,615,71,544,35
"15834","E01015670",2001,602,79,523,15
"15835","E01015671",2001,635,7,628,31
"15836","E01015672",2001,629,36,593,26
"15837","E01015673",2001,661,302,359,24
"15838","E01015649",2001,792,8,784,25
"15839","E01015650",2001,723,50,673,62
"15840","E01015643",2001,602,132,470,56
"15841","E01015638",2001,604,91,513,28
"15842","E01015639",2001,670,347,323,89
"15843","E01015640",2001,599,124,475,54
"15844","E01015641",2001,527,125,402,49
"15845","E01015642",2001,588,284,304,48
"15846","E01015647",2001,630,325,305,62
"15847","E01015637",2001,586,209,377,55
"15848","E01015833",2001,618,6,612,8
"15849","E01015834",2001,625,6,619,28
"15850","E01015835",2001,710,96,614,77
"15851","E01015836",2001,623,9,614,22
"15852","E01015837",2001,720,48,672,47
"15853","E01015838",2001,640,0,640,13
"15854","E01015863",2001,1033,164,869,45
"15855","E01015864",2001,603,50,553,22
"15856","E01015865",2001,655,18,637,34
"15857","E01015866",2001,678,3,675,27
"15858","E01015867",2001,629,214,415,28
"15859","E01015868",2001,643,127,516,69
"15860","E01015814",2001,616,111,505,35
"15861","E01015815",2001,601,9,592,37
"15862","E01015816",2001,789,95,694,50
"15863","E01015817",2001,728,3,725,14
"15864","E01015818",2001,754,75,679,33
"15865","E01015819",2001,611,171,440,55
"15866","E01015857",2001,656,0,656,24
"15867","E01015858",2001,660,25,635,38
"15868","E01015859",2001,809,103,706,109
"15869","E01015860",2001,625,11,614,53
"15870","E01015861",2001,756,234,522,69
"15871","E01015862",2001,642,33,609,156
"15872","E01015820",2001,609,279,330,36
"15873","E01015821",2001,689,51,638,59
"15874","E01015822",2001,492,16,476,52
"15875","E01015823",2001,665,7,658,84
"15876","E01015824",2001,603,240,363,29
"15877","E01015825",2001,583,132,451,16
"15878","E01015826",2001,555,43,512,24
"15879","E01015869",2001,639,47,592,79
"15880","E01015870",2001,628,22,606,102
"15881","E01015871",2001,649,65,584,18
"15882","E01015872",2001,653,13,640,107
"15883","E01015873",2001,544,8,536,125
"15884","E01015874",2001,653,62,591,88
"15885","E01015875",2001,719,282,437,76
"15886","E01015901",2001,576,15,561,149
"15887","E01015902",2001,611,6,605,195
"15888","E01015903",2001,657,12,645,163
"15889","E01015904",2001,663,7,656,138
"15890","E01015905",2001,591,10,581,146
"15891","E01015906",2001,610,32,578,128
"15892","E01015907",2001,620,18,602,136
"15893","E01015908",2001,633,3,630,30
"15894","E01015909",2001,608,29,579,74
"15895","E01015910",2001,622,6,616,53
"15896","E01015911",2001,490,14,476,9
"15897","E01015912",2001,634,24,610,14
"15898","E01015913",2001,720,29,691,116
"15899","E01015883",2001,575,3,572,22
"15900","E01015884",2001,777,78,699,166
"15901","E01015885",2001,719,3,716,19
"15902","E01015886",2001,631,350,281,31
"15903","E01015887",2001,607,229,378,56
"15904","E01015888",2001,645,81,564,25
"15905","E01015895",2001,944,542,402,114
"15906","E01015896",2001,746,220,526,150
"15907","E01015897",2001,693,371,322,30
"15908","E01015898",2001,771,93,678,188
"15909","E01015899",2001,742,48,694,170
"15910","E01015900",2001,623,41,582,199
"15911","E01015845",2001,661,11,650,86
"15912","E01015846",2001,800,37,763,169
"15913","E01015847",2001,757,9,748,203
"15914","E01015848",2001,865,6,859,172
"15915","E01015849",2001,720,30,690,147
"15916","E01015850",2001,659,3,656,91
"15917","E01015827",2001,615,3,612,103
"15918","E01015828",2001,783,112,671,343
"15919","E01015829",2001,620,3,617,108
"15920","E01015830",2001,585,3,582,45
"15921","E01015831",2001,763,27,736,299
"15922","E01015832",2001,702,64,638,106
"15923","E01015876",2001,605,9,596,70
"15924","E01015877",2001,656,168,488,112
"15925","E01015878",2001,585,44,541,66
"15926","E01015879",2001,594,213,381,67
"15927","E01015880",2001,648,319,329,60
"15928","E01015881",2001,566,118,448,16
"15929","E01015882",2001,632,152,480,70
"15930","E01015839",2001,653,99,554,160
"15931","E01015840",2001,605,69,536,161
"15932","E01015841",2001,749,38,711,318
"15933","E01015842",2001,713,489,224,82
"15934","E01015843",2001,684,68,616,171
"15935","E01015844",2001,809,258,551,175
"15936","E01015851",2001,899,11,888,320
"15937","E01015852",2001,794,51,743,339
"15938","E01015853",2001,792,16,776,258
"15939","E01015854",2001,685,48,637,219
"15940","E01015855",2001,756,37,719,319
"15941","E01015856",2001,695,11,684,216
"15942","E01015889",2001,616,10,606,26
"15943","E01015890",2001,591,8,583,37
"15944","E01015891",2001,649,15,634,146
"15945","E01015892",2001,592,3,589,66
"15946","E01015893",2001,789,11,778,26
"15947","E01015894",2001,584,3,581,25
"15948","E01015914",2001,505,3,502,16
"15949","E01015915",2001,626,19,607,23
"15950","E01015916",2001,518,302,216,26
"15951","E01015917",2001,599,244,355,74
"15952","E01015918",2001,507,9,498,93
"15953","E01015919",2001,501,64,437,14
"15954","E01015920",2001,637,6,631,22
"15955","E01015946",2001,629,16,613,41
"15956","E01015943",2001,601,6,595,40
"15957","E01015944",2001,531,3,528,11
"15958","E01015997",2001,516,3,513,6
"15959","E01015999",2001,491,3,488,14
"15960","E01015998",2001,621,47,574,16
"15961","E01015987",2001,604,182,422,16
"15962","E01015988",2001,624,296,328,23
"15963","E01015983",2001,623,24,599,59
"15964","E01015945",2001,506,63,443,9
"15965","E01015984",2001,501,13,488,11
"15966","E01015985",2001,665,63,602,13
"15967","E01015986",2001,620,247,373,26
"15968","E01015990",2001,609,171,438,15
"15969","E01016001",2001,528,14,514,10
"15970","E01015977",2001,542,99,443,28
"15971","E01015978",2001,489,9,480,37
"15972","E01015979",2001,531,9,522,26
"15973","E01015980",2001,621,47,574,26
"15974","E01015991",2001,618,39,579,26
"15975","E01015992",2001,763,85,678,49
"15976","E01016002",2001,520,6,514,5
"15977","E01015989",2001,634,61,573,107
"15978","E01016000",2001,625,24,601,35
"15979","E01015971",2001,713,183,530,94
"15980","E01015972",2001,649,193,456,19
"15981","E01015973",2001,615,216,399,24
"15982","E01015974",2001,586,58,528,9
"15983","E01015975",2001,628,97,531,30
"15984","E01015932",2001,486,134,352,17
"15985","E01015927",2001,624,220,404,14
"15986","E01015928",2001,637,151,486,14
"15987","E01015929",2001,647,331,316,31
"15988","E01015930",2001,620,168,452,7
"15989","E01015931",2001,672,341,331,38
"15990","E01015976",2001,768,377,391,25
"15991","E01015922",2001,594,294,300,20
"15992","E01015923",2001,668,161,507,50
"15993","E01015924",2001,600,155,445,16
"15994","E01015925",2001,564,55,509,10
"15995","E01015926",2001,647,129,518,45
"15996","E01015957",2001,620,263,357,28
"15997","E01015958",2001,518,164,354,18
"15998","E01015993",2001,638,191,447,24
"15999","E01015994",2001,654,198,456,10
"16000","E01015995",2001,614,6,608,10
"16001","E01015996",2001,643,237,406,16
"16002","E01015963",2001,526,247,279,11
"16003","E01015964",2001,638,36,602,30
"16004","E01015965",2001,599,7,592,33
"16005","E01015966",2001,672,13,659,24
"16006","E01015939",2001,544,3,541,27
"16007","E01015940",2001,723,9,714,61
"16008","E01015941",2001,451,18,433,18
"16009","E01015942",2001,487,61,426,39
"16010","E01015981",2001,603,4,599,41
"16011","E01015982",2001,628,3,625,20
"16012","E01015933",2001,639,176,463,13
"16013","E01015934",2001,533,246,287,8
"16014","E01015935",2001,603,235,368,12
"16015","E01015936",2001,742,284,458,15
"16016","E01015937",2001,677,129,548,12
"16017","E01015938",2001,746,409,337,3
"16018","E01015947",2001,557,55,502,97
"16019","E01015948",2001,588,8,580,157
"16020","E01015949",2001,614,68,546,22
"16021","E01015950",2001,603,17,586,55
"16022","E01015967",2001,600,26,574,35
"16023","E01015968",2001,661,17,644,54
"16024","E01015969",2001,721,85,636,60
"16025","E01015970",2001,510,12,498,25
"16026","E01015960",2001,586,94,492,15
"16027","E01015921",2001,546,61,485,91
"16028","E01016011",2001,686,56,630,165
"16029","E01016012",2001,652,236,416,41
"16030","E01016013",2001,740,24,716,136
"16031","E01016014",2001,610,333,277,42
"16032","E01016015",2001,612,80,532,40
"16033","E01015961",2001,642,26,616,58
"16034","E01015962",2001,622,79,543,94
"16035","E01015959",2001,654,133,521,54
"16036","E01015955",2001,679,17,662,81
"16037","E01015956",2001,690,32,658,159
"16038","E01015951",2001,622,122,500,93
"16039","E01015952",2001,807,126,681,198
"16040","E01015953",2001,866,88,778,164
"16041","E01015954",2001,729,491,238,54
"16042","E01016003",2001,637,117,520,67
"16043","E01016004",2001,646,328,318,16
"16044","E01016005",2001,548,151,397,17
"16045","E01016006",2001,612,419,193,26
"16046","E01016007",2001,528,292,236,14
"16047","E01016008",2001,589,46,543,62
"16048","E01016009",2001,630,264,366,54
"16049","E01016010",2001,505,282,223,17
"16050","E01017544",2001,580,50,530,25
"16051","E01017545",2001,461,19,442,57
"16052","E01017540",2001,581,35,546,42
"16053","E01017541",2001,491,53,438,24
"16054","E01017546",2001,471,55,416,49
"16055","E01017547",2001,622,34,588,51
"16056","E01017464",2001,570,36,534,27
"16057","E01017465",2001,609,43,566,36
"16058","E01017503",2001,476,57,419,34
"16059","E01017504",2001,656,65,591,71
"16060","E01017478",2001,676,86,590,60
"16061","E01017479",2001,609,50,559,61
"16062","E01017480",2001,470,21,449,20
"16063","E01017481",2001,492,70,422,34
"16064","E01017528",2001,900,34,866,26
"16065","E01017494",2001,740,23,717,40
"16066","E01017495",2001,737,63,674,45
"16067","E01017496",2001,631,62,569,38
"16068","E01017542",2001,579,76,503,56
"16069","E01017543",2001,569,37,532,58
"16070","E01017453",2001,623,241,382,30
"16071","E01017454",2001,603,36,567,25
"16072","E01017455",2001,647,20,627,40
"16073","E01017456",2001,638,43,595,10
"16074","E01017457",2001,491,109,382,15
"16075","E01017458",2001,512,38,474,21
"16076","E01017529",2001,518,11,507,24
"16077","E01017530",2001,586,8,578,8
"16078","E01017531",2001,595,266,329,18
"16079","E01017532",2001,510,3,507,16
"16080","E01017533",2001,484,4,480,8
"16081","E01017534",2001,649,4,645,18
"16082","E01017488",2001,638,16,622,25
"16083","E01017489",2001,616,289,327,43
"16084","E01017490",2001,602,306,296,34
"16085","E01017491",2001,629,66,563,30
"16086","E01017492",2001,634,206,428,51
"16087","E01017493",2001,501,187,314,21
"16088","E01017459",2001,604,7,597,23
"16089","E01017460",2001,614,9,605,32
"16090","E01017461",2001,509,29,480,17
"16091","E01017462",2001,591,6,585,22
"16092","E01017463",2001,613,65,548,8
"16093","E01017482",2001,631,121,510,152
"16094","E01017483",2001,573,11,562,36
"16095","E01017484",2001,516,59,457,198
"16096","E01017485",2001,512,29,483,160
"16097","E01017497",2001,602,47,555,163
"16098","E01017498",2001,518,8,510,53
"16099","E01017499",2001,695,90,605,243
"16100","E01017500",2001,632,128,504,206
"16101","E01017501",2001,630,147,483,172
"16102","E01017502",2001,750,506,244,97
"16103","E01017524",2001,602,35,567,34
"16104","E01017525",2001,494,118,376,23
"16105","E01017526",2001,600,17,583,47
"16106","E01017527",2001,536,18,518,46
"16107","E01017466",2001,658,120,538,216
"16108","E01017467",2001,631,58,573,142
"16109","E01017468",2001,582,12,570,95
"16110","E01017469",2001,604,127,477,183
"16111","E01017470",2001,487,6,481,45
"16112","E01017471",2001,887,476,411,199
"16113","E01017535",2001,487,50,437,39
"16114","E01017536",2001,505,55,450,111
"16115","E01017537",2001,494,171,323,40
"16116","E01017538",2001,515,48,467,90
"16117","E01017539",2001,503,35,468,105
"16118","E01017518",2001,630,157,473,51
"16119","E01017519",2001,639,269,370,28
"16120","E01017520",2001,666,113,553,43
"16121","E01017521",2001,618,81,537,40
"16122","E01017522",2001,743,192,551,143
"16123","E01017523",2001,619,339,280,34
"16124","E01017472",2001,491,237,254,48
"16125","E01017473",2001,516,77,439,134
"16126","E01017474",2001,597,138,459,99
"16127","E01017475",2001,566,29,537,70
"16128","E01017476",2001,518,36,482,48
"16129","E01017477",2001,511,331,180,10
"16130","E01017509",2001,532,322,210,28
"16131","E01017510",2001,626,62,564,51
"16132","E01017511",2001,487,46,441,21
"16133","E01017512",2001,533,151,382,40
"16134","E01017505",2001,606,72,534,68
"16135","E01017506",2001,632,58,574,84
"16136","E01017507",2001,527,22,505,54
"16137","E01017508",2001,647,27,620,50
"16138","E01017513",2001,520,22,498,18
"16139","E01017514",2001,621,246,375,41
"16140","E01017515",2001,624,205,419,25
"16141","E01017516",2001,529,14,515,14
"16142","E01017517",2001,599,26,573,22
"16143","E01017548",2001,425,57,368,21
"16144","E01017549",2001,534,17,517,37
"16145","E01017550",2001,800,135,665,63
"16146","E01017486",2001,545,97,448,80
"16147","E01017487",2001,546,189,357,43
"16148","E01017551",2001,516,33,483,21
"16149","E01017552",2001,515,32,483,52
"16150","E01017553",2001,475,9,466,9
"16151","E01017554",2001,655,155,500,18
"16152","E01017436",2001,781,0,781,32
"16153","E01017433",2001,657,345,312,34
"16154","E01017434",2001,625,86,539,41
"16155","E01017435",2001,599,182,417,49
"16156","E01017430",2001,606,139,467,38
"16157","E01017431",2001,614,65,549,51
"16158","E01017432",2001,500,32,468,14
"16159","E01017425",2001,426,72,354,45
"16160","E01017426",2001,545,38,507,19
"16161","E01017427",2001,608,144,464,65
"16162","E01017428",2001,601,77,524,34
"16163","E01017429",2001,617,25,592,78
"16164","E01017422",2001,600,76,524,17
"16165","E01017423",2001,611,119,492,52
"16166","E01017424",2001,551,60,491,30
"16167","E01017412",2001,565,97,468,171
"16168","E01017383",2001,759,33,726,77
"16169","E01017384",2001,627,216,411,21
"16170","E01017385",2001,715,72,643,127
"16171","E01017386",2001,608,79,529,58
"16172","E01017387",2001,494,49,445,15
"16173","E01017388",2001,541,104,437,23
"16174","E01017389",2001,661,74,587,21
"16175","E01017390",2001,733,259,474,32
"16176","E01017381",2001,597,7,590,22
"16177","E01017382",2001,578,141,437,12
"16178","E01017394",2001,554,71,483,26
"16179","E01017395",2001,406,63,343,215
"16180","E01017396",2001,447,19,428,40
"16181","E01017397",2001,605,37,568,49
"16182","E01017379",2001,482,90,392,58
"16183","E01017380",2001,504,13,491,32
"16184","E01017410",2001,465,60,405,19
"16185","E01017411",2001,546,58,488,40
"16186","E01017419",2001,520,3,517,25
"16187","E01017420",2001,640,158,482,35
"16188","E01017421",2001,682,94,588,42
"16189","E01017416",2001,650,51,599,66
"16190","E01017417",2001,652,25,627,47
"16191","E01017418",2001,604,149,455,29
"16192","E01017451",2001,577,60,517,137
"16193","E01017452",2001,565,71,494,99
"16194","E01017413",2001,650,32,618,25
"16195","E01017414",2001,659,87,572,36
"16196","E01017415",2001,622,117,505,40
"16197","E01017376",2001,653,24,629,78
"16198","E01017377",2001,618,76,542,44
"16199","E01017378",2001,738,293,445,44
"16200","E01017444",2001,777,138,639,72
"16201","E01017437",2001,630,113,517,68
"16202","E01017438",2001,618,17,601,44
"16203","E01017439",2001,497,50,447,75
"16204","E01017440",2001,471,210,261,24
"16205","E01017441",2001,474,62,412,118
"16206","E01017371",2001,534,17,517,14
"16207","E01017372",2001,639,137,502,37
"16208","E01017373",2001,531,32,499,22
"16209","E01017374",2001,531,11,520,32
"16210","E01017375",2001,614,104,510,61
"16211","E01017442",2001,645,58,587,42
"16212","E01017443",2001,547,41,506,288
"16213","E01017391",2001,523,145,378,28
"16214","E01017392",2001,553,6,547,28
"16215","E01017393",2001,579,52,527,29
"16216","E01017446",2001,723,201,522,29
"16217","E01017447",2001,657,13,644,48
"16218","E01017448",2001,613,64,549,33
"16219","E01017449",2001,584,48,536,27
"16220","E01017399",2001,478,30,448,53
"16221","E01017400",2001,653,375,278,8
"16222","E01017401",2001,403,35,368,28
"16223","E01017402",2001,617,14,603,33
"16224","E01017403",2001,624,81,543,23
"16225","E01017404",2001,490,6,484,8
"16226","E01017405",2001,612,11,601,33
"16227","E01017406",2001,595,15,580,53
"16228","E01017407",2001,615,24,591,46
"16229","E01017408",2001,407,4,403,26
"16230","E01017409",2001,509,75,434,16
"16231","E01017398",2001,784,52,732,45
"16232","E01017450",2001,802,90,712,45
"16233","E01017445",2001,618,52,566,39
"16234","E01017558",2001,660,32,628,44
"16235","E01017559",2001,648,81,567,17
"16236","E01017560",2001,614,7,607,13
"16237","E01017616",2001,944,85,859,54
"16238","E01017615",2001,869,87,782,42
"16239","E01017620",2001,701,35,666,52
"16240","E01017621",2001,633,6,627,17
"16241","E01017622",2001,674,185,489,52
"16242","E01017577",2001,846,114,732,37
"16243","E01017603",2001,643,14,629,39
"16244","E01017604",2001,645,30,615,28
"16245","E01017605",2001,515,207,308,15
"16246","E01017606",2001,634,4,630,15
"16247","E01017607",2001,461,7,454,6
"16248","E01017608",2001,648,125,523,43
"16249","E01017609",2001,643,340,303,30
"16250","E01017555",2001,758,198,560,111
"16251","E01017556",2001,649,33,616,80
"16252","E01017557",2001,773,209,564,42
"16253","E01017610",2001,449,10,439,20
"16254","E01017589",2001,681,135,546,75
"16255","E01017590",2001,635,23,612,33
"16256","E01017591",2001,616,92,524,27
"16257","E01017611",2001,510,0,510,32
"16258","E01017612",2001,540,6,534,24
"16259","E01017613",2001,596,39,557,34
"16260","E01017614",2001,569,36,533,25
"16261","E01017600",2001,841,24,817,86
"16262","E01017601",2001,507,184,323,23
"16263","E01017602",2001,631,270,361,19
"16264","E01017618",2001,623,235,388,13
"16265","E01017619",2001,783,293,490,24
"16266","E01017573",2001,600,4,596,21
"16267","E01017574",2001,539,7,532,38
"16268","E01017575",2001,597,98,499,51
"16269","E01017576",2001,531,88,443,20
"16270","E01017578",2001,594,20,574,15
"16271","E01017579",2001,598,159,439,20
"16272","E01017580",2001,847,199,648,65
"16273","E01017581",2001,740,189,551,38
"16274","E01017617",2001,509,62,447,29
"16275","E01017582",2001,603,7,596,37
"16276","E01017583",2001,617,8,609,18
"16277","E01017584",2001,640,14,626,22
"16278","E01017585",2001,537,16,521,9
"16279","E01017595",2001,476,175,301,12
"16280","E01017596",2001,632,267,365,28
"16281","E01017597",2001,613,142,471,9
"16282","E01017598",2001,413,9,404,9
"16283","E01017599",2001,574,121,453,50
"16284","E01017566",2001,563,9,554,14
"16285","E01017567",2001,640,153,487,49
"16286","E01017568",2001,765,170,595,120
"16287","E01017569",2001,688,108,580,50
"16288","E01017570",2001,631,83,548,50
"16289","E01017565",2001,608,40,568,9
"16290","E01017592",2001,638,75,563,57
"16291","E01017593",2001,590,73,517,11
"16292","E01017594",2001,899,515,384,24
"16293","E01017623",2001,744,87,657,104
"16294","E01017624",2001,571,21,550,18
"16295","E01017625",2001,648,11,637,9
"16296","E01017626",2001,652,7,645,42
"16297","E01017586",2001,608,122,486,13
"16298","E01017587",2001,660,28,632,43
"16299","E01017588",2001,534,60,474,37
"16300","E01017571",2001,521,118,403,17
"16301","E01017572",2001,548,22,526,40
"16302","E01017561",2001,587,37,550,20
"16303","E01017562",2001,688,151,537,83
"16304","E01017563",2001,641,6,635,17
"16305","E01017564",2001,632,34,598,101
"16306","E01017975",2001,656,350,306,35
"16307","E01017976",2001,601,97,504,79
"16308","E01017977",2001,612,284,328,92
"16309","E01017978",2001,625,330,295,57
"16310","E01017979",2001,674,393,281,19
"16311","E01017980",2001,488,92,396,61
"16312","E01017949",2001,667,137,530,202
"16313","E01017950",2001,654,34,620,271
"16314","E01017951",2001,647,179,468,66
"16315","E01017952",2001,667,323,344,45
"16316","E01017953",2001,659,221,438,71
"16317","E01017954",2001,621,230,391,32
"16318","E01017970",2001,782,169,613,208
"16319","E01017971",2001,588,272,316,71
"16320","E01017972",2001,617,174,443,66
"16321","E01017973",2001,633,374,259,94
"16322","E01017974",2001,622,212,410,90
"16323","E01018006",2001,741,69,672,201
"16324","E01018007",2001,593,16,577,81
"16325","E01018008",2001,634,94,540,129
"16326","E01018009",2001,782,191,591,232
"16327","E01018010",2001,889,122,767,320
"16328","E01017955",2001,652,11,641,110
"16329","E01017956",2001,525,14,511,136
"16330","E01017957",2001,501,13,488,188
"16331","E01017958",2001,465,167,298,184
"16332","E01017943",2001,565,79,486,161
"16333","E01017944",2001,556,227,329,41
"16334","E01017945",2001,631,177,454,158
"16335","E01017946",2001,626,268,358,66
"16336","E01017947",2001,647,219,428,40
"16337","E01017948",2001,626,348,278,45
"16338","E01017981",2001,469,84,385,255
"16339","E01017982",2001,446,91,355,195
"16340","E01017983",2001,913,105,808,376
"16341","E01017984",2001,517,6,511,86
"16342","E01017985",2001,776,75,701,270
"16343","E01017986",2001,416,50,366,163
"16344","E01017987",2001,625,72,553,277
"16345","E01017988",2001,589,22,567,282
"16346","E01017989",2001,678,115,563,207
"16347","E01017990",2001,542,32,510,190
"16348","E01017991",2001,578,191,387,150
"16349","E01017997",2001,715,127,588,115
"16350","E01017998",2001,677,58,619,228
"16351","E01017999",2001,706,257,449,124
"16352","E01018000",2001,647,51,596,241
"16353","E01018001",2001,703,45,658,222
"16354","E01017965",2001,734,243,491,92
"16355","E01017966",2001,636,150,486,157
"16356","E01017967",2001,605,271,334,46
"16357","E01017968",2001,650,98,552,89
"16358","E01017969",2001,602,145,457,87
"16359","E01017959",2001,636,44,592,92
"16360","E01017960",2001,558,275,283,33
"16361","E01017961",2001,585,211,374,66
"16362","E01017962",2001,620,166,454,45
"16363","E01017963",2001,644,204,440,44
"16364","E01017964",2001,501,17,484,32
"16365","E01018002",2001,719,160,559,119
"16366","E01018003",2001,646,144,502,53
"16367","E01018004",2001,634,145,489,128
"16368","E01018005",2001,789,149,640,340
"16369","E01017992",2001,628,129,499,81
"16370","E01017993",2001,517,26,491,49
"16371","E01017994",2001,623,212,411,29
"16372","E01017995",2001,578,23,555,50
"16373","E01017996",2001,508,10,498,110
"16374","E01018042",2001,629,157,472,50
"16375","E01018043",2001,645,74,571,72
"16376","E01018044",2001,677,51,626,132
"16377","E01018045",2001,525,81,444,46
"16378","E01018046",2001,538,227,311,17
"16379","E01018055",2001,731,10,721,33
"16380","E01018056",2001,592,138,454,28
"16381","E01018020",2001,557,26,531,38
"16382","E01018021",2001,508,83,425,29
"16383","E01018022",2001,531,70,461,18
"16384","E01018027",2001,733,3,730,70
"16385","E01018028",2001,716,264,452,23
"16386","E01018029",2001,705,67,638,95
"16387","E01018032",2001,802,76,726,70
"16388","E01018033",2001,868,233,635,89
"16389","E01018030",2001,401,108,293,19
"16390","E01018031",2001,506,10,496,60
"16391","E01018024",2001,501,125,376,52
"16392","E01018025",2001,623,131,492,190
"16393","E01018026",2001,599,25,574,75
"16394","E01018036",2001,668,117,551,44
"16395","E01018037",2001,514,23,491,19
"16396","E01018038",2001,568,14,554,23
"16397","E01018039",2001,532,62,470,27
"16398","E01018053",2001,598,127,471,36
"16399","E01018054",2001,817,78,739,48
"16400","E01018047",2001,635,144,491,37
"16401","E01018048",2001,900,48,852,65
"16402","E01018049",2001,584,83,501,72
"16403","E01018050",2001,517,56,461,56
"16404","E01018051",2001,678,137,541,29
"16405","E01018052",2001,736,150,586,163
"16406","E01018040",2001,467,11,456,47
"16407","E01018041",2001,437,106,331,37
"16408","E01018034",2001,601,39,562,66
"16409","E01018035",2001,928,207,721,141
"16410","E01018013",2001,648,28,620,21
"16411","E01018014",2001,637,28,609,47
"16412","E01018015",2001,520,15,505,56
"16413","E01018016",2001,580,192,388,18
"16414","E01018011",2001,996,102,894,92
"16415","E01018012",2001,506,116,390,43
"16416","E01018057",2001,793,144,649,63
"16417","E01018017",2001,588,156,432,54
"16418","E01018018",2001,643,6,637,49
"16419","E01018019",2001,433,0,433,37
"16420","E01018023",2001,865,125,740,82
"16421","E01018094",2001,626,113,513,22
"16422","E01018095",2001,568,34,534,27
"16423","E01018096",2001,688,11,677,56
"16424","E01018097",2001,547,78,469,37
"16425","E01018063",2001,915,167,748,148
"16426","E01018073",2001,876,112,764,56
"16427","E01018107",2001,644,283,361,32
"16428","E01018108",2001,612,275,337,63
"16429","E01018109",2001,764,54,710,77
"16430","E01018069",2001,596,8,588,15
"16431","E01018070",2001,621,169,452,65
"16432","E01018071",2001,745,167,578,59
"16433","E01018093",2001,907,130,777,81
"16434","E01018103",2001,480,217,263,43
"16435","E01018104",2001,504,75,429,13
"16436","E01018089",2001,1076,208,868,155
"16437","E01018090",2001,562,89,473,13
"16438","E01018091",2001,484,102,382,31
"16439","E01018092",2001,602,74,528,27
"16440","E01018066",2001,503,111,392,20
"16441","E01018067",2001,643,52,591,42
"16442","E01018068",2001,502,81,421,58
"16443","E01018081",2001,544,54,490,34
"16444","E01018082",2001,730,19,711,51
"16445","E01018083",2001,586,53,533,103
"16446","E01018084",2001,612,29,583,48
"16447","E01018098",2001,509,21,488,35
"16448","E01018099",2001,510,0,510,21
"16449","E01018100",2001,518,56,462,111
"16450","E01018101",2001,524,20,504,68
"16451","E01018072",2001,664,170,494,21
"16452","E01018074",2001,516,40,476,16
"16453","E01018075",2001,496,203,293,35
"16454","E01018064",2001,743,69,674,30
"16455","E01018077",2001,729,36,693,199
"16456","E01018078",2001,786,318,468,62
"16457","E01018079",2001,743,128,615,47
"16458","E01018080",2001,723,39,684,62
"16459","E01018058",2001,684,6,678,47
"16460","E01018059",2001,501,30,471,28
"16461","E01018060",2001,579,60,519,43
"16462","E01018061",2001,473,54,419,29
"16463","E01018085",2001,626,8,618,73
"16464","E01018086",2001,597,72,525,67
"16465","E01018087",2001,729,129,600,102
"16466","E01018088",2001,646,20,626,37
"16467","E01018065",2001,825,36,789,47
"16468","E01018076",2001,660,64,596,57
"16469","E01018111",2001,682,62,620,26
"16470","E01018110",2001,879,89,790,89
"16471","E01018062",2001,846,137,709,71
"16472","E01018102",2001,992,122,870,106
"16473","E01018105",2001,477,88,389,56
"16474","E01018106",2001,610,18,592,52
"16475","E01018212",2001,608,109,499,20
"16476","E01018213",2001,575,31,544,78
"16477","E01018214",2001,613,195,418,43
"16478","E01018215",2001,558,7,551,36
"16479","E01018216",2001,627,25,602,27
"16480","E01018217",2001,633,100,533,30
"16481","E01018200",2001,605,44,561,35
"16482","E01018201",2001,586,66,520,37
"16483","E01018127",2001,630,44,586,69
"16484","E01018128",2001,488,79,409,74
"16485","E01018156",2001,652,41,611,55
"16486","E01018157",2001,621,88,533,25
"16487","E01018158",2001,746,126,620,161
"16488","E01018159",2001,569,7,562,73
"16489","E01018160",2001,699,263,436,44
"16490","E01018191",2001,493,9,484,53
"16491","E01018192",2001,574,39,535,56
"16492","E01018193",2001,505,7,498,38
"16493","E01018194",2001,582,39,543,80
"16494","E01018195",2001,547,182,365,39
"16495","E01018208",2001,624,123,501,41
"16496","E01018209",2001,563,42,521,45
"16497","E01018210",2001,573,108,465,27
"16498","E01018211",2001,627,43,584,35
"16499","E01018206",2001,469,30,439,278
"16500","E01018207",2001,581,68,513,43
"16501","E01018196",2001,461,43,418,36
"16502","E01018197",2001,645,115,530,66
"16503","E01018198",2001,617,26,591,45
"16504","E01018199",2001,558,17,541,33
"16505","E01018121",2001,486,0,486,14
"16506","E01018122",2001,492,46,446,20
"16507","E01018123",2001,636,42,594,46
"16508","E01018124",2001,736,70,666,37
"16509","E01018143",2001,650,311,339,30
"16510","E01018144",2001,507,205,302,24
"16511","E01018145",2001,488,186,302,24
"16512","E01018146",2001,511,176,335,32
"16513","E01018147",2001,593,247,346,35
"16514","E01018139",2001,564,166,398,66
"16515","E01018140",2001,504,14,490,23
"16516","E01018141",2001,644,3,641,41
"16517","E01018142",2001,596,82,514,31
"16518","E01018116",2001,498,25,473,182
"16519","E01018117",2001,748,167,581,33
"16520","E01018118",2001,758,26,732,95
"16521","E01018112",2001,482,57,425,71
"16522","E01018113",2001,536,33,503,52
"16523","E01018114",2001,479,65,414,44
"16524","E01018161",2001,585,21,564,37
"16525","E01018162",2001,553,10,543,49
"16526","E01018163",2001,598,119,479,69
"16527","E01018164",2001,536,13,523,45
"16528","E01018165",2001,553,42,511,62
"16529","E01018170",2001,605,60,545,52
"16530","E01018171",2001,542,41,501,43
"16531","E01018148",2001,575,50,525,44
"16532","E01018149",2001,561,6,555,57
"16533","E01018150",2001,541,100,441,53
"16534","E01018151",2001,832,75,757,273
"16535","E01018138",2001,735,126,609,92
"16536","E01018166",2001,630,45,585,56
"16537","E01018167",2001,580,7,573,31
"16538","E01018168",2001,900,255,645,178
"16539","E01018169",2001,594,136,458,35
"16540","E01018131",2001,623,168,455,35
"16541","E01018132",2001,786,125,661,125
"16542","E01018133",2001,523,99,424,21
"16543","E01018134",2001,619,14,605,73
"16544","E01018152",2001,554,34,520,64
"16545","E01018153",2001,709,62,647,83
"16546","E01018125",2001,587,58,529,40
"16547","E01018126",2001,585,41,544,71
"16548","E01018129",2001,631,95,536,63
"16549","E01018130",2001,552,22,530,18
"16550","E01018202",2001,630,34,596,51
"16551","E01018203",2001,603,72,531,56
"16552","E01018204",2001,516,36,480,39
"16553","E01018205",2001,693,31,662,78
"16554","E01018137",2001,619,53,566,38
"16555","E01018119",2001,604,40,564,75
"16556","E01018120",2001,666,89,577,66
"16557","E01018115",2001,525,15,510,38
"16558","E01018135",2001,478,58,420,34
"16559","E01018136",2001,649,44,605,49
"16560","E01018154",2001,590,24,566,28
"16561","E01018155",2001,609,11,598,66
"16562","E01018187",2001,803,199,604,137
"16563","E01018188",2001,625,119,506,33
"16564","E01018189",2001,497,3,494,12
"16565","E01018190",2001,621,129,492,41
"16566","E01018172",2001,629,61,568,38
"16567","E01018173",2001,514,17,497,62
"16568","E01018174",2001,674,45,629,66
"16569","E01018175",2001,535,10,525,32
"16570","E01018176",2001,446,0,446,8
"16571","E01018181",2001,669,16,653,79
"16572","E01018182",2001,577,60,517,42
"16573","E01018183",2001,593,198,395,39
"16574","E01018184",2001,507,194,313,25
"16575","E01018185",2001,656,93,563,57
"16576","E01018186",2001,632,140,492,26
"16577","E01018177",2001,591,33,558,34
"16578","E01018178",2001,611,57,554,20
"16579","E01018179",2001,525,167,358,36
"16580","E01018180",2001,569,289,280,18
"16581","E01018304",2001,614,127,487,50
"16582","E01018305",2001,511,68,443,16
"16583","E01018306",2001,524,6,518,28
"16584","E01018307",2001,766,61,705,39
"16585","E01018233",2001,625,25,600,42
"16586","E01018234",2001,624,12,612,47
"16587","E01018235",2001,614,86,528,20
"16588","E01018236",2001,612,178,434,23
"16589","E01018237",2001,521,61,460,44
"16590","E01018266",2001,772,93,679,86
"16591","E01018284",2001,503,10,493,46
"16592","E01018285",2001,456,73,383,11
"16593","E01018298",2001,485,50,435,242
"16594","E01018299",2001,633,131,502,47
"16595","E01018300",2001,484,108,376,49
"16596","E01018301",2001,539,38,501,49
"16597","E01018221",2001,774,30,744,61
"16598","E01018222",2001,588,8,580,21
"16599","E01018223",2001,801,96,705,79
"16600","E01018257",2001,565,200,365,18
"16601","E01018258",2001,666,81,585,37
"16602","E01018259",2001,507,31,476,46
"16603","E01018260",2001,671,63,608,53
"16604","E01018261",2001,427,252,175,21
"16605","E01018262",2001,530,12,518,36
"16606","E01018297",2001,649,103,546,107
"16607","E01018272",2001,485,0,485,37
"16608","E01018273",2001,600,69,531,89
"16609","E01018274",2001,663,28,635,129
"16610","E01018276",2001,418,224,194,16
"16611","E01018277",2001,683,82,601,57
"16612","E01018278",2001,484,117,367,20
"16613","E01018229",2001,543,72,471,54
"16614","E01018230",2001,603,79,524,40
"16615","E01018248",2001,505,13,492,49
"16616","E01018249",2001,408,24,384,35
"16617","E01018250",2001,504,109,395,26
"16618","E01018224",2001,536,90,446,47
"16619","E01018225",2001,497,99,398,53
"16620","E01018251",2001,482,18,464,32
"16621","E01018252",2001,462,38,424,17
"16622","E01018231",2001,619,39,580,45
"16623","E01018232",2001,896,112,784,44
"16624","E01018255",2001,437,62,375,20
"16625","E01018242",2001,642,206,436,24
"16626","E01018243",2001,656,124,532,114
"16627","E01018244",2001,608,29,579,61
"16628","E01018286",2001,623,175,448,73
"16629","E01018287",2001,576,35,541,149
"16630","E01018296",2001,438,74,364,49
"16631","E01018292",2001,512,20,492,20
"16632","E01018293",2001,659,15,644,47
"16633","E01018294",2001,729,262,467,66
"16634","E01018295",2001,595,59,536,25
"16635","E01018275",2001,923,138,785,54
"16636","E01018245",2001,686,30,656,54
"16637","E01018246",2001,659,137,522,50
"16638","E01018247",2001,590,100,490,55
"16639","E01018253",2001,404,15,389,24
"16640","E01018254",2001,552,106,446,32
"16641","E01018256",2001,619,51,568,42
"16642","E01018240",2001,443,67,376,21
"16643","E01018291",2001,478,68,410,51
"16644","E01018279",2001,625,152,473,34
"16645","E01018280",2001,586,90,496,40
"16646","E01018281",2001,607,221,386,12
"16647","E01018282",2001,513,57,456,24
"16648","E01018283",2001,484,11,473,14
"16649","E01018263",2001,581,48,533,44
"16650","E01018264",2001,605,229,376,20
"16651","E01018265",2001,664,16,648,44
"16652","E01018218",2001,682,55,627,40
"16653","E01018219",2001,533,125,408,49
"16654","E01018220",2001,543,75,468,32
"16655","E01018238",2001,537,126,411,43
"16656","E01018239",2001,472,53,419,26
"16657","E01018288",2001,486,94,392,20
"16658","E01018289",2001,449,53,396,107
"16659","E01018302",2001,486,52,434,34
"16660","E01018303",2001,509,99,410,40
"16661","E01018241",2001,472,44,428,31
"16662","E01018267",2001,852,64,788,42
"16663","E01018268",2001,593,49,544,46
"16664","E01018269",2001,610,243,367,24
"16665","E01018270",2001,426,75,351,26
"16666","E01018271",2001,502,123,379,41
"16667","E01018226",2001,436,53,383,135
"16668","E01018227",2001,723,179,544,35
"16669","E01018228",2001,631,84,547,46
"16670","E01018290",2001,892,103,789,53
"16671","E01021237",2001,492,7,485,9
"16672","E01021238",2001,506,3,503,6
"16673","E01021242",2001,483,3,480,13
"16674","E01021250",2001,626,7,619,21
"16675","E01021251",2001,596,3,593,19
"16676","E01021252",2001,621,8,613,43
"16677","E01021245",2001,608,302,306,29
"16678","E01021246",2001,643,4,639,32
"16679","E01021248",2001,618,3,615,40
"16680","E01021249",2001,617,6,611,16
"16681","E01021247",2001,638,65,573,32
"16682","E01021243",2001,654,3,651,19
"16683","E01021239",2001,488,9,479,17
"16684","E01021240",2001,726,142,584,76
"16685","E01021241",2001,659,186,473,19
"16686","E01021244",2001,605,6,599,26
"16687","E01021253",2001,646,0,646,22
"16688","E01021258",2001,757,218,539,38
"16689","E01021255",2001,619,53,566,13
"16690","E01021256",2001,603,6,597,7
"16691","E01021334",2001,671,38,633,39
"16692","E01021336",2001,656,51,605,30
"16693","E01021338",2001,601,150,451,22
"16694","E01021339",2001,633,238,395,47
"16695","E01021329",2001,639,136,503,20
"16696","E01021330",2001,606,0,606,21
"16697","E01021332",2001,614,10,604,13
"16698","E01021333",2001,639,15,624,15
"16699","E01021264",2001,500,28,472,15
"16700","E01021340",2001,605,19,586,33
"16701","E01021341",2001,632,17,615,14
"16702","E01021337",2001,625,7,618,21
"16703","E01021335",2001,508,25,483,12
"16704","E01021345",2001,626,7,619,22
"16705","E01021346",2001,755,12,743,48
"16706","E01021342",2001,651,221,430,31
"16707","E01021343",2001,745,116,629,53
"16708","E01021344",2001,601,30,571,33
"16709","E01021331",2001,605,30,575,46
"16710","E01021257",2001,598,8,590,20
"16711","E01021259",2001,630,56,574,22
"16712","E01021260",2001,659,17,642,37
"16713","E01021254",2001,514,8,506,13
"16714","E01021261",2001,624,63,561,32
"16715","E01021262",2001,725,206,519,43
"16716","E01021263",2001,616,85,531,29
"16717","E01021274",2001,713,194,519,66
"16718","E01021279",2001,591,297,294,12
"16719","E01021301",2001,618,300,318,35
"16720","E01021303",2001,654,231,423,29
"16721","E01021307",2001,569,131,438,65
"16722","E01021308",2001,477,14,463,35
"16723","E01021309",2001,610,70,540,94
"16724","E01021312",2001,522,12,510,27
"16725","E01021272",2001,613,169,444,16
"16726","E01021265",2001,621,149,472,23
"16727","E01021267",2001,719,237,482,24
"16728","E01021269",2001,637,175,462,17
"16729","E01021270",2001,636,224,412,35
"16730","E01021271",2001,622,364,258,31
"16731","E01021302",2001,639,417,222,42
"16732","E01021304",2001,611,309,302,26
"16733","E01021305",2001,601,229,372,27
"16734","E01021306",2001,606,239,367,22
"16735","E01021273",2001,755,305,450,36
"16736","E01021275",2001,626,91,535,11
"16737","E01021276",2001,683,246,437,51
"16738","E01021277",2001,650,150,500,48
"16739","E01021278",2001,759,431,328,39
"16740","E01021268",2001,642,353,289,28
"16741","E01021266",2001,733,191,542,18
"16742","E01021320",2001,608,218,390,20
"16743","E01021321",2001,650,208,442,24
"16744","E01021318",2001,779,308,471,45
"16745","E01021286",2001,642,241,401,55
"16746","E01021288",2001,546,325,221,55
"16747","E01021289",2001,589,294,295,18
"16748","E01021290",2001,568,420,148,32
"16749","E01021291",2001,776,284,492,54
"16750","E01021292",2001,628,158,470,30
"16751","E01021293",2001,714,209,505,30
"16752","E01021287",2001,605,110,495,18
"16753","E01021298",2001,656,134,522,17
"16754","E01021319",2001,731,275,456,45
"16755","E01021313",2001,575,12,563,19
"16756","E01021314",2001,572,297,275,21
"16757","E01021315",2001,667,330,337,30
"16758","E01021316",2001,694,336,358,44
"16759","E01021317",2001,653,270,383,26
"16760","E01021322",2001,583,214,369,29
"16761","E01021323",2001,632,355,277,35
"16762","E01021324",2001,602,365,237,19
"16763","E01021325",2001,632,342,290,51
"16764","E01021327",2001,676,359,317,27
"16765","E01021299",2001,598,19,579,7
"16766","E01021294",2001,641,106,535,25
"16767","E01021295",2001,663,172,491,27
"16768","E01021296",2001,717,222,495,23
"16769","E01021297",2001,604,150,454,40
"16770","E01021280",2001,599,42,557,41
"16771","E01021281",2001,576,23,553,44
"16772","E01021282",2001,549,10,539,27
"16773","E01021283",2001,631,260,371,36
"16774","E01021284",2001,560,9,551,20
"16775","E01021285",2001,527,14,513,26
"16776","E01021300",2001,835,307,528,56
"16777","E01021326",2001,646,186,460,26
"16778","E01021310",2001,694,36,658,90
"16779","E01021311",2001,582,224,358,16
"16780","E01021328",2001,619,167,452,32
"16781","E01021375",2001,436,73,363,24
"16782","E01021376",2001,515,17,498,14
"16783","E01021414",2001,876,136,740,57
"16784","E01021430",2001,826,152,674,54
"16785","E01021406",2001,914,79,835,130
"16786","E01021407",2001,869,70,799,56
"16787","E01021398",2001,609,75,534,50
"16788","E01021399",2001,670,188,482,24
"16789","E01021400",2001,706,113,593,58
"16790","E01021382",2001,521,31,490,51
"16791","E01021397",2001,633,17,616,94
"16792","E01021387",2001,891,178,713,131
"16793","E01021388",2001,634,174,460,53
"16794","E01021391",2001,627,361,266,10
"16795","E01021392",2001,752,138,614,53
"16796","E01021393",2001,614,145,469,45
"16797","E01021404",2001,842,94,748,54
"16798","E01021411",2001,533,107,426,45
"16799","E01021412",2001,535,76,459,62
"16800","E01021413",2001,503,51,452,42
"16801","E01021408",2001,670,44,626,42
"16802","E01021409",2001,626,57,569,62
"16803","E01021410",2001,683,222,461,66
"16804","E01021389",2001,615,57,558,26
"16805","E01021390",2001,628,26,602,34
"16806","E01021381",2001,520,44,476,23
"16807","E01021349",2001,477,11,466,22
"16808","E01021351",2001,541,7,534,20
"16809","E01021352",2001,541,9,532,20
"16810","E01021355",2001,653,124,529,71
"16811","E01021356",2001,519,78,441,17
"16812","E01021357",2001,598,165,433,36
"16813","E01021358",2001,625,351,274,13
"16814","E01021359",2001,882,467,415,29
"16815","E01021354",2001,516,236,280,15
"16816","E01021363",2001,893,148,745,153
"16817","E01021365",2001,854,216,638,95
"16818","E01021353",2001,720,91,629,63
"16819","E01021350",2001,655,26,629,36
"16820","E01021366",2001,581,6,575,21
"16821","E01021364",2001,631,20,611,32
"16822","E01021383",2001,459,28,431,11
"16823","E01021405",2001,795,38,757,52
"16824","E01021368",2001,642,126,516,50
"16825","E01021370",2001,693,347,346,38
"16826","E01021372",2001,705,71,634,55
"16827","E01021373",2001,759,113,646,61
"16828","E01021374",2001,601,265,336,13
"16829","E01021380",2001,899,178,721,40
"16830","E01021369",2001,619,165,454,21
"16831","E01021367",2001,520,233,287,9
"16832","E01021360",2001,754,322,432,17
"16833","E01021361",2001,554,62,492,39
"16834","E01021347",2001,675,75,600,31
"16835","E01021371",2001,639,64,575,17
"16836","E01021384",2001,585,6,579,27
"16837","E01021385",2001,470,52,418,22
"16838","E01021386",2001,507,3,504,10
"16839","E01021401",2001,645,216,429,45
"16840","E01021402",2001,758,78,680,64
"16841","E01021403",2001,597,6,591,39
"16842","E01021377",2001,674,82,592,60
"16843","E01021378",2001,763,239,524,66
"16844","E01021379",2001,654,31,623,40
"16845","E01021417",2001,620,198,422,32
"16846","E01021418",2001,580,262,318,15
"16847","E01021419",2001,688,145,543,18
"16848","E01021426",2001,503,137,366,14
"16849","E01021428",2001,619,10,609,17
"16850","E01021362",2001,571,73,498,15
"16851","E01021429",2001,510,153,357,23
"16852","E01021427",2001,526,243,283,30
"16853","E01021423",2001,589,241,348,25
"16854","E01021425",2001,590,226,364,23
"16855","E01021420",2001,724,151,573,48
"16856","E01021421",2001,657,85,572,72
"16857","E01021422",2001,766,273,493,42
"16858","E01021415",2001,749,260,489,43
"16859","E01021416",2001,703,28,675,93
"16860","E01021424",2001,606,33,573,37
"16861","E01021394",2001,649,193,456,50
"16862","E01021395",2001,618,94,524,18
"16863","E01021396",2001,515,17,498,50
"16864","E01021348",2001,634,82,552,144
"16865","E01021441",2001,560,67,493,18
"16866","E01021442",2001,497,3,494,3
"16867","E01021443",2001,535,30,505,38
"16868","E01021444",2001,615,74,541,39
"16869","E01021469",2001,444,32,412,13
"16870","E01021470",2001,410,67,343,14
"16871","E01021471",2001,604,23,581,10
"16872","E01021457",2001,623,143,480,53
"16873","E01021458",2001,757,61,696,90
"16874","E01021459",2001,503,3,500,16
"16875","E01021460",2001,604,83,521,38
"16876","E01021448",2001,634,217,417,23
"16877","E01021449",2001,620,134,486,32
"16878","E01021450",2001,782,3,779,23
"16879","E01021451",2001,625,282,343,18
"16880","E01021452",2001,620,7,613,18
"16881","E01021461",2001,643,264,379,19
"16882","E01021464",2001,612,103,509,25
"16883","E01021431",2001,620,9,611,69
"16884","E01021432",2001,612,225,387,38
"16885","E01021434",2001,500,76,424,50
"16886","E01021465",2001,791,9,782,108
"16887","E01021466",2001,641,4,637,14
"16888","E01021467",2001,668,6,662,29
"16889","E01021447",2001,917,11,906,19
"16890","E01021455",2001,523,0,523,12
"16891","E01021453",2001,518,31,487,48
"16892","E01021462",2001,557,11,546,31
"16893","E01021463",2001,613,86,527,22
"16894","E01021468",2001,739,17,722,66
"16895","E01021438",2001,749,4,745,51
"16896","E01021439",2001,780,146,634,122
"16897","E01021440",2001,772,153,619,107
"16898","E01021436",2001,915,123,792,169
"16899","E01021433",2001,777,22,755,121
"16900","E01021475",2001,653,46,607,104
"16901","E01021472",2001,637,180,457,92
"16902","E01021473",2001,511,25,486,65
"16903","E01021474",2001,600,3,597,24
"16904","E01021437",2001,735,312,423,31
"16905","E01021435",2001,750,182,568,27
"16906","E01021456",2001,513,3,510,47
"16907","E01021454",2001,517,11,506,44
"16908","E01021445",2001,801,25,776,45
"16909","E01021446",2001,671,24,647,47
"16910","E01021513",2001,647,14,633,10
"16911","E01021514",2001,618,64,554,9
"16912","E01021515",2001,499,18,481,15
"16913","E01021525",2001,612,22,590,70
"16914","E01021527",2001,671,0,671,18
"16915","E01021528",2001,623,6,617,22
"16916","E01021531",2001,527,24,503,14
"16917","E01021509",2001,628,22,606,15
"16918","E01021510",2001,645,7,638,25
"16919","E01021511",2001,507,8,499,19
"16920","E01021516",2001,540,6,534,10
"16921","E01021476",2001,771,73,698,27
"16922","E01021477",2001,636,3,633,16
"16923","E01021478",2001,644,7,637,13
"16924","E01021479",2001,611,14,597,17
"16925","E01021481",2001,545,3,542,23
"16926","E01021483",2001,643,3,640,13
"16927","E01021512",2001,631,3,628,35
"16928","E01021526",2001,634,6,628,22
"16929","E01021532",2001,648,3,645,16
"16930","E01021530",2001,622,14,608,16
"16931","E01021517",2001,730,14,716,28
"16932","E01021519",2001,651,16,635,21
"16933","E01021520",2001,651,11,640,42
"16934","E01021518",2001,773,71,702,143
"16935","E01021482",2001,599,27,572,27
"16936","E01021529",2001,638,187,451,42
"16937","E01021480",2001,641,0,641,25
"16938","E01021521",2001,619,3,616,16
"16939","E01021522",2001,719,91,628,69
"16940","E01021523",2001,605,20,585,21
"16941","E01021524",2001,653,19,634,21
"16942","E01021504",2001,499,32,467,19
"16943","E01021505",2001,489,29,460,10
"16944","E01021506",2001,520,19,501,45
"16945","E01021487",2001,603,18,585,30
"16946","E01021494",2001,591,34,557,29
"16947","E01021495",2001,780,10,770,88
"16948","E01021496",2001,580,23,557,44
"16949","E01021492",2001,738,24,714,50
"16950","E01021493",2001,673,23,650,32
"16951","E01021485",2001,496,162,334,16
"16952","E01021486",2001,462,95,367,27
"16953","E01021488",2001,636,173,463,33
"16954","E01021507",2001,627,242,385,30
"16955","E01021508",2001,464,26,438,47
"16956","E01021503",2001,544,38,506,27
"16957","E01021498",2001,589,4,585,47
"16958","E01021499",2001,657,27,630,14
"16959","E01021501",2001,623,32,591,58
"16960","E01021502",2001,665,0,665,32
"16961","E01021484",2001,578,19,559,31
"16962","E01021500",2001,727,73,654,72
"16963","E01021497",2001,656,6,650,34
"16964","E01021489",2001,612,6,606,36
"16965","E01021490",2001,667,86,581,41
"16966","E01021491",2001,663,10,653,30
"16967","E01021538",2001,631,77,554,30
"16968","E01021539",2001,539,100,439,32
"16969","E01021540",2001,638,55,583,40
"16970","E01021541",2001,660,203,457,35
"16971","E01021542",2001,645,66,579,50
"16972","E01021543",2001,604,11,593,31
"16973","E01021590",2001,606,6,600,34
"16974","E01021591",2001,646,10,636,63
"16975","E01021587",2001,610,12,598,23
"16976","E01021597",2001,571,145,426,21
"16977","E01021598",2001,659,208,451,16
"16978","E01021600",2001,443,13,430,8
"16979","E01021601",2001,687,270,417,30
"16980","E01021550",2001,564,48,516,62
"16981","E01021616",2001,547,3,544,15
"16982","E01021617",2001,612,177,435,21
"16983","E01021619",2001,644,45,599,32
"16984","E01021620",2001,654,11,643,99
"16985","E01021623",2001,521,5,516,30
"16986","E01021624",2001,519,6,513,30
"16987","E01021536",2001,705,226,479,37
"16988","E01021537",2001,731,22,709,39
"16989","E01021549",2001,504,60,444,16
"16990","E01021568",2001,609,28,581,19
"16991","E01021576",2001,593,385,208,21
"16992","E01021592",2001,661,366,295,43
"16993","E01021588",2001,618,251,367,31
"16994","E01021589",2001,636,134,502,68
"16995","E01021596",2001,635,340,295,13
"16996","E01021621",2001,626,15,611,49
"16997","E01021622",2001,628,26,602,20
"16998","E01021618",2001,599,24,575,47
"16999","E01021625",2001,634,19,615,26
"17000","E01021626",2001,497,0,497,29
"17001","E01021628",2001,642,104,538,46
"17002","E01021629",2001,629,161,468,52
"17003","E01021544",2001,645,3,642,103
"17004","E01021545",2001,578,15,563,27
"17005","E01021546",2001,588,129,459,31
"17006","E01021547",2001,702,51,651,94
"17007","E01021573",2001,624,95,529,43
"17008","E01021630",2001,727,78,649,79
"17009","E01021631",2001,786,375,411,23
"17010","E01021599",2001,625,48,577,28
"17011","E01021575",2001,619,154,465,68
"17012","E01021627",2001,597,97,500,68
"17013","E01021574",2001,640,45,595,173
"17014","E01021578",2001,745,66,679,184
"17015","E01021581",2001,872,83,789,222
"17016","E01021582",2001,815,49,766,161
"17017","E01021551",2001,538,72,466,51
"17018","E01021632",2001,609,41,568,9
"17019","E01021633",2001,511,20,491,59
"17020","E01021634",2001,602,12,590,53
"17021","E01021635",2001,637,105,532,34
"17022","E01021636",2001,516,248,268,17
"17023","E01021556",2001,660,64,596,57
"17024","E01021584",2001,480,6,474,8
"17025","E01021579",2001,602,8,594,67
"17026","E01021580",2001,493,10,483,20
"17027","E01021577",2001,600,7,593,51
"17028","E01021571",2001,588,51,537,45
"17029","E01021564",2001,638,42,596,23
"17030","E01021560",2001,763,59,704,71
"17031","E01021561",2001,618,5,613,14
"17032","E01021548",2001,543,45,498,34
"17033","E01021562",2001,721,231,490,44
"17034","E01021563",2001,760,287,473,53
"17035","E01021565",2001,623,373,250,7
"17036","E01021566",2001,619,78,541,12
"17037","E01021567",2001,879,121,758,26
"17038","E01021585",2001,493,4,489,14
"17039","E01021586",2001,629,3,626,30
"17040","E01021583",2001,486,27,459,8
"17041","E01021557",2001,488,0,488,5
"17042","E01021558",2001,506,3,503,17
"17043","E01021533",2001,853,13,840,49
"17044","E01021569",2001,636,6,630,15
"17045","E01021570",2001,729,21,708,36
"17046","E01021535",2001,644,72,572,31
"17047","E01021572",2001,640,240,400,18
"17048","E01021559",2001,560,22,538,14
"17049","E01021552",2001,685,134,551,30
"17050","E01021553",2001,580,108,472,17
"17051","E01021554",2001,652,220,432,22
"17052","E01021555",2001,521,35,486,25
"17053","E01021534",2001,538,11,527,57
"17054","E01021602",2001,733,144,589,81
"17055","E01021603",2001,642,15,627,37
"17056","E01021604",2001,744,32,712,17
"17057","E01021611",2001,529,6,523,13
"17058","E01021612",2001,613,6,607,12
"17059","E01021613",2001,704,35,669,88
"17060","E01021614",2001,624,5,619,18
"17061","E01021615",2001,617,7,610,39
"17062","E01021605",2001,469,6,463,18
"17063","E01021606",2001,523,93,430,23
"17064","E01021607",2001,619,76,543,47
"17065","E01021608",2001,548,72,476,73
"17066","E01021609",2001,497,4,493,9
"17067","E01021610",2001,576,8,568,78
"17068","E01021593",2001,657,14,643,14
"17069","E01021594",2001,630,94,536,76
"17070","E01021595",2001,720,12,708,16
"17071","E01021655",2001,528,35,493,38
"17072","E01021656",2001,706,100,606,54
"17073","E01021661",2001,569,26,543,24
"17074","E01021659",2001,812,109,703,50
"17075","E01021668",2001,798,59,739,213
"17076","E01021669",2001,701,192,509,109
"17077","E01021670",2001,619,139,480,50
"17078","E01021671",2001,586,57,529,28
"17079","E01021672",2001,622,97,525,61
"17080","E01021660",2001,580,51,529,46
"17081","E01021728",2001,642,10,632,20
"17082","E01021729",2001,671,94,577,54
"17083","E01021730",2001,667,99,568,35
"17084","E01021679",2001,666,33,633,53
"17085","E01021680",2001,609,81,528,47
"17086","E01021681",2001,625,3,622,49
"17087","E01021682",2001,632,30,602,71
"17088","E01021708",2001,630,62,568,20
"17089","E01021709",2001,644,10,634,31
"17090","E01021710",2001,772,9,763,39
"17091","E01021702",2001,524,30,494,43
"17092","E01021703",2001,484,308,176,13
"17093","E01021704",2001,635,159,476,57
"17094","E01021705",2001,784,70,714,47
"17095","E01021706",2001,592,89,503,112
"17096","E01021707",2001,584,93,491,24
"17097","E01021646",2001,514,74,440,104
"17098","E01021647",2001,640,13,627,73
"17099","E01021648",2001,730,110,620,139
"17100","E01021649",2001,885,238,647,290
"17101","E01021650",2001,777,52,725,230
"17102","E01021696",2001,773,492,281,47
"17103","E01021697",2001,723,343,380,34
"17104","E01021698",2001,521,161,360,98
"17105","E01021699",2001,638,323,315,54
"17106","E01021700",2001,584,347,237,62
"17107","E01021701",2001,617,213,404,158
"17108","E01021673",2001,622,0,622,23
"17109","E01021674",2001,498,139,359,27
"17110","E01021675",2001,516,29,487,19
"17111","E01021676",2001,619,66,553,44
"17112","E01021677",2001,488,8,480,16
"17113","E01021678",2001,544,60,484,52
"17114","E01021662",2001,621,46,575,31
"17115","E01021663",2001,463,42,421,29
"17116","E01021654",2001,707,33,674,68
"17117","E01021683",2001,508,69,439,109
"17118","E01021684",2001,658,74,584,82
"17119","E01021685",2001,585,188,397,119
"17120","E01021686",2001,762,234,528,182
"17121","E01021687",2001,735,47,688,171
"17122","E01021688",2001,602,30,572,91
"17123","E01021718",2001,665,12,653,72
"17124","E01021719",2001,639,20,619,36
"17125","E01021720",2001,716,241,475,38
"17126","E01021721",2001,574,7,567,10
"17127","E01021722",2001,603,124,479,22
"17128","E01021717",2001,505,55,450,119
"17129","E01021651",2001,622,21,601,152
"17130","E01021652",2001,641,48,593,98
"17131","E01021653",2001,491,11,480,37
"17132","E01021689",2001,630,118,512,22
"17133","E01021690",2001,506,10,496,25
"17134","E01021691",2001,638,72,566,28
"17135","E01021692",2001,618,6,612,34
"17136","E01021693",2001,735,25,710,31
"17137","E01021711",2001,645,312,333,25
"17138","E01021712",2001,490,125,365,294
"17139","E01021713",2001,503,180,323,13
"17140","E01021714",2001,504,79,425,212
"17141","E01021715",2001,599,170,429,26
"17142","E01021716",2001,498,93,405,332
"17143","E01021664",2001,604,83,521,55
"17144","E01021665",2001,613,288,325,38
"17145","E01021666",2001,623,56,567,114
"17146","E01021667",2001,619,217,402,40
"17147","E01021657",2001,544,75,469,37
"17148","E01021658",2001,456,122,334,16
"17149","E01021736",2001,444,18,426,81
"17150","E01021737",2001,575,12,563,73
"17151","E01021738",2001,744,31,713,135
"17152","E01021739",2001,644,12,632,47
"17153","E01021740",2001,751,113,638,63
"17154","E01021637",2001,474,77,397,18
"17155","E01021638",2001,480,173,307,25
"17156","E01021639",2001,569,131,438,51
"17157","E01021640",2001,475,72,403,39
"17158","E01021641",2001,588,132,456,38
"17159","E01021642",2001,637,177,460,62
"17160","E01021643",2001,633,27,606,40
"17161","E01021644",2001,654,87,567,86
"17162","E01021645",2001,586,23,563,19
"17163","E01021694",2001,563,47,516,26
"17164","E01021695",2001,418,24,394,10
"17165","E01021723",2001,643,41,602,40
"17166","E01021724",2001,617,20,597,17
"17167","E01021725",2001,499,8,491,43
"17168","E01021726",2001,648,207,441,29
"17169","E01021727",2001,631,19,612,14
"17170","E01021731",2001,622,17,605,51
"17171","E01021732",2001,692,166,526,41
"17172","E01021733",2001,542,11,531,21
"17173","E01021734",2001,614,25,589,28
"17174","E01021735",2001,651,20,631,34
"17175","E01021768",2001,875,127,748,53
"17176","E01021797",2001,509,43,466,34
"17177","E01021798",2001,615,91,524,23
"17178","E01021799",2001,653,179,474,40
"17179","E01021795",2001,981,18,963,221
"17180","E01021801",2001,837,92,745,33
"17181","E01021792",2001,493,9,484,20
"17182","E01021793",2001,624,6,618,14
"17183","E01021794",2001,493,121,372,19
"17184","E01021741",2001,751,55,696,61
"17185","E01021769",2001,810,128,682,75
"17186","E01021800",2001,792,50,742,81
"17187","E01021796",2001,852,110,742,76
"17188","E01021802",2001,800,293,507,37
"17189","E01021753",2001,625,149,476,83
"17190","E01021754",2001,615,10,605,23
"17191","E01021755",2001,460,8,452,26
"17192","E01021760",2001,640,99,541,45
"17193","E01021761",2001,601,79,522,45
"17194","E01021762",2001,613,206,407,39
"17195","E01021763",2001,662,111,551,45
"17196","E01021756",2001,618,62,556,42
"17197","E01021757",2001,734,13,721,103
"17198","E01021758",2001,718,231,487,83
"17199","E01021759",2001,589,118,471,30
"17200","E01021811",2001,616,245,371,13
"17201","E01021813",2001,575,29,546,30
"17202","E01021814",2001,613,124,489,33
"17203","E01021815",2001,606,205,401,17
"17204","E01021816",2001,619,356,263,22
"17205","E01021817",2001,847,224,623,40
"17206","E01021807",2001,603,75,528,23
"17207","E01021808",2001,619,189,430,19
"17208","E01021809",2001,623,187,436,14
"17209","E01021810",2001,719,82,637,73
"17210","E01021812",2001,537,24,513,29
"17211","E01021818",2001,794,181,613,105
"17212","E01021806",2001,968,33,935,82
"17213","E01021803",2001,534,115,419,10
"17214","E01021804",2001,566,25,541,58
"17215","E01021805",2001,497,7,490,3
"17216","E01021770",2001,816,155,661,42
"17217","E01021774",2001,641,195,446,58
"17218","E01021775",2001,628,223,405,25
"17219","E01021776",2001,759,337,422,58
"17220","E01021777",2001,618,191,427,17
"17221","E01021778",2001,609,128,481,23
"17222","E01021779",2001,714,240,474,55
"17223","E01021786",2001,519,5,514,71
"17224","E01021787",2001,636,11,625,47
"17225","E01021788",2001,633,27,606,33
"17226","E01021789",2001,529,5,524,12
"17227","E01021790",2001,399,123,276,5
"17228","E01021791",2001,630,11,619,101
"17229","E01021783",2001,630,35,595,26
"17230","E01021784",2001,616,20,596,25
"17231","E01021771",2001,747,381,366,19
"17232","E01021772",2001,617,141,476,16
"17233","E01021773",2001,610,138,472,23
"17234","E01021785",2001,611,185,426,18
"17235","E01021780",2001,505,3,502,9
"17236","E01021781",2001,604,17,587,56
"17237","E01021782",2001,614,0,614,64
"17238","E01021742",2001,509,134,375,13
"17239","E01021743",2001,770,171,599,65
"17240","E01021744",2001,637,57,580,47
"17241","E01021745",2001,622,13,609,66
"17242","E01021746",2001,854,55,799,101
"17243","E01021747",2001,630,22,608,46
"17244","E01021748",2001,707,23,684,99
"17245","E01021749",2001,857,66,791,49
"17246","E01021750",2001,423,6,417,44
"17247","E01021751",2001,471,3,468,8
"17248","E01021752",2001,561,38,523,37
"17249","E01021764",2001,738,407,331,41
"17250","E01021765",2001,652,20,632,90
"17251","E01021766",2001,515,17,498,24
"17252","E01021767",2001,660,26,634,25
"17253","E01021854",2001,730,219,511,37
"17254","E01021855",2001,582,215,367,35
"17255","E01021856",2001,611,163,448,37
"17256","E01021857",2001,581,176,405,20
"17257","E01021844",2001,512,195,317,14
"17258","E01021845",2001,622,342,280,18
"17259","E01021846",2001,610,278,332,61
"17260","E01021847",2001,619,293,326,15
"17261","E01021848",2001,611,253,358,14
"17262","E01021849",2001,641,222,419,23
"17263","E01021850",2001,619,311,308,23
"17264","E01021851",2001,725,339,386,73
"17265","E01021852",2001,666,295,371,22
"17266","E01021853",2001,502,190,312,10
"17267","E01021839",2001,653,229,424,31
"17268","E01021840",2001,700,346,354,28
"17269","E01021841",2001,532,195,337,19
"17270","E01021842",2001,655,296,359,46
"17271","E01021843",2001,608,242,366,35
"17272","E01021824",2001,633,11,622,23
"17273","E01021825",2001,645,4,641,27
"17274","E01021826",2001,637,81,556,29
"17275","E01021827",2001,716,90,626,52
"17276","E01021828",2001,569,15,554,30
"17277","E01021822",2001,601,239,362,9
"17278","E01021823",2001,756,377,379,38
"17279","E01021819",2001,632,254,378,26
"17280","E01021820",2001,639,228,411,16
"17281","E01021870",2001,578,211,367,20
"17282","E01021871",2001,617,304,313,20
"17283","E01021872",2001,728,283,445,95
"17284","E01021868",2001,667,235,432,28
"17285","E01021869",2001,554,130,424,14
"17286","E01021831",2001,626,231,395,18
"17287","E01021821",2001,602,284,318,33
"17288","E01021834",2001,631,260,371,14
"17289","E01021835",2001,611,213,398,28
"17290","E01021836",2001,632,322,310,29
"17291","E01021837",2001,632,203,429,33
"17292","E01021865",2001,577,183,394,32
"17293","E01021832",2001,499,48,451,24
"17294","E01021833",2001,527,183,344,24
"17295","E01021829",2001,644,223,421,35
"17296","E01021830",2001,504,57,447,16
"17297","E01021838",2001,606,174,432,9
"17298","E01021858",2001,644,280,364,37
"17299","E01021859",2001,618,272,346,47
"17300","E01021860",2001,602,227,375,39
"17301","E01021861",2001,483,184,299,12
"17302","E01021862",2001,618,225,393,28
"17303","E01021863",2001,636,219,417,43
"17304","E01021864",2001,537,230,307,46
"17305","E01021866",2001,625,202,423,45
"17306","E01021867",2001,580,45,535,15
"17307","E01021908",2001,808,24,784,46
"17308","E01021909",2001,500,86,414,31
"17309","E01021910",2001,607,98,509,61
"17310","E01021911",2001,456,29,427,22
"17311","E01021912",2001,790,52,738,35
"17312","E01021913",2001,557,32,525,44
"17313","E01021882",2001,787,37,750,49
"17314","E01021883",2001,581,74,507,22
"17315","E01021884",2001,615,32,583,45
"17316","E01021885",2001,444,7,437,32
"17317","E01021886",2001,499,22,477,24
"17318","E01021887",2001,724,77,647,22
"17319","E01021888",2001,775,272,503,41
"17320","E01021889",2001,922,329,593,88
"17321","E01021890",2001,766,100,666,132
"17322","E01021891",2001,638,57,581,55
"17323","E01021892",2001,482,179,303,26
"17324","E01021893",2001,581,8,573,13
"17325","E01021894",2001,481,119,362,25
"17326","E01021895",2001,484,18,466,18
"17327","E01021896",2001,499,3,496,13
"17328","E01021897",2001,484,32,452,20
"17329","E01021898",2001,602,122,480,14
"17330","E01021904",2001,486,33,453,30
"17331","E01021905",2001,490,86,404,23
"17332","E01021906",2001,606,75,531,87
"17333","E01021907",2001,842,89,753,86
"17334","E01021901",2001,612,40,572,38
"17335","E01021902",2001,612,16,596,26
"17336","E01021903",2001,593,73,520,23
"17337","E01021899",2001,472,3,469,14
"17338","E01021900",2001,426,48,378,25
"17339","E01021873",2001,449,4,445,13
"17340","E01021874",2001,520,90,430,33
"17341","E01021875",2001,574,17,557,35
"17342","E01021876",2001,428,128,300,19
"17343","E01021877",2001,491,3,488,16
"17344","E01021878",2001,631,61,570,25
"17345","E01021879",2001,624,84,540,44
"17346","E01021880",2001,740,152,588,81
"17347","E01021881",2001,519,7,512,58
"17348","E01021942",2001,788,16,772,62
"17349","E01021943",2001,660,57,603,11
"17350","E01021944",2001,607,7,600,19
"17351","E01021945",2001,614,13,601,12
"17352","E01021927",2001,492,3,489,11
"17353","E01021928",2001,663,63,600,31
"17354","E01021929",2001,491,0,491,9
"17355","E01021931",2001,581,4,577,21
"17356","E01021914",2001,693,10,683,23
"17357","E01021933",2001,487,19,468,6
"17358","E01021934",2001,508,6,502,15
"17359","E01021935",2001,516,0,516,21
"17360","E01021936",2001,724,155,569,26
"17361","E01021937",2001,679,8,671,53
"17362","E01021938",2001,634,6,628,14
"17363","E01021939",2001,655,0,655,22
"17364","E01021940",2001,714,47,667,12
"17365","E01021941",2001,755,3,752,15
"17366","E01021953",2001,521,313,208,18
"17367","E01021955",2001,623,298,325,43
"17368","E01021915",2001,496,70,426,55
"17369","E01021916",2001,412,40,372,16
"17370","E01021960",2001,758,3,755,8
"17371","E01021961",2001,633,50,583,10
"17372","E01021925",2001,664,12,652,32
"17373","E01021918",2001,523,3,520,13
"17374","E01021919",2001,522,13,509,19
"17375","E01021920",2001,492,24,468,24
"17376","E01021926",2001,835,38,797,36
"17377","E01021957",2001,614,221,393,22
"17378","E01021958",2001,520,0,520,23
"17379","E01021959",2001,628,61,567,27
"17380","E01021956",2001,614,100,514,49
"17381","E01021954",2001,541,53,488,61
"17382","E01021952",2001,600,40,560,40
"17383","E01021932",2001,614,4,610,38
"17384","E01021930",2001,643,55,588,115
"17385","E01021950",2001,593,110,483,20
"17386","E01021951",2001,513,40,473,11
"17387","E01021962",2001,494,122,372,42
"17388","E01021963",2001,507,3,504,31
"17389","E01021964",2001,619,23,596,16
"17390","E01021966",2001,751,166,585,65
"17391","E01021965",2001,912,4,908,26
"17392","E01021946",2001,517,3,514,13
"17393","E01021947",2001,504,24,480,9
"17394","E01021948",2001,517,15,502,22
"17395","E01021949",2001,588,3,585,11
"17396","E01021921",2001,578,75,503,122
"17397","E01021922",2001,677,194,483,27
"17398","E01021923",2001,518,30,488,25
"17399","E01021924",2001,482,4,478,22
"17400","E01021917",2001,688,46,642,70
"17401","E01021997",2001,618,201,417,98
"17402","E01021998",2001,599,33,566,118
"17403","E01021999",2001,739,107,632,88
"17404","E01022001",2001,741,80,661,218
"17405","E01022000",2001,625,33,592,27
"17406","E01022003",2001,681,133,548,56
"17407","E01022006",2001,773,221,552,72
"17408","E01022007",2001,637,187,450,27
"17409","E01022029",2001,441,15,426,65
"17410","E01022013",2001,622,23,599,49
"17411","E01022014",2001,622,186,436,30
"17412","E01022015",2001,630,25,605,49
"17413","E01022019",2001,547,39,508,43
"17414","E01022020",2001,750,79,671,103
"17415","E01022021",2001,614,166,448,36
"17416","E01021978",2001,887,55,832,46
"17417","E01021991",2001,405,21,384,28
"17418","E01021992",2001,520,72,448,34
"17419","E01022004",2001,675,35,640,43
"17420","E01022005",2001,776,14,762,32
"17421","E01022002",2001,612,23,589,33
"17422","E01022028",2001,531,81,450,27
"17423","E01022051",2001,610,33,577,58
"17424","E01022052",2001,590,80,510,23
"17425","E01021971",2001,410,6,404,26
"17426","E01021972",2001,493,84,409,30
"17427","E01021985",2001,640,7,633,49
"17428","E01021986",2001,753,18,735,94
"17429","E01022054",2001,634,77,557,82
"17430","E01022055",2001,667,156,511,36
"17431","E01022056",2001,755,58,697,218
"17432","E01022016",2001,817,10,807,54
"17433","E01022017",2001,596,11,585,45
"17434","E01022018",2001,628,111,517,23
"17435","E01021973",2001,469,7,462,17
"17436","E01021974",2001,485,54,431,55
"17437","E01021987",2001,642,25,617,44
"17438","E01021994",2001,630,31,599,23
"17439","E01021995",2001,655,3,652,20
"17440","E01021996",2001,656,55,601,55
"17441","E01022009",2001,649,14,635,41
"17442","E01022010",2001,670,6,664,32
"17443","E01022011",2001,675,56,619,38
"17444","E01022012",2001,1053,94,959,63
"17445","E01022053",2001,657,11,646,35
"17446","E01021993",2001,922,58,864,56
"17447","E01021983",2001,606,7,599,31
"17448","E01021967",2001,852,40,812,44
"17449","E01021984",2001,1023,9,1014,39
"17450","E01022039",2001,686,140,546,51
"17451","E01022040",2001,749,30,719,23
"17452","E01022041",2001,751,8,743,42
"17453","E01022046",2001,642,4,638,31
"17454","E01021979",2001,622,112,510,17
"17455","E01021980",2001,773,57,716,42
"17456","E01021981",2001,770,38,732,64
"17457","E01021982",2001,769,31,738,138
"17458","E01022033",2001,760,3,757,15
"17459","E01022034",2001,749,8,741,66
"17460","E01022035",2001,754,14,740,30
"17461","E01022008",2001,1057,42,1015,37
"17462","E01022022",2001,633,18,615,60
"17463","E01022044",2001,729,101,628,40
"17464","E01021975",2001,616,86,530,32
"17465","E01021976",2001,622,7,615,37
"17466","E01021977",2001,648,23,625,32
"17467","E01022048",2001,651,11,640,53
"17468","E01022049",2001,636,8,628,62
"17469","E01022050",2001,748,98,650,70
"17470","E01022042",2001,730,105,625,115
"17471","E01022043",2001,724,72,652,131
"17472","E01022023",2001,651,20,631,85
"17473","E01022024",2001,658,118,540,44
"17474","E01022030",2001,758,261,497,35
"17475","E01022031",2001,611,318,293,53
"17476","E01022032",2001,757,156,601,34
"17477","E01022025",2001,706,38,668,317
"17478","E01022026",2001,615,46,569,186
"17479","E01022027",2001,742,11,731,220
"17480","E01021970",2001,879,218,661,163
"17481","E01022036",2001,596,8,588,32
"17482","E01022037",2001,619,13,606,54
"17483","E01022038",2001,621,88,533,35
"17484","E01021968",2001,781,75,706,110
"17485","E01021969",2001,624,57,567,76
"17486","E01021988",2001,869,44,825,266
"17487","E01021989",2001,738,3,735,42
"17488","E01021990",2001,840,3,837,82
"17489","E01022045",2001,629,175,454,42
"17490","E01022047",2001,628,19,609,53
"17491","E01022057",2001,619,55,564,55
"17492","E01022077",2001,653,58,595,61
"17493","E01022075",2001,667,9,658,80
"17494","E01022094",2001,671,57,614,73
"17495","E01022074",2001,562,181,381,17
"17496","E01022076",2001,884,175,709,131
"17497","E01022078",2001,618,241,377,45
"17498","E01022079",2001,737,100,637,63
"17499","E01022080",2001,629,32,597,56
"17500","E01022081",2001,753,133,620,48
"17501","E01022082",2001,615,48,567,48
"17502","E01022098",2001,577,60,517,45
"17503","E01022061",2001,545,50,495,34
"17504","E01022071",2001,628,56,572,98
"17505","E01022072",2001,643,49,594,56
"17506","E01022073",2001,623,131,492,23
"17507","E01022099",2001,716,83,633,190
"17508","E01022092",2001,663,36,627,64
"17509","E01022093",2001,640,168,472,26
"17510","E01022097",2001,676,67,609,54
"17511","E01022089",2001,568,85,483,78
"17512","E01022087",2001,493,47,446,45
"17513","E01022083",2001,634,26,608,62
"17514","E01022084",2001,594,3,591,25
"17515","E01022085",2001,626,47,579,85
"17516","E01022062",2001,757,30,727,60
"17517","E01022063",2001,611,86,525,26
"17518","E01022086",2001,461,187,274,50
"17519","E01022090",2001,611,103,508,57
"17520","E01022091",2001,595,31,564,45
"17521","E01022095",2001,587,50,537,70
"17522","E01022066",2001,981,185,796,57
"17523","E01022067",2001,806,144,662,164
"17524","E01022068",2001,578,95,483,37
"17525","E01022069",2001,609,45,564,69
"17526","E01022064",2001,627,24,603,46
"17527","E01022065",2001,500,145,355,39
"17528","E01022058",2001,580,60,520,51
"17529","E01022088",2001,578,64,514,39
"17530","E01022096",2001,694,93,601,65
"17531","E01022059",2001,596,54,542,82
"17532","E01022060",2001,653,55,598,32
"17533","E01022070",2001,665,115,550,33
"17534","E01023316",2001,515,6,509,14
"17535","E01023317",2001,609,11,598,26
"17536","E01023318",2001,621,9,612,31
"17537","E01023319",2001,616,32,584,6
"17538","E01023327",2001,505,46,459,49
"17539","E01023328",2001,487,62,425,26
"17540","E01023329",2001,509,77,432,18
"17541","E01023330",2001,615,104,511,36
"17542","E01023331",2001,611,134,477,35
"17543","E01023320",2001,744,46,698,118
"17544","E01023321",2001,720,49,671,47
"17545","E01023322",2001,655,76,579,58
"17546","E01023323",2001,778,303,475,76
"17547","E01023289",2001,511,3,508,4
"17548","E01023290",2001,616,57,559,12
"17549","E01023291",2001,600,15,585,31
"17550","E01023292",2001,607,15,592,35
"17551","E01023340",2001,734,45,689,88
"17552","E01023341",2001,684,71,613,34
"17553","E01023342",2001,635,149,486,66
"17554","E01023343",2001,635,257,378,46
"17555","E01023344",2001,710,57,653,31
"17556","E01023307",2001,505,21,484,8
"17557","E01023308",2001,631,17,614,12
"17558","E01023309",2001,622,8,614,13
"17559","E01023310",2001,662,229,433,28
"17560","E01023311",2001,629,35,594,32
"17561","E01023312",2001,494,6,488,11
"17562","E01023313",2001,613,15,598,7
"17563","E01023315",2001,534,29,505,4
"17564","E01023302",2001,630,232,398,6
"17565","E01023303",2001,605,123,482,43
"17566","E01023304",2001,629,110,519,21
"17567","E01023305",2001,511,17,494,24
"17568","E01023306",2001,620,54,566,13
"17569","E01023314",2001,511,40,471,17
"17570","E01023324",2001,521,74,447,9
"17571","E01023325",2001,625,64,561,31
"17572","E01023326",2001,662,221,441,28
"17573","E01023297",2001,499,3,496,11
"17574","E01023298",2001,636,20,616,16
"17575","E01023299",2001,632,21,611,26
"17576","E01023300",2001,652,182,470,54
"17577","E01023301",2001,620,82,538,80
"17578","E01023293",2001,651,70,581,10
"17579","E01023294",2001,724,307,417,25
"17580","E01023295",2001,552,105,447,8
"17581","E01023296",2001,629,168,461,11
"17582","E01023332",2001,759,18,741,41
"17583","E01023333",2001,735,176,559,62
"17584","E01023334",2001,626,9,617,38
"17585","E01023335",2001,661,20,641,29
"17586","E01023336",2001,676,104,572,53
"17587","E01023337",2001,598,54,544,60
"17588","E01023338",2001,971,360,611,99
"17589","E01023339",2001,594,247,347,24
"17590","E01023430",2001,473,45,428,30
"17591","E01023431",2001,465,85,380,60
"17592","E01023432",2001,520,66,454,16
"17593","E01023433",2001,663,172,491,50
"17594","E01023423",2001,520,39,481,24
"17595","E01023424",2001,519,68,451,33
"17596","E01023425",2001,512,30,482,18
"17597","E01023426",2001,645,71,574,114
"17598","E01023418",2001,627,289,338,10
"17599","E01023419",2001,817,110,707,57
"17600","E01023420",2001,601,43,558,48
"17601","E01023421",2001,643,61,582,55
"17602","E01023422",2001,473,9,464,21
"17603","E01023352",2001,977,115,862,79
"17604","E01023434",2001,639,115,524,54
"17605","E01023435",2001,641,29,612,111
"17606","E01023436",2001,492,8,484,31
"17607","E01023437",2001,641,302,339,72
"17608","E01023355",2001,595,69,526,27
"17609","E01023356",2001,445,61,384,20
"17610","E01023416",2001,600,3,597,40
"17611","E01023417",2001,610,133,477,40
"17612","E01023393",2001,798,384,414,35
"17613","E01023394",2001,511,122,389,16
"17614","E01023395",2001,617,191,426,27
"17615","E01023396",2001,587,125,462,23
"17616","E01023397",2001,536,327,209,8
"17617","E01023401",2001,599,271,328,33
"17618","E01023402",2001,606,184,422,19
"17619","E01023403",2001,626,257,369,22
"17620","E01023404",2001,511,340,171,12
"17621","E01023405",2001,612,344,268,15
"17622","E01023361",2001,755,100,655,144
"17623","E01023362",2001,622,6,616,39
"17624","E01023363",2001,615,7,608,32
"17625","E01023364",2001,501,0,501,13
"17626","E01023390",2001,857,288,569,35
"17627","E01023391",2001,650,128,522,18
"17628","E01023399",2001,747,182,565,60
"17629","E01023392",2001,631,239,392,8
"17630","E01023427",2001,642,261,381,7
"17631","E01023428",2001,602,51,551,45
"17632","E01023429",2001,786,389,397,17
"17633","E01023369",2001,641,353,288,16
"17634","E01023370",2001,469,65,404,50
"17635","E01023371",2001,513,78,435,15
"17636","E01023372",2001,515,7,508,11
"17637","E01023345",2001,645,115,530,41
"17638","E01023346",2001,493,122,371,33
"17639","E01023347",2001,510,107,403,11
"17640","E01023348",2001,652,402,250,21
"17641","E01023365",2001,519,85,434,72
"17642","E01023366",2001,621,255,366,22
"17643","E01023367",2001,408,3,405,24
"17644","E01023368",2001,641,9,632,53
"17645","E01023400",2001,780,259,521,64
"17646","E01023398",2001,645,58,587,79
"17647","E01023349",2001,767,352,415,22
"17648","E01023350",2001,636,293,343,7
"17649","E01023351",2001,628,122,506,20
"17650","E01023383",2001,607,129,478,25
"17651","E01023384",2001,773,295,478,23
"17652","E01023385",2001,672,174,498,9
"17653","E01023409",2001,621,175,446,20
"17654","E01023410",2001,522,31,491,13
"17655","E01023411",2001,601,170,431,9
"17656","E01023412",2001,501,17,484,4
"17657","E01023413",2001,501,159,342,14
"17658","E01023379",2001,621,31,590,46
"17659","E01023380",2001,485,28,457,27
"17660","E01023381",2001,516,13,503,12
"17661","E01023382",2001,650,162,488,38
"17662","E01023353",2001,619,138,481,93
"17663","E01023354",2001,630,28,602,48
"17664","E01023386",2001,531,245,286,19
"17665","E01023387",2001,499,189,310,12
"17666","E01023388",2001,633,112,521,43
"17667","E01023389",2001,634,71,563,12
"17668","E01023357",2001,637,297,340,17
"17669","E01023358",2001,502,219,283,28
"17670","E01023359",2001,613,254,359,9
"17671","E01023360",2001,526,103,423,23
"17672","E01023414",2001,519,146,373,41
"17673","E01023415",2001,540,82,458,7
"17674","E01023373",2001,497,84,413,30
"17675","E01023374",2001,558,30,528,57
"17676","E01023375",2001,631,86,545,35
"17677","E01023376",2001,497,121,376,27
"17678","E01023377",2001,510,4,506,30
"17679","E01023378",2001,575,12,563,33
"17680","E01023406",2001,828,193,635,70
"17681","E01023407",2001,631,83,548,31
"17682","E01023408",2001,599,29,570,20
"17683","E01023464",2001,772,16,756,21
"17684","E01023465",2001,545,46,499,33
"17685","E01023466",2001,728,153,575,49
"17686","E01023462",2001,510,73,437,45
"17687","E01023467",2001,933,126,807,38
"17688","E01023494",2001,461,90,371,41
"17689","E01023495",2001,472,70,402,27
"17690","E01023508",2001,565,81,484,67
"17691","E01023509",2001,481,93,388,40
"17692","E01023463",2001,463,68,395,40
"17693","E01023452",2001,490,21,469,19
"17694","E01023453",2001,512,15,497,50
"17695","E01023454",2001,495,0,495,24
"17696","E01023455",2001,505,11,494,30
"17697","E01023493",2001,860,110,750,69
"17698","E01023449",2001,641,0,641,61
"17699","E01023450",2001,808,176,632,148
"17700","E01023451",2001,862,8,854,48
"17701","E01023438",2001,600,87,513,54
"17702","E01023439",2001,491,107,384,19
"17703","E01023440",2001,619,3,616,11
"17704","E01023441",2001,483,28,455,65
"17705","E01023442",2001,500,63,437,18
"17706","E01023506",2001,540,91,449,33
"17707","E01023507",2001,574,30,544,45
"17708","E01023498",2001,1041,166,875,60
"17709","E01023443",2001,585,34,551,32
"17710","E01023444",2001,618,29,589,64
"17711","E01023445",2001,641,194,447,19
"17712","E01023446",2001,856,93,763,203
"17713","E01023447",2001,521,355,166,9
"17714","E01023448",2001,556,56,500,26
"17715","E01023456",2001,509,3,506,28
"17716","E01023457",2001,612,15,597,46
"17717","E01023458",2001,500,45,455,33
"17718","E01023459",2001,503,3,500,29
"17719","E01023460",2001,525,6,519,16
"17720","E01023461",2001,480,0,480,11
"17721","E01023491",2001,495,85,410,74
"17722","E01023492",2001,540,90,450,39
"17723","E01023496",2001,441,72,369,53
"17724","E01023497",2001,604,92,512,52
"17725","E01023485",2001,928,105,823,125
"17726","E01023486",2001,915,100,815,76
"17727","E01023521",2001,404,120,284,17
"17728","E01023522",2001,518,17,501,93
"17729","E01023499",2001,734,227,507,29
"17730","E01023500",2001,612,3,609,12
"17731","E01023501",2001,645,32,613,37
"17732","E01023502",2001,728,14,714,132
"17733","E01023503",2001,603,17,586,21
"17734","E01023512",2001,742,55,687,99
"17735","E01023513",2001,583,124,459,16
"17736","E01023514",2001,773,124,649,147
"17737","E01023518",2001,606,199,407,16
"17738","E01023519",2001,635,163,472,26
"17739","E01023520",2001,653,12,641,46
"17740","E01023515",2001,638,4,634,69
"17741","E01023516",2001,872,17,855,62
"17742","E01023517",2001,634,157,477,28
"17743","E01023510",2001,532,25,507,28
"17744","E01023511",2001,523,112,411,76
"17745","E01023470",2001,772,75,697,156
"17746","E01023471",2001,533,15,518,48
"17747","E01023472",2001,591,242,349,40
"17748","E01023473",2001,604,6,598,21
"17749","E01023474",2001,598,3,595,47
"17750","E01023487",2001,643,288,355,23
"17751","E01023488",2001,636,337,299,25
"17752","E01023489",2001,629,31,598,50
"17753","E01023490",2001,477,88,389,5
"17754","E01023482",2001,739,0,739,36
"17755","E01023483",2001,728,67,661,49
"17756","E01023484",2001,579,147,432,52
"17757","E01023475",2001,611,211,400,41
"17758","E01023476",2001,494,23,471,16
"17759","E01023477",2001,641,13,628,77
"17760","E01023478",2001,651,67,584,156
"17761","E01023479",2001,630,33,597,73
"17762","E01023480",2001,671,145,526,23
"17763","E01023481",2001,438,17,421,71
"17764","E01023468",2001,499,16,483,43
"17765","E01023469",2001,601,183,418,46
"17766","E01023504",2001,538,138,400,57
"17767","E01023505",2001,561,9,552,59
"17768","E01023576",2001,587,6,581,36
"17769","E01023577",2001,673,11,662,17
"17770","E01023578",2001,637,3,634,30
"17771","E01023579",2001,473,24,449,90
"17772","E01023580",2001,628,25,603,51
"17773","E01023567",2001,716,11,705,17
"17774","E01023568",2001,642,13,629,15
"17775","E01023569",2001,608,103,505,17
"17776","E01023570",2001,628,141,487,36
"17777","E01023571",2001,612,18,594,23
"17778","E01023572",2001,634,81,553,27
"17779","E01023573",2001,520,208,312,28
"17780","E01023574",2001,638,239,399,19
"17781","E01023575",2001,642,128,514,22
"17782","E01023581",2001,525,14,511,11
"17783","E01023582",2001,590,113,477,42
"17784","E01023583",2001,562,126,436,60
"17785","E01023584",2001,463,99,364,51
"17786","E01023523",2001,591,0,591,21
"17787","E01023524",2001,541,6,535,20
"17788","E01023525",2001,727,51,676,125
"17789","E01023526",2001,606,3,603,27
"17790","E01023527",2001,613,183,430,25
"17791","E01023534",2001,617,230,387,15
"17792","E01023535",2001,643,179,464,20
"17793","E01023536",2001,747,462,285,24
"17794","E01023537",2001,648,219,429,5
"17795","E01023538",2001,735,308,427,39
"17796","E01023529",2001,504,158,346,15
"17797","E01023530",2001,506,242,264,75
"17798","E01023531",2001,632,130,502,43
"17799","E01023532",2001,630,49,581,35
"17800","E01023533",2001,620,191,429,21
"17801","E01023552",2001,617,127,490,15
"17802","E01023553",2001,539,14,525,54
"17803","E01023554",2001,617,91,526,76
"17804","E01023555",2001,624,120,504,43
"17805","E01023544",2001,488,49,439,10
"17806","E01023545",2001,578,96,482,64
"17807","E01023546",2001,676,183,493,25
"17808","E01023547",2001,662,231,431,25
"17809","E01023528",2001,552,22,530,95
"17810","E01023564",2001,604,84,520,60
"17811","E01023565",2001,630,24,606,44
"17812","E01023566",2001,519,6,513,13
"17813","E01023539",2001,639,64,575,124
"17814","E01023540",2001,615,98,517,10
"17815","E01023541",2001,609,72,537,29
"17816","E01023542",2001,634,147,487,16
"17817","E01023543",2001,650,213,437,33
"17818","E01023558",2001,744,20,724,90
"17819","E01023559",2001,506,3,503,35
"17820","E01023560",2001,621,258,363,100
"17821","E01023561",2001,601,111,490,50
"17822","E01023562",2001,523,50,473,3
"17823","E01023563",2001,630,25,605,49
"17824","E01023556",2001,621,113,508,14
"17825","E01023557",2001,613,34,579,37
"17826","E01023548",2001,735,33,702,58
"17827","E01023549",2001,729,4,725,79
"17828","E01023550",2001,650,21,629,175
"17829","E01023551",2001,526,0,526,13
"17830","E01023660",2001,918,141,777,108
"17831","E01023661",2001,519,222,297,16
"17832","E01023662",2001,625,49,576,59
"17833","E01023654",2001,654,13,641,52
"17834","E01023655",2001,631,84,547,33
"17835","E01023656",2001,742,146,596,88
"17836","E01023657",2001,639,12,627,18
"17837","E01023658",2001,631,151,480,16
"17838","E01023659",2001,503,7,496,16
"17839","E01023635",2001,643,223,420,30
"17840","E01023636",2001,737,225,512,34
"17841","E01023637",2001,895,532,363,21
"17842","E01023638",2001,651,218,433,37
"17843","E01023587",2001,492,7,485,62
"17844","E01023588",2001,508,10,498,23
"17845","E01023589",2001,769,140,629,130
"17846","E01023590",2001,716,113,603,66
"17847","E01023591",2001,590,28,562,35
"17848","E01023592",2001,556,296,260,20
"17849","E01023593",2001,576,211,365,28
"17850","E01023585",2001,423,64,359,70
"17851","E01023586",2001,611,62,549,42
"17852","E01023597",2001,459,46,413,36
"17853","E01023598",2001,531,120,411,49
"17854","E01023599",2001,618,19,599,33
"17855","E01023600",2001,555,157,398,41
"17856","E01023663",2001,811,127,684,108
"17857","E01023630",2001,540,220,320,26
"17858","E01023631",2001,632,285,347,56
"17859","E01023632",2001,593,176,417,52
"17860","E01023633",2001,611,197,414,98
"17861","E01023634",2001,514,20,494,25
"17862","E01023649",2001,621,74,547,76
"17863","E01023650",2001,618,388,230,31
"17864","E01023651",2001,497,71,426,39
"17865","E01023652",2001,634,320,314,19
"17866","E01023644",2001,614,92,522,65
"17867","E01023645",2001,627,171,456,44
"17868","E01023646",2001,511,301,210,9
"17869","E01023647",2001,598,18,580,19
"17870","E01023648",2001,481,19,462,40
"17871","E01023639",2001,502,57,445,27
"17872","E01023640",2001,590,349,241,15
"17873","E01023641",2001,621,353,268,14
"17874","E01023642",2001,491,3,488,7
"17875","E01023643",2001,499,155,344,13
"17876","E01023601",2001,742,202,540,167
"17877","E01023602",2001,609,53,556,76
"17878","E01023603",2001,578,11,567,65
"17879","E01023604",2001,539,27,512,53
"17880","E01023605",2001,589,122,467,158
"17881","E01023617",2001,626,33,593,27
"17882","E01023618",2001,602,165,437,35
"17883","E01023619",2001,621,45,576,74
"17884","E01023620",2001,519,275,244,14
"17885","E01023621",2001,592,145,447,38
"17886","E01023611",2001,640,307,333,19
"17887","E01023612",2001,732,115,617,61
"17888","E01023613",2001,775,550,225,19
"17889","E01023614",2001,718,5,713,36
"17890","E01023615",2001,643,20,623,34
"17891","E01023616",2001,754,133,621,108
"17892","E01023606",2001,664,199,465,67
"17893","E01023607",2001,596,3,593,31
"17894","E01023608",2001,608,4,604,12
"17895","E01023609",2001,595,25,570,102
"17896","E01023610",2001,495,3,492,49
"17897","E01023622",2001,433,125,308,37
"17898","E01023623",2001,550,142,408,67
"17899","E01023624",2001,514,125,389,84
"17900","E01023625",2001,411,23,388,101
"17901","E01023653",2001,841,191,650,81
"17902","E01023594",2001,966,279,687,64
"17903","E01023595",2001,639,63,576,61
"17904","E01023596",2001,498,157,341,9
"17905","E01023626",2001,829,151,678,38
"17906","E01023627",2001,605,40,565,55
"17907","E01023628",2001,729,43,686,92
"17908","E01023629",2001,763,261,502,44
"17909","E01023690",2001,604,11,593,50
"17910","E01023691",2001,485,4,481,9
"17911","E01023692",2001,500,158,342,41
"17912","E01023693",2001,507,40,467,25
"17913","E01023694",2001,500,3,497,19
"17914","E01023685",2001,601,77,524,28
"17915","E01023686",2001,502,6,496,11
"17916","E01023687",2001,616,263,353,19
"17917","E01023688",2001,614,98,516,68
"17918","E01023689",2001,495,28,467,27
"17919","E01023699",2001,588,4,584,40
"17920","E01023700",2001,484,3,481,14
"17921","E01023701",2001,718,107,611,123
"17922","E01023702",2001,664,8,656,109
"17923","E01023703",2001,494,17,477,29
"17924","E01023746",2001,614,236,378,27
"17925","E01023747",2001,631,74,557,49
"17926","E01023748",2001,552,42,510,36
"17927","E01023749",2001,629,8,621,23
"17928","E01023695",2001,608,25,583,20
"17929","E01023696",2001,639,3,636,16
"17930","E01023697",2001,750,85,665,74
"17931","E01023698",2001,605,0,605,6
"17932","E01023722",2001,555,27,528,81
"17933","E01023723",2001,628,254,374,15
"17934","E01023724",2001,640,47,593,34
"17935","E01023725",2001,529,4,525,36
"17936","E01023734",2001,654,9,645,32
"17937","E01023735",2001,777,14,763,77
"17938","E01023736",2001,665,138,527,75
"17939","E01023713",2001,612,120,492,41
"17940","E01023709",2001,741,167,574,39
"17941","E01023710",2001,518,8,510,4
"17942","E01023711",2001,619,79,540,20
"17943","E01023712",2001,726,92,634,92
"17944","E01023669",2001,630,291,339,42
"17945","E01023670",2001,630,46,584,63
"17946","E01023671",2001,719,237,482,19
"17947","E01023672",2001,588,107,481,23
"17948","E01023673",2001,502,18,484,27
"17949","E01023714",2001,613,0,613,19
"17950","E01023715",2001,507,49,458,14
"17951","E01023716",2001,774,14,760,90
"17952","E01023674",2001,629,26,603,91
"17953","E01023675",2001,502,15,487,29
"17954","E01023676",2001,789,109,680,163
"17955","E01023666",2001,656,154,502,153
"17956","E01023726",2001,779,46,733,229
"17957","E01023727",2001,864,151,713,226
"17958","E01023728",2001,864,77,787,149
"17959","E01023729",2001,716,119,597,202
"17960","E01023664",2001,618,49,569,48
"17961","E01023665",2001,522,23,499,56
"17962","E01023667",2001,541,9,532,80
"17963","E01023668",2001,466,37,429,14
"17964","E01023742",2001,612,20,592,22
"17965","E01023743",2001,727,9,718,124
"17966","E01023744",2001,606,4,602,16
"17967","E01023745",2001,744,27,717,111
"17968","E01023677",2001,406,190,216,19
"17969","E01023678",2001,654,24,630,35
"17970","E01023679",2001,591,136,455,39
"17971","E01023680",2001,491,58,433,39
"17972","E01023681",2001,641,298,343,39
"17973","E01023682",2001,628,99,529,56
"17974","E01023683",2001,650,216,434,29
"17975","E01023684",2001,643,15,628,30
"17976","E01023737",2001,503,210,293,44
"17977","E01023738",2001,628,287,341,33
"17978","E01023739",2001,507,150,357,26
"17979","E01023740",2001,645,90,555,137
"17980","E01023741",2001,606,42,564,45
"17981","E01023704",2001,729,71,658,102
"17982","E01023705",2001,621,199,422,37
"17983","E01023706",2001,624,46,578,43
"17984","E01023707",2001,522,50,472,21
"17985","E01023708",2001,630,142,488,34
"17986","E01023718",2001,686,16,670,21
"17987","E01023719",2001,493,138,355,31
"17988","E01023720",2001,598,98,500,84
"17989","E01023721",2001,507,14,493,7
"17990","E01023730",2001,669,13,656,15
"17991","E01023731",2001,614,39,575,59
"17992","E01023732",2001,613,18,595,44
"17993","E01023733",2001,641,6,635,21
"17994","E01023717",2001,476,49,427,60
"17995","E01023787",2001,526,113,413,22
"17996","E01023788",2001,608,182,426,33
"17997","E01023789",2001,637,173,464,29
"17998","E01023790",2001,595,202,393,55
"17999","E01023776",2001,665,79,586,55
"18000","E01023777",2001,637,83,554,31
"18001","E01023778",2001,639,351,288,14
"18002","E01023799",2001,499,99,400,13
"18003","E01023800",2001,644,151,493,42
"18004","E01023801",2001,712,136,576,32
"18005","E01023771",2001,646,111,535,28
"18006","E01023772",2001,756,268,488,37
"18007","E01023773",2001,511,227,284,14
"18008","E01023774",2001,629,215,414,48
"18009","E01023767",2001,623,12,611,52
"18010","E01023768",2001,636,7,629,27
"18011","E01023769",2001,692,220,472,16
"18012","E01023770",2001,629,17,612,27
"18013","E01023795",2001,644,155,489,48
"18014","E01023796",2001,730,296,434,77
"18015","E01023797",2001,596,265,331,15
"18016","E01023798",2001,645,111,534,63
"18017","E01023775",2001,738,285,453,73
"18018","E01023779",2001,652,254,398,25
"18019","E01023780",2001,639,222,417,26
"18020","E01023781",2001,731,331,400,43
"18021","E01023782",2001,635,138,497,35
"18022","E01023759",2001,589,177,412,13
"18023","E01023760",2001,595,128,467,23
"18024","E01023761",2001,642,198,444,21
"18025","E01023762",2001,617,143,474,12
"18026","E01023755",2001,622,226,396,18
"18027","E01023756",2001,607,292,315,17
"18028","E01023757",2001,743,326,417,23
"18029","E01023758",2001,985,620,365,64
"18030","E01023750",2001,627,376,251,26
"18031","E01023751",2001,481,119,362,20
"18032","E01023752",2001,516,153,363,17
"18033","E01023753",2001,620,15,605,38
"18034","E01023754",2001,470,125,345,19
"18035","E01023791",2001,631,194,437,13
"18036","E01023792",2001,598,242,356,10
"18037","E01023793",2001,609,301,308,24
"18038","E01023794",2001,636,287,349,25
"18039","E01023783",2001,625,258,367,33
"18040","E01023784",2001,632,154,478,17
"18041","E01023785",2001,643,272,371,21
"18042","E01023786",2001,605,177,428,35
"18043","E01023763",2001,514,84,430,24
"18044","E01023764",2001,632,188,444,29
"18045","E01023765",2001,605,163,442,15
"18046","E01023766",2001,617,238,379,9
"18047","E01023802",2001,741,58,683,32
"18048","E01023803",2001,590,26,564,14
"18049","E01023804",2001,624,219,405,28
"18050","E01023807",2001,612,134,478,13
"18051","E01023808",2001,780,22,758,59
"18052","E01023829",2001,622,282,340,10
"18053","E01023830",2001,763,199,564,39
"18054","E01023832",2001,582,129,453,34
"18055","E01023833",2001,617,15,602,23
"18056","E01023834",2001,568,51,517,32
"18057","E01023831",2001,641,71,570,27
"18058","E01023854",2001,799,71,728,59
"18059","E01023823",2001,594,157,437,13
"18060","E01023824",2001,743,18,725,27
"18061","E01023812",2001,476,0,476,21
"18062","E01023813",2001,488,0,488,17
"18063","E01023814",2001,506,15,491,40
"18064","E01023851",2001,530,33,497,71
"18065","E01023815",2001,597,64,533,26
"18066","E01023816",2001,502,58,444,16
"18067","E01023817",2001,517,7,510,86
"18068","E01023818",2001,514,22,492,16
"18069","E01023819",2001,653,62,591,61
"18070","E01023820",2001,508,39,469,20
"18071","E01023821",2001,493,27,466,24
"18072","E01023822",2001,529,14,515,12
"18073","E01023825",2001,862,8,854,72
"18074","E01023826",2001,509,63,446,20
"18075","E01023852",2001,607,97,510,46
"18076","E01023853",2001,749,6,743,31
"18077","E01023850",2001,705,101,604,112
"18078","E01023847",2001,749,91,658,53
"18079","E01023848",2001,625,217,408,18
"18080","E01023845",2001,658,131,527,18
"18081","E01023846",2001,562,35,527,15
"18082","E01023827",2001,849,265,584,18
"18083","E01023828",2001,604,279,325,13
"18084","E01023835",2001,535,115,420,10
"18085","E01023836",2001,627,223,404,60
"18086","E01023837",2001,549,41,508,75
"18087","E01023838",2001,488,214,274,13
"18088","E01023809",2001,767,67,700,57
"18089","E01023810",2001,745,5,740,11
"18090","E01023811",2001,619,4,615,35
"18091","E01023805",2001,617,185,432,21
"18092","E01023839",2001,768,0,768,46
"18093","E01023840",2001,489,7,482,142
"18094","E01023841",2001,592,3,589,64
"18095","E01023849",2001,582,31,551,24
"18096","E01023842",2001,623,310,313,7
"18097","E01023843",2001,739,224,515,28
"18098","E01023844",2001,777,494,283,30
"18099","E01023806",2001,840,285,555,31
"18100","E01023904",2001,737,230,507,26
"18101","E01023905",2001,748,161,587,63
"18102","E01023906",2001,622,306,316,11
"18103","E01023907",2001,712,51,661,58
"18104","E01023890",2001,496,63,433,35
"18105","E01023891",2001,487,254,233,18
"18106","E01023892",2001,486,104,382,16
"18107","E01023893",2001,633,19,614,51
"18108","E01023894",2001,520,4,516,17
"18109","E01023873",2001,510,203,307,23
"18110","E01023874",2001,471,92,379,6
"18111","E01023875",2001,667,38,629,42
"18112","E01023876",2001,514,338,176,8
"18113","E01023877",2001,638,241,397,24
"18114","E01023868",2001,652,248,404,20
"18115","E01023869",2001,468,116,352,26
"18116","E01023870",2001,486,236,250,12
"18117","E01023871",2001,496,25,471,57
"18118","E01023872",2001,592,19,573,51
"18119","E01023895",2001,656,11,645,107
"18120","E01023896",2001,429,4,425,24
"18121","E01023897",2001,631,93,538,19
"18122","E01023898",2001,537,6,531,8
"18123","E01023855",2001,710,27,683,118
"18124","E01023856",2001,891,48,843,99
"18125","E01023857",2001,514,159,355,39
"18126","E01023858",2001,697,19,678,122
"18127","E01023878",2001,747,13,734,39
"18128","E01023879",2001,658,7,651,103
"18129","E01023880",2001,781,96,685,180
"18130","E01023881",2001,578,33,545,24
"18131","E01023886",2001,546,16,530,50
"18132","E01023887",2001,622,6,616,18
"18133","E01023888",2001,488,60,428,38
"18134","E01023889",2001,631,10,621,18
"18135","E01023859",2001,749,27,722,187
"18136","E01023860",2001,790,295,495,126
"18137","E01023861",2001,781,89,692,196
"18138","E01023862",2001,722,84,638,86
"18139","E01023899",2001,495,27,468,114
"18140","E01023900",2001,521,8,513,84
"18141","E01023901",2001,651,16,635,119
"18142","E01023902",2001,469,18,451,67
"18143","E01023903",2001,504,74,430,72
"18144","E01023863",2001,649,8,641,117
"18145","E01023864",2001,626,189,437,64
"18146","E01023865",2001,511,301,210,13
"18147","E01023866",2001,608,323,285,18
"18148","E01023867",2001,535,54,481,104
"18149","E01023882",2001,629,38,591,31
"18150","E01023883",2001,637,273,364,24
"18151","E01023884",2001,743,67,676,102
"18152","E01023885",2001,641,8,633,52
"18153","E01023965",2001,517,6,511,18
"18154","E01023966",2001,636,12,624,17
"18155","E01023967",2001,548,104,444,31
"18156","E01023971",2001,611,29,582,31
"18157","E01023968",2001,508,19,489,22
"18158","E01023969",2001,625,85,540,54
"18159","E01023970",2001,507,217,290,16
"18160","E01023928",2001,515,23,492,42
"18161","E01023959",2001,555,15,540,19
"18162","E01023960",2001,618,168,450,16
"18163","E01023961",2001,618,246,372,12
"18164","E01023962",2001,591,122,469,23
"18165","E01023912",2001,614,95,519,19
"18166","E01023913",2001,583,189,394,27
"18167","E01023914",2001,776,366,410,21
"18168","E01023915",2001,655,200,455,46
"18169","E01023950",2001,618,82,536,63
"18170","E01023951",2001,750,388,362,43
"18171","E01023952",2001,853,270,583,79
"18172","E01023953",2001,622,51,571,27
"18173","E01023916",2001,631,224,407,21
"18174","E01023917",2001,763,132,631,35
"18175","E01023918",2001,871,292,579,108
"18176","E01023919",2001,591,36,555,13
"18177","E01023954",2001,624,329,295,40
"18178","E01023955",2001,517,258,259,11
"18179","E01023956",2001,520,226,294,12
"18180","E01023957",2001,622,284,338,51
"18181","E01023958",2001,504,354,150,8
"18182","E01023943",2001,611,209,402,29
"18183","E01023944",2001,646,231,415,17
"18184","E01023945",2001,635,263,372,0
"18185","E01023946",2001,506,86,420,9
"18186","E01023939",2001,516,225,291,13
"18187","E01023940",2001,629,253,376,18
"18188","E01023941",2001,600,248,352,55
"18189","E01023942",2001,595,244,351,29
"18190","E01023929",2001,643,207,436,26
"18191","E01023930",2001,638,281,357,51
"18192","E01023931",2001,613,215,398,39
"18193","E01023938",2001,601,65,536,28
"18194","E01023924",2001,642,315,327,89
"18195","E01023925",2001,565,81,484,123
"18196","E01023926",2001,696,31,665,70
"18197","E01023927",2001,572,229,343,27
"18198","E01023920",2001,740,468,272,79
"18199","E01023921",2001,757,233,524,109
"18200","E01023922",2001,653,271,382,46
"18201","E01023923",2001,654,158,496,61
"18202","E01023932",2001,613,204,409,66
"18203","E01023934",2001,498,126,372,99
"18204","E01023935",2001,496,118,378,84
"18205","E01023936",2001,767,244,523,75
"18206","E01023937",2001,488,211,277,75
"18207","E01023933",2001,641,300,341,51
"18208","E01023963",2001,978,217,761,67
"18209","E01023964",2001,599,11,588,38
"18210","E01023908",2001,608,13,595,45
"18211","E01023909",2001,409,0,409,28
"18212","E01023910",2001,487,22,465,41
"18213","E01023911",2001,690,44,646,27
"18214","E01023947",2001,686,96,590,72
"18215","E01023948",2001,645,6,639,10
"18216","E01023949",2001,764,8,756,7
"18217","E01026436",2001,902,99,803,72
"18218","E01026460",2001,425,83,342,148
"18219","E01026461",2001,560,17,543,55
"18220","E01026482",2001,481,32,449,38
"18221","E01026483",2001,499,99,400,102
"18222","E01026462",2001,884,43,841,45
"18223","E01026445",2001,963,159,804,78
"18224","E01026442",2001,918,123,795,83
"18225","E01026443",2001,833,123,710,159
"18226","E01026428",2001,844,155,689,46
"18227","E01026429",2001,686,145,541,67
"18228","E01026430",2001,511,47,464,34
"18229","E01026431",2001,506,65,441,23
"18230","E01026446",2001,839,105,734,49
"18231","E01026452",2001,688,93,595,38
"18232","E01026453",2001,623,86,537,48
"18233","E01026454",2001,642,10,632,48
"18234","E01026432",2001,620,10,610,50
"18235","E01026433",2001,626,65,561,84
"18236","E01026434",2001,724,20,704,52
"18237","E01026425",2001,758,272,486,37
"18238","E01026426",2001,923,329,594,118
"18239","E01026427",2001,746,37,709,40
"18240","E01026484",2001,521,48,473,47
"18241","E01026485",2001,433,35,398,29
"18242","E01026479",2001,609,113,496,27
"18243","E01026480",2001,622,7,615,23
"18244","E01026481",2001,433,76,357,29
"18245","E01026455",2001,711,209,502,86
"18246","E01026456",2001,511,7,504,55
"18247","E01026457",2001,628,26,602,26
"18248","E01026458",2001,634,197,437,44
"18249","E01026459",2001,647,182,465,52
"18250","E01026437",2001,534,70,464,31
"18251","E01026438",2001,444,46,398,39
"18252","E01026495",2001,560,113,447,30
"18253","E01026496",2001,485,18,467,49
"18254","E01026451",2001,900,111,789,55
"18255","E01026486",2001,653,45,608,53
"18256","E01026487",2001,553,15,538,93
"18257","E01026488",2001,506,188,318,108
"18258","E01026489",2001,639,46,593,29
"18259","E01026490",2001,616,24,592,22
"18260","E01026491",2001,862,54,808,110
"18261","E01026463",2001,447,7,440,70
"18262","E01026464",2001,490,42,448,34
"18263","E01026419",2001,469,38,431,46
"18264","E01026420",2001,432,26,406,23
"18265","E01026422",2001,918,12,906,47
"18266","E01026423",2001,731,104,627,70
"18267","E01026447",2001,741,290,451,46
"18268","E01026449",2001,649,52,597,129
"18269","E01026450",2001,732,13,719,60
"18270","E01026444",2001,851,156,695,118
"18271","E01026424",2001,896,86,810,107
"18272","E01026492",2001,518,74,444,61
"18273","E01026493",2001,522,13,509,80
"18274","E01026435",2001,832,92,740,141
"18275","E01026448",2001,621,24,597,32
"18276","E01026421",2001,703,52,651,60
"18277","E01026439",2001,650,11,639,57
"18278","E01026440",2001,432,25,407,53
"18279","E01026441",2001,634,136,498,50
"18280","E01026494",2001,868,79,789,104
"18281","E01026465",2001,751,213,538,92
"18282","E01026466",2001,602,165,437,47
"18283","E01026467",2001,758,479,279,23
"18284","E01026468",2001,939,102,837,152
"18285","E01026469",2001,605,68,537,95
"18286","E01026470",2001,550,15,535,57
"18287","E01026471",2001,523,6,517,62
"18288","E01026472",2001,492,0,492,39
"18289","E01026473",2001,582,7,575,49
"18290","E01026474",2001,631,210,421,51
"18291","E01026475",2001,636,131,505,51
"18292","E01026476",2001,580,216,364,32
"18293","E01026477",2001,619,287,332,17
"18294","E01026478",2001,607,230,377,48
"18295","E01026499",2001,690,221,469,63
"18296","E01026500",2001,625,41,584,41
"18297","E01026501",2001,643,57,586,54
"18298","E01026502",2001,403,39,364,53
"18299","E01026503",2001,614,21,593,59
"18300","E01026522",2001,529,73,456,70
"18301","E01026523",2001,650,108,542,104
"18302","E01026524",2001,547,47,500,50
"18303","E01026525",2001,405,32,373,62
"18304","E01026547",2001,595,78,517,110
"18305","E01026548",2001,467,3,464,47
"18306","E01026514",2001,599,68,531,124
"18307","E01026515",2001,421,13,408,40
"18308","E01026516",2001,516,112,404,47
"18309","E01026517",2001,567,13,554,72
"18310","E01026533",2001,492,29,463,27
"18311","E01026534",2001,561,34,527,44
"18312","E01026535",2001,648,30,618,88
"18313","E01026536",2001,576,54,522,46
"18314","E01026537",2001,563,31,532,23
"18315","E01026549",2001,771,133,638,47
"18316","E01026550",2001,434,10,424,30
"18317","E01026551",2001,495,8,487,29
"18318","E01026552",2001,589,3,586,10
"18319","E01026562",2001,445,8,437,19
"18320","E01026563",2001,546,73,473,47
"18321","E01026564",2001,572,33,539,32
"18322","E01026565",2001,513,52,461,54
"18323","E01026566",2001,631,40,591,35
"18324","E01026567",2001,736,0,736,24
"18325","E01026568",2001,602,0,602,18
"18326","E01026518",2001,528,81,447,34
"18327","E01026519",2001,711,37,674,51
"18328","E01026520",2001,492,65,427,27
"18329","E01026521",2001,475,6,469,30
"18330","E01026578",2001,622,20,602,33
"18331","E01026579",2001,602,44,558,35
"18332","E01026580",2001,707,72,635,61
"18333","E01026545",2001,407,46,361,22
"18334","E01026546",2001,566,0,566,24
"18335","E01026540",2001,639,3,636,25
"18336","E01026541",2001,725,231,494,67
"18337","E01026542",2001,626,4,622,22
"18338","E01026543",2001,627,6,621,54
"18339","E01026544",2001,612,23,589,29
"18340","E01026526",2001,640,86,554,15
"18341","E01026527",2001,672,5,667,20
"18342","E01026528",2001,597,65,532,15
"18343","E01026529",2001,688,87,601,38
"18344","E01026530",2001,735,21,714,63
"18345","E01026531",2001,758,5,753,20
"18346","E01026532",2001,737,38,699,28
"18347","E01026553",2001,600,125,475,21
"18348","E01026554",2001,485,6,479,17
"18349","E01026555",2001,602,93,509,15
"18350","E01026556",2001,626,94,532,54
"18351","E01026557",2001,623,11,612,64
"18352","E01026558",2001,612,6,606,38
"18353","E01026559",2001,611,18,593,37
"18354","E01026560",2001,632,6,626,22
"18355","E01026561",2001,591,9,582,11
"18356","E01026512",2001,508,114,394,27
"18357","E01026513",2001,541,28,513,15
"18358","E01026504",2001,590,41,549,85
"18359","E01026505",2001,524,162,362,24
"18360","E01026506",2001,572,7,565,14
"18361","E01026507",2001,545,14,531,19
"18362","E01026569",2001,730,181,549,31
"18363","E01026570",2001,728,14,714,23
"18364","E01026571",2001,635,3,632,22
"18365","E01026572",2001,631,3,628,17
"18366","E01026573",2001,601,150,451,24
"18367","E01026574",2001,676,7,669,33
"18368","E01026575",2001,612,105,507,36
"18369","E01026576",2001,684,41,643,45
"18370","E01026577",2001,735,61,674,114
"18371","E01026508",2001,623,80,543,28
"18372","E01026509",2001,631,6,625,36
"18373","E01026510",2001,639,11,628,45
"18374","E01026511",2001,438,72,366,36
"18375","E01026497",2001,641,13,628,49
"18376","E01026498",2001,573,112,461,50
"18377","E01026538",2001,539,80,459,50
"18378","E01026539",2001,597,54,543,39
"18379","E01026605",2001,621,14,607,31
"18380","E01026606",2001,679,66,613,34
"18381","E01026607",2001,603,51,552,55
"18382","E01026627",2001,609,4,605,18
"18383","E01026628",2001,577,40,537,34
"18384","E01026629",2001,624,48,576,38
"18385","E01026608",2001,507,30,477,37
"18386","E01026609",2001,461,82,379,51
"18387","E01026636",2001,663,72,591,52
"18388","E01026637",2001,665,7,658,50
"18389","E01026638",2001,601,114,487,31
"18390","E01026589",2001,624,59,565,47
"18391","E01026590",2001,664,7,657,58
"18392","E01026591",2001,741,10,731,53
"18393","E01026592",2001,739,170,569,36
"18394","E01026593",2001,588,7,581,42
"18395","E01026594",2001,699,31,668,55
"18396","E01026599",2001,525,9,516,105
"18397","E01026639",2001,616,15,601,84
"18398","E01026640",2001,734,156,578,26
"18399","E01026641",2001,621,384,237,13
"18400","E01026595",2001,723,233,490,94
"18401","E01026596",2001,618,52,566,72
"18402","E01026597",2001,764,283,481,192
"18403","E01026598",2001,659,86,573,185
"18404","E01026622",2001,621,356,265,55
"18405","E01026623",2001,651,63,588,213
"18406","E01026624",2001,728,112,616,195
"18407","E01026625",2001,775,588,187,43
"18408","E01026626",2001,623,81,542,173
"18409","E01026600",2001,628,230,398,37
"18410","E01026633",2001,620,33,587,153
"18411","E01026634",2001,608,36,572,112
"18412","E01026635",2001,739,224,515,140
"18413","E01026581",2001,631,15,616,17
"18414","E01026582",2001,720,6,714,23
"18415","E01026583",2001,573,108,465,22
"18416","E01026584",2001,685,6,679,10
"18417","E01026632",2001,726,101,625,75
"18418","E01026601",2001,630,49,581,74
"18419","E01026602",2001,717,140,577,37
"18420","E01026603",2001,755,466,289,21
"18421","E01026604",2001,724,412,312,23
"18422","E01026630",2001,638,145,493,81
"18423","E01026631",2001,742,33,709,141
"18424","E01026610",2001,635,10,625,112
"18425","E01026611",2001,622,28,594,69
"18426","E01026612",2001,718,67,651,27
"18427","E01026617",2001,619,221,398,40
"18428","E01026618",2001,612,179,433,22
"18429","E01026619",2001,608,360,248,13
"18430","E01026620",2001,646,381,265,16
"18431","E01026621",2001,576,173,403,14
"18432","E01026613",2001,577,19,558,40
"18433","E01026614",2001,569,82,487,41
"18434","E01026615",2001,559,0,559,17
"18435","E01026616",2001,496,32,464,16
"18436","E01026585",2001,594,84,510,20
"18437","E01026586",2001,497,165,332,15
"18438","E01026587",2001,643,14,629,28
"18439","E01026588",2001,966,38,928,72
"18440","E01026680",2001,802,205,597,28
"18441","E01026681",2001,705,56,649,116
"18442","E01026682",2001,625,68,557,59
"18443","E01026683",2001,635,22,613,165
"18444","E01026695",2001,1003,147,856,157
"18445","E01026656",2001,805,138,667,112
"18446","E01026645",2001,759,85,674,142
"18447","E01026646",2001,966,148,818,142
"18448","E01026676",2001,740,5,735,54
"18449","E01026677",2001,739,208,531,42
"18450","E01026678",2001,745,11,734,48
"18451","E01026701",2001,627,12,615,42
"18452","E01026702",2001,613,97,516,51
"18453","E01026703",2001,485,44,441,93
"18454","E01026718",2001,943,113,830,213
"18455","E01026653",2001,730,3,727,37
"18456","E01026654",2001,732,196,536,47
"18457","E01026655",2001,650,14,636,57
"18458","E01026691",2001,416,31,385,18
"18459","E01026692",2001,521,11,510,33
"18460","E01026708",2001,482,3,479,19
"18461","E01026709",2001,595,3,592,9
"18462","E01026710",2001,489,7,482,42
"18463","E01026669",2001,645,7,638,24
"18464","E01026670",2001,602,177,425,34
"18465","E01026671",2001,528,0,528,13
"18466","E01026672",2001,622,9,613,40
"18467","E01026673",2001,621,14,607,43
"18468","E01026687",2001,663,413,250,16
"18469","E01026688",2001,521,273,248,30
"18470","E01026689",2001,626,70,556,151
"18471","E01026690",2001,616,330,286,35
"18472","E01026711",2001,603,169,434,48
"18473","E01026712",2001,639,68,571,32
"18474","E01026713",2001,579,30,549,36
"18475","E01026647",2001,912,81,831,32
"18476","E01026693",2001,787,93,694,41
"18477","E01026666",2001,727,373,354,38
"18478","E01026667",2001,657,36,621,97
"18479","E01026668",2001,608,34,574,92
"18480","E01026714",2001,774,19,755,41
"18481","E01026662",2001,622,312,310,57
"18482","E01026663",2001,704,353,351,29
"18483","E01026664",2001,864,114,750,83
"18484","E01026704",2001,609,316,293,41
"18485","E01026705",2001,497,44,453,26
"18486","E01026706",2001,610,74,536,82
"18487","E01026698",2001,904,170,734,185
"18488","E01026699",2001,849,430,419,202
"18489","E01026700",2001,612,161,451,136
"18490","E01026694",2001,1000,180,820,152
"18491","E01026674",2001,473,28,445,17
"18492","E01026675",2001,492,39,453,23
"18493","E01026665",2001,920,142,778,90
"18494","E01026684",2001,457,41,416,47
"18495","E01026685",2001,552,79,473,15
"18496","E01026719",2001,838,95,743,46
"18497","E01026720",2001,500,34,466,23
"18498","E01026721",2001,511,78,433,33
"18499","E01026723",2001,627,9,618,19
"18500","E01026724",2001,664,71,593,31
"18501","E01026725",2001,621,72,549,39
"18502","E01026642",2001,519,33,486,62
"18503","E01026643",2001,594,30,564,100
"18504","E01026644",2001,512,90,422,365
"18505","E01026726",2001,755,104,651,54
"18506","E01026722",2001,855,68,787,65
"18507","E01026696",2001,435,78,357,18
"18508","E01026697",2001,533,24,509,53
"18509","E01026715",2001,534,29,505,42
"18510","E01026716",2001,715,141,574,48
"18511","E01026717",2001,531,91,440,44
"18512","E01026659",2001,559,101,458,36
"18513","E01026660",2001,635,61,574,30
"18514","E01026661",2001,586,36,550,42
"18515","E01026657",2001,912,195,717,124
"18516","E01026658",2001,601,100,501,34
"18517","E01026686",2001,786,11,775,40
"18518","E01026707",2001,955,58,897,28
"18519","E01026727",2001,1004,99,905,110
"18520","E01026728",2001,866,114,752,81
"18521","E01026679",2001,917,144,773,111
"18522","E01026648",2001,622,78,544,92
"18523","E01026649",2001,613,61,552,77
"18524","E01026650",2001,402,11,391,73
"18525","E01026651",2001,939,111,828,103
"18526","E01026652",2001,473,79,394,33
"18527","E01026770",2001,1003,49,954,237
"18528","E01026771",2001,747,142,605,63
"18529","E01026772",2001,717,20,697,80
"18530","E01026773",2001,868,105,763,49
"18531","E01026763",2001,658,214,444,105
"18532","E01026764",2001,723,90,633,96
"18533","E01026765",2001,585,84,501,59
"18534","E01026739",2001,1006,149,857,127
"18535","E01026777",2001,529,66,463,15
"18536","E01026778",2001,679,88,591,75
"18537","E01026779",2001,535,148,387,34
"18538","E01026734",2001,640,29,611,255
"18539","E01026735",2001,675,40,635,218
"18540","E01026736",2001,607,158,449,50
"18541","E01026741",2001,852,99,753,60
"18542","E01026742",2001,649,8,641,38
"18543","E01026743",2001,1019,301,718,93
"18544","E01026781",2001,963,62,901,103
"18545","E01026766",2001,887,88,799,61
"18546","E01026762",2001,1000,70,930,115
"18547","E01026737",2001,931,105,826,124
"18548","E01026731",2001,493,43,450,28
"18549","E01026732",2001,532,61,471,102
"18550","E01026733",2001,965,148,817,127
"18551","E01026738",2001,962,129,833,68
"18552","E01026750",2001,635,140,495,92
"18553","E01026751",2001,631,62,569,69
"18554","E01026752",2001,578,61,517,54
"18555","E01026788",2001,534,74,460,52
"18556","E01026729",2001,876,73,803,143
"18557","E01026730",2001,877,134,743,66
"18558","E01026782",2001,996,200,796,195
"18559","E01026780",2001,994,81,913,127
"18560","E01026787",2001,416,55,361,65
"18561","E01026753",2001,686,273,413,55
"18562","E01026754",2001,607,64,543,46
"18563","E01026755",2001,549,40,509,12
"18564","E01026756",2001,502,169,333,26
"18565","E01026757",2001,616,8,608,41
"18566","E01026758",2001,651,22,629,84
"18567","E01026759",2001,507,148,359,8
"18568","E01026760",2001,491,34,457,61
"18569","E01026761",2001,638,64,574,73
"18570","E01026745",2001,729,159,570,28
"18571","E01026746",2001,743,31,712,77
"18572","E01026747",2001,626,187,439,84
"18573","E01026748",2001,592,9,583,24
"18574","E01026749",2001,600,173,427,32
"18575","E01026767",2001,505,68,437,55
"18576","E01026768",2001,464,75,389,273
"18577","E01026789",2001,473,40,433,45
"18578","E01026790",2001,449,75,374,52
"18579","E01026740",2001,1004,80,924,139
"18580","E01026786",2001,856,61,795,107
"18581","E01026774",2001,614,49,565,48
"18582","E01026775",2001,565,208,357,36
"18583","E01026776",2001,643,19,624,111
"18584","E01026769",2001,917,119,798,68
"18585","E01026783",2001,761,68,693,45
"18586","E01026784",2001,478,158,320,34
"18587","E01026785",2001,525,63,462,33
"18588","E01026744",2001,949,147,802,83
"18589","E01026797",2001,707,169,538,216
"18590","E01026798",2001,652,393,259,51
"18591","E01026799",2001,591,306,285,21
"18592","E01026800",2001,782,453,329,61
"18593","E01026801",2001,650,45,605,25
"18594","E01026802",2001,780,164,616,86
"18595","E01026828",2001,609,372,237,15
"18596","E01026829",2001,625,293,332,64
"18597","E01026830",2001,648,318,330,73
"18598","E01026831",2001,586,71,515,138
"18599","E01026832",2001,510,327,183,9
"18600","E01026833",2001,657,512,145,17
"18601","E01026834",2001,632,349,283,34
"18602","E01026841",2001,702,42,660,191
"18603","E01026842",2001,766,46,720,175
"18604","E01026843",2001,874,338,536,125
"18605","E01026844",2001,744,339,405,62
"18606","E01026845",2001,759,28,731,214
"18607","E01026846",2001,800,76,724,218
"18608","E01026803",2001,610,274,336,12
"18609","E01026804",2001,632,167,465,17
"18610","E01026805",2001,650,318,332,15
"18611","E01026806",2001,507,14,493,21
"18612","E01026807",2001,529,129,400,61
"18613","E01026808",2001,504,379,125,9
"18614","E01026809",2001,729,438,291,22
"18615","E01026791",2001,662,357,305,50
"18616","E01026792",2001,619,220,399,39
"18617","E01026793",2001,624,385,239,30
"18618","E01026794",2001,643,259,384,16
"18619","E01026795",2001,684,415,269,32
"18620","E01026796",2001,634,314,320,47
"18621","E01026863",2001,640,114,526,95
"18622","E01026864",2001,612,151,461,29
"18623","E01026865",2001,608,412,196,60
"18624","E01026866",2001,735,171,564,131
"18625","E01026867",2001,519,315,204,19
"18626","E01026868",2001,494,304,190,36
"18627","E01026869",2001,657,465,192,7
"18628","E01026822",2001,862,450,412,170
"18629","E01026823",2001,895,249,646,292
"18630","E01026824",2001,885,552,333,101
"18631","E01026825",2001,598,214,384,105
"18632","E01026826",2001,826,513,313,120
"18633","E01026827",2001,917,670,247,57
"18634","E01026847",2001,1016,416,600,227
"18635","E01026848",2001,1000,733,267,52
"18636","E01026849",2001,837,43,794,233
"18637","E01026850",2001,863,141,722,154
"18638","E01026851",2001,804,108,696,341
"18639","E01026835",2001,658,48,610,262
"18640","E01026836",2001,616,20,596,155
"18641","E01026837",2001,729,113,616,234
"18642","E01026838",2001,651,10,641,153
"18643","E01026839",2001,663,17,646,259
"18644","E01026840",2001,735,41,694,157
"18645","E01026858",2001,707,408,299,37
"18646","E01026859",2001,474,151,323,35
"18647","E01026860",2001,494,157,337,45
"18648","E01026861",2001,533,274,259,37
"18649","E01026862",2001,482,209,273,24
"18650","E01026852",2001,595,13,582,77
"18651","E01026853",2001,934,511,423,97
"18652","E01026854",2001,869,609,260,67
"18653","E01026855",2001,714,58,656,203
"18654","E01026856",2001,872,93,779,316
"18655","E01026857",2001,742,159,583,124
"18656","E01026810",2001,638,111,527,45
"18657","E01026811",2001,725,43,682,38
"18658","E01026812",2001,630,18,612,48
"18659","E01026813",2001,646,16,630,12
"18660","E01026814",2001,660,306,354,43
"18661","E01026815",2001,620,11,609,95
"18662","E01026816",2001,910,225,685,188
"18663","E01026817",2001,664,266,398,35
"18664","E01026818",2001,637,355,282,15
"18665","E01026819",2001,608,396,212,24
"18666","E01026820",2001,757,419,338,20
"18667","E01026821",2001,717,381,336,11
"18668","E01026916",2001,860,5,855,26
"18669","E01026917",2001,623,76,547,29
"18670","E01026918",2001,757,16,741,67
"18671","E01026923",2001,647,139,508,18
"18672","E01026924",2001,663,124,539,19
"18673","E01026925",2001,700,325,375,29
"18674","E01026895",2001,448,35,413,21
"18675","E01026896",2001,449,41,408,36
"18676","E01026881",2001,504,21,483,95
"18677","E01026882",2001,617,3,614,25
"18678","E01026883",2001,576,74,502,37
"18679","E01026905",2001,512,210,302,8
"18680","E01026906",2001,590,23,567,10
"18681","E01026907",2001,634,30,604,32
"18682","E01026908",2001,585,14,571,81
"18683","E01026909",2001,618,157,461,48
"18684","E01026910",2001,535,16,519,31
"18685","E01026947",2001,475,54,421,63
"18686","E01026948",2001,457,18,439,31
"18687","E01026921",2001,630,12,618,59
"18688","E01026922",2001,640,179,461,34
"18689","E01026870",2001,785,167,618,156
"18690","E01026871",2001,564,18,546,30
"18691","E01026875",2001,419,10,409,32
"18692","E01026876",2001,631,85,546,40
"18693","E01026936",2001,605,68,537,26
"18694","E01026937",2001,476,51,425,83
"18695","E01026926",2001,638,22,616,72
"18696","E01026927",2001,650,8,642,24
"18697","E01026928",2001,533,130,403,21
"18698","E01026933",2001,860,49,811,74
"18699","E01026945",2001,602,63,539,21
"18700","E01026946",2001,482,25,457,18
"18701","E01026884",2001,453,99,354,27
"18702","E01026885",2001,459,37,422,41
"18703","E01026879",2001,453,97,356,25
"18704","E01026880",2001,571,25,546,30
"18705","E01026911",2001,518,167,351,39
"18706","E01026912",2001,629,39,590,43
"18707","E01026929",2001,526,29,497,44
"18708","E01026930",2001,590,54,536,39
"18709","E01026941",2001,486,33,453,36
"18710","E01026942",2001,413,13,400,25
"18711","E01026913",2001,591,124,467,22
"18712","E01026914",2001,574,26,548,70
"18713","E01026915",2001,572,34,538,21
"18714","E01026919",2001,529,104,425,24
"18715","E01026920",2001,436,43,393,20
"18716","E01026898",2001,585,77,508,51
"18717","E01026899",2001,592,26,566,100
"18718","E01026943",2001,610,61,549,52
"18719","E01026944",2001,438,30,408,35
"18720","E01026938",2001,649,19,630,42
"18721","E01026939",2001,620,19,601,31
"18722","E01026940",2001,639,184,455,30
"18723","E01026897",2001,965,61,904,56
"18724","E01026877",2001,562,39,523,32
"18725","E01026878",2001,417,67,350,21
"18726","E01026903",2001,465,19,446,26
"18727","E01026904",2001,538,84,454,36
"18728","E01026892",2001,551,75,476,82
"18729","E01026893",2001,439,14,425,30
"18730","E01026894",2001,984,126,858,73
"18731","E01026900",2001,597,87,510,25
"18732","E01026901",2001,552,12,540,64
"18733","E01026902",2001,695,134,561,80
"18734","E01026872",2001,930,135,795,99
"18735","E01026873",2001,480,43,437,39
"18736","E01026874",2001,525,69,456,42
"18737","E01026886",2001,508,44,464,26
"18738","E01026887",2001,563,53,510,66
"18739","E01026934",2001,447,43,404,28
"18740","E01026935",2001,509,30,479,71
"18741","E01026931",2001,455,3,452,18
"18742","E01026932",2001,500,39,461,39
"18743","E01026888",2001,764,271,493,39
"18744","E01026889",2001,707,21,686,87
"18745","E01026890",2001,979,63,916,133
"18746","E01026891",2001,759,179,580,102
"18747","E01029876",2001,825,138,687,72
"18748","E01029898",2001,868,177,691,70
"18749","E01029907",2001,895,115,780,82
"18750","E01029881",2001,789,64,725,74
"18751","E01029884",2001,611,101,510,62
"18752","E01029885",2001,870,25,845,61
"18753","E01029900",2001,719,233,486,19
"18754","E01029901",2001,932,26,906,139
"18755","E01029917",2001,632,69,563,15
"18756","E01029911",2001,868,83,785,75
"18757","E01029892",2001,820,269,551,86
"18758","E01029893",2001,645,55,590,25
"18759","E01029894",2001,503,23,480,37
"18760","E01029895",2001,476,13,463,21
"18761","E01029896",2001,597,182,415,38
"18762","E01029877",2001,484,25,459,53
"18763","E01029878",2001,482,24,458,54
"18764","E01029879",2001,625,71,554,65
"18765","E01029908",2001,503,3,500,15
"18766","E01029909",2001,740,11,729,76
"18767","E01029910",2001,520,228,292,23
"18768","E01029921",2001,530,27,503,21
"18769","E01029922",2001,530,119,411,34
"18770","E01029923",2001,551,15,536,28
"18771","E01029880",2001,729,76,653,54
"18772","E01029912",2001,709,210,499,57
"18773","E01029913",2001,510,12,498,25
"18774","E01029914",2001,593,185,408,39
"18775","E01029915",2001,507,69,438,37
"18776","E01029916",2001,503,231,272,22
"18777","E01029918",2001,526,117,409,80
"18778","E01029919",2001,626,37,589,70
"18779","E01029920",2001,770,199,571,156
"18780","E01029886",2001,487,137,350,22
"18781","E01029887",2001,612,3,609,47
"18782","E01029888",2001,475,161,314,19
"18783","E01029889",2001,492,206,286,23
"18784","E01029890",2001,474,12,462,17
"18785","E01029891",2001,558,10,548,50
"18786","E01029899",2001,738,35,703,28
"18787","E01029902",2001,847,58,789,70
"18788","E01029875",2001,880,82,798,64
"18789","E01029906",2001,791,99,692,74
"18790","E01029903",2001,553,6,547,20
"18791","E01029904",2001,605,29,576,32
"18792","E01029905",2001,442,23,419,38
"18793","E01029882",2001,616,106,510,38
"18794","E01029883",2001,828,24,804,70
"18795","E01029872",2001,578,19,559,32
"18796","E01029870",2001,465,77,388,31
"18797","E01029871",2001,540,50,490,47
"18798","E01029873",2001,942,117,825,106
"18799","E01029874",2001,730,10,720,80
"18800","E01029897",2001,759,69,690,79
"18801","E01029926",2001,744,8,736,57
"18802","E01029927",2001,1014,309,705,171
"18803","E01029928",2001,673,26,647,158
"18804","E01029929",2001,966,251,715,124
"18805","E01029930",2001,633,12,621,90
"18806","E01029935",2001,450,18,432,119
"18807","E01029936",2001,456,24,432,96
"18808","E01029942",2001,615,14,601,102
"18809","E01029943",2001,639,111,528,131
"18810","E01029944",2001,646,63,583,78
"18811","E01029945",2001,703,70,633,87
"18812","E01029931",2001,422,6,416,138
"18813","E01029932",2001,585,42,543,153
"18814","E01029933",2001,585,42,543,203
"18815","E01029934",2001,631,38,593,112
"18816","E01029946",2001,729,213,516,110
"18817","E01029947",2001,924,95,829,185
"18818","E01029938",2001,530,240,290,62
"18819","E01029939",2001,658,24,634,95
"18820","E01029940",2001,618,235,383,52
"18821","E01029941",2001,741,104,637,155
"18822","E01029948",2001,765,15,750,161
"18823","E01029957",2001,714,44,670,105
"18824","E01029953",2001,598,123,475,50
"18825","E01029954",2001,758,222,536,100
"18826","E01029955",2001,788,124,664,74
"18827","E01029956",2001,514,9,505,80
"18828","E01029937",2001,832,114,718,110
"18829","E01029924",2001,865,150,715,161
"18830","E01029925",2001,768,53,715,158
"18831","E01029949",2001,602,191,411,45
"18832","E01029950",2001,731,335,396,71
"18833","E01029951",2001,623,31,592,60
"18834","E01029952",2001,510,47,463,40
"18835","E01030032",2001,505,317,188,13
"18836","E01030033",2001,636,7,629,30
"18837","E01030034",2001,626,3,623,14
"18838","E01030035",2001,599,302,297,16
"18839","E01030036",2001,758,400,358,11
"18840","E01029973",2001,633,6,627,24
"18841","E01029974",2001,604,5,599,32
"18842","E01029975",2001,516,104,412,16
"18843","E01029976",2001,627,70,557,28
"18844","E01029977",2001,638,9,629,25
"18845","E01030027",2001,642,59,583,85
"18846","E01030028",2001,588,132,456,20
"18847","E01030029",2001,616,222,394,32
"18848","E01030030",2001,622,111,511,81
"18849","E01030031",2001,650,358,292,12
"18850","E01029997",2001,624,93,531,28
"18851","E01029998",2001,736,298,438,30
"18852","E01029999",2001,611,23,588,34
"18853","E01030000",2001,634,24,610,72
"18854","E01030001",2001,646,175,471,17
"18855","E01030007",2001,641,8,633,155
"18856","E01030008",2001,501,12,489,54
"18857","E01030009",2001,578,9,569,100
"18858","E01030010",2001,854,147,707,265
"18859","E01030011",2001,626,54,572,12
"18860","E01030022",2001,723,55,668,172
"18861","E01030023",2001,674,93,581,180
"18862","E01030024",2001,861,346,515,232
"18863","E01030025",2001,755,117,638,226
"18864","E01030026",2001,604,23,581,132
"18865","E01029958",2001,615,62,553,103
"18866","E01029959",2001,885,416,469,250
"18867","E01029960",2001,739,53,686,132
"18868","E01029961",2001,574,22,552,106
"18869","E01029962",2001,632,25,607,159
"18870","E01030002",2001,745,92,653,107
"18871","E01030003",2001,639,23,616,91
"18872","E01030004",2001,478,3,475,26
"18873","E01030005",2001,633,34,599,80
"18874","E01030006",2001,722,152,570,83
"18875","E01029963",2001,642,3,639,11
"18876","E01029964",2001,502,15,487,53
"18877","E01029965",2001,600,3,597,24
"18878","E01029966",2001,743,75,668,211
"18879","E01029967",2001,614,0,614,10
"18880","E01029984",2001,603,214,389,49
"18881","E01029985",2001,606,121,485,96
"18882","E01029986",2001,640,357,283,15
"18883","E01029987",2001,630,308,322,12
"18884","E01029988",2001,770,295,475,194
"18885","E01029989",2001,651,97,554,152
"18886","E01029990",2001,640,9,631,114
"18887","E01029991",2001,636,5,631,27
"18888","E01029992",2001,517,18,499,60
"18889","E01029968",2001,650,89,561,117
"18890","E01029969",2001,495,55,440,72
"18891","E01029970",2001,614,142,472,32
"18892","E01029971",2001,594,311,283,13
"18893","E01029972",2001,801,282,519,223
"18894","E01030012",2001,617,325,292,11
"18895","E01030013",2001,601,258,343,18
"18896","E01030014",2001,604,235,369,10
"18897","E01030015",2001,517,3,514,26
"18898","E01030016",2001,616,83,533,126
"18899","E01029993",2001,635,264,371,20
"18900","E01029994",2001,615,381,234,12
"18901","E01029995",2001,622,6,616,43
"18902","E01029996",2001,609,191,418,32
"18903","E01030017",2001,616,263,353,16
"18904","E01030018",2001,633,405,228,16
"18905","E01030019",2001,618,45,573,37
"18906","E01030020",2001,606,66,540,25
"18907","E01030021",2001,619,369,250,14
"18908","E01029978",2001,530,98,432,40
"18909","E01029979",2001,624,377,247,24
"18910","E01029980",2001,621,395,226,15
"18911","E01029981",2001,506,32,474,21
"18912","E01029982",2001,495,277,218,11
"18913","E01029983",2001,619,12,607,71
"18914","E01030052",2001,870,180,690,83
"18915","E01030058",2001,811,82,729,90
"18916","E01030064",2001,791,66,725,51
"18917","E01030088",2001,427,46,381,30
"18918","E01030066",2001,598,104,494,37
"18919","E01030067",2001,530,11,519,62
"18920","E01030068",2001,635,95,540,67
"18921","E01030054",2001,426,22,404,38
"18922","E01030055",2001,479,36,443,28
"18923","E01030039",2001,501,52,449,46
"18924","E01030053",2001,907,121,786,99
"18925","E01030090",2001,889,72,817,118
"18926","E01030082",2001,1003,164,839,98
"18927","E01030084",2001,622,6,616,30
"18928","E01030085",2001,652,56,596,66
"18929","E01030049",2001,553,68,485,40
"18930","E01030050",2001,649,3,646,49
"18931","E01030040",2001,468,63,405,52
"18932","E01030037",2001,437,45,392,38
"18933","E01030038",2001,480,21,459,44
"18934","E01030059",2001,888,117,771,73
"18935","E01030081",2001,905,123,782,62
"18936","E01030056",2001,843,180,663,50
"18937","E01030051",2001,627,160,467,16
"18938","E01030086",2001,434,60,374,26
"18939","E01030089",2001,802,113,689,29
"18940","E01030065",2001,768,99,669,51
"18941","E01030048",2001,878,118,760,70
"18942","E01030087",2001,472,43,429,41
"18943","E01030083",2001,854,57,797,56
"18944","E01030057",2001,806,52,754,137
"18945","E01030079",2001,622,296,326,17
"18946","E01030080",2001,650,83,567,18
"18947","E01030073",2001,743,176,567,22
"18948","E01030077",2001,607,253,354,30
"18949","E01030075",2001,524,0,524,18
"18950","E01030072",2001,673,55,618,67
"18951","E01030063",2001,803,108,695,42
"18952","E01030069",2001,487,19,468,32
"18953","E01030071",2001,624,36,588,66
"18954","E01030074",2001,639,19,620,72
"18955","E01030076",2001,589,87,502,80
"18956","E01030078",2001,718,8,710,53
"18957","E01030060",2001,661,67,594,51
"18958","E01030061",2001,742,169,573,78
"18959","E01030062",2001,618,10,608,55
"18960","E01030043",2001,486,20,466,38
"18961","E01030041",2001,829,84,745,58
"18962","E01030070",2001,455,39,416,228
"18963","E01030042",2001,634,8,626,39
"18964","E01030044",2001,552,114,438,35
"18965","E01030045",2001,610,6,604,30
"18966","E01030046",2001,563,38,525,51
"18967","E01030047",2001,547,103,444,30
"18968","E01030095",2001,450,48,402,49
"18969","E01030096",2001,566,49,517,31
"18970","E01030097",2001,463,99,364,30
"18971","E01030145",2001,582,29,553,32
"18972","E01030146",2001,498,99,399,70
"18973","E01030094",2001,519,83,436,122
"18974","E01030121",2001,816,131,685,74
"18975","E01030132",2001,409,38,371,250
"18976","E01030133",2001,577,88,489,177
"18977","E01030130",2001,514,120,394,28
"18978","E01030131",2001,497,313,184,9
"18979","E01030139",2001,758,445,313,41
"18980","E01030140",2001,502,152,350,18
"18981","E01030141",2001,631,206,425,23
"18982","E01030103",2001,847,111,736,50
"18983","E01030104",2001,852,56,796,40
"18984","E01030138",2001,900,114,786,110
"18985","E01030126",2001,451,43,408,36
"18986","E01030127",2001,514,3,511,67
"18987","E01030128",2001,570,8,562,59
"18988","E01030129",2001,581,6,575,41
"18989","E01030093",2001,730,118,612,139
"18990","E01030136",2001,1335,369,966,197
"18991","E01030137",2001,509,20,489,70
"18992","E01030091",2001,725,84,641,216
"18993","E01030092",2001,739,121,618,107
"18994","E01030148",2001,503,6,497,45
"18995","E01030149",2001,622,10,612,30
"18996","E01030123",2001,627,243,384,14
"18997","E01030124",2001,710,7,703,62
"18998","E01030125",2001,616,167,449,17
"18999","E01030119",2001,886,93,793,63
"19000","E01030134",2001,432,93,339,62
"19001","E01030135",2001,519,13,506,64
"19002","E01030100",2001,857,86,771,63
"19003","E01030098",2001,845,89,756,80
"19004","E01030102",2001,1073,269,804,168
"19005","E01030147",2001,637,10,627,36
"19006","E01030142",2001,623,10,613,21
"19007","E01030143",2001,618,165,453,45
"19008","E01030144",2001,518,42,476,72
"19009","E01030150",2001,831,124,707,59
"19010","E01030101",2001,873,152,721,78
"19011","E01030099",2001,787,74,713,71
"19012","E01030120",2001,882,75,807,69
"19013","E01030122",2001,766,53,713,45
"19014","E01030151",2001,794,50,744,124
"19015","E01030109",2001,722,323,399,19
"19016","E01030110",2001,742,295,447,29
"19017","E01030111",2001,527,3,524,12
"19018","E01030112",2001,641,75,566,60
"19019","E01030115",2001,617,267,350,23
"19020","E01030116",2001,656,0,656,35
"19021","E01030117",2001,597,32,565,29
"19022","E01030118",2001,594,201,393,25
"19023","E01030113",2001,747,163,584,50
"19024","E01030114",2001,523,257,266,17
"19025","E01030105",2001,627,129,498,56
"19026","E01030106",2001,754,293,461,43
"19027","E01030107",2001,627,3,624,13
"19028","E01030108",2001,651,178,473,23
"19029","E01030201",2001,862,86,776,92
"19030","E01030222",2001,868,68,800,89
"19031","E01030219",2001,919,97,822,85
"19032","E01030176",2001,817,82,735,145
"19033","E01030172",2001,608,28,580,66
"19034","E01030173",2001,665,161,504,69
"19035","E01030174",2001,517,56,461,71
"19036","E01030154",2001,838,75,763,102
"19037","E01030186",2001,594,90,504,38
"19038","E01030208",2001,562,124,438,58
"19039","E01030209",2001,727,55,672,96
"19040","E01030210",2001,476,281,195,25
"19041","E01030212",2001,829,68,761,119
"19042","E01030187",2001,644,191,453,54
"19043","E01030188",2001,753,83,670,187
"19044","E01030189",2001,647,182,465,50
"19045","E01030152",2001,1050,86,964,89
"19046","E01030153",2001,762,147,615,114
"19047","E01030193",2001,595,51,544,50
"19048","E01030194",2001,742,194,548,47
"19049","E01030195",2001,647,3,644,27
"19050","E01030220",2001,953,221,732,77
"19051","E01030221",2001,806,64,742,54
"19052","E01030200",2001,856,89,767,84
"19053","E01030175",2001,927,98,829,78
"19054","E01030199",2001,829,85,744,144
"19055","E01030202",2001,791,39,752,412
"19056","E01030213",2001,894,97,797,326
"19057","E01030177",2001,421,51,370,23
"19058","E01030178",2001,433,23,410,94
"19059","E01030211",2001,981,103,878,172
"19060","E01030203",2001,857,77,780,53
"19061","E01030185",2001,855,239,616,45
"19062","E01030155",2001,827,94,733,61
"19063","E01030179",2001,611,84,527,28
"19064","E01030180",2001,545,6,539,36
"19065","E01030183",2001,876,5,871,27
"19066","E01030184",2001,726,128,598,26
"19067","E01030207",2001,668,45,623,35
"19068","E01030181",2001,515,11,504,85
"19069","E01030182",2001,591,0,591,17
"19070","E01030190",2001,657,42,615,63
"19071","E01030191",2001,779,94,685,144
"19072","E01030192",2001,614,6,608,30
"19073","E01030198",2001,541,45,496,42
"19074","E01030204",2001,599,3,596,6
"19075","E01030205",2001,470,0,470,9
"19076","E01030206",2001,633,0,633,16
"19077","E01030196",2001,576,3,573,46
"19078","E01030197",2001,609,27,582,80
"19079","E01030171",2001,780,59,721,47
"19080","E01030214",2001,523,8,515,43
"19081","E01030215",2001,629,125,504,76
"19082","E01030216",2001,617,16,601,32
"19083","E01030217",2001,516,41,475,41
"19084","E01030218",2001,607,53,554,60
"19085","E01030156",2001,457,77,380,17
"19086","E01030157",2001,630,6,624,27
"19087","E01030158",2001,682,9,673,26
"19088","E01030159",2001,633,19,614,76
"19089","E01030166",2001,642,3,639,42
"19090","E01030164",2001,645,18,627,29
"19091","E01030168",2001,648,303,345,27
"19092","E01030169",2001,757,142,615,111
"19093","E01030170",2001,739,295,444,21
"19094","E01030160",2001,717,260,457,50
"19095","E01030161",2001,614,117,497,62
"19096","E01030162",2001,621,100,521,162
"19097","E01030163",2001,640,124,516,165
"19098","E01030167",2001,626,16,610,92
"19099","E01030165",2001,756,51,705,199
"19100","E01030259",2001,453,32,421,39
"19101","E01030260",2001,415,6,409,115
"19102","E01030240",2001,725,24,701,74
"19103","E01030241",2001,641,80,561,32
"19104","E01030242",2001,604,3,601,19
"19105","E01030261",2001,622,365,257,28
"19106","E01030262",2001,583,155,428,57
"19107","E01030277",2001,502,292,210,19
"19108","E01030281",2001,592,183,409,23
"19109","E01030279",2001,616,380,236,16
"19110","E01030280",2001,614,22,592,25
"19111","E01030278",2001,646,83,563,6
"19112","E01030271",2001,698,6,692,12
"19113","E01030266",2001,622,114,508,80
"19114","E01030267",2001,577,141,436,22
"19115","E01030264",2001,634,67,567,137
"19116","E01030265",2001,606,37,569,139
"19117","E01030246",2001,624,39,585,156
"19118","E01030248",2001,640,51,589,136
"19119","E01030249",2001,732,75,657,189
"19120","E01030250",2001,832,80,752,334
"19121","E01030263",2001,665,97,568,31
"19122","E01030255",2001,509,74,435,54
"19123","E01030270",2001,647,105,542,60
"19124","E01030289",2001,631,135,496,64
"19125","E01030290",2001,709,27,682,42
"19126","E01030268",2001,534,3,531,23
"19127","E01030269",2001,752,19,733,88
"19128","E01030288",2001,622,6,616,17
"19129","E01030233",2001,622,0,622,11
"19130","E01030235",2001,638,28,610,27
"19131","E01030247",2001,842,395,447,219
"19132","E01030254",2001,615,44,571,120
"19133","E01030256",2001,609,48,561,168
"19134","E01030258",2001,745,143,602,322
"19135","E01030276",2001,622,19,603,132
"19136","E01030291",2001,608,221,387,25
"19137","E01030274",2001,620,328,292,25
"19138","E01030275",2001,500,25,475,27
"19139","E01030257",2001,625,92,533,72
"19140","E01030287",2001,634,157,477,29
"19141","E01030236",2001,735,107,628,74
"19142","E01030237",2001,615,8,607,29
"19143","E01030238",2001,620,12,608,31
"19144","E01030234",2001,652,151,501,79
"19145","E01030227",2001,595,278,317,26
"19146","E01030228",2001,753,76,677,35
"19147","E01030223",2001,744,167,577,77
"19148","E01030224",2001,726,90,636,56
"19149","E01030225",2001,760,62,698,195
"19150","E01030226",2001,762,118,644,34
"19151","E01030286",2001,870,69,801,122
"19152","E01030292",2001,617,7,610,15
"19153","E01030293",2001,516,39,477,26
"19154","E01030294",2001,626,98,528,24
"19155","E01030272",2001,733,28,705,68
"19156","E01030273",2001,741,7,734,39
"19157","E01030239",2001,615,24,591,50
"19158","E01030251",2001,708,37,671,64
"19159","E01030252",2001,683,39,644,59
"19160","E01030253",2001,689,238,451,47
"19161","E01030230",2001,873,120,753,181
"19162","E01030231",2001,624,145,479,36
"19163","E01030232",2001,644,109,535,19
"19164","E01030285",2001,863,87,776,56
"19165","E01030282",2001,787,138,649,65
"19166","E01030283",2001,518,131,387,48
"19167","E01030284",2001,614,5,609,21
"19168","E01030295",2001,938,153,785,127
"19169","E01030229",2001,926,147,779,63
"19170","E01030243",2001,647,86,561,45
"19171","E01030244",2001,757,168,589,105
"19172","E01030245",2001,734,57,677,41
"19173","E01000907",2001,615,342,273,80
"19174","E01000908",2001,886,580,306,66
"19175","E01000909",2001,629,135,494,94
"19176","E01000912",2001,736,401,335,81
"19177","E01000913",2001,655,40,615,114
"19178","E01000899",2001,709,42,667,195
"19179","E01000893",2001,793,36,757,329
"19180","E01000894",2001,630,40,590,219
"19181","E01000895",2001,875,250,625,272
"19182","E01000896",2001,729,31,698,226
"19183","E01000910",2001,615,105,510,124
"19184","E01000911",2001,714,304,410,94
"19185","E01000923",2001,689,238,451,107
"19186","E01000921",2001,764,186,578,298
"19187","E01000928",2001,634,261,373,104
"19188","E01000878",2001,613,68,545,191
"19189","E01000879",2001,648,62,586,241
"19190","E01000880",2001,632,51,581,245
"19191","E01000884",2001,604,34,570,177
"19192","E01000885",2001,606,49,557,164
"19193","E01000871",2001,601,120,481,152
"19194","E01000872",2001,744,128,616,340
"19195","E01000873",2001,661,99,562,183
"19196","E01000874",2001,660,43,617,205
"19197","E01000877",2001,626,70,556,237
"19198","E01000892",2001,767,276,491,149
"19199","E01000903",2001,710,234,476,185
"19200","E01000886",2001,680,122,558,195
"19201","E01000887",2001,685,185,500,197
"19202","E01000888",2001,680,233,447,127
"19203","E01000889",2001,618,455,163,36
"19204","E01000890",2001,757,650,107,15
"19205","E01000891",2001,633,482,151,43
"19206","E01000901",2001,671,474,197,94
"19207","E01000922",2001,526,267,259,84
"19208","E01000927",2001,641,184,457,116
"19209","E01000881",2001,636,93,543,275
"19210","E01000882",2001,722,59,663,286
"19211","E01000883",2001,843,138,705,359
"19212","E01000897",2001,764,27,737,290
"19213","E01000898",2001,489,219,270,93
"19214","E01000870",2001,750,348,402,103
"19215","E01000866",2001,778,346,432,151
"19216","E01000924",2001,741,227,514,188
"19217","E01000925",2001,624,404,220,87
"19218","E01000926",2001,583,269,314,118
"19219","E01000969",2001,768,59,709,337
"19220","E01000970",2001,833,79,754,365
"19221","E01000971",2001,619,71,548,194
"19222","E01000972",2001,770,428,342,174
"19223","E01000973",2001,706,212,494,271
"19224","E01000844",2001,865,105,760,383
"19225","E01000848",2001,798,150,648,241
"19226","E01000849",2001,877,142,735,347
"19227","E01000842",2001,767,125,642,258
"19228","E01000902",2001,621,401,220,89
"19229","E01000904",2001,799,489,310,98
"19230","E01000905",2001,790,602,188,63
"19231","E01000906",2001,822,126,696,246
"19232","E01000900",2001,644,282,362,115
"19233","E01000931",2001,694,391,303,129
"19234","E01000932",2001,855,262,593,251
"19235","E01000875",2001,744,148,596,340
"19236","E01000876",2001,729,363,366,140
"19237","E01000974",2001,630,277,353,138
"19238","E01000843",2001,867,167,700,337
"19239","E01000845",2001,680,102,578,202
"19240","E01000846",2001,634,320,314,108
"19241","E01000847",2001,658,253,405,156
"19242","E01000864",2001,764,208,556,210
"19243","E01000865",2001,468,130,338,110
"19244","E01000867",2001,637,349,288,116
"19245","E01000868",2001,620,450,170,64
"19246","E01000869",2001,704,221,483,187
"19247","E01000964",2001,733,267,466,183
"19248","E01000965",2001,781,194,587,228
"19249","E01000966",2001,705,46,659,250
"19250","E01000962",2001,764,47,717,319
"19251","E01000968",2001,763,153,610,271
"19252","E01000963",2001,744,85,659,295
"19253","E01000967",2001,642,120,522,172
"19254","E01000960",2001,836,137,699,361
"19255","E01000961",2001,631,253,378,138
"19256","E01000862",2001,767,97,670,212
"19257","E01000857",2001,749,208,541,219
"19258","E01000858",2001,558,400,158,59
"19259","E01000859",2001,747,118,629,235
"19260","E01000860",2001,863,442,421,174
"19261","E01000861",2001,633,261,372,164
"19262","E01000856",2001,597,311,286,114
"19263","E01000957",2001,798,322,476,159
"19264","E01000958",2001,598,400,198,65
"19265","E01000959",2001,646,466,180,49
"19266","E01000929",2001,646,423,223,74
"19267","E01000930",2001,925,495,430,200
"19268","E01000933",2001,776,131,645,315
"19269","E01000934",2001,620,308,312,117
"19270","E01000935",2001,708,482,226,106
"19271","E01000863",2001,453,116,337,168
"19272","E01000946",2001,727,217,510,269
"19273","E01000947",2001,715,263,452,243
"19274","E01000948",2001,789,310,479,195
"19275","E01000952",2001,626,437,189,58
"19276","E01000953",2001,726,546,180,46
"19277","E01000954",2001,669,550,119,30
"19278","E01000955",2001,703,610,93,36
"19279","E01000956",2001,550,378,172,90
"19280","E01000949",2001,757,431,326,256
"19281","E01000950",2001,598,462,136,40
"19282","E01000951",2001,635,426,209,77
"19283","E01000944",2001,615,421,194,63
"19284","E01000945",2001,465,264,201,94
"19285","E01000938",2001,590,390,200,107
"19286","E01000939",2001,467,328,139,56
"19287","E01000940",2001,488,332,156,78
"19288","E01000936",2001,485,226,259,147
"19289","E01000937",2001,532,104,428,269
"19290","E01000853",2001,851,555,296,135
"19291","E01000941",2001,635,479,156,78
"19292","E01000942",2001,652,196,456,203
"19293","E01000943",2001,547,170,377,193
"19294","E01000854",2001,599,221,378,212
"19295","E01000850",2001,572,111,461,266
"19296","E01000851",2001,579,169,410,236
"19297","E01000852",2001,456,129,327,155
"19298","E01000920",2001,730,329,401,218
"19299","E01000915",2001,643,417,226,100
"19300","E01000916",2001,788,385,403,156
"19301","E01000917",2001,871,635,236,100
"19302","E01000918",2001,829,431,398,171
"19303","E01000919",2001,629,293,336,169
"19304","E01000914",2001,773,233,540,298
"19305","E01000855",2001,923,193,730,257
"19306","E01000001",2001,989,51,938,208
"19307","E01000002",2001,927,84,843,132
"19308","E01000003",2001,903,371,532,151
"19309","E01000004",2001,974,44,930,465
"19310","E01000005",2001,542,387,155,87
"19311","E01001808",2001,466,97,369,199
"19312","E01001809",2001,504,132,372,162
"19313","E01001814",2001,431,89,342,143
"19314","E01001823",2001,436,146,290,95
"19315","E01001825",2001,441,72,369,119
"19316","E01001813",2001,557,400,157,53
"19317","E01001810",2001,653,498,155,50
"19318","E01001811",2001,676,503,173,58
"19319","E01001714",2001,637,388,249,102
"19320","E01001721",2001,585,401,184,74
"19321","E01001812",2001,605,294,311,127
"19322","E01001807",2001,613,242,371,120
"19323","E01001799",2001,493,106,387,133
"19324","E01001802",2001,478,224,254,97
"19325","E01001804",2001,510,147,363,135
"19326","E01001800",2001,659,443,216,112
"19327","E01001824",2001,548,347,201,84
"19328","E01001826",2001,628,311,317,127
"19329","E01001725",2001,503,181,322,125
"19330","E01001726",2001,462,298,164,65
"19331","E01001728",2001,495,225,270,138
"19332","E01001722",2001,617,373,244,98
"19333","E01001827",2001,588,391,197,54
"19334","E01001828",2001,686,416,270,75
"19335","E01001822",2001,626,323,303,93
"19336","E01001797",2001,686,326,360,93
"19337","E01001798",2001,571,306,265,79
"19338","E01001723",2001,512,144,368,125
"19339","E01001724",2001,684,189,495,182
"19340","E01001727",2001,519,130,389,137
"19341","E01001768",2001,563,175,388,107
"19342","E01001769",2001,572,216,356,122
"19343","E01001715",2001,680,190,490,226
"19344","E01001716",2001,751,411,340,114
"19345","E01001717",2001,492,194,298,64
"19346","E01001718",2001,733,148,585,250
"19347","E01001719",2001,611,414,197,73
"19348","E01001720",2001,759,179,580,229
"19349","E01001742",2001,749,376,373,62
"19350","E01001801",2001,543,246,297,91
"19351","E01001803",2001,709,131,578,194
"19352","E01001806",2001,666,362,304,79
"19353","E01001829",2001,630,86,544,103
"19354","E01001831",2001,616,234,382,124
"19355","E01001832",2001,517,155,362,102
"19356","E01001805",2001,503,132,371,148
"19357","E01001741",2001,628,125,503,126
"19358","E01001770",2001,681,409,272,67
"19359","E01001764",2001,609,315,294,80
"19360","E01001765",2001,751,594,157,43
"19361","E01001766",2001,747,292,455,170
"19362","E01001767",2001,542,197,345,104
"19363","E01001792",2001,517,154,363,56
"19364","E01001793",2001,550,150,400,105
"19365","E01001794",2001,484,107,377,82
"19366","E01001795",2001,515,128,387,125
"19367","E01001796",2001,581,182,399,157
"19368","E01001736",2001,634,208,426,120
"19369","E01001737",2001,630,207,423,104
"19370","E01001738",2001,735,247,488,141
"19371","E01001739",2001,729,198,531,95
"19372","E01001790",2001,622,477,145,43
"19373","E01001786",2001,668,481,187,51
"19374","E01001787",2001,654,473,181,26
"19375","E01001788",2001,626,456,170,73
"19376","E01001833",2001,688,292,396,109
"19377","E01001834",2001,626,250,376,106
"19378","E01001835",2001,484,93,391,98
"19379","E01001830",2001,751,495,256,92
"19380","E01001740",2001,608,438,170,41
"19381","E01001747",2001,684,250,434,126
"19382","E01001733",2001,608,133,475,116
"19383","E01001789",2001,607,197,410,84
"19384","E01001791",2001,536,203,333,72
"19385","E01001785",2001,640,202,438,81
"19386","E01001757",2001,564,425,139,63
"19387","E01001758",2001,689,433,256,93
"19388","E01001759",2001,695,314,381,116
"19389","E01001745",2001,610,374,236,79
"19390","E01001746",2001,566,453,113,44
"19391","E01001761",2001,644,451,193,78
"19392","E01001762",2001,694,283,411,188
"19393","E01001760",2001,597,303,294,120
"19394","E01001734",2001,670,235,435,194
"19395","E01001731",2001,786,440,346,152
"19396","E01001846",2001,611,405,206,37
"19397","E01001847",2001,804,486,318,109
"19398","E01001848",2001,643,324,319,82
"19399","E01001849",2001,617,250,367,109
"19400","E01001850",2001,674,547,127,31
"19401","E01001732",2001,613,464,149,42
"19402","E01001735",2001,650,295,355,60
"19403","E01001729",2001,716,569,147,64
"19404","E01001730",2001,719,573,146,50
"19405","E01001838",2001,652,546,106,26
"19406","E01001816",2001,600,261,339,61
"19407","E01001819",2001,628,341,287,46
"19408","E01001763",2001,718,358,360,115
"19409","E01001748",2001,724,278,446,142
"19410","E01001749",2001,628,229,399,83
"19411","E01001750",2001,622,320,302,90
"19412","E01001751",2001,637,100,537,141
"19413","E01001743",2001,638,273,365,156
"19414","E01001744",2001,703,352,351,86
"19415","E01001817",2001,702,435,267,105
"19416","E01001756",2001,611,176,435,159
"19417","E01001844",2001,620,279,341,83
"19418","E01001845",2001,740,592,148,38
"19419","E01001840",2001,608,399,209,57
"19420","E01001841",2001,678,347,331,89
"19421","E01001836",2001,752,391,361,156
"19422","E01001837",2001,673,169,504,126
"19423","E01001842",2001,592,365,227,66
"19424","E01001843",2001,526,236,290,55
"19425","E01001839",2001,596,291,305,116
"19426","E01001818",2001,761,354,407,149
"19427","E01001820",2001,585,404,181,29
"19428","E01001821",2001,564,422,142,27
"19429","E01001815",2001,644,448,196,35
"19430","E01001774",2001,630,331,299,99
"19431","E01001775",2001,621,470,151,31
"19432","E01001772",2001,594,485,109,38
"19433","E01001773",2001,622,468,154,29
"19434","E01001776",2001,626,480,146,34
"19435","E01001752",2001,512,355,157,44
"19436","E01001753",2001,630,486,144,66
"19437","E01001754",2001,668,416,252,155
"19438","E01001755",2001,624,444,180,62
"19439","E01001779",2001,741,493,248,46
"19440","E01001781",2001,740,517,223,48
"19441","E01001782",2001,694,345,349,77
"19442","E01001783",2001,739,603,136,28
"19443","E01001784",2001,703,454,249,59
"19444","E01001780",2001,810,541,269,87
"19445","E01001777",2001,710,466,244,67
"19446","E01001778",2001,789,399,390,154
"19447","E01001771",2001,701,182,519,255
"19448","E01001874",2001,855,510,345,95
"19449","E01001875",2001,592,274,318,62
"19450","E01001876",2001,586,381,205,66
"19451","E01001877",2001,574,225,349,91
"19452","E01001878",2001,588,339,249,45
"19453","E01001961",2001,526,355,171,53
"19454","E01001957",2001,608,427,181,40
"19455","E01001958",2001,610,421,189,45
"19456","E01001955",2001,637,370,267,50
"19457","E01001956",2001,614,220,394,85
"19458","E01001959",2001,496,196,300,35
"19459","E01001960",2001,685,165,520,161
"19460","E01001954",2001,616,273,343,78
"19461","E01001943",2001,784,230,554,207
"19462","E01001944",2001,754,516,238,68
"19463","E01001945",2001,654,199,455,139
"19464","E01001946",2001,699,235,464,163
"19465","E01001940",2001,675,309,366,151
"19466","E01001941",2001,610,150,460,187
"19467","E01001942",2001,757,259,498,166
"19468","E01001862",2001,759,330,429,142
"19469","E01001863",2001,648,140,508,168
"19470","E01001864",2001,735,203,532,217
"19471","E01001858",2001,643,221,422,128
"19472","E01001860",2001,731,343,388,146
"19473","E01001861",2001,603,253,350,120
"19474","E01001852",2001,950,223,727,244
"19475","E01001853",2001,686,148,538,164
"19476","E01001854",2001,885,220,665,221
"19477","E01001857",2001,762,456,306,122
"19478","E01001859",2001,732,208,524,133
"19479","E01001865",2001,634,130,504,122
"19480","E01001927",2001,575,53,522,97
"19481","E01001930",2001,711,237,474,167
"19482","E01001929",2001,669,91,578,142
"19483","E01001895",2001,671,203,468,161
"19484","E01001896",2001,689,243,446,182
"19485","E01001897",2001,615,172,443,124
"19486","E01001873",2001,699,274,425,134
"19487","E01001855",2001,841,165,676,218
"19488","E01001856",2001,672,307,365,140
"19489","E01001851",2001,664,119,545,136
"19490","E01001869",2001,678,178,500,167
"19491","E01001928",2001,722,259,463,130
"19492","E01001931",2001,711,160,551,218
"19493","E01001932",2001,649,168,481,183
"19494","E01001933",2001,699,189,510,108
"19495","E01001870",2001,786,150,636,245
"19496","E01001871",2001,745,120,625,226
"19497","E01001872",2001,692,139,553,226
"19498","E01001866",2001,674,163,511,165
"19499","E01001867",2001,608,116,492,188
"19500","E01001868",2001,559,362,197,78
"19501","E01001893",2001,630,360,270,89
"19502","E01001894",2001,613,275,338,120
"19503","E01001898",2001,704,212,492,221
"19504","E01001899",2001,716,476,240,91
"19505","E01001900",2001,676,385,291,93
"19506","E01001889",2001,605,134,471,139
"19507","E01001913",2001,792,101,691,264
"19508","E01001914",2001,893,197,696,297
"19509","E01001910",2001,918,241,677,274
"19510","E01001911",2001,662,386,276,82
"19511","E01001912",2001,547,305,242,98
"19512","E01001908",2001,814,154,660,297
"19513","E01001909",2001,811,279,532,155
"19514","E01001885",2001,627,455,172,48
"19515","E01001886",2001,625,290,335,97
"19516","E01001887",2001,682,296,386,128
"19517","E01001890",2001,614,162,452,141
"19518","E01001892",2001,629,329,300,74
"19519","E01001880",2001,756,327,429,161
"19520","E01001881",2001,625,122,503,167
"19521","E01001882",2001,639,117,522,178
"19522","E01001883",2001,693,263,430,168
"19523","E01001884",2001,798,407,391,140
"19524","E01001888",2001,630,105,525,114
"19525","E01001917",2001,747,225,522,135
"19526","E01001918",2001,628,92,536,117
"19527","E01001919",2001,646,87,559,114
"19528","E01001891",2001,715,95,620,235
"19529","E01001901",2001,638,99,539,134
"19530","E01001902",2001,774,224,550,212
"19531","E01001903",2001,640,240,400,115
"19532","E01001879",2001,588,182,406,103
"19533","E01001920",2001,758,359,399,117
"19534","E01001921",2001,640,104,536,141
"19535","E01001922",2001,632,98,534,150
"19536","E01001923",2001,625,182,443,119
"19537","E01001924",2001,617,53,564,148
"19538","E01001947",2001,597,412,185,53
"19539","E01001948",2001,738,87,651,190
"19540","E01001949",2001,640,62,578,181
"19541","E01001950",2001,603,54,549,178
"19542","E01001951",2001,660,169,491,171
"19543","E01001953",2001,591,206,385,134
"19544","E01001904",2001,649,73,576,159
"19545","E01001905",2001,662,108,554,156
"19546","E01001906",2001,621,104,517,164
"19547","E01001907",2001,565,123,442,107
"19548","E01001939",2001,788,324,464,116
"19549","E01001935",2001,945,301,644,146
"19550","E01001936",2001,738,249,489,166
"19551","E01001952",2001,754,166,588,254
"19552","E01001926",2001,605,59,546,125
"19553","E01001915",2001,619,107,512,132
"19554","E01001916",2001,709,54,655,159
"19555","E01001925",2001,591,90,501,135
"19556","E01001937",2001,708,100,608,193
"19557","E01001938",2001,592,254,338,89
"19558","E01001934",2001,675,313,362,84
"19559","E01001969",2001,751,245,506,183
"19560","E01001974",2001,803,100,703,215
"19561","E01001975",2001,671,119,552,215
"19562","E01001971",2001,685,414,271,78
"19563","E01002039",2001,623,489,134,32
"19564","E01002040",2001,744,227,517,138
"19565","E01002036",2001,626,215,411,104
"19566","E01002037",2001,604,355,249,71
"19567","E01002038",2001,636,369,267,111
"19568","E01002041",2001,631,287,344,86
"19569","E01002034",2001,745,482,263,99
"19570","E01002035",2001,504,286,218,53
"19571","E01001972",2001,720,273,447,106
"19572","E01001973",2001,666,131,535,92
"19573","E01001970",2001,634,292,342,124
"19574","E01001962",2001,604,124,480,66
"19575","E01002090",2001,512,207,305,34
"19576","E01002093",2001,607,384,223,27
"19577","E01002096",2001,571,338,233,24
"19578","E01002097",2001,599,304,295,58
"19579","E01002094",2001,515,299,216,23
"19580","E01002095",2001,619,414,205,34
"19581","E01002091",2001,605,344,261,31
"19582","E01002092",2001,600,260,340,103
"19583","E01002098",2001,597,100,497,143
"19584","E01002101",2001,610,71,539,161
"19585","E01002102",2001,618,123,495,169
"19586","E01002105",2001,735,208,527,239
"19587","E01002103",2001,550,84,466,119
"19588","E01002104",2001,495,106,389,71
"19589","E01002099",2001,659,428,231,64
"19590","E01002100",2001,550,149,401,100
"19591","E01001963",2001,614,52,562,86
"19592","E01001964",2001,607,82,525,142
"19593","E01001965",2001,633,100,533,81
"19594","E01001966",2001,505,31,474,69
"19595","E01002032",2001,717,398,319,79
"19596","E01002033",2001,631,299,332,61
"19597","E01002027",2001,523,181,342,102
"19598","E01002028",2001,614,185,429,109
"19599","E01001976",2001,639,203,436,126
"19600","E01001977",2001,579,201,378,136
"19601","E01001978",2001,730,315,415,145
"19602","E01001979",2001,631,260,371,110
"19603","E01002074",2001,730,366,364,93
"19604","E01002077",2001,583,358,225,82
"19605","E01002079",2001,529,89,440,98
"19606","E01002081",2001,585,331,254,80
"19607","E01002082",2001,558,437,121,24
"19608","E01002086",2001,578,222,356,79
"19609","E01002088",2001,601,109,492,108
"19610","E01002089",2001,632,526,106,28
"19611","E01001996",2001,717,79,638,207
"19612","E01001997",2001,665,52,613,289
"19613","E01001967",2001,630,58,572,92
"19614","E01001968",2001,735,90,645,186
"19615","E01002080",2001,528,117,411,111
"19616","E01002078",2001,946,455,491,96
"19617","E01002075",2001,612,237,375,104
"19618","E01002076",2001,634,177,457,112
"19619","E01002026",2001,670,483,187,64
"19620","E01002029",2001,487,265,222,98
"19621","E01002030",2001,516,103,413,134
"19622","E01002031",2001,587,117,470,209
"19623","E01001995",2001,633,253,380,34
"19624","E01001991",2001,789,70,719,387
"19625","E01001992",2001,694,37,657,175
"19626","E01001993",2001,609,53,556,80
"19627","E01001980",2001,594,160,434,111
"19628","E01001981",2001,532,128,404,112
"19629","E01001982",2001,635,130,505,150
"19630","E01001983",2001,599,124,475,114
"19631","E01002083",2001,495,54,441,127
"19632","E01002084",2001,601,115,486,123
"19633","E01002085",2001,640,179,461,146
"19634","E01002087",2001,655,171,484,195
"19635","E01002012",2001,718,460,258,124
"19636","E01002014",2001,753,140,613,272
"19637","E01002015",2001,622,285,337,84
"19638","E01002018",2001,594,222,372,68
"19639","E01002020",2001,681,134,547,169
"19640","E01002025",2001,630,44,586,141
"19641","E01002022",2001,790,54,736,378
"19642","E01002023",2001,612,70,542,108
"19643","E01002024",2001,507,134,373,71
"19644","E01002021",2001,600,58,542,93
"19645","E01002019",2001,504,31,473,76
"19646","E01002013",2001,605,87,518,121
"19647","E01001998",2001,691,80,611,251
"19648","E01001999",2001,629,66,563,215
"19649","E01002003",2001,613,225,388,209
"19650","E01002004",2001,601,86,515,162
"19651","E01002073",2001,663,290,373,139
"19652","E01002069",2001,734,323,411,188
"19653","E01002070",2001,652,149,503,110
"19654","E01002067",2001,646,331,315,93
"19655","E01002068",2001,640,237,403,140
"19656","E01002071",2001,596,339,257,93
"19657","E01002072",2001,636,281,355,99
"19658","E01002066",2001,640,366,274,90
"19659","E01002049",2001,623,254,369,73
"19660","E01002043",2001,633,129,504,182
"19661","E01002045",2001,628,283,345,88
"19662","E01002046",2001,632,312,320,70
"19663","E01002047",2001,595,91,504,196
"19664","E01002048",2001,635,153,482,146
"19665","E01002044",2001,590,82,508,161
"19666","E01002042",2001,523,85,438,134
"19667","E01002016",2001,651,214,437,117
"19668","E01002017",2001,690,124,566,158
"19669","E01002059",2001,663,237,426,92
"19670","E01002060",2001,656,99,557,131
"19671","E01002050",2001,483,76,407,79
"19672","E01002051",2001,617,227,390,150
"19673","E01002052",2001,488,122,366,74
"19674","E01002055",2001,458,102,356,102
"19675","E01002010",2001,711,218,493,116
"19676","E01002011",2001,735,124,611,202
"19677","E01002008",2001,593,57,536,112
"19678","E01001994",2001,745,67,678,238
"19679","E01002000",2001,707,109,598,236
"19680","E01002001",2001,623,73,550,211
"19681","E01002002",2001,655,125,530,229
"19682","E01002058",2001,526,115,411,165
"19683","E01002056",2001,754,365,389,112
"19684","E01002057",2001,467,121,346,91
"19685","E01002053",2001,639,304,335,113
"19686","E01002054",2001,658,444,214,72
"19687","E01001989",2001,708,109,599,148
"19688","E01001987",2001,794,53,741,232
"19689","E01001984",2001,957,275,682,247
"19690","E01001985",2001,768,54,714,213
"19691","E01001986",2001,654,113,541,165
"19692","E01001988",2001,774,132,642,275
"19693","E01001990",2001,743,85,658,334
"19694","E01002062",2001,773,136,637,210
"19695","E01002009",2001,662,41,621,249
"19696","E01002005",2001,745,71,674,341
"19697","E01002006",2001,793,67,726,282
"19698","E01002007",2001,745,55,690,291
"19699","E01002063",2001,737,239,498,165
"19700","E01002064",2001,629,262,367,146
"19701","E01002065",2001,743,208,535,256
"19702","E01002061",2001,692,107,585,196
"19703","E01002758",2001,701,487,214,66
"19704","E01002755",2001,692,463,229,51
"19705","E01002756",2001,657,234,423,135
"19706","E01002804",2001,636,350,286,86
"19707","E01002807",2001,737,397,340,121
"19708","E01002811",2001,697,408,289,56
"19709","E01002772",2001,722,292,430,152
"19710","E01002757",2001,545,222,323,63
"19711","E01002759",2001,588,178,410,105
"19712","E01002760",2001,594,371,223,57
"19713","E01002753",2001,603,304,299,92
"19714","E01002754",2001,625,168,457,131
"19715","E01002735",2001,745,338,407,201
"19716","E01002805",2001,755,225,530,271
"19717","E01002806",2001,684,271,413,100
"19718","E01002808",2001,817,301,516,183
"19719","E01002809",2001,702,266,436,162
"19720","E01002810",2001,743,395,348,116
"19721","E01002773",2001,796,570,226,47
"19722","E01002774",2001,881,496,385,138
"19723","E01002770",2001,701,238,463,202
"19724","E01002771",2001,679,372,307,105
"19725","E01002768",2001,835,482,353,94
"19726","E01002751",2001,780,531,249,98
"19727","E01002736",2001,621,454,167,46
"19728","E01002737",2001,695,418,277,74
"19729","E01002734",2001,620,464,156,73
"19730","E01002732",2001,676,421,255,90
"19731","E01002747",2001,617,159,458,151
"19732","E01002748",2001,586,299,287,128
"19733","E01002749",2001,502,233,269,75
"19734","E01002750",2001,616,167,449,113
"19735","E01002742",2001,640,131,509,154
"19736","E01002763",2001,620,271,349,155
"19737","E01002733",2001,712,145,567,157
"19738","E01002730",2001,742,275,467,203
"19739","E01002731",2001,725,257,468,200
"19740","E01002769",2001,704,254,450,101
"19741","E01002785",2001,673,168,505,133
"19742","E01002788",2001,866,225,641,217
"19743","E01002789",2001,762,146,616,145
"19744","E01002752",2001,646,307,339,68
"19745","E01002743",2001,667,270,397,124
"19746","E01002744",2001,745,305,440,123
"19747","E01002738",2001,722,277,445,110
"19748","E01002741",2001,657,421,236,51
"19749","E01002764",2001,803,428,375,112
"19750","E01002786",2001,815,431,384,153
"19751","E01002787",2001,571,310,261,144
"19752","E01002783",2001,760,451,309,107
"19753","E01002784",2001,729,425,304,84
"19754","E01002767",2001,944,525,419,105
"19755","E01002761",2001,683,439,244,75
"19756","E01002762",2001,768,286,482,157
"19757","E01002746",2001,707,310,397,159
"19758","E01002781",2001,621,375,246,67
"19759","E01002782",2001,587,417,170,41
"19760","E01002777",2001,722,276,446,163
"19761","E01002778",2001,642,460,182,49
"19762","E01002779",2001,744,272,472,174
"19763","E01002795",2001,671,315,356,144
"19764","E01002796",2001,519,276,243,77
"19765","E01002739",2001,704,198,506,119
"19766","E01002740",2001,713,137,576,177
"19767","E01002745",2001,724,250,474,135
"19768","E01002718",2001,750,219,531,197
"19769","E01002716",2001,786,528,258,74
"19770","E01002721",2001,737,431,306,65
"19771","E01002780",2001,748,334,414,134
"19772","E01002775",2001,689,247,442,164
"19773","E01002776",2001,723,336,387,120
"19774","E01002708",2001,641,342,299,86
"19775","E01002712",2001,438,191,247,87
"19776","E01002713",2001,782,556,226,50
"19777","E01002765",2001,594,375,219,66
"19778","E01002766",2001,741,548,193,91
"19779","E01002717",2001,487,227,260,65
"19780","E01002719",2001,744,249,495,102
"19781","E01002720",2001,630,468,162,55
"19782","E01002790",2001,720,553,167,71
"19783","E01002791",2001,797,236,561,208
"19784","E01002793",2001,894,520,374,150
"19785","E01002792",2001,821,280,541,189
"19786","E01002714",2001,633,164,469,176
"19787","E01002698",2001,746,312,434,135
"19788","E01002699",2001,764,332,432,121
"19789","E01002700",2001,653,137,516,111
"19790","E01002722",2001,603,438,165,42
"19791","E01002797",2001,766,466,300,99
"19792","E01002798",2001,856,206,650,199
"19793","E01002799",2001,767,519,248,82
"19794","E01002800",2001,666,540,126,45
"19795","E01002697",2001,699,489,210,74
"19796","E01002715",2001,598,469,129,39
"19797","E01002709",2001,631,416,215,66
"19798","E01002710",2001,667,391,276,69
"19799","E01002694",2001,621,436,185,79
"19800","E01002696",2001,716,237,479,146
"19801","E01002801",2001,772,239,533,190
"19802","E01002802",2001,708,240,468,161
"19803","E01002803",2001,728,328,400,133
"19804","E01002794",2001,703,248,455,207
"19805","E01002711",2001,748,268,480,217
"19806","E01002727",2001,748,337,411,145
"19807","E01002728",2001,479,324,155,33
"19808","E01002729",2001,614,283,331,82
"19809","E01002695",2001,685,329,356,189
"19810","E01002723",2001,744,466,278,75
"19811","E01002724",2001,782,236,546,216
"19812","E01002725",2001,561,437,124,38
"19813","E01002726",2001,699,403,296,126
"19814","E01002705",2001,770,233,537,217
"19815","E01002707",2001,692,375,317,156
"19816","E01002706",2001,741,528,213,77
"19817","E01002701",2001,678,473,205,65
"19818","E01002702",2001,710,541,169,76
"19819","E01002703",2001,652,459,193,71
"19820","E01002704",2001,783,542,241,106
"19821","E01002852",2001,575,416,159,43
"19822","E01002853",2001,609,473,136,64
"19823","E01002854",2001,557,418,139,27
"19824","E01002855",2001,606,394,212,66
"19825","E01002857",2001,617,504,113,20
"19826","E01002904",2001,594,511,83,23
"19827","E01002905",2001,592,415,177,52
"19828","E01002906",2001,615,323,292,63
"19829","E01002907",2001,636,529,107,35
"19830","E01002908",2001,651,230,421,113
"19831","E01002909",2001,822,377,445,113
"19832","E01002876",2001,689,182,507,130
"19833","E01002877",2001,649,350,299,74
"19834","E01002878",2001,755,327,428,93
"19835","E01002856",2001,785,361,424,159
"19836","E01002829",2001,740,432,308,140
"19837","E01002830",2001,797,471,326,118
"19838","E01002831",2001,835,418,417,133
"19839","E01002832",2001,747,345,402,119
"19840","E01002879",2001,620,386,234,57
"19841","E01002880",2001,624,431,193,31
"19842","E01002881",2001,559,365,194,42
"19843","E01002870",2001,633,467,166,42
"19844","E01002872",2001,702,470,232,63
"19845","E01002882",2001,830,199,631,185
"19846","E01002883",2001,883,47,836,230
"19847","E01002884",2001,1051,248,803,435
"19848","E01002885",2001,901,96,805,390
"19849","E01002886",2001,880,100,780,256
"19850","E01002873",2001,631,172,459,117
"19851","E01002874",2001,656,192,464,117
"19852","E01002875",2001,762,151,611,146
"19853","E01002871",2001,742,68,674,149
"19854","E01002833",2001,886,223,663,217
"19855","E01002824",2001,758,49,709,272
"19856","E01002825",2001,744,37,707,245
"19857","E01002826",2001,867,58,809,363
"19858","E01002827",2001,991,33,958,262
"19859","E01002828",2001,792,136,656,203
"19860","E01002864",2001,594,18,576,142
"19861","E01002866",2001,760,174,586,170
"19862","E01002867",2001,763,162,601,247
"19863","E01002868",2001,795,27,768,213
"19864","E01002869",2001,857,178,679,245
"19865","E01002887",2001,741,43,698,340
"19866","E01002889",2001,705,39,666,317
"19867","E01002890",2001,721,20,701,184
"19868","E01002891",2001,761,22,739,366
"19869","E01002892",2001,922,72,850,338
"19870","E01002865",2001,622,21,601,222
"19871","E01002815",2001,762,140,622,232
"19872","E01002816",2001,734,98,636,311
"19873","E01002817",2001,686,79,607,202
"19874","E01002813",2001,759,69,690,227
"19875","E01002818",2001,976,50,926,401
"19876","E01002819",2001,853,53,800,354
"19877","E01002863",2001,838,37,801,306
"19878","E01002859",2001,890,61,829,330
"19879","E01002860",2001,780,25,755,267
"19880","E01002850",2001,786,133,653,312
"19881","E01002888",2001,889,74,815,308
"19882","E01002812",2001,845,71,774,326
"19883","E01002839",2001,1002,216,786,426
"19884","E01002834",2001,822,135,687,291
"19885","E01002823",2001,760,458,302,104
"19886","E01002821",2001,745,54,691,303
"19887","E01002858",2001,1025,231,794,402
"19888","E01002861",2001,828,167,661,232
"19889","E01002862",2001,893,524,369,178
"19890","E01002851",2001,926,496,430,215
"19891","E01002847",2001,775,153,622,252
"19892","E01002848",2001,970,327,643,299
"19893","E01002814",2001,673,260,413,154
"19894","E01002822",2001,713,82,631,265
"19895","E01002820",2001,784,64,720,375
"19896","E01002835",2001,814,23,791,326
"19897","E01002836",2001,882,78,804,357
"19898","E01002837",2001,717,46,671,292
"19899","E01002849",2001,894,171,723,229
"19900","E01002846",2001,852,262,590,272
"19901","E01002893",2001,874,235,639,222
"19902","E01002894",2001,724,90,634,234
"19903","E01002898",2001,744,73,671,212
"19904","E01002899",2001,883,300,583,204
"19905","E01002900",2001,768,38,730,235
"19906","E01002901",2001,758,216,542,197
"19907","E01002902",2001,915,135,780,308
"19908","E01002903",2001,759,21,738,213
"19909","E01002914",2001,780,45,735,278
"19910","E01002910",2001,794,181,613,156
"19911","E01002911",2001,787,30,757,178
"19912","E01002844",2001,872,125,747,228
"19913","E01002845",2001,847,286,561,145
"19914","E01002912",2001,725,113,612,221
"19915","E01002895",2001,637,21,616,176
"19916","E01002896",2001,769,47,722,222
"19917","E01002897",2001,758,70,688,358
"19918","E01002838",2001,666,30,636,226
"19919","E01002840",2001,794,388,406,86
"19920","E01002841",2001,843,280,563,157
"19921","E01002842",2001,532,379,153,30
"19922","E01002843",2001,706,477,229,68
"19923","E01002913",2001,711,166,545,168
"19924","E01003016",2001,1027,279,748,592
"19925","E01003017",2001,795,505,290,125
"19926","E01003012",2001,685,429,256,128
"19927","E01003013",2001,706,177,529,307
"19928","E01003014",2001,663,349,314,95
"19929","E01003015",2001,718,482,236,76
"19930","E01003110",2001,668,242,426,125
"19931","E01003111",2001,634,521,113,44
"19932","E01003112",2001,740,472,268,88
"19933","E01003108",2001,751,518,233,70
"19934","E01003109",2001,713,502,211,71
"19935","E01003101",2001,638,398,240,114
"19936","E01003105",2001,645,436,209,66
"19937","E01003106",2001,737,341,396,121
"19938","E01003107",2001,759,263,496,162
"19939","E01003102",2001,640,280,360,154
"19940","E01003103",2001,752,455,297,100
"19941","E01003104",2001,728,206,522,248
"19942","E01003122",2001,617,310,307,108
"19943","E01003129",2001,641,253,388,158
"19944","E01003098",2001,623,242,381,127
"19945","E01003099",2001,633,325,308,99
"19946","E01003100",2001,763,96,667,345
"19947","E01003183",2001,622,434,188,47
"19948","E01003180",2001,613,317,296,80
"19949","E01003097",2001,737,522,215,106
"19950","E01003123",2001,707,246,461,151
"19951","E01003124",2001,654,317,337,157
"19952","E01003125",2001,659,541,118,28
"19953","E01003121",2001,630,536,94,32
"19954","E01003181",2001,641,390,251,120
"19955","E01003184",2001,594,484,110,39
"19956","E01003185",2001,775,417,358,137
"19957","E01003186",2001,740,300,440,155
"19958","E01003187",2001,620,449,171,42
"19959","E01003128",2001,614,428,186,65
"19960","E01003126",2001,623,390,233,85
"19961","E01003089",2001,622,470,152,55
"19962","E01003091",2001,639,378,261,95
"19963","E01003092",2001,626,450,176,54
"19964","E01003188",2001,510,407,103,40
"19965","E01003182",2001,648,375,273,89
"19966","E01003046",2001,684,553,131,43
"19967","E01003048",2001,651,548,103,35
"19968","E01003075",2001,659,538,121,21
"19969","E01003093",2001,546,406,140,52
"19970","E01003094",2001,650,285,365,115
"19971","E01003096",2001,729,194,535,233
"19972","E01003088",2001,630,355,275,93
"19973","E01003127",2001,632,307,325,109
"19974","E01003049",2001,603,378,225,83
"19975","E01003047",2001,640,396,244,115
"19976","E01003045",2001,510,439,71,21
"19977","E01003059",2001,580,468,112,41
"19978","E01003060",2001,611,502,109,39
"19979","E01003061",2001,493,235,258,117
"19980","E01003034",2001,645,260,385,117
"19981","E01003035",2001,637,198,439,226
"19982","E01003036",2001,713,264,449,137
"19983","E01003090",2001,722,281,441,177
"19984","E01003095",2001,641,170,471,142
"19985","E01003037",2001,608,391,217,83
"19986","E01003038",2001,723,133,590,192
"19987","E01003039",2001,720,95,625,246
"19988","E01003040",2001,702,164,538,204
"19989","E01003042",2001,620,277,343,112
"19990","E01003076",2001,738,261,477,230
"19991","E01003077",2001,681,230,451,197
"19992","E01003078",2001,623,115,508,83
"19993","E01003072",2001,649,144,505,132
"19994","E01003073",2001,600,310,290,78
"19995","E01003058",2001,659,176,483,168
"19996","E01003053",2001,615,152,463,143
"19997","E01003054",2001,672,125,547,226
"19998","E01003056",2001,628,227,401,175
"19999","E01003019",2001,743,216,527,144
"20000","E01003020",2001,691,263,428,138
"20001","E01003055",2001,737,350,387,134
"20002","E01003050",2001,676,284,392,156
"20003","E01003052",2001,637,445,192,73
"20004","E01003176",2001,727,415,312,169
"20005","E01003057",2001,646,385,261,94
"20006","E01003032",2001,763,383,380,160
"20007","E01003029",2001,751,248,503,189
"20008","E01003041",2001,659,413,246,108
"20009","E01003043",2001,607,184,423,123
"20010","E01003044",2001,608,492,116,42
"20011","E01003051",2001,565,293,272,126
"20012","E01003074",2001,722,256,466,121
"20013","E01003071",2001,603,181,422,132
"20014","E01003033",2001,641,149,492,132
"20015","E01003030",2001,653,93,560,203
"20016","E01003026",2001,729,141,588,182
"20017","E01003027",2001,513,37,476,109
"20018","E01003028",2001,615,190,425,95
"20019","E01003018",2001,885,189,696,319
"20020","E01003177",2001,630,273,357,150
"20021","E01003178",2001,619,153,466,162
"20022","E01003171",2001,748,273,475,160
"20023","E01003173",2001,622,97,525,120
"20024","E01003021",2001,649,404,245,59
"20025","E01003022",2001,716,237,479,151
"20026","E01003023",2001,748,246,502,178
"20027","E01003024",2001,698,502,196,91
"20028","E01003025",2001,700,338,362,102
"20029","E01003162",2001,722,498,224,85
"20030","E01003159",2001,684,418,266,81
"20031","E01003160",2001,604,457,147,64
"20032","E01003136",2001,764,210,554,229
"20033","E01003137",2001,730,329,401,181
"20034","E01003156",2001,743,271,472,155
"20035","E01003157",2001,604,105,499,140
"20036","E01003158",2001,841,173,668,207
"20037","E01003161",2001,614,166,448,162
"20038","E01003163",2001,631,167,464,85
"20039","E01003031",2001,725,353,372,159
"20040","E01003174",2001,646,377,269,143
"20041","E01003175",2001,529,324,205,44
"20042","E01003172",2001,627,402,225,47
"20043","E01003179",2001,626,495,131,38
"20044","E01003132",2001,589,326,263,60
"20045","E01003164",2001,747,216,531,247
"20046","E01003165",2001,644,225,419,115
"20047","E01003168",2001,586,491,95,42
"20048","E01003169",2001,785,243,542,158
"20049","E01003170",2001,733,95,638,94
"20050","E01003130",2001,718,111,607,223
"20051","E01003131",2001,618,127,491,174
"20052","E01003138",2001,708,71,637,208
"20053","E01003151",2001,742,416,326,119
"20054","E01003135",2001,676,280,396,99
"20055","E01003152",2001,662,86,576,149
"20056","E01003133",2001,633,137,496,181
"20057","E01003134",2001,616,196,420,74
"20058","E01003079",2001,663,260,403,144
"20059","E01003080",2001,656,101,555,162
"20060","E01003081",2001,732,242,490,216
"20061","E01003064",2001,682,100,582,195
"20062","E01003066",2001,750,338,412,120
"20063","E01003166",2001,762,116,646,262
"20064","E01003167",2001,654,65,589,119
"20065","E01003153",2001,791,99,692,327
"20066","E01003155",2001,671,86,585,156
"20067","E01003116",2001,627,90,537,154
"20068","E01003117",2001,749,143,606,262
"20069","E01003118",2001,563,103,460,134
"20070","E01003083",2001,625,128,497,97
"20071","E01003084",2001,670,115,555,162
"20072","E01003085",2001,705,160,545,59
"20073","E01003154",2001,723,308,415,119
"20074","E01003149",2001,677,46,631,146
"20075","E01003086",2001,606,351,255,53
"20076","E01003087",2001,603,349,254,70
"20077","E01003068",2001,729,339,390,95
"20078","E01003065",2001,679,385,294,66
"20079","E01003082",2001,711,342,369,88
"20080","E01003119",2001,767,84,683,298
"20081","E01003120",2001,806,113,693,416
"20082","E01003113",2001,691,125,566,204
"20083","E01003114",2001,754,83,671,224
"20084","E01003150",2001,754,293,461,182
"20085","E01003148",2001,814,138,676,229
"20086","E01003069",2001,555,217,338,47
"20087","E01003070",2001,663,417,246,74
"20088","E01003067",2001,620,158,462,149
"20089","E01003062",2001,767,254,513,177
"20090","E01003063",2001,704,396,308,75
"20091","E01003147",2001,674,147,527,154
"20092","E01003141",2001,654,156,498,133
"20093","E01003144",2001,521,32,489,71
"20094","E01003145",2001,707,123,584,261
"20095","E01003115",2001,649,148,501,204
"20096","E01003146",2001,535,130,405,75
"20097","E01003142",2001,475,35,440,59
"20098","E01003143",2001,576,178,398,68
"20099","E01003139",2001,611,57,554,118
"20100","E01003140",2001,504,29,475,72
"20101","E01003249",2001,618,395,223,50
"20102","E01003250",2001,633,447,186,53
"20103","E01003244",2001,567,499,68,12
"20104","E01003245",2001,509,416,93,34
"20105","E01003247",2001,715,249,466,115
"20106","E01003248",2001,643,405,238,87
"20107","E01003246",2001,468,339,129,32
"20108","E01003251",2001,610,512,98,18
"20109","E01003252",2001,596,515,81,17
"20110","E01003253",2001,594,408,186,60
"20111","E01003297",2001,804,192,612,295
"20112","E01003301",2001,633,229,404,126
"20113","E01003302",2001,690,286,404,119
"20114","E01003305",2001,698,478,220,48
"20115","E01003299",2001,598,343,255,63
"20116","E01003300",2001,627,453,174,39
"20117","E01003306",2001,693,475,218,61
"20118","E01003303",2001,576,285,291,120
"20119","E01003304",2001,756,380,376,163
"20120","E01003298",2001,498,351,147,47
"20121","E01003207",2001,581,438,143,56
"20122","E01003209",2001,634,373,261,72
"20123","E01003210",2001,664,197,467,188
"20124","E01003212",2001,724,199,525,129
"20125","E01003215",2001,491,217,274,134
"20126","E01003338",2001,631,436,195,60
"20127","E01003339",2001,644,328,316,83
"20128","E01003340",2001,621,121,500,200
"20129","E01003341",2001,542,147,395,112
"20130","E01003343",2001,622,224,398,75
"20131","E01003201",2001,618,277,341,82
"20132","E01003204",2001,638,238,400,119
"20133","E01003205",2001,579,382,197,41
"20134","E01003206",2001,706,154,552,139
"20135","E01003199",2001,747,142,605,176
"20136","E01003211",2001,748,256,492,161
"20137","E01003208",2001,599,298,301,42
"20138","E01003213",2001,765,239,526,190
"20139","E01003214",2001,644,284,360,107
"20140","E01003202",2001,760,71,689,196
"20141","E01003203",2001,826,377,449,150
"20142","E01003198",2001,660,218,442,93
"20143","E01003200",2001,737,109,628,215
"20144","E01003344",2001,653,266,387,89
"20145","E01003345",2001,650,177,473,116
"20146","E01003342",2001,675,150,525,165
"20147","E01003336",2001,605,454,151,25
"20148","E01003337",2001,492,413,79,14
"20149","E01003273",2001,587,144,443,55
"20150","E01003277",2001,740,221,519,150
"20151","E01003278",2001,736,216,520,163
"20152","E01003279",2001,624,122,502,82
"20153","E01003296",2001,733,221,512,167
"20154","E01003288",2001,668,315,353,102
"20155","E01003289",2001,713,198,515,163
"20156","E01003290",2001,582,251,331,104
"20157","E01003291",2001,664,457,207,48
"20158","E01003286",2001,749,410,339,91
"20159","E01003282",2001,677,148,529,124
"20160","E01003283",2001,700,85,615,97
"20161","E01003284",2001,655,137,518,84
"20162","E01003272",2001,675,147,528,155
"20163","E01003274",2001,647,128,519,131
"20164","E01003275",2001,611,225,386,74
"20165","E01003276",2001,662,158,504,73
"20166","E01003225",2001,598,38,560,50
"20167","E01003231",2001,640,129,511,143
"20168","E01003232",2001,614,68,546,81
"20169","E01003233",2001,653,103,550,80
"20170","E01003280",2001,640,228,412,45
"20171","E01003281",2001,578,85,493,25
"20172","E01003285",2001,732,82,650,115
"20173","E01003287",2001,616,88,528,71
"20174","E01003292",2001,665,99,566,138
"20175","E01003293",2001,634,160,474,141
"20176","E01003294",2001,707,138,569,129
"20177","E01003295",2001,649,142,507,167
"20178","E01003319",2001,591,135,456,119
"20179","E01003320",2001,658,237,421,87
"20180","E01003323",2001,629,147,482,112
"20181","E01003325",2001,711,203,508,126
"20182","E01003226",2001,607,68,539,158
"20183","E01003227",2001,617,71,546,97
"20184","E01003228",2001,665,99,566,180
"20185","E01003229",2001,672,266,406,108
"20186","E01003230",2001,744,215,529,116
"20187","E01003324",2001,692,292,400,92
"20188","E01003317",2001,634,106,528,101
"20189","E01003318",2001,672,164,508,208
"20190","E01003321",2001,693,222,471,106
"20191","E01003322",2001,614,111,503,132
"20192","E01003254",2001,616,105,511,62
"20193","E01003255",2001,782,172,610,215
"20194","E01003260",2001,621,163,458,69
"20195","E01003261",2001,644,174,470,80
"20196","E01003262",2001,658,200,458,113
"20197","E01003224",2001,614,61,553,75
"20198","E01003222",2001,619,99,520,48
"20199","E01003217",2001,658,51,607,50
"20200","E01003218",2001,532,57,475,25
"20201","E01003220",2001,601,95,506,93
"20202","E01003263",2001,762,237,525,82
"20203","E01003268",2001,720,178,542,95
"20204","E01003269",2001,618,196,422,24
"20205","E01003270",2001,651,32,619,50
"20206","E01003271",2001,604,17,587,21
"20207","E01003307",2001,633,140,493,86
"20208","E01003308",2001,625,183,442,80
"20209","E01003314",2001,638,155,483,65
"20210","E01003315",2001,561,201,360,111
"20211","E01003316",2001,598,110,488,79
"20212","E01003221",2001,668,130,538,118
"20213","E01003219",2001,604,56,548,35
"20214","E01003216",2001,631,129,502,100
"20215","E01003223",2001,613,50,563,48
"20216","E01003346",2001,604,209,395,26
"20217","E01003349",2001,548,274,274,16
"20218","E01003351",2001,624,305,319,19
"20219","E01003354",2001,720,44,676,83
"20220","E01003309",2001,641,330,311,49
"20221","E01003310",2001,600,281,319,97
"20222","E01003311",2001,597,72,525,43
"20223","E01003312",2001,702,114,588,91
"20224","E01003313",2001,618,297,321,57
"20225","E01003256",2001,772,306,466,91
"20226","E01003257",2001,740,268,472,74
"20227","E01003258",2001,682,415,267,55
"20228","E01003259",2001,732,161,571,133
"20229","E01003193",2001,647,226,421,37
"20230","E01003194",2001,660,293,367,79
"20231","E01003195",2001,594,78,516,45
"20232","E01003196",2001,608,294,314,33
"20233","E01003197",2001,611,345,266,33
"20234","E01003352",2001,682,272,410,29
"20235","E01003353",2001,615,63,552,35
"20236","E01003350",2001,521,200,321,25
"20237","E01003347",2001,629,434,195,28
"20238","E01003348",2001,568,138,430,21
"20239","E01003264",2001,724,149,575,81
"20240","E01003265",2001,698,203,495,153
"20241","E01003266",2001,751,346,405,29
"20242","E01003267",2001,591,233,358,27
"20243","E01003242",2001,554,245,309,16
"20244","E01003236",2001,639,302,337,33
"20245","E01003237",2001,624,301,323,31
"20246","E01003238",2001,602,276,326,10
"20247","E01003239",2001,585,271,314,11
"20248","E01003334",2001,691,311,380,77
"20249","E01003329",2001,633,198,435,66
"20250","E01003330",2001,736,439,297,57
"20251","E01003331",2001,609,226,383,34
"20252","E01003332",2001,741,321,420,73
"20253","E01003189",2001,606,349,257,20
"20254","E01003190",2001,714,368,346,58
"20255","E01003191",2001,664,275,389,52
"20256","E01003192",2001,717,466,251,34
"20257","E01003333",2001,643,176,467,101
"20258","E01003335",2001,597,363,234,24
"20259","E01003326",2001,630,180,450,77
"20260","E01003327",2001,673,132,541,112
"20261","E01003328",2001,804,279,525,128
"20262","E01003243",2001,587,221,366,61
"20263","E01003240",2001,671,310,361,30
"20264","E01003241",2001,621,263,358,27
"20265","E01003234",2001,655,305,350,16
"20266","E01003235",2001,535,151,384,24
"20267","E01003543",2001,600,135,465,116
"20268","E01003544",2001,615,134,481,140
"20269","E01003546",2001,590,277,313,80
"20270","E01003550",2001,611,212,399,98
"20271","E01003576",2001,659,362,297,120
"20272","E01003581",2001,445,49,396,120
"20273","E01003582",2001,512,176,336,96
"20274","E01003583",2001,471,64,407,112
"20275","E01003584",2001,606,116,490,117
"20276","E01003578",2001,502,74,428,171
"20277","E01003586",2001,476,72,404,124
"20278","E01003590",2001,565,320,245,65
"20279","E01003591",2001,630,238,392,172
"20280","E01003587",2001,660,253,407,186
"20281","E01003579",2001,471,106,365,103
"20282","E01003585",2001,406,36,370,113
"20283","E01003580",2001,582,168,414,99
"20284","E01003577",2001,692,509,183,40
"20285","E01003575",2001,489,94,395,111
"20286","E01003528",2001,423,270,153,35
"20287","E01003548",2001,767,247,520,143
"20288","E01003549",2001,671,325,346,119
"20289","E01003545",2001,620,274,346,94
"20290","E01003557",2001,565,185,380,158
"20291","E01003555",2001,464,71,393,101
"20292","E01003561",2001,466,61,405,122
"20293","E01003567",2001,508,100,408,163
"20294","E01003547",2001,621,126,495,92
"20295","E01003570",2001,491,98,393,122
"20296","E01003571",2001,494,42,452,142
"20297","E01003572",2001,460,91,369,115
"20298","E01003556",2001,553,241,312,101
"20299","E01003558",2001,490,120,370,147
"20300","E01003559",2001,729,232,497,159
"20301","E01003551",2001,599,193,406,168
"20302","E01003553",2001,705,366,339,126
"20303","E01003554",2001,595,157,438,132
"20304","E01003534",2001,579,69,510,164
"20305","E01003529",2001,544,80,464,142
"20306","E01003530",2001,452,64,388,93
"20307","E01003531",2001,474,129,345,113
"20308","E01003532",2001,492,71,421,121
"20309","E01003533",2001,447,84,363,96
"20310","E01003560",2001,460,51,409,114
"20311","E01003563",2001,510,65,445,126
"20312","E01003588",2001,455,96,359,98
"20313","E01003589",2001,498,59,439,136
"20314","E01003616",2001,648,264,384,145
"20315","E01003617",2001,570,380,190,53
"20316","E01003618",2001,799,196,603,213
"20317","E01003619",2001,762,464,298,120
"20318","E01003620",2001,696,540,156,38
"20319","E01003613",2001,728,425,303,89
"20320","E01003614",2001,701,309,392,183
"20321","E01003615",2001,631,277,354,93
"20322","E01003564",2001,539,100,439,141
"20323","E01003565",2001,499,95,404,144
"20324","E01003566",2001,505,216,289,92
"20325","E01003562",2001,555,63,492,149
"20326","E01003625",2001,489,107,382,117
"20327","E01003626",2001,410,33,377,105
"20328","E01003627",2001,434,66,368,105
"20329","E01003628",2001,433,42,391,94
"20330","E01003629",2001,477,50,427,146
"20331","E01003635",2001,597,132,465,123
"20332","E01003552",2001,532,130,402,135
"20333","E01003596",2001,556,149,407,128
"20334","E01003597",2001,471,123,348,114
"20335","E01003573",2001,519,73,446,122
"20336","E01003574",2001,765,223,542,174
"20337","E01003568",2001,624,110,514,166
"20338","E01003569",2001,466,83,383,128
"20339","E01003520",2001,484,87,397,153
"20340","E01003521",2001,515,59,456,184
"20341","E01003522",2001,515,96,419,107
"20342","E01003525",2001,461,56,405,121
"20343","E01003526",2001,497,93,404,106
"20344","E01003524",2001,497,110,387,128
"20345","E01003488",2001,664,466,198,52
"20346","E01003489",2001,511,294,217,75
"20347","E01003490",2001,496,133,363,90
"20348","E01003636",2001,631,354,277,84
"20349","E01003631",2001,701,281,420,118
"20350","E01003632",2001,648,113,535,125
"20351","E01003633",2001,717,529,188,47
"20352","E01003634",2001,570,367,203,37
"20353","E01003630",2001,653,364,289,103
"20354","E01003637",2001,556,162,394,105
"20355","E01003598",2001,668,470,198,66
"20356","E01003600",2001,635,379,256,51
"20357","E01003599",2001,464,204,260,75
"20358","E01003592",2001,589,196,393,111
"20359","E01003606",2001,610,118,492,125
"20360","E01003491",2001,601,254,347,115
"20361","E01003535",2001,588,380,208,60
"20362","E01003536",2001,613,129,484,111
"20363","E01003621",2001,429,46,383,74
"20364","E01003622",2001,547,197,350,110
"20365","E01003623",2001,524,209,315,66
"20366","E01003624",2001,554,177,377,79
"20367","E01003542",2001,716,368,348,50
"20368","E01003537",2001,639,121,518,56
"20369","E01003527",2001,556,65,491,66
"20370","E01003523",2001,657,217,440,94
"20371","E01003492",2001,498,64,434,86
"20372","E01003493",2001,607,144,463,134
"20373","E01003494",2001,615,63,552,82
"20374","E01003495",2001,620,45,575,96
"20375","E01003607",2001,481,172,309,81
"20376","E01003602",2001,526,139,387,95
"20377","E01003594",2001,525,214,311,86
"20378","E01003595",2001,634,362,272,91
"20379","E01003593",2001,585,299,286,72
"20380","E01003496",2001,606,435,171,60
"20381","E01003498",2001,657,380,277,85
"20382","E01003500",2001,608,338,270,45
"20383","E01003601",2001,595,253,342,55
"20384","E01003603",2001,570,65,505,77
"20385","E01003608",2001,695,84,611,122
"20386","E01003605",2001,612,222,390,89
"20387","E01003538",2001,642,221,421,107
"20388","E01003539",2001,662,157,505,81
"20389","E01003540",2001,586,262,324,69
"20390","E01003541",2001,591,99,492,67
"20391","E01003501",2001,575,253,322,54
"20392","E01003502",2001,628,338,290,83
"20393","E01003503",2001,626,481,145,30
"20394","E01003499",2001,770,476,294,75
"20395","E01003507",2001,687,275,412,97
"20396","E01003508",2001,606,297,309,97
"20397","E01003509",2001,781,142,639,444
"20398","E01003604",2001,623,176,447,119
"20399","E01003483",2001,535,288,247,61
"20400","E01003484",2001,582,96,486,133
"20401","E01003516",2001,629,422,207,43
"20402","E01003518",2001,599,124,475,76
"20403","E01003519",2001,487,131,356,58
"20404","E01003482",2001,643,227,416,116
"20405","E01003480",2001,581,247,334,74
"20406","E01003486",2001,490,371,119,42
"20407","E01003487",2001,444,275,169,41
"20408","E01003510",2001,613,473,140,20
"20409","E01003504",2001,565,383,182,32
"20410","E01003505",2001,530,435,95,17
"20411","E01003506",2001,521,336,185,43
"20412","E01003497",2001,628,319,309,108
"20413","E01003479",2001,676,157,519,157
"20414","E01003481",2001,497,224,273,70
"20415","E01003485",2001,671,158,513,152
"20416","E01003513",2001,597,111,486,112
"20417","E01003514",2001,525,287,238,68
"20418","E01003515",2001,733,460,273,56
"20419","E01003517",2001,521,281,240,53
"20420","E01003511",2001,501,381,120,27
"20421","E01003512",2001,661,306,355,64
"20422","E01003609",2001,610,382,228,59
"20423","E01003610",2001,748,395,353,115
"20424","E01003611",2001,646,497,149,42
"20425","E01003612",2001,757,177,580,181
"20426","E01004032",2001,648,47,601,149
"20427","E01004029",2001,664,147,517,173
"20428","E01004053",2001,728,99,629,188
"20429","E01004054",2001,686,76,610,167
"20430","E01004055",2001,500,352,148,25
"20431","E01003927",2001,593,356,237,103
"20432","E01003929",2001,645,391,254,104
"20433","E01003934",2001,756,358,398,111
"20434","E01003935",2001,408,290,118,44
"20435","E01003939",2001,605,322,283,122
"20436","E01003976",2001,757,501,256,87
"20437","E01003982",2001,752,358,394,146
"20438","E01004025",2001,870,54,816,344
"20439","E01004026",2001,935,87,848,310
"20440","E01004027",2001,739,494,245,91
"20441","E01004028",2001,737,587,150,40
"20442","E01004022",2001,658,412,246,47
"20443","E01004023",2001,721,444,277,75
"20444","E01003978",2001,633,346,287,100
"20445","E01003975",2001,612,509,103,28
"20446","E01003930",2001,463,249,214,91
"20447","E01003931",2001,575,340,235,88
"20448","E01003932",2001,650,428,222,69
"20449","E01003933",2001,493,224,269,88
"20450","E01003928",2001,620,368,252,120
"20451","E01003940",2001,636,495,141,47
"20452","E01003941",2001,485,332,153,54
"20453","E01003942",2001,605,440,165,42
"20454","E01003979",2001,759,373,386,135
"20455","E01003981",2001,643,413,230,108
"20456","E01003938",2001,580,437,143,40
"20457","E01004033",2001,658,426,232,59
"20458","E01004034",2001,584,388,196,75
"20459","E01004036",2001,716,531,185,79
"20460","E01004030",2001,625,394,231,74
"20461","E01004031",2001,629,331,298,105
"20462","E01004056",2001,687,314,373,125
"20463","E01004057",2001,613,180,433,93
"20464","E01004058",2001,755,81,674,271
"20465","E01004059",2001,620,51,569,236
"20466","E01004060",2001,677,342,335,113
"20467","E01003959",2001,665,564,101,29
"20468","E01003943",2001,567,435,132,52
"20469","E01003944",2001,505,402,103,33
"20470","E01003936",2001,439,146,293,157
"20471","E01003937",2001,745,235,510,256
"20472","E01003977",2001,778,514,264,76
"20473","E01004042",2001,693,525,168,20
"20474","E01004043",2001,575,226,349,46
"20475","E01004037",2001,788,368,420,139
"20476","E01004038",2001,640,203,437,164
"20477","E01004035",2001,613,475,138,22
"20478","E01004024",2001,749,547,202,67
"20479","E01003986",2001,597,494,103,26
"20480","E01003987",2001,631,517,114,24
"20481","E01003994",2001,567,360,207,86
"20482","E01003960",2001,652,279,373,127
"20483","E01003961",2001,719,545,174,57
"20484","E01003962",2001,733,624,109,39
"20485","E01003965",2001,684,342,342,230
"20486","E01003980",2001,736,555,181,56
"20487","E01004039",2001,621,201,420,128
"20488","E01004040",2001,617,510,107,51
"20489","E01004041",2001,693,433,260,148
"20490","E01004044",2001,587,435,152,34
"20491","E01003995",2001,820,584,236,60
"20492","E01003996",2001,743,575,168,38
"20493","E01003998",2001,634,300,334,124
"20494","E01003999",2001,616,352,264,76
"20495","E01003992",2001,626,467,159,42
"20496","E01003974",2001,598,490,108,49
"20497","E01003971",2001,551,472,79,12
"20498","E01003968",2001,587,519,68,19
"20499","E01003964",2001,603,376,227,74
"20500","E01003966",2001,679,469,210,118
"20501","E01003967",2001,679,579,100,30
"20502","E01003963",2001,645,532,113,44
"20503","E01003970",2001,664,541,123,23
"20504","E01003972",2001,772,567,205,94
"20505","E01003973",2001,786,655,131,69
"20506","E01003969",2001,612,299,313,127
"20507","E01003993",2001,654,551,103,25
"20508","E01003997",2001,475,221,254,65
"20509","E01003923",2001,630,351,279,90
"20510","E01003991",2001,634,452,182,25
"20511","E01003988",2001,746,506,240,45
"20512","E01003989",2001,606,546,60,20
"20513","E01003990",2001,657,524,133,29
"20514","E01004007",2001,494,425,69,29
"20515","E01003983",2001,645,558,87,24
"20516","E01004011",2001,474,424,50,17
"20517","E01004012",2001,531,424,107,38
"20518","E01004013",2001,507,444,63,22
"20519","E01004014",2001,532,467,65,16
"20520","E01003912",2001,611,498,113,46
"20521","E01003916",2001,560,296,264,72
"20522","E01003917",2001,792,413,379,118
"20523","E01003918",2001,619,475,144,52
"20524","E01003925",2001,604,475,129,54
"20525","E01003911",2001,633,438,195,51
"20526","E01003926",2001,531,396,135,58
"20527","E01003924",2001,706,603,103,49
"20528","E01003919",2001,508,252,256,105
"20529","E01003920",2001,634,522,112,38
"20530","E01003921",2001,579,462,117,74
"20531","E01003922",2001,695,450,245,76
"20532","E01004008",2001,594,468,126,17
"20533","E01004009",2001,573,280,293,58
"20534","E01004010",2001,501,293,208,60
"20535","E01003985",2001,562,499,63,29
"20536","E01004067",2001,605,386,219,62
"20537","E01003984",2001,664,401,263,62
"20538","E01004003",2001,663,504,159,26
"20539","E01004004",2001,653,300,353,104
"20540","E01004005",2001,636,475,161,54
"20541","E01004006",2001,647,267,380,77
"20542","E01003913",2001,600,180,420,92
"20543","E01003914",2001,618,227,391,107
"20544","E01003915",2001,775,493,282,74
"20545","E01004050",2001,640,114,526,173
"20546","E01004052",2001,658,243,415,104
"20547","E01004065",2001,621,172,449,125
"20548","E01004066",2001,669,338,331,80
"20549","E01004061",2001,654,178,476,111
"20550","E01004062",2001,639,265,374,130
"20551","E01004063",2001,693,248,445,97
"20552","E01004064",2001,725,412,313,73
"20553","E01004068",2001,695,447,248,42
"20554","E01004000",2001,718,319,399,107
"20555","E01004001",2001,623,426,197,46
"20556","E01004019",2001,636,299,337,95
"20557","E01004051",2001,613,115,498,77
"20558","E01004045",2001,613,498,115,45
"20559","E01004047",2001,596,422,174,40
"20560","E01004048",2001,608,236,372,70
"20561","E01004049",2001,479,353,126,36
"20562","E01004046",2001,628,176,452,120
"20563","E01004021",2001,814,149,665,294
"20564","E01004015",2001,663,157,506,126
"20565","E01003953",2001,741,160,581,169
"20566","E01003955",2001,699,201,498,113
"20567","E01004016",2001,842,212,630,134
"20568","E01004017",2001,602,102,500,104
"20569","E01004020",2001,624,373,251,64
"20570","E01004002",2001,581,118,463,88
"20571","E01003956",2001,659,100,559,139
"20572","E01003952",2001,649,106,543,153
"20573","E01003954",2001,609,116,493,112
"20574","E01004071",2001,618,244,374,96
"20575","E01004072",2001,592,75,517,84
"20576","E01004073",2001,640,79,561,133
"20577","E01004074",2001,495,61,434,44
"20578","E01004075",2001,597,53,544,84
"20579","E01004069",2001,499,62,437,38
"20580","E01004070",2001,645,139,506,80
"20581","E01003949",2001,653,130,523,113
"20582","E01003950",2001,653,371,282,64
"20583","E01003957",2001,630,122,508,111
"20584","E01003958",2001,662,171,491,104
"20585","E01004018",2001,751,97,654,146
"20586","E01003951",2001,562,92,470,71
"20587","E01003945",2001,628,172,456,54
"20588","E01003946",2001,724,147,577,102
"20589","E01003947",2001,610,425,185,49
"20590","E01003948",2001,768,119,649,179
"20591","E01004222",2001,759,533,226,37
"20592","E01004223",2001,697,479,218,56
"20593","E01004224",2001,614,428,186,61
"20594","E01004226",2001,602,371,231,58
"20595","E01004197",2001,669,376,293,95
"20596","E01004198",2001,572,382,190,60
"20597","E01004199",2001,532,393,139,53
"20598","E01004201",2001,611,344,267,104
"20599","E01004232",2001,545,121,424,132
"20600","E01004233",2001,728,448,280,79
"20601","E01004234",2001,757,222,535,148
"20602","E01004228",2001,619,227,392,101
"20603","E01004230",2001,681,304,377,111
"20604","E01004231",2001,531,299,232,55
"20605","E01004229",2001,541,284,257,71
"20606","E01004227",2001,707,404,303,98
"20607","E01004225",2001,835,83,752,248
"20608","E01004202",2001,511,231,280,76
"20609","E01004203",2001,607,279,328,88
"20610","E01004204",2001,668,438,230,54
"20611","E01004200",2001,452,154,298,146
"20612","E01004311",2001,676,441,235,76
"20613","E01004314",2001,519,129,390,161
"20614","E01004315",2001,633,379,254,65
"20615","E01004318",2001,679,479,200,73
"20616","E01004266",2001,591,297,294,61
"20617","E01004263",2001,547,399,148,58
"20618","E01004259",2001,782,347,435,133
"20619","E01004260",2001,519,347,172,46
"20620","E01004235",2001,511,414,97,39
"20621","E01004236",2001,453,335,118,24
"20622","E01004237",2001,650,418,232,64
"20623","E01004238",2001,498,369,129,27
"20624","E01004239",2001,458,297,161,43
"20625","E01004316",2001,408,270,138,43
"20626","E01004317",2001,602,234,368,124
"20627","E01004312",2001,625,483,142,34
"20628","E01004313",2001,575,370,205,69
"20629","E01004264",2001,477,285,192,58
"20630","E01004265",2001,778,501,277,68
"20631","E01004261",2001,462,299,163,56
"20632","E01004262",2001,474,283,191,63
"20633","E01004207",2001,568,368,200,86
"20634","E01004209",2001,535,415,120,41
"20635","E01004210",2001,446,312,134,40
"20636","E01004212",2001,589,298,291,82
"20637","E01004213",2001,406,289,117,38
"20638","E01004240",2001,553,380,173,55
"20639","E01004241",2001,529,404,125,39
"20640","E01004242",2001,534,400,134,41
"20641","E01004267",2001,612,266,346,107
"20642","E01004268",2001,619,511,108,53
"20643","E01004211",2001,688,199,489,195
"20644","E01004208",2001,669,195,474,159
"20645","E01004205",2001,583,420,163,60
"20646","E01004206",2001,558,385,173,50
"20647","E01004269",2001,699,426,273,91
"20648","E01004270",2001,647,237,410,144
"20649","E01004271",2001,598,430,168,52
"20650","E01004272",2001,588,476,112,39
"20651","E01004273",2001,472,341,131,47
"20652","E01004306",2001,508,275,233,72
"20653","E01004307",2001,814,254,560,273
"20654","E01004308",2001,489,211,278,69
"20655","E01004309",2001,533,334,199,71
"20656","E01004310",2001,583,352,231,98
"20657","E01004283",2001,629,385,244,64
"20658","E01004287",2001,695,483,212,39
"20659","E01004289",2001,656,391,265,74
"20660","E01004290",2001,624,275,349,119
"20661","E01004322",2001,579,339,240,107
"20662","E01004323",2001,534,231,303,108
"20663","E01004324",2001,513,361,152,38
"20664","E01004326",2001,633,294,339,156
"20665","E01004245",2001,430,336,94,31
"20666","E01004246",2001,615,223,392,58
"20667","E01004248",2001,442,351,91,22
"20668","E01004249",2001,626,455,171,55
"20669","E01004288",2001,507,372,135,26
"20670","E01004284",2001,486,355,131,53
"20671","E01004285",2001,462,330,132,43
"20672","E01004286",2001,564,350,214,62
"20673","E01004247",2001,541,365,176,32
"20674","E01004250",2001,613,513,100,30
"20675","E01004243",2001,516,350,166,47
"20676","E01004244",2001,634,403,231,63
"20677","E01004325",2001,493,137,356,243
"20678","E01004319",2001,472,294,178,41
"20679","E01004320",2001,620,162,458,227
"20680","E01004321",2001,493,324,169,101
"20681","E01004300",2001,534,377,157,49
"20682","E01004304",2001,547,334,213,71
"20683","E01004305",2001,517,349,168,52
"20684","E01004298",2001,485,376,109,30
"20685","E01004251",2001,670,432,238,49
"20686","E01004254",2001,756,129,627,264
"20687","E01004255",2001,508,340,168,52
"20688","E01004258",2001,735,240,495,178
"20689","E01004256",2001,563,368,195,65
"20690","E01004257",2001,575,365,210,45
"20691","E01004252",2001,569,403,166,40
"20692","E01004253",2001,729,460,269,59
"20693","E01004299",2001,807,115,692,303
"20694","E01004301",2001,474,310,164,56
"20695","E01004302",2001,408,299,109,45
"20696","E01004303",2001,665,276,389,116
"20697","E01004292",2001,779,104,675,207
"20698","E01004294",2001,667,267,400,166
"20699","E01004295",2001,499,346,153,66
"20700","E01004296",2001,607,348,259,100
"20701","E01004297",2001,954,186,768,247
"20702","E01004293",2001,868,201,667,280
"20703","E01004291",2001,928,183,745,215
"20704","E01004219",2001,532,352,180,82
"20705","E01004220",2001,734,119,615,304
"20706","E01004221",2001,624,222,402,169
"20707","E01004215",2001,613,265,348,103
"20708","E01004277",2001,793,179,614,349
"20709","E01004278",2001,601,406,195,73
"20710","E01004279",2001,619,195,424,252
"20711","E01004280",2001,611,317,294,104
"20712","E01004216",2001,756,208,548,247
"20713","E01004217",2001,707,327,380,124
"20714","E01004218",2001,697,145,552,193
"20715","E01004214",2001,641,445,196,107
"20716","E01004281",2001,828,118,710,302
"20717","E01004282",2001,771,247,524,233
"20718","E01004274",2001,476,231,245,111
"20719","E01004275",2001,557,142,415,109
"20720","E01004276",2001,762,77,685,324
"20721","E01004560",2001,820,176,644,239
"20722","E01004566",2001,818,107,711,252
"20723","E01004582",2001,747,105,642,165
"20724","E01004583",2001,806,159,647,235
"20725","E01004567",2001,712,541,171,63
"20726","E01004561",2001,843,412,431,193
"20727","E01004562",2001,728,352,376,123
"20728","E01004563",2001,659,387,272,102
"20729","E01004564",2001,761,278,483,200
"20730","E01004539",2001,768,522,246,78
"20731","E01004540",2001,815,331,484,139
"20732","E01004584",2001,639,464,175,66
"20733","E01004577",2001,800,168,632,235
"20734","E01004578",2001,738,242,496,166
"20735","E01004579",2001,691,247,444,140
"20736","E01004580",2001,739,161,578,207
"20737","E01004581",2001,794,209,585,209
"20738","E01004590",2001,768,389,379,102
"20739","E01004591",2001,737,248,489,195
"20740","E01004592",2001,761,474,287,87
"20741","E01004565",2001,786,294,492,201
"20742","E01004604",2001,594,20,574,110
"20743","E01004605",2001,728,154,574,138
"20744","E01004606",2001,728,18,710,277
"20745","E01004607",2001,721,37,684,192
"20746","E01004608",2001,771,182,589,165
"20747","E01004541",2001,761,461,300,87
"20748","E01004535",2001,652,489,163,55
"20749","E01004537",2001,717,468,249,67
"20750","E01004538",2001,668,357,311,85
"20751","E01004536",2001,802,312,490,228
"20752","E01004534",2001,661,86,575,153
"20753","E01004552",2001,741,71,670,300
"20754","E01004588",2001,719,63,656,216
"20755","E01004585",2001,764,176,588,169
"20756","E01004586",2001,729,102,627,210
"20757","E01004587",2001,715,83,632,189
"20758","E01004589",2001,646,53,593,214
"20759","E01004554",2001,626,60,566,132
"20760","E01004556",2001,538,27,511,105
"20761","E01004509",2001,788,177,611,226
"20762","E01004511",2001,654,28,626,212
"20763","E01004609",2001,770,51,719,318
"20764","E01004602",2001,669,43,626,236
"20765","E01004603",2001,698,40,658,239
"20766","E01004638",2001,501,39,462,35
"20767","E01004639",2001,724,84,640,232
"20768","E01004640",2001,765,53,712,199
"20769","E01004641",2001,714,177,537,78
"20770","E01004506",2001,810,67,743,256
"20771","E01004510",2001,748,138,610,191
"20772","E01004508",2001,796,158,638,241
"20773","E01004514",2001,743,102,641,162
"20774","E01004515",2001,701,205,496,141
"20775","E01004551",2001,697,340,357,161
"20776","E01004574",2001,666,446,220,66
"20777","E01004575",2001,593,309,284,65
"20778","E01004576",2001,526,230,296,63
"20779","E01004568",2001,405,285,120,32
"20780","E01004507",2001,848,140,708,277
"20781","E01004500",2001,789,152,637,232
"20782","E01004501",2001,668,201,467,145
"20783","E01004503",2001,721,124,597,203
"20784","E01004505",2001,778,43,735,229
"20785","E01004557",2001,606,73,533,129
"20786","E01004558",2001,635,74,561,153
"20787","E01004559",2001,523,65,458,111
"20788","E01004553",2001,726,138,588,173
"20789","E01004619",2001,524,70,454,102
"20790","E01004642",2001,712,221,491,96
"20791","E01004643",2001,777,276,501,129
"20792","E01004644",2001,635,183,452,54
"20793","E01004645",2001,753,353,400,107
"20794","E01004572",2001,656,201,455,92
"20795","E01004555",2001,580,26,554,108
"20796","E01004550",2001,557,138,419,144
"20797","E01004477",2001,629,81,548,95
"20798","E01004478",2001,538,49,489,94
"20799","E01004479",2001,624,104,520,120
"20800","E01004494",2001,642,191,451,146
"20801","E01004513",2001,739,183,556,160
"20802","E01004600",2001,641,419,222,105
"20803","E01004601",2001,782,193,589,168
"20804","E01004620",2001,684,126,558,150
"20805","E01004621",2001,633,88,545,128
"20806","E01004627",2001,607,118,489,116
"20807","E01004623",2001,656,80,576,117
"20808","E01004512",2001,612,110,502,137
"20809","E01004493",2001,724,128,596,158
"20810","E01004502",2001,605,37,568,132
"20811","E01004499",2001,670,87,583,194
"20812","E01004504",2001,563,22,541,189
"20813","E01004629",2001,513,82,431,68
"20814","E01004594",2001,593,12,581,105
"20815","E01004596",2001,624,22,602,146
"20816","E01004476",2001,754,138,616,298
"20817","E01004544",2001,569,86,483,106
"20818","E01004542",2001,615,74,541,135
"20819","E01004474",2001,631,102,529,230
"20820","E01004472",2001,624,51,573,142
"20821","E01004630",2001,613,327,286,80
"20822","E01004631",2001,648,161,487,150
"20823","E01004633",2001,591,307,284,110
"20824","E01004628",2001,424,148,276,63
"20825","E01004573",2001,617,184,433,78
"20826","E01004569",2001,601,203,398,101
"20827","E01004570",2001,661,437,224,67
"20828","E01004571",2001,586,289,297,77
"20829","E01004624",2001,612,110,502,84
"20830","E01004622",2001,522,124,398,114
"20831","E01004495",2001,496,208,288,69
"20832","E01004496",2001,676,100,576,219
"20833","E01004497",2001,508,97,411,67
"20834","E01004593",2001,821,59,762,243
"20835","E01004597",2001,770,147,623,133
"20836","E01004598",2001,760,64,696,190
"20837","E01004599",2001,580,16,564,73
"20838","E01004595",2001,741,52,689,193
"20839","E01004480",2001,646,44,602,187
"20840","E01004483",2001,733,42,691,195
"20841","E01004484",2001,642,110,532,175
"20842","E01004486",2001,794,141,653,273
"20843","E01004473",2001,652,114,538,149
"20844","E01004475",2001,574,118,456,134
"20845","E01004625",2001,468,13,455,49
"20846","E01004626",2001,649,24,625,143
"20847","E01004543",2001,648,47,601,173
"20848","E01004545",2001,904,54,850,316
"20849","E01004546",2001,633,75,558,157
"20850","E01004549",2001,656,112,544,194
"20851","E01004634",2001,684,129,555,153
"20852","E01004635",2001,621,92,529,146
"20853","E01004636",2001,622,133,489,151
"20854","E01004637",2001,588,162,426,104
"20855","E01004632",2001,581,73,508,120
"20856","E01004547",2001,554,144,410,119
"20857","E01004548",2001,826,99,727,315
"20858","E01004481",2001,672,80,592,244
"20859","E01004488",2001,616,110,506,158
"20860","E01004489",2001,650,124,526,235
"20861","E01004482",2001,583,75,508,165
"20862","E01004487",2001,726,195,531,237
"20863","E01004485",2001,634,135,499,159
"20864","E01004490",2001,592,20,572,163
"20865","E01004491",2001,688,212,476,242
"20866","E01004492",2001,693,131,562,162
"20867","E01004498",2001,738,53,685,218
"20868","E01004532",2001,608,135,473,116
"20869","E01004618",2001,547,28,519,137
"20870","E01004611",2001,530,59,471,123
"20871","E01004612",2001,511,55,456,191
"20872","E01004613",2001,621,205,416,198
"20873","E01004610",2001,512,54,458,111
"20874","E01004533",2001,564,190,374,101
"20875","E01004531",2001,650,213,437,118
"20876","E01004614",2001,753,149,604,223
"20877","E01004615",2001,717,344,373,126
"20878","E01004616",2001,651,66,585,268
"20879","E01004617",2001,600,115,485,235
"20880","E01004525",2001,589,29,560,258
"20881","E01004526",2001,589,91,498,210
"20882","E01004527",2001,533,46,487,155
"20883","E01004528",2001,640,177,463,141
"20884","E01004529",2001,702,82,620,250
"20885","E01004530",2001,606,71,535,167
"20886","E01004523",2001,713,212,501,113
"20887","E01004516",2001,495,46,449,61
"20888","E01004518",2001,594,56,538,118
"20889","E01004519",2001,580,114,466,114
"20890","E01004520",2001,431,70,361,58
"20891","E01004521",2001,695,100,595,144
"20892","E01004522",2001,577,55,522,135
"20893","E01004517",2001,652,58,594,243
"20894","E01004524",2001,769,319,450,150
"20895","E01004649",2001,698,72,626,296
"20896","E01004647",2001,747,190,557,219
"20897","E01004724",2001,808,147,661,309
"20898","E01004730",2001,760,47,713,262
"20899","E01004710",2001,656,294,362,130
"20900","E01004711",2001,789,321,468,203
"20901","E01004648",2001,732,58,674,252
"20902","E01004650",2001,748,57,691,298
"20903","E01004646",2001,644,116,528,230
"20904","E01004651",2001,1123,207,916,430
"20905","E01004725",2001,862,382,480,231
"20906","E01004726",2001,824,84,740,309
"20907","E01004728",2001,815,216,599,253
"20908","E01004729",2001,789,389,400,167
"20909","E01004718",2001,635,339,296,76
"20910","E01004719",2001,640,358,282,36
"20911","E01004720",2001,627,349,278,26
"20912","E01004721",2001,701,432,269,72
"20913","E01004722",2001,588,407,181,57
"20914","E01004723",2001,652,368,284,115
"20915","E01004677",2001,631,276,355,106
"20916","E01004678",2001,637,284,353,106
"20917","E01004679",2001,626,349,277,113
"20918","E01004674",2001,608,361,247,44
"20919","E01004675",2001,741,374,367,152
"20920","E01004676",2001,754,231,523,259
"20921","E01004706",2001,717,57,660,289
"20922","E01004707",2001,855,46,809,302
"20923","E01004708",2001,751,201,550,233
"20924","E01004756",2001,755,277,478,229
"20925","E01004709",2001,812,194,618,227
"20926","E01004701",2001,887,107,780,357
"20927","E01004703",2001,684,50,634,163
"20928","E01004704",2001,897,185,712,256
"20929","E01004705",2001,760,64,696,299
"20930","E01004712",2001,733,77,656,319
"20931","E01004727",2001,913,69,844,359
"20932","E01004659",2001,871,78,793,410
"20933","E01004660",2001,752,45,707,291
"20934","E01004670",2001,619,429,190,78
"20935","E01004671",2001,733,456,277,90
"20936","E01004672",2001,652,388,264,60
"20937","E01004673",2001,749,302,447,252
"20938","E01004702",2001,706,320,386,117
"20939","E01004757",2001,615,321,294,86
"20940","E01004758",2001,574,433,141,49
"20941","E01004759",2001,624,396,228,64
"20942","E01004754",2001,605,366,239,55
"20943","E01004755",2001,646,260,386,194
"20944","E01004762",2001,759,218,541,242
"20945","E01004716",2001,722,37,685,309
"20946","E01004717",2001,870,31,839,595
"20947","E01004713",2001,850,56,794,452
"20948","E01004714",2001,828,34,794,475
"20949","E01004661",2001,712,103,609,334
"20950","E01004662",2001,905,118,787,487
"20951","E01004663",2001,810,146,664,272
"20952","E01004657",2001,701,42,659,394
"20953","E01004658",2001,726,26,700,437
"20954","E01004715",2001,789,241,548,244
"20955","E01004763",2001,758,120,638,417
"20956","E01004764",2001,998,479,519,301
"20957","E01004765",2001,859,242,617,295
"20958","E01004760",2001,625,221,404,124
"20959","E01004653",2001,817,153,664,247
"20960","E01004654",2001,921,167,754,295
"20961","E01004655",2001,907,306,601,242
"20962","E01004656",2001,966,241,725,279
"20963","E01004683",2001,698,35,663,257
"20964","E01004684",2001,617,50,567,295
"20965","E01004685",2001,651,226,425,215
"20966","E01004686",2001,822,70,752,487
"20967","E01004680",2001,709,35,674,289
"20968","E01004681",2001,882,76,806,372
"20969","E01004682",2001,636,85,551,307
"20970","E01004694",2001,786,83,703,409
"20971","E01004697",2001,842,138,704,362
"20972","E01004700",2001,910,18,892,525
"20973","E01004693",2001,766,63,703,343
"20974","E01004698",2001,771,93,678,385
"20975","E01004699",2001,872,58,814,505
"20976","E01004695",2001,694,73,621,396
"20977","E01004696",2001,779,327,452,170
"20978","E01004652",2001,923,110,813,433
"20979","E01004761",2001,806,141,665,309
"20980","E01004734",2001,877,353,524,337
"20981","E01004735",2001,765,384,381,184
"20982","E01004736",2001,640,82,558,303
"20983","E01004687",2001,815,52,763,320
"20984","E01004688",2001,528,72,456,159
"20985","E01004689",2001,513,87,426,218
"20986","E01004690",2001,740,97,643,262
"20987","E01004691",2001,909,117,792,376
"20988","E01004692",2001,725,161,564,212
"20989","E01004731",2001,743,125,618,324
"20990","E01004732",2001,744,549,195,87
"20991","E01004733",2001,659,189,470,187
"20992","E01004744",2001,697,350,347,182
"20993","E01004748",2001,605,89,516,167
"20994","E01004745",2001,858,296,562,181
"20995","E01004746",2001,756,466,290,85
"20996","E01004747",2001,769,261,508,219
"20997","E01004740",2001,711,414,297,69
"20998","E01004743",2001,618,346,272,94
"20999","E01004742",2001,912,188,724,355
"21000","E01004749",2001,841,63,778,324
"21001","E01004751",2001,903,124,779,310
"21002","E01004752",2001,989,442,547,252
"21003","E01004753",2001,997,414,583,228
"21004","E01004750",2001,908,398,510,244
"21005","E01004666",2001,589,284,305,151
"21006","E01004667",2001,753,366,387,156
"21007","E01004668",2001,652,256,396,104
"21008","E01004664",2001,738,565,173,62
"21009","E01004665",2001,609,354,255,61
"21010","E01004669",2001,741,370,371,86
"21011","E01004741",2001,749,307,442,194
"21012","E01004737",2001,733,388,345,170
"21013","E01004738",2001,770,142,628,326
"21014","E01004739",2001,1158,723,435,355
"21015","E01000027",2001,633,297,336,13
"21016","E01000028",2001,640,357,283,31
"21017","E01000029",2001,731,75,656,33
"21018","E01000030",2001,729,439,290,28
"21019","E01000031",2001,617,31,586,27
"21020","E01000032",2001,640,120,520,66
"21021","E01000110",2001,536,15,521,38
"21022","E01000111",2001,752,259,493,52
"21023","E01000112",2001,599,61,538,94
"21024","E01000113",2001,637,27,610,82
"21025","E01000037",2001,594,32,562,19
"21026","E01000038",2001,597,90,507,25
"21027","E01000039",2001,663,82,581,25
"21028","E01000034",2001,542,224,318,17
"21029","E01000063",2001,643,258,385,13
"21030","E01000114",2001,744,75,669,58
"21031","E01000100",2001,623,226,397,16
"21032","E01000101",2001,577,235,342,22
"21033","E01000109",2001,607,99,508,27
"21034","E01000097",2001,649,282,367,18
"21035","E01000098",2001,586,244,342,34
"21036","E01000099",2001,644,226,418,19
"21037","E01000026",2001,462,151,311,52
"21038","E01000019",2001,550,156,394,33
"21039","E01000020",2001,624,219,405,38
"21040","E01000033",2001,539,285,254,7
"21041","E01000064",2001,655,217,438,39
"21042","E01000060",2001,739,363,376,16
"21043","E01000061",2001,651,569,82,16
"21044","E01000062",2001,739,259,480,27
"21045","E01000078",2001,635,246,389,36
"21046","E01000102",2001,630,273,357,21
"21047","E01000065",2001,739,358,381,29
"21048","E01000080",2001,606,250,356,19
"21049","E01000081",2001,647,224,423,19
"21050","E01000082",2001,619,265,354,36
"21051","E01000083",2001,640,252,388,33
"21052","E01000021",2001,610,169,441,86
"21053","E01000022",2001,510,132,378,34
"21054","E01000023",2001,408,146,262,44
"21055","E01000024",2001,489,154,335,30
"21056","E01000025",2001,640,254,386,22
"21057","E01000077",2001,598,276,322,30
"21058","E01000079",2001,626,255,371,15
"21059","E01000015",2001,626,266,360,18
"21060","E01000016",2001,662,249,413,37
"21061","E01000017",2001,642,284,358,24
"21062","E01000018",2001,611,245,366,21
"21063","E01000035",2001,573,111,462,53
"21064","E01000036",2001,485,28,457,39
"21065","E01000107",2001,603,82,521,24
"21066","E01000108",2001,650,75,575,63
"21067","E01000069",2001,496,10,486,10
"21068","E01000070",2001,594,43,551,32
"21069","E01000071",2001,616,65,551,47
"21070","E01000066",2001,643,187,456,18
"21071","E01000067",2001,642,145,497,24
"21072","E01000057",2001,498,214,284,34
"21073","E01000073",2001,636,238,398,20
"21074","E01000074",2001,642,306,336,21
"21075","E01000075",2001,633,250,383,16
"21076","E01000076",2001,702,334,368,30
"21077","E01000084",2001,533,246,287,21
"21078","E01000085",2001,624,283,341,30
"21079","E01000086",2001,506,212,294,16
"21080","E01000013",2001,618,223,395,20
"21081","E01000014",2001,669,305,364,19
"21082","E01000059",2001,618,264,354,26
"21083","E01000103",2001,585,215,370,26
"21084","E01000104",2001,720,439,281,37
"21085","E01000105",2001,805,471,334,35
"21086","E01000106",2001,863,401,462,90
"21087","E01000012",2001,617,147,470,168
"21088","E01000007",2001,663,410,253,66
"21089","E01000008",2001,524,380,144,25
"21090","E01000010",2001,596,254,342,96
"21091","E01000011",2001,466,76,390,79
"21092","E01000009",2001,604,161,443,85
"21093","E01000006",2001,621,67,554,69
"21094","E01000068",2001,491,25,466,36
"21095","E01000044",2001,631,80,551,79
"21096","E01000045",2001,597,252,345,34
"21097","E01000046",2001,644,243,401,14
"21098","E01000072",2001,640,291,349,33
"21099","E01000041",2001,621,247,374,23
"21100","E01000042",2001,632,374,258,16
"21101","E01000058",2001,608,267,341,16
"21102","E01000054",2001,649,257,392,19
"21103","E01000055",2001,580,241,339,14
"21104","E01000056",2001,519,247,272,13
"21105","E01000095",2001,560,156,404,35
"21106","E01000092",2001,640,239,401,24
"21107","E01000050",2001,613,234,379,55
"21108","E01000052",2001,789,224,565,58
"21109","E01000043",2001,499,200,299,17
"21110","E01000040",2001,629,358,271,34
"21111","E01000053",2001,601,211,390,64
"21112","E01000087",2001,466,156,310,30
"21113","E01000088",2001,606,37,569,67
"21114","E01000089",2001,617,21,596,45
"21115","E01000090",2001,567,41,526,50
"21116","E01000051",2001,645,549,96,13
"21117","E01000047",2001,737,534,203,60
"21118","E01000048",2001,631,520,111,21
"21119","E01000049",2001,638,474,164,22
"21120","E01000091",2001,648,383,265,18
"21121","E01000093",2001,629,428,201,17
"21122","E01000094",2001,630,306,324,43
"21123","E01000096",2001,616,425,191,17
"21124","E01000248",2001,624,47,577,74
"21125","E01000249",2001,576,8,568,44
"21126","E01000250",2001,742,60,682,121
"21127","E01000254",2001,602,18,584,40
"21128","E01000292",2001,627,57,570,58
"21129","E01000293",2001,628,22,606,54
"21130","E01000246",2001,642,12,630,53
"21131","E01000247",2001,756,36,720,125
"21132","E01000251",2001,780,114,666,159
"21133","E01000252",2001,768,139,629,116
"21134","E01000167",2001,558,195,363,37
"21135","E01000168",2001,575,16,559,22
"21136","E01000169",2001,709,28,681,123
"21137","E01000172",2001,612,21,591,55
"21138","E01000166",2001,635,69,566,56
"21139","E01000294",2001,657,136,521,77
"21140","E01000287",2001,604,206,398,37
"21141","E01000288",2001,580,76,504,32
"21142","E01000289",2001,648,380,268,34
"21143","E01000285",2001,636,113,523,40
"21144","E01000291",2001,594,304,290,24
"21145","E01000267",2001,587,26,561,70
"21146","E01000268",2001,633,59,574,121
"21147","E01000269",2001,513,14,499,26
"21148","E01000270",2001,620,30,590,61
"21149","E01000173",2001,607,47,560,35
"21150","E01000174",2001,683,75,608,146
"21151","E01000175",2001,610,12,598,49
"21152","E01000170",2001,633,123,510,78
"21153","E01000171",2001,782,63,719,230
"21154","E01000228",2001,463,76,387,24
"21155","E01000279",2001,519,3,516,34
"21156","E01000280",2001,505,6,499,24
"21157","E01000253",2001,587,11,576,22
"21158","E01000286",2001,677,223,454,35
"21159","E01000290",2001,621,132,489,20
"21160","E01000281",2001,508,43,465,253
"21161","E01000282",2001,629,19,610,91
"21162","E01000271",2001,614,12,602,68
"21163","E01000272",2001,467,3,464,34
"21164","E01000273",2001,644,120,524,103
"21165","E01000119",2001,512,15,497,36
"21166","E01000120",2001,498,8,490,36
"21167","E01000122",2001,516,9,507,44
"21168","E01000115",2001,489,19,470,19
"21169","E01000116",2001,605,43,562,45
"21170","E01000117",2001,637,18,619,27
"21171","E01000118",2001,604,22,582,29
"21172","E01000123",2001,675,34,641,68
"21173","E01000124",2001,626,185,441,90
"21174","E01000121",2001,477,189,288,41
"21175","E01000274",2001,624,119,505,42
"21176","E01000265",2001,765,84,681,147
"21177","E01000266",2001,506,9,497,21
"21178","E01000320",2001,646,25,621,87
"21179","E01000322",2001,750,65,685,230
"21180","E01000321",2001,647,49,598,199
"21181","E01000277",2001,779,220,559,206
"21182","E01000283",2001,487,7,480,55
"21183","E01000284",2001,771,110,661,171
"21184","E01000275",2001,622,51,571,131
"21185","E01000229",2001,617,170,447,41
"21186","E01000230",2001,617,17,600,34
"21187","E01000231",2001,638,47,591,64
"21188","E01000232",2001,610,75,535,63
"21189","E01000233",2001,609,29,580,69
"21190","E01000195",2001,623,161,462,82
"21191","E01000186",2001,497,3,494,16
"21192","E01000187",2001,592,124,468,41
"21193","E01000188",2001,478,3,475,27
"21194","E01000189",2001,638,445,193,64
"21195","E01000190",2001,534,39,495,36
"21196","E01000191",2001,489,4,485,30
"21197","E01000158",2001,542,90,452,80
"21198","E01000159",2001,607,77,530,55
"21199","E01000160",2001,644,30,614,127
"21200","E01000161",2001,642,97,545,86
"21201","E01000162",2001,516,57,459,56
"21202","E01000324",2001,627,48,579,71
"21203","E01000256",2001,638,41,597,47
"21204","E01000258",2001,634,21,613,75
"21205","E01000263",2001,499,6,493,19
"21206","E01000264",2001,593,51,542,140
"21207","E01000261",2001,623,125,498,37
"21208","E01000262",2001,542,29,513,89
"21209","E01000257",2001,618,238,380,132
"21210","E01000255",2001,486,116,370,41
"21211","E01000192",2001,617,20,597,145
"21212","E01000193",2001,516,8,508,75
"21213","E01000194",2001,552,26,526,135
"21214","E01000226",2001,647,277,370,54
"21215","E01000227",2001,606,7,599,54
"21216","E01000323",2001,788,42,746,293
"21217","E01000317",2001,615,46,569,148
"21218","E01000318",2001,578,39,539,64
"21219","E01000299",2001,583,57,526,148
"21220","E01000300",2001,629,71,558,119
"21221","E01000302",2001,745,88,657,259
"21222","E01000303",2001,511,31,480,93
"21223","E01000304",2001,591,59,532,146
"21224","E01000301",2001,505,6,499,104
"21225","E01000276",2001,477,3,474,52
"21226","E01000278",2001,497,3,494,83
"21227","E01000234",2001,621,19,602,87
"21228","E01000235",2001,521,168,353,42
"21229","E01000130",2001,587,210,377,58
"21230","E01000132",2001,529,231,298,23
"21231","E01000133",2001,596,260,336,48
"21232","E01000163",2001,754,277,477,103
"21233","E01000164",2001,626,215,411,85
"21234","E01000165",2001,634,23,611,68
"21235","E01000156",2001,639,33,606,142
"21236","E01000157",2001,659,89,570,106
"21237","E01000315",2001,601,283,318,33
"21238","E01000298",2001,654,59,595,206
"21239","E01000295",2001,635,26,609,165
"21240","E01000296",2001,658,45,613,252
"21241","E01000197",2001,645,12,633,202
"21242","E01000134",2001,645,209,436,93
"21243","E01000131",2001,622,89,533,108
"21244","E01000127",2001,548,245,303,39
"21245","E01000128",2001,637,208,429,44
"21246","E01000129",2001,602,296,306,97
"21247","E01000125",2001,645,269,376,75
"21248","E01000198",2001,632,6,626,99
"21249","E01000199",2001,646,11,635,97
"21250","E01000204",2001,606,69,537,114
"21251","E01000259",2001,613,6,607,67
"21252","E01000260",2001,651,36,615,101
"21253","E01000126",2001,482,252,230,54
"21254","E01000151",2001,633,417,216,55
"21255","E01000152",2001,584,376,208,41
"21256","E01000153",2001,633,404,229,34
"21257","E01000154",2001,613,387,226,39
"21258","E01000297",2001,531,57,474,100
"21259","E01000316",2001,636,61,575,137
"21260","E01000319",2001,521,50,471,73
"21261","E01000184",2001,478,242,236,44
"21262","E01000178",2001,607,70,537,104
"21263","E01000176",2001,665,381,284,43
"21264","E01000196",2001,781,24,757,313
"21265","E01000200",2001,764,42,722,139
"21266","E01000201",2001,501,8,493,53
"21267","E01000202",2001,604,29,575,120
"21268","E01000203",2001,598,120,478,120
"21269","E01000177",2001,679,26,653,131
"21270","E01000179",2001,777,42,735,202
"21271","E01000180",2001,697,233,464,126
"21272","E01000181",2001,630,21,609,199
"21273","E01000182",2001,709,23,686,201
"21274","E01000185",2001,613,336,277,76
"21275","E01000155",2001,861,181,680,281
"21276","E01000147",2001,524,18,506,51
"21277","E01000148",2001,631,208,423,103
"21278","E01000149",2001,630,55,575,79
"21279","E01000239",2001,741,80,661,198
"21280","E01000240",2001,529,19,510,81
"21281","E01000241",2001,651,48,603,124
"21282","E01000309",2001,556,49,507,116
"21283","E01000242",2001,564,99,465,68
"21284","E01000243",2001,723,40,683,235
"21285","E01000244",2001,527,59,468,110
"21286","E01000245",2001,749,308,441,117
"21287","E01000237",2001,644,32,612,189
"21288","E01000314",2001,582,19,563,164
"21289","E01000206",2001,454,3,451,59
"21290","E01000207",2001,606,39,567,118
"21291","E01000208",2001,612,12,600,124
"21292","E01000210",2001,595,6,589,110
"21293","E01000213",2001,493,88,405,23
"21294","E01000183",2001,601,68,533,118
"21295","E01000238",2001,574,16,558,125
"21296","E01000236",2001,657,48,609,209
"21297","E01000310",2001,588,79,509,144
"21298","E01000311",2001,464,20,444,97
"21299","E01000211",2001,783,53,730,296
"21300","E01000212",2001,525,16,509,118
"21301","E01000209",2001,778,107,671,80
"21302","E01000216",2001,645,50,595,194
"21303","E01000217",2001,498,10,488,150
"21304","E01000205",2001,611,8,603,60
"21305","E01000312",2001,654,123,531,141
"21306","E01000313",2001,591,67,524,162
"21307","E01000308",2001,752,470,282,51
"21308","E01000305",2001,548,96,452,113
"21309","E01000306",2001,497,26,471,84
"21310","E01000150",2001,608,53,555,80
"21311","E01000145",2001,431,5,426,110
"21312","E01000225",2001,500,80,420,63
"21313","E01000218",2001,510,5,505,174
"21314","E01000219",2001,490,22,468,156
"21315","E01000220",2001,490,56,434,168
"21316","E01000215",2001,617,62,555,145
"21317","E01000214",2001,708,21,687,239
"21318","E01000146",2001,638,66,572,288
"21319","E01000144",2001,577,16,561,269
"21320","E01000135",2001,485,16,469,109
"21321","E01000136",2001,520,11,509,107
"21322","E01000141",2001,711,147,564,247
"21323","E01000223",2001,496,173,323,60
"21324","E01000221",2001,516,301,215,53
"21325","E01000307",2001,514,101,413,63
"21326","E01000222",2001,488,55,433,90
"21327","E01000224",2001,496,13,483,94
"21328","E01000142",2001,604,57,547,174
"21329","E01000138",2001,515,44,471,106
"21330","E01000139",2001,552,45,507,118
"21331","E01000140",2001,631,85,546,211
"21332","E01000143",2001,527,230,297,76
"21333","E01000137",2001,657,308,349,99
"21334","E01000466",2001,561,276,285,34
"21335","E01000467",2001,608,129,479,80
"21336","E01000468",2001,685,63,622,80
"21337","E01000469",2001,649,68,581,80
"21338","E01000470",2001,629,416,213,51
"21339","E01000464",2001,544,250,294,41
"21340","E01000465",2001,727,439,288,52
"21341","E01000418",2001,744,111,633,61
"21342","E01000416",2001,494,81,413,48
"21343","E01000422",2001,683,486,197,48
"21344","E01000333",2001,792,157,635,80
"21345","E01000335",2001,559,128,431,63
"21346","E01000336",2001,749,276,473,75
"21347","E01000337",2001,637,54,583,71
"21348","E01000338",2001,641,23,618,94
"21349","E01000403",2001,612,257,355,43
"21350","E01000404",2001,718,200,518,132
"21351","E01000405",2001,504,54,450,55
"21352","E01000408",2001,559,21,538,54
"21353","E01000406",2001,590,26,564,90
"21354","E01000407",2001,608,70,538,29
"21355","E01000402",2001,627,166,461,53
"21356","E01000332",2001,613,42,571,37
"21357","E01000334",2001,638,25,613,40
"21358","E01000442",2001,619,48,571,18
"21359","E01000419",2001,601,3,598,17
"21360","E01000420",2001,611,16,595,26
"21361","E01000417",2001,649,101,548,54
"21362","E01000437",2001,503,28,475,16
"21363","E01000438",2001,601,7,594,34
"21364","E01000439",2001,500,70,430,65
"21365","E01000440",2001,514,0,514,12
"21366","E01000441",2001,628,185,443,48
"21367","E01000429",2001,724,186,538,161
"21368","E01000430",2001,661,105,556,40
"21369","E01000431",2001,652,299,353,47
"21370","E01000432",2001,613,147,466,44
"21371","E01000433",2001,651,255,396,33
"21372","E01000434",2001,564,327,237,29
"21373","E01000373",2001,670,469,201,43
"21374","E01000359",2001,490,3,487,22
"21375","E01000356",2001,621,0,621,36
"21376","E01000357",2001,491,0,491,7
"21377","E01000421",2001,608,3,605,4
"21378","E01000450",2001,645,144,501,21
"21379","E01000451",2001,616,10,606,23
"21380","E01000452",2001,490,3,487,9
"21381","E01000435",2001,573,161,412,32
"21382","E01000367",2001,626,208,418,30
"21383","E01000368",2001,612,245,367,23
"21384","E01000380",2001,756,301,455,57
"21385","E01000372",2001,586,193,393,19
"21386","E01000358",2001,672,16,656,57
"21387","E01000353",2001,660,3,657,8
"21388","E01000354",2001,609,159,450,18
"21389","E01000355",2001,616,6,610,9
"21390","E01000436",2001,614,3,611,21
"21391","E01000397",2001,749,210,539,41
"21392","E01000398",2001,613,119,494,19
"21393","E01000399",2001,605,40,565,26
"21394","E01000400",2001,592,31,561,33
"21395","E01000401",2001,636,147,489,49
"21396","E01000453",2001,513,4,509,18
"21397","E01000454",2001,629,119,510,24
"21398","E01000455",2001,607,3,604,20
"21399","E01000456",2001,484,6,478,12
"21400","E01000369",2001,617,42,575,37
"21401","E01000370",2001,586,25,561,25
"21402","E01000371",2001,635,18,617,39
"21403","E01000325",2001,582,8,574,24
"21404","E01000326",2001,549,3,546,25
"21405","E01000360",2001,622,9,613,122
"21406","E01000362",2001,613,35,578,13
"21407","E01000365",2001,685,43,642,72
"21408","E01000366",2001,624,12,612,56
"21409","E01000394",2001,629,34,595,49
"21410","E01000409",2001,634,4,630,14
"21411","E01000411",2001,560,0,560,12
"21412","E01000414",2001,607,12,595,81
"21413","E01000415",2001,513,0,513,12
"21414","E01000392",2001,604,134,470,104
"21415","E01000388",2001,591,8,583,21
"21416","E01000327",2001,602,29,573,16
"21417","E01000328",2001,591,29,562,12
"21418","E01000329",2001,514,69,445,39
"21419","E01000330",2001,767,106,661,66
"21420","E01000331",2001,607,176,431,26
"21421","E01000340",2001,610,6,604,29
"21422","E01000412",2001,632,23,609,25
"21423","E01000413",2001,504,6,498,35
"21424","E01000410",2001,594,4,590,21
"21425","E01000395",2001,503,3,500,18
"21426","E01000396",2001,503,3,500,6
"21427","E01000374",2001,523,215,308,21
"21428","E01000375",2001,578,135,443,40
"21429","E01000376",2001,605,67,538,35
"21430","E01000377",2001,656,36,620,36
"21431","E01000378",2001,733,127,606,121
"21432","E01000379",2001,609,111,498,32
"21433","E01000363",2001,556,6,550,32
"21434","E01000361",2001,588,47,541,28
"21435","E01000389",2001,631,75,556,36
"21436","E01000390",2001,516,32,484,36
"21437","E01000393",2001,638,3,635,56
"21438","E01000348",2001,509,0,509,3
"21439","E01000349",2001,639,3,636,10
"21440","E01000350",2001,501,3,498,30
"21441","E01000346",2001,594,3,591,14
"21442","E01000347",2001,623,30,593,51
"21443","E01000352",2001,636,36,600,67
"21444","E01000391",2001,644,41,603,24
"21445","E01000345",2001,484,3,481,19
"21446","E01000341",2001,608,10,598,20
"21447","E01000342",2001,641,3,638,36
"21448","E01000343",2001,532,0,532,35
"21449","E01000460",2001,478,3,475,19
"21450","E01000447",2001,663,64,599,77
"21451","E01000448",2001,514,3,511,5
"21452","E01000449",2001,636,15,621,26
"21453","E01000444",2001,601,6,595,14
"21454","E01000364",2001,647,39,608,42
"21455","E01000351",2001,586,0,586,16
"21456","E01000445",2001,636,0,636,20
"21457","E01000446",2001,601,3,598,24
"21458","E01000443",2001,513,90,423,12
"21459","E01000461",2001,562,5,557,10
"21460","E01000463",2001,451,3,448,10
"21461","E01000423",2001,594,6,588,10
"21462","E01000425",2001,591,6,585,6
"21463","E01000344",2001,618,15,603,30
"21464","E01000339",2001,590,127,463,12
"21465","E01000426",2001,691,77,614,81
"21466","E01000427",2001,855,122,733,32
"21467","E01000424",2001,769,41,728,27
"21468","E01000462",2001,727,74,653,108
"21469","E01000457",2001,737,42,695,136
"21470","E01000458",2001,644,41,603,44
"21471","E01000459",2001,760,144,616,70
"21472","E01000428",2001,822,368,454,63
"21473","E01000382",2001,583,23,560,13
"21474","E01000384",2001,776,110,666,62
"21475","E01000387",2001,569,28,541,11
"21476","E01000385",2001,593,195,398,58
"21477","E01000386",2001,637,296,341,66
"21478","E01000383",2001,637,71,566,25
"21479","E01000381",2001,631,152,479,43
"21480","E01000587",2001,488,15,473,49
"21481","E01000589",2001,504,28,476,52
"21482","E01000590",2001,625,13,612,80
"21483","E01000592",2001,502,44,458,68
"21484","E01000593",2001,526,129,397,56
"21485","E01000594",2001,519,51,468,99
"21486","E01000588",2001,505,100,405,56
"21487","E01000516",2001,495,34,461,84
"21488","E01000520",2001,633,108,525,130
"21489","E01000513",2001,503,30,473,49
"21490","E01000514",2001,510,30,480,72
"21491","E01000515",2001,630,186,444,116
"21492","E01000517",2001,513,29,484,92
"21493","E01000537",2001,400,46,354,42
"21494","E01000542",2001,493,12,481,27
"21495","E01000543",2001,504,63,441,66
"21496","E01000591",2001,618,66,552,119
"21497","E01000536",2001,528,9,519,72
"21498","E01000538",2001,504,0,504,39
"21499","E01000539",2001,614,53,561,75
"21500","E01000540",2001,510,10,500,32
"21501","E01000541",2001,488,50,438,96
"21502","E01000518",2001,522,95,427,63
"21503","E01000519",2001,616,106,510,112
"21504","E01000623",2001,522,25,497,92
"21505","E01000624",2001,607,31,576,62
"21506","E01000629",2001,590,44,546,69
"21507","E01000480",2001,526,12,514,72
"21508","E01000484",2001,498,233,265,56
"21509","E01000485",2001,521,163,358,61
"21510","E01000486",2001,529,16,513,79
"21511","E01000487",2001,612,89,523,161
"21512","E01000572",2001,506,30,476,47
"21513","E01000573",2001,504,25,479,67
"21514","E01000574",2001,464,32,432,53
"21515","E01000575",2001,609,65,544,155
"21516","E01000577",2001,523,167,356,130
"21517","E01000566",2001,512,19,493,35
"21518","E01000562",2001,506,45,461,44
"21519","E01000563",2001,493,13,480,29
"21520","E01000568",2001,410,71,339,93
"21521","E01000569",2001,515,15,500,36
"21522","E01000481",2001,614,204,410,141
"21523","E01000482",2001,508,225,283,76
"21524","E01000483",2001,622,264,358,87
"21525","E01000479",2001,497,10,487,34
"21526","E01000625",2001,612,97,515,99
"21527","E01000626",2001,640,303,337,130
"21528","E01000496",2001,494,33,461,90
"21529","E01000500",2001,421,32,389,47
"21530","E01000498",2001,492,26,466,86
"21531","E01000622",2001,680,121,559,150
"21532","E01000499",2001,494,79,415,92
"21533","E01000501",2001,635,265,370,65
"21534","E01000502",2001,482,67,415,61
"21535","E01000503",2001,634,146,488,78
"21536","E01000497",2001,594,105,489,73
"21537","E01000570",2001,530,111,419,70
"21538","E01000571",2001,469,15,454,51
"21539","E01000578",2001,640,86,554,102
"21540","E01000576",2001,512,36,476,84
"21541","E01000564",2001,510,45,465,115
"21542","E01000565",2001,478,101,377,57
"21543","E01000607",2001,650,35,615,91
"21544","E01000608",2001,607,114,493,158
"21545","E01000613",2001,630,108,522,183
"21546","E01000506",2001,591,164,427,136
"21547","E01000509",2001,452,19,433,79
"21548","E01000510",2001,517,50,467,132
"21549","E01000511",2001,518,52,466,110
"21550","E01000627",2001,641,205,436,135
"21551","E01000628",2001,562,81,481,108
"21552","E01000553",2001,583,82,501,177
"21553","E01000554",2001,618,106,512,139
"21554","E01000555",2001,481,47,434,100
"21555","E01000556",2001,598,143,455,308
"21556","E01000557",2001,648,102,546,255
"21557","E01000558",2001,657,165,492,190
"21558","E01000567",2001,464,50,414,66
"21559","E01000609",2001,584,40,544,92
"21560","E01000606",2001,579,64,515,96
"21561","E01000611",2001,528,187,341,80
"21562","E01000617",2001,507,38,469,61
"21563","E01000618",2001,499,46,453,47
"21564","E01000619",2001,486,30,456,36
"21565","E01000614",2001,626,113,513,176
"21566","E01000615",2001,562,61,501,156
"21567","E01000559",2001,657,173,484,222
"21568","E01000512",2001,604,56,548,133
"21569","E01000507",2001,496,55,441,75
"21570","E01000504",2001,677,163,514,163
"21571","E01000505",2001,498,138,360,75
"21572","E01000610",2001,634,105,529,107
"21573","E01000612",2001,534,121,413,64
"21574","E01000631",2001,484,34,450,73
"21575","E01000633",2001,472,58,414,106
"21576","E01000634",2001,600,127,473,129
"21577","E01000635",2001,494,61,433,109
"21578","E01000636",2001,497,33,464,90
"21579","E01000620",2001,494,23,471,76
"21580","E01000621",2001,488,36,452,73
"21581","E01000616",2001,521,57,464,120
"21582","E01000596",2001,632,398,234,49
"21583","E01000601",2001,470,310,160,35
"21584","E01000602",2001,501,263,238,28
"21585","E01000603",2001,601,149,452,100
"21586","E01000604",2001,516,376,140,15
"21587","E01000605",2001,498,354,144,19
"21588","E01000488",2001,486,108,378,89
"21589","E01000637",2001,605,145,460,172
"21590","E01000639",2001,645,128,517,269
"21591","E01000642",2001,759,193,566,327
"21592","E01000644",2001,619,175,444,149
"21593","E01000490",2001,680,134,546,262
"21594","E01000494",2001,606,128,478,157
"21595","E01000495",2001,808,333,475,180
"21596","E01000560",2001,708,135,573,231
"21597","E01000561",2001,798,306,492,213
"21598","E01000643",2001,667,387,280,86
"21599","E01000640",2001,598,121,477,221
"21600","E01000641",2001,642,186,456,178
"21601","E01000638",2001,642,177,465,220
"21602","E01000508",2001,601,222,379,132
"21603","E01000521",2001,603,246,357,125
"21604","E01000522",2001,624,275,349,71
"21605","E01000526",2001,616,415,201,56
"21606","E01000527",2001,618,225,393,91
"21607","E01000528",2001,602,456,146,45
"21608","E01000474",2001,486,117,369,63
"21609","E01000476",2001,491,41,450,53
"21610","E01000477",2001,663,71,592,113
"21611","E01000471",2001,487,62,425,52
"21612","E01000630",2001,557,180,377,77
"21613","E01000597",2001,470,364,106,28
"21614","E01000598",2001,565,437,128,47
"21615","E01000599",2001,596,491,105,33
"21616","E01000600",2001,494,326,168,27
"21617","E01000595",2001,519,243,276,52
"21618","E01000545",2001,739,237,502,251
"21619","E01000546",2001,707,182,525,247
"21620","E01000547",2001,692,192,500,154
"21621","E01000548",2001,750,342,408,163
"21622","E01000549",2001,724,152,572,165
"21623","E01000478",2001,474,58,416,65
"21624","E01000475",2001,489,61,428,72
"21625","E01000472",2001,621,123,498,190
"21626","E01000473",2001,494,50,444,122
"21627","E01000632",2001,517,29,488,97
"21628","E01000491",2001,648,156,492,125
"21629","E01000492",2001,475,58,417,72
"21630","E01000493",2001,567,44,523,87
"21631","E01000489",2001,581,144,437,102
"21632","E01000581",2001,594,137,457,130
"21633","E01000535",2001,617,116,501,139
"21634","E01000529",2001,724,262,462,136
"21635","E01000533",2001,629,302,327,112
"21636","E01000523",2001,640,218,422,105
"21637","E01000524",2001,620,301,319,142
"21638","E01000525",2001,641,318,323,99
"21639","E01000582",2001,631,103,528,131
"21640","E01000583",2001,763,190,573,187
"21641","E01000586",2001,733,245,488,200
"21642","E01000579",2001,647,158,489,125
"21643","E01000580",2001,631,142,489,90
"21644","E01000584",2001,584,74,510,83
"21645","E01000585",2001,621,113,508,128
"21646","E01000534",2001,596,94,502,113
"21647","E01000530",2001,568,63,505,88
"21648","E01000531",2001,655,188,467,148
"21649","E01000532",2001,654,179,475,116
"21650","E01000544",2001,690,417,273,115
"21651","E01000550",2001,762,463,299,77
"21652","E01000551",2001,758,583,175,55
"21653","E01000552",2001,774,596,178,65
"21654","E01000779",2001,576,61,515,56
"21655","E01000780",2001,616,170,446,25
"21656","E01000781",2001,631,278,353,23
"21657","E01000782",2001,645,315,330,31
"21658","E01000783",2001,654,247,407,23
"21659","E01000785",2001,645,243,402,27
"21660","E01000784",2001,592,62,530,50
"21661","E01000689",2001,601,143,458,58
"21662","E01000690",2001,537,29,508,12
"21663","E01000691",2001,606,125,481,42
"21664","E01000692",2001,647,33,614,77
"21665","E01000816",2001,611,47,564,24
"21666","E01000817",2001,595,245,350,17
"21667","E01000818",2001,579,25,554,18
"21668","E01000819",2001,662,218,444,50
"21669","E01000821",2001,576,10,566,32
"21670","E01000799",2001,632,98,534,112
"21671","E01000802",2001,759,207,552,114
"21672","E01000803",2001,736,190,546,103
"21673","E01000804",2001,557,37,520,32
"21674","E01000805",2001,698,153,545,85
"21675","E01000740",2001,812,207,605,224
"21676","E01000741",2001,801,304,497,163
"21677","E01000742",2001,916,229,687,228
"21678","E01000745",2001,896,259,637,161
"21679","E01000746",2001,835,191,644,165
"21680","E01000709",2001,787,158,629,113
"21681","E01000710",2001,856,55,801,172
"21682","E01000711",2001,975,145,830,214
"21683","E01000714",2001,818,45,773,231
"21684","E01000718",2001,906,306,600,111
"21685","E01000694",2001,598,5,593,19
"21686","E01000695",2001,612,26,586,39
"21687","E01000696",2001,651,22,629,54
"21688","E01000697",2001,757,29,728,107
"21689","E01000645",2001,518,12,506,29
"21690","E01000649",2001,630,23,607,37
"21691","E01000674",2001,760,156,604,106
"21692","E01000676",2001,781,243,538,180
"21693","E01000822",2001,737,122,615,123
"21694","E01000823",2001,687,61,626,111
"21695","E01000824",2001,556,92,464,100
"21696","E01000825",2001,727,96,631,127
"21697","E01000820",2001,657,149,508,74
"21698","E01000806",2001,659,283,376,143
"21699","E01000800",2001,762,200,562,146
"21700","E01000796",2001,615,457,158,27
"21701","E01000798",2001,649,339,310,91
"21702","E01000743",2001,732,353,379,128
"21703","E01000744",2001,680,390,290,55
"21704","E01000736",2001,642,198,444,13
"21705","E01000737",2001,588,162,426,23
"21706","E01000693",2001,549,42,507,37
"21707","E01000698",2001,435,4,431,8
"21708","E01000672",2001,642,34,608,76
"21709","E01000673",2001,621,59,562,62
"21710","E01000716",2001,696,39,657,90
"21711","E01000717",2001,829,61,768,141
"21712","E01000828",2001,748,112,636,87
"21713","E01000715",2001,849,61,788,127
"21714","E01000712",2001,814,22,792,176
"21715","E01000713",2001,842,45,797,127
"21716","E01000770",2001,666,19,647,90
"21717","E01000772",2001,711,26,685,67
"21718","E01000702",2001,561,56,505,82
"21719","E01000703",2001,571,38,533,115
"21720","E01000706",2001,614,93,521,39
"21721","E01000700",2001,691,129,562,69
"21722","E01000797",2001,663,98,565,80
"21723","E01000729",2001,767,423,344,25
"21724","E01000730",2001,630,317,313,15
"21725","E01000738",2001,635,85,550,15
"21726","E01000739",2001,642,307,335,19
"21727","E01000735",2001,557,192,365,12
"21728","E01000704",2001,626,38,588,59
"21729","E01000705",2001,589,121,468,84
"21730","E01000701",2001,647,51,596,72
"21731","E01000699",2001,656,138,518,123
"21732","E01000801",2001,660,150,510,87
"21733","E01000678",2001,572,41,531,45
"21734","E01000646",2001,685,51,634,126
"21735","E01000647",2001,622,38,584,50
"21736","E01000648",2001,637,25,612,52
"21737","E01000653",2001,598,66,532,27
"21738","E01000707",2001,531,13,518,36
"21739","E01000708",2001,613,41,572,53
"21740","E01000774",2001,561,21,540,37
"21741","E01000771",2001,611,12,599,31
"21742","E01000776",2001,613,197,416,47
"21743","E01000829",2001,717,45,672,80
"21744","E01000762",2001,723,21,702,73
"21745","E01000677",2001,728,48,680,150
"21746","E01000675",2001,645,28,617,141
"21747","E01000670",2001,564,30,534,67
"21748","E01000719",2001,734,129,605,46
"21749","E01000720",2001,641,211,430,44
"21750","E01000721",2001,610,359,251,24
"21751","E01000728",2001,656,106,550,47
"21752","E01000724",2001,651,329,322,25
"21753","E01000671",2001,689,82,607,101
"21754","E01000668",2001,666,61,605,81
"21755","E01000669",2001,724,51,673,97
"21756","E01000679",2001,586,20,566,46
"21757","E01000651",2001,635,71,564,45
"21758","E01000830",2001,537,4,533,14
"21759","E01000831",2001,774,89,685,74
"21760","E01000826",2001,570,4,566,15
"21761","E01000827",2001,742,42,700,81
"21762","E01000833",2001,499,3,496,7
"21763","E01000807",2001,587,10,577,84
"21764","E01000809",2001,617,11,606,3
"21765","E01000652",2001,635,26,609,18
"21766","E01000650",2001,624,99,525,20
"21767","E01000725",2001,760,216,544,77
"21768","E01000731",2001,529,126,403,7
"21769","E01000732",2001,588,87,501,14
"21770","E01000733",2001,607,101,506,25
"21771","E01000722",2001,673,66,607,65
"21772","E01000775",2001,574,39,535,36
"21773","E01000773",2001,610,87,523,19
"21774","E01000777",2001,540,6,534,26
"21775","E01000778",2001,618,93,525,27
"21776","E01000769",2001,454,71,383,12
"21777","E01000810",2001,598,4,594,7
"21778","E01000811",2001,583,8,575,57
"21779","E01000815",2001,562,3,559,7
"21780","E01000813",2001,633,3,630,19
"21781","E01000808",2001,595,40,555,14
"21782","E01000661",2001,657,379,278,39
"21783","E01000662",2001,644,115,529,29
"21784","E01000663",2001,634,158,476,18
"21785","E01000664",2001,613,123,490,27
"21786","E01000766",2001,622,14,608,7
"21787","E01000767",2001,568,3,565,12
"21788","E01000763",2001,499,4,495,9
"21789","E01000764",2001,639,100,539,16
"21790","E01000834",2001,464,7,457,19
"21791","E01000814",2001,564,5,559,11
"21792","E01000812",2001,634,68,566,29
"21793","E01000790",2001,637,36,601,120
"21794","E01000734",2001,513,54,459,22
"21795","E01000727",2001,602,25,577,54
"21796","E01000726",2001,580,14,566,32
"21797","E01000723",2001,556,12,544,4
"21798","E01000791",2001,606,52,554,12
"21799","E01000787",2001,675,111,564,26
"21800","E01000788",2001,572,96,476,28
"21801","E01000835",2001,595,21,574,92
"21802","E01000836",2001,501,11,490,15
"21803","E01000837",2001,645,59,586,31
"21804","E01000838",2001,523,7,516,24
"21805","E01000839",2001,510,3,507,10
"21806","E01000840",2001,636,125,511,9
"21807","E01000841",2001,600,6,594,36
"21808","E01000832",2001,602,6,596,29
"21809","E01000757",2001,604,3,601,7
"21810","E01000758",2001,588,29,559,12
"21811","E01000753",2001,750,4,746,26
"21812","E01000754",2001,748,17,731,47
"21813","E01000755",2001,624,9,615,12
"21814","E01000789",2001,605,407,198,30
"21815","E01000795",2001,535,105,430,8
"21816","E01000792",2001,659,188,471,26
"21817","E01000793",2001,634,7,627,10
"21818","E01000786",2001,614,28,586,11
"21819","E01000756",2001,633,7,626,35
"21820","E01000665",2001,672,33,639,43
"21821","E01000666",2001,695,7,688,34
"21822","E01000667",2001,609,0,609,9
"21823","E01000759",2001,536,3,533,14
"21824","E01000760",2001,549,14,535,54
"21825","E01000761",2001,571,3,568,11
"21826","E01000765",2001,614,20,594,56
"21827","E01000768",2001,593,39,554,34
"21828","E01000681",2001,658,8,650,20
"21829","E01000682",2001,647,8,639,29
"21830","E01000683",2001,644,53,591,55
"21831","E01000684",2001,592,10,582,17
"21832","E01000794",2001,616,11,605,8
"21833","E01000749",2001,628,34,594,29
"21834","E01000750",2001,653,348,305,18
"21835","E01000751",2001,679,7,672,47
"21836","E01000752",2001,764,60,704,41
"21837","E01000685",2001,614,71,543,34
"21838","E01000686",2001,621,80,541,22
"21839","E01000687",2001,631,13,618,37
"21840","E01000688",2001,516,14,502,17
"21841","E01000680",2001,624,18,606,39
"21842","E01000658",2001,526,3,523,14
"21843","E01000747",2001,623,34,589,125
"21844","E01000748",2001,646,9,637,20
"21845","E01000660",2001,647,34,613,34
"21846","E01000659",2001,484,6,478,10
"21847","E01000654",2001,495,10,485,17
"21848","E01000655",2001,490,6,484,8
"21849","E01000656",2001,502,6,496,8
"21850","E01000657",2001,628,89,539,34
"21851","E01001137",2001,768,144,624,102
"21852","E01001138",2001,736,135,601,121
"21853","E01001156",2001,658,199,459,64
"21854","E01001164",2001,767,218,549,157
"21855","E01001162",2001,740,254,486,97
"21856","E01001163",2001,703,80,623,86
"21857","E01001157",2001,610,75,535,44
"21858","E01001159",2001,753,73,680,80
"21859","E01001160",2001,599,22,577,45
"21860","E01001084",2001,596,22,574,45
"21861","E01001083",2001,517,8,509,31
"21862","E01001161",2001,543,252,291,39
"21863","E01001086",2001,586,11,575,52
"21864","E01001087",2001,617,119,498,133
"21865","E01001088",2001,611,102,509,52
"21866","E01001089",2001,649,197,452,92
"21867","E01001090",2001,657,138,519,110
"21868","E01001091",2001,601,3,598,71
"21869","E01001085",2001,635,80,555,134
"21870","E01001158",2001,686,99,587,113
"21871","E01001147",2001,615,135,480,92
"21872","E01001148",2001,642,72,570,83
"21873","E01001151",2001,658,197,461,125
"21874","E01001152",2001,641,122,519,136
"21875","E01001153",2001,601,70,531,99
"21876","E01001154",2001,641,117,524,105
"21877","E01001149",2001,622,71,551,93
"21878","E01001150",2001,590,33,557,72
"21879","E01001146",2001,589,60,529,63
"21880","E01001139",2001,711,54,657,109
"21881","E01001140",2001,795,50,745,123
"21882","E01001142",2001,644,40,604,81
"21883","E01001144",2001,646,122,524,147
"21884","E01001136",2001,788,98,690,229
"21885","E01001145",2001,740,298,442,155
"21886","E01001143",2001,731,196,535,99
"21887","E01001141",2001,638,171,467,111
"21888","E01001191",2001,737,87,650,241
"21889","E01001192",2001,713,138,575,138
"21890","E01000999",2001,497,25,472,60
"21891","E01001002",2001,570,37,533,79
"21892","E01000994",2001,590,24,566,108
"21893","E01000995",2001,607,35,572,157
"21894","E01000996",2001,499,22,477,65
"21895","E01000997",2001,499,25,474,78
"21896","E01000998",2001,662,87,575,166
"21897","E01001003",2001,624,109,515,119
"21898","E01001000",2001,582,43,539,119
"21899","E01001155",2001,764,297,467,150
"21900","E01001111",2001,590,71,519,87
"21901","E01001182",2001,544,30,514,106
"21902","E01001183",2001,528,30,498,124
"21903","E01001184",2001,485,11,474,58
"21904","E01001174",2001,578,33,545,65
"21905","E01001175",2001,592,60,532,106
"21906","E01001176",2001,568,57,511,84
"21907","E01001189",2001,580,56,524,53
"21908","E01001190",2001,616,98,518,50
"21909","E01001194",2001,688,67,621,106
"21910","E01000988",2001,640,390,250,23
"21911","E01000990",2001,528,305,223,29
"21912","E01001001",2001,565,120,445,101
"21913","E01001112",2001,737,239,498,138
"21914","E01001113",2001,768,141,627,188
"21915","E01001114",2001,566,206,360,97
"21916","E01001116",2001,632,78,554,109
"21917","E01001109",2001,792,233,559,140
"21918","E01001188",2001,693,130,563,103
"21919","E01001193",2001,523,256,267,26
"21920","E01001185",2001,715,72,643,118
"21921","E01001186",2001,817,173,644,145
"21922","E01000992",2001,578,219,359,40
"21923","E01001004",2001,586,91,495,89
"21924","E01001181",2001,650,212,438,144
"21925","E01001178",2001,559,101,458,199
"21926","E01001117",2001,613,108,505,145
"21927","E01001115",2001,631,252,379,71
"21928","E01001179",2001,618,34,584,80
"21929","E01001180",2001,629,60,569,128
"21930","E01001177",2001,547,128,419,61
"21931","E01001006",2001,628,163,465,78
"21932","E01001007",2001,619,71,548,79
"21933","E01000980",2001,592,85,507,57
"21934","E01000981",2001,612,39,573,44
"21935","E01000982",2001,703,62,641,93
"21936","E01000983",2001,634,31,603,70
"21937","E01001187",2001,755,128,627,92
"21938","E01001134",2001,687,32,655,41
"21939","E01001131",2001,742,115,627,36
"21940","E01001132",2001,618,33,585,16
"21941","E01000991",2001,660,12,648,17
"21942","E01000989",2001,606,16,590,29
"21943","E01001008",2001,534,172,362,48
"21944","E01001009",2001,558,71,487,106
"21945","E01001010",2001,569,256,313,35
"21946","E01001011",2001,617,151,466,159
"21947","E01001005",2001,551,57,494,121
"21948","E01001048",2001,964,190,774,384
"21949","E01001012",2001,654,80,574,204
"21950","E01001013",2001,764,404,360,105
"21951","E01001118",2001,734,268,466,95
"21952","E01001110",2001,680,176,504,185
"21953","E01000985",2001,486,19,467,18
"21954","E01000986",2001,594,20,574,64
"21955","E01000987",2001,504,10,494,30
"21956","E01000993",2001,632,42,590,60
"21957","E01000984",2001,726,229,497,127
"21958","E01000975",2001,729,83,646,187
"21959","E01000976",2001,789,135,654,158
"21960","E01000977",2001,923,242,681,192
"21961","E01000978",2001,962,142,820,260
"21962","E01000979",2001,796,43,753,208
"21963","E01001049",2001,505,9,496,50
"21964","E01001050",2001,924,348,576,221
"21965","E01001044",2001,860,45,815,202
"21966","E01001046",2001,885,33,852,294
"21967","E01001042",2001,692,136,556,176
"21968","E01001014",2001,675,265,410,98
"21969","E01001165",2001,585,57,528,87
"21970","E01001166",2001,764,201,563,139
"21971","E01001168",2001,677,48,629,85
"21972","E01001127",2001,592,44,548,15
"21973","E01001128",2001,585,310,275,21
"21974","E01001135",2001,634,10,624,37
"21975","E01001130",2001,585,399,186,39
"21976","E01001129",2001,514,3,511,10
"21977","E01001133",2001,742,46,696,20
"21978","E01001062",2001,538,21,517,25
"21979","E01001063",2001,581,6,575,40
"21980","E01001064",2001,612,11,601,20
"21981","E01001047",2001,870,124,746,309
"21982","E01001043",2001,756,108,648,290
"21983","E01001045",2001,837,152,685,314
"21984","E01001035",2001,784,88,696,231
"21985","E01001170",2001,838,175,663,193
"21986","E01001171",2001,659,213,446,80
"21987","E01001172",2001,591,290,301,33
"21988","E01001173",2001,726,86,640,119
"21989","E01001169",2001,677,265,412,53
"21990","E01001167",2001,621,66,555,58
"21991","E01001036",2001,589,24,565,74
"21992","E01001037",2001,647,120,527,128
"21993","E01001038",2001,830,108,722,264
"21994","E01001039",2001,594,22,572,53
"21995","E01001040",2001,745,62,683,159
"21996","E01001051",2001,584,392,192,14
"21997","E01001052",2001,479,291,188,13
"21998","E01001054",2001,591,259,332,18
"21999","E01001056",2001,644,420,224,15
"22000","E01001057",2001,657,471,186,6
"22001","E01001041",2001,739,67,672,214
"22002","E01001033",2001,737,52,685,130
"22003","E01001034",2001,638,27,611,127
"22004","E01001095",2001,665,47,618,108
"22005","E01001100",2001,601,46,555,55
"22006","E01001082",2001,539,213,326,10
"22007","E01001053",2001,527,194,333,6
"22008","E01001055",2001,587,297,290,19
"22009","E01001077",2001,508,28,480,10
"22010","E01001078",2001,518,223,295,10
"22011","E01001120",2001,495,8,487,17
"22012","E01001122",2001,489,9,480,36
"22013","E01001123",2001,611,14,597,16
"22014","E01001124",2001,609,6,603,12
"22015","E01001125",2001,589,24,565,52
"22016","E01001126",2001,607,19,588,21
"22017","E01001119",2001,576,25,551,7
"22018","E01001058",2001,536,12,524,21
"22019","E01001059",2001,700,22,678,72
"22020","E01001060",2001,664,40,624,35
"22021","E01001061",2001,663,108,555,71
"22022","E01001065",2001,673,22,651,87
"22023","E01001066",2001,594,282,312,38
"22024","E01001032",2001,517,9,508,20
"22025","E01001101",2001,503,3,500,14
"22026","E01001102",2001,592,55,537,27
"22027","E01001107",2001,649,12,637,55
"22028","E01001108",2001,616,10,606,16
"22029","E01001079",2001,621,277,344,7
"22030","E01001080",2001,658,467,191,9
"22031","E01001081",2001,511,201,310,18
"22032","E01001076",2001,581,168,413,60
"22033","E01001073",2001,643,51,592,102
"22034","E01001092",2001,468,29,439,49
"22035","E01001093",2001,658,46,612,58
"22036","E01001096",2001,508,17,491,17
"22037","E01001097",2001,734,101,633,126
"22038","E01001098",2001,505,8,497,19
"22039","E01001094",2001,497,6,491,25
"22040","E01001028",2001,514,4,510,19
"22041","E01001029",2001,496,20,476,56
"22042","E01001030",2001,459,6,453,8
"22043","E01001031",2001,482,3,479,17
"22044","E01001105",2001,618,155,463,17
"22045","E01001106",2001,515,35,480,24
"22046","E01001103",2001,630,33,597,18
"22047","E01001121",2001,494,13,481,7
"22048","E01001099",2001,546,112,434,28
"22049","E01001075",2001,639,55,584,78
"22050","E01001069",2001,498,29,469,24
"22051","E01001070",2001,623,102,521,25
"22052","E01001067",2001,549,5,544,11
"22053","E01001074",2001,624,51,573,75
"22054","E01001023",2001,606,63,543,108
"22055","E01001015",2001,506,135,371,33
"22056","E01001016",2001,660,48,612,31
"22057","E01001068",2001,697,129,568,41
"22058","E01001071",2001,600,81,519,27
"22059","E01001072",2001,517,0,517,22
"22060","E01001104",2001,644,22,622,24
"22061","E01001024",2001,533,26,507,31
"22062","E01001025",2001,489,16,473,15
"22063","E01001026",2001,625,84,541,29
"22064","E01001027",2001,502,26,476,18
"22065","E01001017",2001,633,13,620,26
"22066","E01001018",2001,622,17,605,26
"22067","E01001019",2001,591,40,551,14
"22068","E01001020",2001,652,45,607,23
"22069","E01001021",2001,597,293,304,25
"22070","E01001022",2001,622,5,617,18
"22071","E01001271",2001,591,45,546,84
"22072","E01001269",2001,580,19,561,90
"22073","E01001309",2001,589,16,573,48
"22074","E01001310",2001,642,50,592,67
"22075","E01001311",2001,652,227,425,46
"22076","E01001312",2001,608,52,556,91
"22077","E01001313",2001,518,23,495,50
"22078","E01001314",2001,518,16,502,59
"22079","E01001307",2001,593,11,582,62
"22080","E01001308",2001,620,13,607,75
"22081","E01001315",2001,503,70,433,45
"22082","E01001316",2001,599,273,326,31
"22083","E01001317",2001,627,180,447,36
"22084","E01001318",2001,608,254,354,27
"22085","E01001320",2001,497,263,234,17
"22086","E01001321",2001,657,90,567,41
"22087","E01001322",2001,636,60,576,61
"22088","E01001323",2001,668,72,596,103
"22089","E01001319",2001,487,38,449,35
"22090","E01001270",2001,573,22,551,43
"22091","E01001341",2001,520,17,503,72
"22092","E01001342",2001,613,20,593,108
"22093","E01001343",2001,490,11,479,48
"22094","E01001345",2001,487,75,412,46
"22095","E01001349",2001,499,166,333,29
"22096","E01001272",2001,528,24,504,93
"22097","E01001265",2001,609,83,526,93
"22098","E01001266",2001,576,15,561,59
"22099","E01001267",2001,802,265,537,97
"22100","E01001346",2001,623,19,604,70
"22101","E01001347",2001,518,19,499,67
"22102","E01001348",2001,637,52,585,128
"22103","E01001344",2001,629,74,555,84
"22104","E01001324",2001,665,70,595,121
"22105","E01001326",2001,650,218,432,37
"22106","E01001330",2001,634,298,336,52
"22107","E01001332",2001,521,245,276,63
"22108","E01001257",2001,606,383,223,26
"22109","E01001331",2001,622,277,345,51
"22110","E01001327",2001,595,151,444,32
"22111","E01001328",2001,610,237,373,37
"22112","E01001329",2001,620,154,466,46
"22113","E01001325",2001,609,195,414,18
"22114","E01001258",2001,642,66,576,58
"22115","E01001256",2001,593,142,451,74
"22116","E01001262",2001,544,198,346,36
"22117","E01001263",2001,632,236,396,41
"22118","E01001264",2001,617,126,491,32
"22119","E01001276",2001,623,11,612,203
"22120","E01001277",2001,625,25,600,166
"22121","E01001278",2001,752,53,699,248
"22122","E01001280",2001,769,15,754,202
"22123","E01001260",2001,643,64,579,75
"22124","E01001261",2001,591,117,474,113
"22125","E01001268",2001,639,12,627,77
"22126","E01001218",2001,655,246,409,79
"22127","E01001211",2001,674,97,577,159
"22128","E01001209",2001,654,17,637,103
"22129","E01001279",2001,577,12,565,45
"22130","E01001281",2001,666,21,645,92
"22131","E01001291",2001,496,19,477,54
"22132","E01001292",2001,496,17,479,45
"22133","E01001293",2001,478,39,439,50
"22134","E01001259",2001,493,34,459,71
"22135","E01001217",2001,478,24,454,36
"22136","E01001238",2001,738,185,553,184
"22137","E01001239",2001,547,195,352,69
"22138","E01001196",2001,623,271,352,97
"22139","E01001246",2001,500,120,380,86
"22140","E01001247",2001,609,73,536,108
"22141","E01001282",2001,635,308,327,37
"22142","E01001283",2001,729,330,399,48
"22143","E01001285",2001,577,138,439,47
"22144","E01001286",2001,625,158,467,52
"22145","E01001287",2001,477,213,264,42
"22146","E01001210",2001,712,411,301,55
"22147","E01001294",2001,511,26,485,38
"22148","E01001295",2001,495,12,483,41
"22149","E01001296",2001,409,51,358,31
"22150","E01001297",2001,491,59,432,60
"22151","E01001298",2001,516,72,444,50
"22152","E01001204",2001,612,80,532,80
"22153","E01001205",2001,597,208,389,108
"22154","E01001206",2001,594,352,242,62
"22155","E01001207",2001,647,64,583,162
"22156","E01001208",2001,522,37,485,33
"22157","E01001212",2001,717,52,665,141
"22158","E01001222",2001,758,96,662,312
"22159","E01001224",2001,581,23,558,91
"22160","E01001226",2001,701,85,616,242
"22161","E01001227",2001,627,40,587,129
"22162","E01001228",2001,709,51,658,263
"22163","E01001225",2001,827,170,657,216
"22164","E01001223",2001,632,56,576,200
"22165","E01001235",2001,627,45,582,277
"22166","E01001236",2001,752,130,622,252
"22167","E01001221",2001,848,144,704,352
"22168","E01001273",2001,617,14,603,161
"22169","E01001274",2001,599,48,551,201
"22170","E01001275",2001,782,91,691,287
"22171","E01001195",2001,583,24,559,101
"22172","E01001197",2001,590,115,475,159
"22173","E01001198",2001,531,73,458,105
"22174","E01001199",2001,606,173,433,131
"22175","E01001288",2001,535,50,485,98
"22176","E01001289",2001,481,42,439,64
"22177","E01001290",2001,695,96,599,155
"22178","E01001284",2001,558,29,529,43
"22179","E01001361",2001,471,118,353,115
"22180","E01001213",2001,501,106,395,52
"22181","E01001214",2001,487,32,455,72
"22182","E01001215",2001,531,98,433,84
"22183","E01001216",2001,483,52,431,70
"22184","E01001240",2001,488,107,381,72
"22185","E01001241",2001,494,79,415,78
"22186","E01001242",2001,533,156,377,92
"22187","E01001243",2001,613,180,433,171
"22188","E01001244",2001,528,267,261,80
"22189","E01001245",2001,616,80,536,164
"22190","E01001200",2001,631,61,570,136
"22191","E01001201",2001,627,132,495,106
"22192","E01001202",2001,624,223,401,129
"22193","E01001203",2001,778,287,491,189
"22194","E01001351",2001,651,162,489,150
"22195","E01001359",2001,506,36,470,64
"22196","E01001360",2001,511,33,478,60
"22197","E01001362",2001,493,77,416,67
"22198","E01001363",2001,488,51,437,38
"22199","E01001364",2001,519,219,300,37
"22200","E01001365",2001,601,43,558,74
"22201","E01001352",2001,540,82,458,180
"22202","E01001350",2001,633,117,516,155
"22203","E01001354",2001,615,78,537,173
"22204","E01001234",2001,610,86,524,244
"22205","E01001231",2001,574,16,558,156
"22206","E01001255",2001,606,35,571,78
"22207","E01001249",2001,829,483,346,106
"22208","E01001250",2001,900,303,597,154
"22209","E01001383",2001,630,35,595,123
"22210","E01001388",2001,690,283,407,136
"22211","E01001389",2001,651,90,561,134
"22212","E01001334",2001,534,272,262,48
"22213","E01001337",2001,479,161,318,42
"22214","E01001338",2001,470,92,378,38
"22215","E01001339",2001,503,220,283,25
"22216","E01001340",2001,493,203,290,57
"22217","E01001219",2001,618,317,301,32
"22218","E01001220",2001,512,357,155,31
"22219","E01001251",2001,617,45,572,115
"22220","E01001252",2001,649,110,539,151
"22221","E01001253",2001,625,65,560,88
"22222","E01001254",2001,747,122,625,99
"22223","E01001232",2001,641,148,493,98
"22224","E01001233",2001,585,135,450,111
"22225","E01001237",2001,627,68,559,194
"22226","E01001386",2001,755,54,701,169
"22227","E01001229",2001,613,224,389,78
"22228","E01001230",2001,589,52,537,174
"22229","E01001387",2001,735,101,634,196
"22230","E01001384",2001,649,40,609,156
"22231","E01001385",2001,681,38,643,142
"22232","E01001303",2001,606,25,581,132
"22233","E01001382",2001,587,15,572,70
"22234","E01001353",2001,713,249,464,153
"22235","E01001355",2001,752,194,558,170
"22236","E01001356",2001,762,527,235,56
"22237","E01001357",2001,598,338,260,62
"22238","E01001358",2001,594,413,181,60
"22239","E01001375",2001,707,23,684,112
"22240","E01001377",2001,737,69,668,129
"22241","E01001379",2001,696,41,655,106
"22242","E01001381",2001,685,73,612,215
"22243","E01001305",2001,595,9,586,52
"22244","E01001306",2001,728,20,708,134
"22245","E01001299",2001,640,14,626,80
"22246","E01001248",2001,576,105,471,71
"22247","E01001374",2001,766,103,663,145
"22248","E01001380",2001,771,90,681,180
"22249","E01001378",2001,727,121,606,221
"22250","E01001376",2001,756,167,589,175
"22251","E01001370",2001,515,56,459,56
"22252","E01001371",2001,501,91,410,66
"22253","E01001372",2001,483,67,416,82
"22254","E01001373",2001,403,35,368,41
"22255","E01001366",2001,496,24,472,86
"22256","E01001367",2001,466,76,390,102
"22257","E01001368",2001,458,82,376,59
"22258","E01001369",2001,489,74,415,79
"22259","E01001335",2001,522,66,456,37
"22260","E01001336",2001,521,146,375,49
"22261","E01001333",2001,540,186,354,59
"22262","E01001300",2001,598,14,584,111
"22263","E01001301",2001,837,125,712,306
"22264","E01001302",2001,600,42,558,115
"22265","E01001304",2001,728,101,627,138
"22266","E01001446",2001,633,45,588,69
"22267","E01001444",2001,633,42,591,45
"22268","E01001546",2001,638,105,533,37
"22269","E01001552",2001,637,52,585,32
"22270","E01001547",2001,608,63,545,39
"22271","E01001548",2001,604,125,479,27
"22272","E01001545",2001,634,294,340,27
"22273","E01001551",2001,602,232,370,23
"22274","E01001442",2001,592,256,336,50
"22275","E01001443",2001,741,168,573,46
"22276","E01001445",2001,672,45,627,85
"22277","E01001447",2001,723,284,439,54
"22278","E01001448",2001,640,121,519,59
"22279","E01001449",2001,547,88,459,32
"22280","E01001408",2001,722,75,647,59
"22281","E01001411",2001,718,77,641,66
"22282","E01001412",2001,661,135,526,53
"22283","E01001413",2001,621,41,580,35
"22284","E01001414",2001,691,403,288,23
"22285","E01001409",2001,664,105,559,64
"22286","E01001410",2001,702,309,393,62
"22287","E01001407",2001,612,104,508,30
"22288","E01001516",2001,611,170,441,32
"22289","E01001537",2001,662,31,631,122
"22290","E01001549",2001,773,251,522,82
"22291","E01001550",2001,548,157,391,23
"22292","E01001517",2001,599,343,256,28
"22293","E01001439",2001,718,168,550,129
"22294","E01001441",2001,612,203,409,45
"22295","E01001438",2001,534,102,432,43
"22296","E01001433",2001,519,225,294,15
"22297","E01001434",2001,545,38,507,28
"22298","E01001435",2001,495,46,449,31
"22299","E01001436",2001,641,33,608,52
"22300","E01001536",2001,729,95,634,110
"22301","E01001540",2001,619,20,599,90
"22302","E01001541",2001,654,20,634,51
"22303","E01001542",2001,661,154,507,67
"22304","E01001469",2001,616,115,501,55
"22305","E01001543",2001,591,11,580,22
"22306","E01001544",2001,596,10,586,26
"22307","E01001538",2001,602,24,578,23
"22308","E01001539",2001,648,30,618,43
"22309","E01001471",2001,897,45,852,119
"22310","E01001472",2001,731,56,675,125
"22311","E01001474",2001,743,27,716,81
"22312","E01001468",2001,476,87,389,54
"22313","E01001457",2001,736,11,725,144
"22314","E01001415",2001,647,99,548,114
"22315","E01001417",2001,545,22,523,40
"22316","E01001418",2001,670,119,551,79
"22317","E01001422",2001,525,19,506,28
"22318","E01001440",2001,589,124,465,31
"22319","E01001504",2001,467,36,431,34
"22320","E01001505",2001,512,115,397,46
"22321","E01001507",2001,631,145,486,101
"22322","E01001508",2001,512,67,445,87
"22323","E01001513",2001,586,193,393,46
"22324","E01001475",2001,636,6,630,29
"22325","E01001473",2001,503,85,418,22
"22326","E01001470",2001,632,33,599,22
"22327","E01001416",2001,600,18,582,22
"22328","E01001437",2001,768,337,431,52
"22329","E01001506",2001,521,132,389,52
"22330","E01001509",2001,610,89,521,78
"22331","E01001510",2001,530,421,109,29
"22332","E01001512",2001,798,57,741,115
"22333","E01001515",2001,652,301,351,36
"22334","E01001450",2001,789,65,724,133
"22335","E01001405",2001,792,59,733,79
"22336","E01001406",2001,613,105,508,86
"22337","E01001401",2001,490,8,482,23
"22338","E01001514",2001,650,115,535,32
"22339","E01001511",2001,649,25,624,67
"22340","E01001518",2001,620,46,574,108
"22341","E01001478",2001,536,82,454,20
"22342","E01001484",2001,501,19,482,17
"22343","E01001451",2001,642,27,615,45
"22344","E01001452",2001,478,12,466,20
"22345","E01001453",2001,625,24,601,32
"22346","E01001454",2001,636,12,624,56
"22347","E01001481",2001,513,31,482,25
"22348","E01001476",2001,592,81,511,57
"22349","E01001477",2001,589,173,416,29
"22350","E01001502",2001,519,65,454,49
"22351","E01001503",2001,585,83,502,58
"22352","E01001522",2001,635,81,554,77
"22353","E01001523",2001,737,16,721,66
"22354","E01001524",2001,535,85,450,61
"22355","E01001520",2001,636,118,518,66
"22356","E01001526",2001,598,9,589,42
"22357","E01001525",2001,665,29,636,108
"22358","E01001519",2001,891,51,840,314
"22359","E01001419",2001,753,66,687,120
"22360","E01001420",2001,573,155,418,47
"22361","E01001421",2001,720,162,558,113
"22362","E01001402",2001,615,12,603,57
"22363","E01001403",2001,637,33,604,42
"22364","E01001398",2001,494,9,485,17
"22365","E01001399",2001,485,3,482,19
"22366","E01001400",2001,568,7,561,14
"22367","E01001455",2001,573,24,549,24
"22368","E01001456",2001,478,3,475,24
"22369","E01001567",2001,597,16,581,38
"22370","E01001568",2001,513,7,506,15
"22371","E01001569",2001,690,76,614,127
"22372","E01001564",2001,638,25,613,80
"22373","E01001491",2001,641,110,531,77
"22374","E01001489",2001,598,58,540,76
"22375","E01001482",2001,652,143,509,57
"22376","E01001479",2001,580,50,530,58
"22377","E01001487",2001,620,82,538,64
"22378","E01001488",2001,634,41,593,66
"22379","E01001480",2001,541,64,477,73
"22380","E01001459",2001,538,28,510,30
"22381","E01001460",2001,642,106,536,103
"22382","E01001462",2001,531,86,445,86
"22383","E01001483",2001,611,174,437,96
"22384","E01001485",2001,643,167,476,74
"22385","E01001486",2001,608,210,398,59
"22386","E01001490",2001,617,299,318,40
"22387","E01001492",2001,624,87,537,43
"22388","E01001493",2001,686,214,472,64
"22389","E01001494",2001,500,8,492,22
"22390","E01001496",2001,577,21,556,36
"22391","E01001404",2001,518,48,470,26
"22392","E01001570",2001,643,95,548,59
"22393","E01001423",2001,604,216,388,34
"22394","E01001425",2001,635,200,435,81
"22395","E01001428",2001,586,210,376,51
"22396","E01001464",2001,415,171,244,13
"22397","E01001461",2001,653,253,400,82
"22398","E01001521",2001,635,61,574,101
"22399","E01001531",2001,494,10,484,38
"22400","E01001532",2001,631,12,619,74
"22401","E01001533",2001,512,5,507,20
"22402","E01001535",2001,496,32,464,45
"22403","E01001495",2001,663,21,642,162
"22404","E01001498",2001,634,17,617,158
"22405","E01001565",2001,642,59,583,72
"22406","E01001566",2001,606,19,587,106
"22407","E01001563",2001,662,47,615,103
"22408","E01001429",2001,772,545,227,70
"22409","E01001430",2001,627,356,271,39
"22410","E01001426",2001,590,233,357,33
"22411","E01001427",2001,596,309,287,51
"22412","E01001424",2001,629,437,192,39
"22413","E01001465",2001,487,33,454,40
"22414","E01001466",2001,595,57,538,64
"22415","E01001467",2001,595,39,556,70
"22416","E01001463",2001,500,62,438,34
"22417","E01001499",2001,526,25,501,27
"22418","E01001497",2001,503,41,462,17
"22419","E01001528",2001,585,304,281,36
"22420","E01001529",2001,617,159,458,162
"22421","E01001530",2001,477,81,396,54
"22422","E01001534",2001,543,23,520,80
"22423","E01001392",2001,629,41,588,70
"22424","E01001431",2001,589,158,431,79
"22425","E01001432",2001,605,102,503,87
"22426","E01001555",2001,620,101,519,59
"22427","E01001557",2001,510,112,398,22
"22428","E01001558",2001,509,188,321,58
"22429","E01001559",2001,553,77,476,60
"22430","E01001553",2001,498,202,296,27
"22431","E01001554",2001,686,456,230,39
"22432","E01001561",2001,653,96,557,63
"22433","E01001562",2001,582,285,297,90
"22434","E01001458",2001,610,284,326,54
"22435","E01001394",2001,600,114,486,89
"22436","E01001395",2001,600,230,370,47
"22437","E01001397",2001,622,85,537,76
"22438","E01001500",2001,503,21,482,55
"22439","E01001556",2001,526,36,490,35
"22440","E01001560",2001,510,101,409,37
"22441","E01001501",2001,778,105,673,169
"22442","E01001527",2001,636,78,558,88
"22443","E01001396",2001,477,37,440,67
"22444","E01001393",2001,688,50,638,145
"22445","E01001390",2001,653,35,618,107
"22446","E01001391",2001,642,94,548,167
"22447","E01001692",2001,616,397,219,51
"22448","E01001693",2001,644,467,177,45
"22449","E01001694",2001,621,201,420,79
"22450","E01001690",2001,729,467,262,49
"22451","E01001691",2001,518,81,437,29
"22452","E01001687",2001,584,220,364,70
"22453","E01001688",2001,717,190,527,108
"22454","E01001689",2001,529,108,421,34
"22455","E01001575",2001,613,313,300,30
"22456","E01001576",2001,614,363,251,32
"22457","E01001577",2001,713,380,333,38
"22458","E01001578",2001,614,208,406,49
"22459","E01001579",2001,643,315,328,29
"22460","E01001711",2001,634,239,395,142
"22461","E01001712",2001,757,588,169,57
"22462","E01001707",2001,748,538,210,81
"22463","E01001709",2001,491,318,173,59
"22464","E01001710",2001,646,567,79,17
"22465","E01001708",2001,664,247,417,60
"22466","E01001713",2001,647,565,82,21
"22467","E01001705",2001,627,482,145,37
"22468","E01001706",2001,476,348,128,30
"22469","E01001672",2001,639,173,466,117
"22470","E01001673",2001,743,346,397,121
"22471","E01001674",2001,623,110,513,75
"22472","E01001675",2001,611,139,472,90
"22473","E01001677",2001,647,143,504,72
"22474","E01001635",2001,622,126,496,72
"22475","E01001636",2001,626,148,478,111
"22476","E01001630",2001,591,228,363,54
"22477","E01001631",2001,653,512,141,27
"22478","E01001632",2001,617,133,484,104
"22479","E01001571",2001,620,108,512,48
"22480","E01001572",2001,608,81,527,54
"22481","E01001573",2001,508,61,447,40
"22482","E01001574",2001,762,508,254,37
"22483","E01001633",2001,742,433,309,92
"22484","E01001634",2001,653,512,141,29
"22485","E01001637",2001,649,209,440,105
"22486","E01001629",2001,643,484,159,14
"22487","E01001662",2001,727,181,546,165
"22488","E01001663",2001,599,112,487,146
"22489","E01001664",2001,736,321,415,143
"22490","E01001665",2001,565,138,427,108
"22491","E01001666",2001,606,207,399,109
"22492","E01001667",2001,674,474,200,43
"22493","E01001668",2001,735,376,359,111
"22494","E01001695",2001,676,428,248,53
"22495","E01001696",2001,494,364,130,43
"22496","E01001697",2001,630,259,371,103
"22497","E01001703",2001,680,509,171,53
"22498","E01001704",2001,609,171,438,86
"22499","E01001700",2001,635,286,349,81
"22500","E01001595",2001,653,363,290,24
"22501","E01001588",2001,631,310,321,46
"22502","E01001589",2001,622,278,344,77
"22503","E01001591",2001,803,487,316,96
"22504","E01001669",2001,628,202,426,38
"22505","E01001670",2001,583,88,495,22
"22506","E01001671",2001,707,153,554,63
"22507","E01001676",2001,616,266,350,85
"22508","E01001592",2001,734,159,575,100
"22509","E01001593",2001,781,134,647,120
"22510","E01001594",2001,702,528,174,44
"22511","E01001590",2001,731,198,533,138
"22512","E01001698",2001,624,377,247,90
"22513","E01001699",2001,583,326,257,138
"22514","E01001701",2001,549,258,291,143
"22515","E01001702",2001,463,329,134,31
"22516","E01001585",2001,639,135,504,118
"22517","E01001586",2001,746,340,406,89
"22518","E01001587",2001,707,159,548,113
"22519","E01001581",2001,849,387,462,120
"22520","E01001683",2001,586,157,429,62
"22521","E01001684",2001,581,227,354,27
"22522","E01001685",2001,642,154,488,39
"22523","E01001678",2001,640,88,552,31
"22524","E01001638",2001,703,484,219,62
"22525","E01001639",2001,752,375,377,144
"22526","E01001640",2001,661,505,156,48
"22527","E01001641",2001,763,278,485,184
"22528","E01001642",2001,825,153,672,142
"22529","E01001643",2001,853,330,523,152
"22530","E01001644",2001,850,222,628,200
"22531","E01001646",2001,655,374,281,68
"22532","E01001650",2001,613,268,345,25
"22533","E01001651",2001,747,414,333,29
"22534","E01001652",2001,737,175,562,134
"22535","E01001679",2001,510,76,434,36
"22536","E01001680",2001,605,45,560,31
"22537","E01001681",2001,494,110,384,53
"22538","E01001682",2001,524,75,449,19
"22539","E01001686",2001,735,280,455,91
"22540","E01001582",2001,645,212,433,59
"22541","E01001583",2001,828,184,644,201
"22542","E01001584",2001,724,148,576,128
"22543","E01001580",2001,826,151,675,257
"22544","E01001647",2001,573,127,446,15
"22545","E01001648",2001,706,172,534,56
"22546","E01001649",2001,588,257,331,15
"22547","E01001645",2001,718,292,426,33
"22548","E01001605",2001,564,22,542,13
"22549","E01001606",2001,615,32,583,35
"22550","E01001610",2001,660,113,547,23
"22551","E01001611",2001,761,261,500,25
"22552","E01001622",2001,543,414,129,20
"22553","E01001626",2001,622,536,86,10
"22554","E01001627",2001,641,574,67,9
"22555","E01001628",2001,576,287,289,13
"22556","E01001623",2001,569,245,324,34
"22557","E01001624",2001,640,261,379,15
"22558","E01001625",2001,585,332,253,9
"22559","E01001620",2001,500,240,260,14
"22560","E01001621",2001,617,285,332,16
"22561","E01001656",2001,601,178,423,52
"22562","E01001657",2001,676,139,537,67
"22563","E01001658",2001,802,170,632,80
"22564","E01001659",2001,489,70,419,22
"22565","E01001604",2001,608,91,517,54
"22566","E01001607",2001,636,155,481,27
"22567","E01001608",2001,621,122,499,24
"22568","E01001609",2001,746,236,510,58
"22569","E01001613",2001,763,189,574,68
"22570","E01001614",2001,555,32,523,18
"22571","E01001615",2001,805,200,605,106
"22572","E01001617",2001,724,62,662,61
"22573","E01001660",2001,579,272,307,22
"22574","E01001661",2001,584,225,359,12
"22575","E01001653",2001,616,397,219,22
"22576","E01001654",2001,577,296,281,17
"22577","E01001655",2001,651,430,221,28
"22578","E01001618",2001,652,202,450,26
"22579","E01001619",2001,628,67,561,65
"22580","E01001616",2001,745,431,314,37
"22581","E01001612",2001,451,150,301,185
"22582","E01001602",2001,693,295,398,36
"22583","E01001603",2001,762,433,329,39
"22584","E01001597",2001,608,75,533,74
"22585","E01001598",2001,613,63,550,26
"22586","E01001599",2001,615,145,470,16
"22587","E01001600",2001,651,89,562,70
"22588","E01001601",2001,634,86,548,41
"22589","E01001596",2001,608,23,585,25
"22590","E01002112",2001,606,36,570,47
"22591","E01002114",2001,800,198,602,91
"22592","E01002225",2001,618,19,599,54
"22593","E01002226",2001,763,83,680,106
"22594","E01002115",2001,497,44,453,47
"22595","E01002116",2001,611,31,580,68
"22596","E01002117",2001,494,6,488,31
"22597","E01002118",2001,627,24,603,112
"22598","E01002113",2001,594,135,459,45
"22599","E01002227",2001,608,253,355,33
"22600","E01002228",2001,509,61,448,148
"22601","E01002229",2001,750,121,629,65
"22602","E01002230",2001,630,7,623,34
"22603","E01002144",2001,544,59,485,29
"22604","E01002149",2001,482,4,478,25
"22605","E01002146",2001,512,3,509,23
"22606","E01002147",2001,494,6,488,35
"22607","E01002145",2001,612,94,518,34
"22608","E01002140",2001,572,80,492,48
"22609","E01002141",2001,659,74,585,31
"22610","E01002142",2001,617,16,601,55
"22611","E01002143",2001,528,81,447,51
"22612","E01002139",2001,502,287,215,18
"22613","E01002148",2001,493,37,456,24
"22614","E01002150",2001,781,62,719,157
"22615","E01002151",2001,521,240,281,17
"22616","E01002152",2001,631,14,617,65
"22617","E01002119",2001,536,72,464,44
"22618","E01002120",2001,471,184,287,26
"22619","E01002121",2001,526,30,496,45
"22620","E01002122",2001,507,13,494,48
"22621","E01002123",2001,492,23,469,80
"22622","E01002106",2001,638,35,603,33
"22623","E01002108",2001,484,11,473,18
"22624","E01002109",2001,616,25,591,49
"22625","E01002110",2001,493,4,489,37
"22626","E01002111",2001,604,59,545,31
"22627","E01002185",2001,626,304,322,39
"22628","E01002186",2001,764,109,655,114
"22629","E01002187",2001,743,107,636,63
"22630","E01002190",2001,637,6,631,23
"22631","E01002198",2001,471,14,457,35
"22632","E01002200",2001,487,33,454,46
"22633","E01002203",2001,502,16,486,65
"22634","E01002124",2001,478,15,463,36
"22635","E01002125",2001,475,40,435,69
"22636","E01002232",2001,622,62,560,91
"22637","E01002233",2001,637,92,545,113
"22638","E01002234",2001,493,27,466,62
"22639","E01002235",2001,601,207,394,49
"22640","E01002236",2001,522,49,473,79
"22641","E01002201",2001,503,7,496,32
"22642","E01002202",2001,623,83,540,160
"22643","E01002199",2001,424,11,413,31
"22644","E01002197",2001,400,14,386,20
"22645","E01002107",2001,538,12,526,16
"22646","E01002231",2001,630,69,561,92
"22647","E01002183",2001,535,27,508,59
"22648","E01002184",2001,648,86,562,84
"22649","E01002179",2001,611,69,542,114
"22650","E01002180",2001,641,143,498,111
"22651","E01002172",2001,503,39,464,30
"22652","E01002173",2001,519,8,511,42
"22653","E01002177",2001,469,28,441,64
"22654","E01002178",2001,516,13,503,26
"22655","E01002162",2001,622,68,554,79
"22656","E01002163",2001,512,6,506,36
"22657","E01002156",2001,491,6,485,12
"22658","E01002154",2001,712,93,619,83
"22659","E01002188",2001,630,3,627,54
"22660","E01002189",2001,667,47,620,99
"22661","E01002192",2001,630,54,576,56
"22662","E01002193",2001,632,112,520,45
"22663","E01002165",2001,500,29,471,60
"22664","E01002166",2001,478,14,464,43
"22665","E01002167",2001,495,78,417,75
"22666","E01002168",2001,516,229,287,24
"22667","E01002169",2001,515,121,394,39
"22668","E01002170",2001,401,57,344,23
"22669","E01002171",2001,480,11,469,57
"22670","E01002174",2001,475,10,465,48
"22671","E01002175",2001,404,15,389,37
"22672","E01002176",2001,485,10,475,63
"22673","E01002157",2001,522,12,510,80
"22674","E01002158",2001,492,8,484,15
"22675","E01002155",2001,656,26,630,38
"22676","E01002153",2001,617,7,610,43
"22677","E01002128",2001,608,34,574,197
"22678","E01002130",2001,682,98,584,225
"22679","E01002181",2001,611,16,595,112
"22680","E01002182",2001,597,9,588,102
"22681","E01002159",2001,617,49,568,76
"22682","E01002160",2001,643,27,616,167
"22683","E01002161",2001,592,54,538,80
"22684","E01002164",2001,607,21,586,109
"22685","E01002194",2001,656,41,615,25
"22686","E01002195",2001,614,34,580,33
"22687","E01002196",2001,600,10,590,27
"22688","E01002191",2001,621,17,604,36
"22689","E01002131",2001,595,225,370,63
"22690","E01002129",2001,738,104,634,171
"22691","E01002126",2001,879,100,779,244
"22692","E01002127",2001,588,36,552,96
"22693","E01002237",2001,660,106,554,170
"22694","E01002238",2001,600,32,568,85
"22695","E01002240",2001,641,120,521,67
"22696","E01002242",2001,610,17,593,39
"22697","E01002241",2001,616,157,459,48
"22698","E01002239",2001,626,16,610,62
"22699","E01002208",2001,502,8,494,23
"22700","E01002209",2001,525,13,512,108
"22701","E01002210",2001,510,21,489,42
"22702","E01002204",2001,603,66,537,143
"22703","E01002205",2001,513,8,505,27
"22704","E01002206",2001,463,15,448,50
"22705","E01002207",2001,517,10,507,45
"22706","E01002213",2001,713,80,633,120
"22707","E01002133",2001,815,373,442,87
"22708","E01002136",2001,599,31,568,79
"22709","E01002138",2001,504,22,482,66
"22710","E01002211",2001,476,138,338,38
"22711","E01002212",2001,640,109,531,112
"22712","E01002216",2001,529,14,515,32
"22713","E01002217",2001,574,372,202,26
"22714","E01002137",2001,650,53,597,192
"22715","E01002134",2001,631,21,610,161
"22716","E01002135",2001,613,115,498,96
"22717","E01002132",2001,729,40,689,175
"22718","E01002218",2001,618,32,586,101
"22719","E01002219",2001,594,55,539,124
"22720","E01002221",2001,493,51,442,79
"22721","E01002222",2001,512,24,488,48
"22722","E01002223",2001,584,24,560,58
"22723","E01002224",2001,531,147,384,41
"22724","E01002220",2001,499,39,460,28
"22725","E01002214",2001,604,101,503,40
"22726","E01002215",2001,633,256,377,63
"22727","E01002276",2001,611,168,443,19
"22728","E01002278",2001,629,289,340,31
"22729","E01002312",2001,647,159,488,15
"22730","E01002313",2001,630,230,400,18
"22731","E01002299",2001,604,145,459,23
"22732","E01002279",2001,644,181,463,18
"22733","E01002281",2001,748,383,365,47
"22734","E01002283",2001,578,187,391,17
"22735","E01002277",2001,596,236,360,24
"22736","E01002301",2001,615,21,594,20
"22737","E01002306",2001,614,295,319,45
"22738","E01002307",2001,635,152,483,11
"22739","E01002303",2001,651,201,450,23
"22740","E01002304",2001,518,31,487,32
"22741","E01002316",2001,729,402,327,12
"22742","E01002314",2001,611,289,322,13
"22743","E01002297",2001,672,396,276,29
"22744","E01002284",2001,720,228,492,30
"22745","E01002282",2001,709,406,303,35
"22746","E01002280",2001,683,377,306,34
"22747","E01002302",2001,575,45,530,24
"22748","E01002308",2001,615,152,463,20
"22749","E01002305",2001,611,63,548,30
"22750","E01002331",2001,600,41,559,26
"22751","E01002326",2001,627,67,560,64
"22752","E01002309",2001,638,163,475,31
"22753","E01002310",2001,645,261,384,33
"22754","E01002311",2001,643,177,466,29
"22755","E01002315",2001,615,162,453,24
"22756","E01002300",2001,675,69,606,43
"22757","E01002298",2001,640,45,595,37
"22758","E01002296",2001,651,29,622,21
"22759","E01002293",2001,727,47,680,115
"22760","E01002294",2001,617,75,542,28
"22761","E01002333",2001,494,4,490,12
"22762","E01002334",2001,633,12,621,10
"22763","E01002336",2001,614,19,595,36
"22764","E01002339",2001,595,19,576,9
"22765","E01002341",2001,541,6,535,6
"22766","E01002340",2001,493,5,488,26
"22767","E01002338",2001,517,10,507,26
"22768","E01002335",2001,588,136,452,28
"22769","E01002327",2001,606,43,563,23
"22770","E01002328",2001,628,19,609,28
"22771","E01002332",2001,690,63,627,42
"22772","E01002377",2001,634,44,590,49
"22773","E01002378",2001,599,8,591,35
"22774","E01002383",2001,636,17,619,23
"22775","E01002295",2001,604,52,552,36
"22776","E01002268",2001,524,50,474,22
"22777","E01002269",2001,637,7,630,17
"22778","E01002244",2001,616,27,589,60
"22779","E01002245",2001,608,88,520,54
"22780","E01002329",2001,613,19,594,37
"22781","E01002330",2001,673,80,593,56
"22782","E01002325",2001,746,274,472,27
"22783","E01002337",2001,512,101,411,12
"22784","E01002376",2001,520,5,515,23
"22785","E01002379",2001,628,19,609,71
"22786","E01002380",2001,655,213,442,36
"22787","E01002381",2001,619,110,509,27
"22788","E01002354",2001,549,10,539,44
"22789","E01002356",2001,666,275,391,113
"22790","E01002357",2001,750,92,658,147
"22791","E01002353",2001,637,81,556,42
"22792","E01002243",2001,626,265,361,70
"22793","E01002274",2001,633,17,616,31
"22794","E01002272",2001,523,12,511,36
"22795","E01002382",2001,593,47,546,39
"22796","E01002355",2001,562,8,554,21
"22797","E01002317",2001,526,9,517,17
"22798","E01002318",2001,613,46,567,29
"22799","E01002273",2001,487,8,479,21
"22800","E01002275",2001,487,6,481,12
"22801","E01002270",2001,605,90,515,20
"22802","E01002271",2001,495,3,492,11
"22803","E01002319",2001,616,106,510,50
"22804","E01002350",2001,650,113,537,108
"22805","E01002351",2001,629,32,597,75
"22806","E01002352",2001,721,73,648,101
"22807","E01002358",2001,667,57,610,100
"22808","E01002246",2001,636,29,607,36
"22809","E01002247",2001,643,19,624,76
"22810","E01002248",2001,601,135,466,63
"22811","E01002249",2001,478,19,459,25
"22812","E01002250",2001,633,27,606,72
"22813","E01002251",2001,522,168,354,30
"22814","E01002252",2001,605,22,583,8
"22815","E01002256",2001,631,11,620,22
"22816","E01002258",2001,772,192,580,53
"22817","E01002259",2001,592,15,577,19
"22818","E01002391",2001,610,21,589,16
"22819","E01002384",2001,631,18,613,23
"22820","E01002257",2001,631,8,623,20
"22821","E01002253",2001,618,3,615,7
"22822","E01002254",2001,633,9,624,20
"22823","E01002359",2001,517,10,507,12
"22824","E01002360",2001,724,134,590,50
"22825","E01002361",2001,734,169,565,117
"22826","E01002363",2001,663,213,450,33
"22827","E01002367",2001,613,25,588,71
"22828","E01002320",2001,508,6,502,15
"22829","E01002321",2001,626,7,619,49
"22830","E01002322",2001,604,5,599,17
"22831","E01002323",2001,597,3,594,17
"22832","E01002324",2001,652,147,505,25
"22833","E01002362",2001,574,14,560,49
"22834","E01002386",2001,772,34,738,107
"22835","E01002255",2001,634,27,607,21
"22836","E01002289",2001,625,51,574,32
"22837","E01002292",2001,624,119,505,24
"22838","E01002287",2001,586,9,577,30
"22839","E01002291",2001,745,7,738,88
"22840","E01002364",2001,536,21,515,25
"22841","E01002365",2001,536,41,495,46
"22842","E01002366",2001,523,30,493,15
"22843","E01002387",2001,600,3,597,8
"22844","E01002388",2001,607,3,604,8
"22845","E01002389",2001,630,8,622,14
"22846","E01002390",2001,522,3,519,4
"22847","E01002385",2001,578,21,557,19
"22848","E01002288",2001,505,3,502,3
"22849","E01002290",2001,627,19,608,8
"22850","E01002285",2001,513,8,505,21
"22851","E01002286",2001,604,6,598,5
"22852","E01002265",2001,620,15,605,23
"22853","E01002260",2001,551,22,529,35
"22854","E01002261",2001,634,16,618,62
"22855","E01002262",2001,621,129,492,11
"22856","E01002263",2001,502,20,482,6
"22857","E01002264",2001,711,356,355,24
"22858","E01002266",2001,579,31,548,16
"22859","E01002267",2001,729,230,499,20
"22860","E01002372",2001,587,23,564,16
"22861","E01002373",2001,606,34,572,17
"22862","E01002374",2001,613,122,491,25
"22863","E01002375",2001,635,173,462,20
"22864","E01002368",2001,716,377,339,39
"22865","E01002369",2001,663,28,635,24
"22866","E01002370",2001,771,240,531,43
"22867","E01002371",2001,620,23,597,33
"22868","E01002348",2001,649,4,645,12
"22869","E01002349",2001,603,51,552,14
"22870","E01002343",2001,611,7,604,20
"22871","E01002344",2001,611,19,592,38
"22872","E01002345",2001,663,131,532,103
"22873","E01002346",2001,533,103,430,30
"22874","E01002347",2001,518,5,513,23
"22875","E01002342",2001,621,59,562,68
"22876","E01002475",2001,714,214,500,92
"22877","E01002476",2001,615,31,584,78
"22878","E01002477",2001,529,65,464,97
"22879","E01002482",2001,610,3,607,46
"22880","E01002473",2001,609,167,442,23
"22881","E01002474",2001,652,115,537,79
"22882","E01002483",2001,707,52,655,157
"22883","E01002484",2001,582,158,424,47
"22884","E01002485",2001,763,135,628,114
"22885","E01002478",2001,646,63,583,96
"22886","E01002472",2001,773,95,678,152
"22887","E01002438",2001,455,44,411,30
"22888","E01002439",2001,601,144,457,55
"22889","E01002440",2001,599,177,422,12
"22890","E01002441",2001,661,164,497,55
"22891","E01002442",2001,632,168,464,34
"22892","E01002433",2001,620,103,517,30
"22893","E01002436",2001,665,78,587,39
"22894","E01002479",2001,606,181,425,22
"22895","E01002480",2001,742,50,692,39
"22896","E01002481",2001,632,209,423,18
"22897","E01002533",2001,604,146,458,21
"22898","E01002534",2001,609,115,494,36
"22899","E01002538",2001,736,118,618,40
"22900","E01002539",2001,616,90,526,29
"22901","E01002437",2001,607,39,568,20
"22902","E01002431",2001,480,8,472,7
"22903","E01002432",2001,622,41,581,96
"22904","E01002418",2001,656,98,558,18
"22905","E01002419",2001,601,12,589,57
"22906","E01002434",2001,506,24,482,23
"22907","E01002435",2001,531,10,521,20
"22908","E01002430",2001,524,14,510,9
"22909","E01002535",2001,673,41,632,158
"22910","E01002470",2001,615,90,525,96
"22911","E01002471",2001,623,22,601,25
"22912","E01002420",2001,659,146,513,44
"22913","E01002421",2001,638,48,590,42
"22914","E01002416",2001,585,31,554,17
"22915","E01002417",2001,649,19,630,60
"22916","E01002465",2001,635,48,587,84
"22917","E01002467",2001,649,7,642,33
"22918","E01002494",2001,633,89,544,25
"22919","E01002536",2001,601,22,579,195
"22920","E01002537",2001,588,15,573,88
"22921","E01002495",2001,523,27,496,107
"22922","E01002468",2001,625,30,595,27
"22923","E01002469",2001,640,13,627,35
"22924","E01002466",2001,634,10,624,20
"22925","E01002415",2001,629,11,618,19
"22926","E01002462",2001,511,21,490,70
"22927","E01002458",2001,536,7,529,20
"22928","E01002459",2001,631,4,627,24
"22929","E01002460",2001,605,48,557,74
"22930","E01002464",2001,606,50,556,29
"22931","E01002496",2001,786,118,668,117
"22932","E01002497",2001,718,88,630,96
"22933","E01002498",2001,513,28,485,28
"22934","E01002499",2001,633,67,566,48
"22935","E01002500",2001,599,73,526,24
"22936","E01002512",2001,610,15,595,62
"22937","E01002513",2001,522,72,450,23
"22938","E01002516",2001,489,21,468,39
"22939","E01002461",2001,503,29,474,27
"22940","E01002463",2001,530,27,503,12
"22941","E01002450",2001,495,10,485,23
"22942","E01002451",2001,486,40,446,14
"22943","E01002452",2001,502,36,466,29
"22944","E01002453",2001,601,53,548,47
"22945","E01002454",2001,668,161,507,50
"22946","E01002414",2001,523,68,455,81
"22947","E01002514",2001,645,87,558,70
"22948","E01002515",2001,677,177,500,159
"22949","E01002510",2001,468,87,381,206
"22950","E01002522",2001,577,165,412,92
"22951","E01002523",2001,495,65,430,59
"22952","E01002524",2001,651,87,564,75
"22953","E01002520",2001,620,139,481,77
"22954","E01002521",2001,764,346,418,97
"22955","E01002517",2001,502,110,392,146
"22956","E01002511",2001,631,169,462,48
"22957","E01002509",2001,514,4,510,27
"22958","E01002412",2001,520,17,503,36
"22959","E01002410",2001,622,40,582,54
"22960","E01002456",2001,623,112,511,111
"22961","E01002427",2001,489,14,475,22
"22962","E01002428",2001,499,25,474,20
"22963","E01002422",2001,496,28,468,44
"22964","E01002423",2001,528,4,524,35
"22965","E01002424",2001,513,19,494,38
"22966","E01002425",2001,622,144,478,48
"22967","E01002429",2001,512,127,385,35
"22968","E01002408",2001,637,187,450,73
"22969","E01002409",2001,576,156,420,39
"22970","E01002457",2001,491,174,317,40
"22971","E01002455",2001,616,107,509,41
"22972","E01002392",2001,605,304,301,23
"22973","E01002393",2001,667,117,550,60
"22974","E01002542",2001,641,226,415,64
"22975","E01002543",2001,625,168,457,34
"22976","E01002540",2001,643,154,489,52
"22977","E01002394",2001,499,43,456,42
"22978","E01002395",2001,406,21,385,38
"22979","E01002397",2001,468,40,428,112
"22980","E01002398",2001,481,38,443,58
"22981","E01002399",2001,497,31,466,46
"22982","E01002426",2001,639,40,599,37
"22983","E01002413",2001,598,198,400,37
"22984","E01002411",2001,624,189,435,37
"22985","E01002550",2001,821,150,671,170
"22986","E01002554",2001,809,107,702,203
"22987","E01002518",2001,490,22,468,55
"22988","E01002519",2001,740,175,565,113
"22989","E01002544",2001,567,47,520,45
"22990","E01002545",2001,488,314,174,22
"22991","E01002546",2001,464,25,439,72
"22992","E01002547",2001,485,71,414,47
"22993","E01002541",2001,699,54,645,58
"22994","E01002400",2001,590,151,439,63
"22995","E01002401",2001,603,109,494,86
"22996","E01002402",2001,490,146,344,39
"22997","E01002403",2001,502,119,383,34
"22998","E01002404",2001,671,221,450,76
"22999","E01002551",2001,642,164,478,35
"23000","E01002552",2001,533,161,372,38
"23001","E01002553",2001,608,265,343,34
"23002","E01002548",2001,655,263,392,27
"23003","E01002549",2001,612,67,545,43
"23004","E01002508",2001,630,314,316,44
"23005","E01002505",2001,679,289,390,74
"23006","E01002501",2001,470,80,390,31
"23007","E01002502",2001,478,156,322,24
"23008","E01002396",2001,530,155,375,35
"23009","E01002405",2001,624,140,484,74
"23010","E01002406",2001,627,111,516,72
"23011","E01002503",2001,464,147,317,34
"23012","E01002504",2001,651,102,549,66
"23013","E01002506",2001,611,265,346,101
"23014","E01002507",2001,470,41,429,35
"23015","E01002486",2001,604,160,444,29
"23016","E01002487",2001,613,154,459,43
"23017","E01002528",2001,516,149,367,21
"23018","E01002526",2001,488,196,292,21
"23019","E01002532",2001,628,184,444,66
"23020","E01002529",2001,599,71,528,96
"23021","E01002530",2001,639,255,384,34
"23022","E01002531",2001,592,61,531,26
"23023","E01002525",2001,619,42,577,44
"23024","E01002445",2001,630,243,387,59
"23025","E01002407",2001,539,76,463,81
"23026","E01002488",2001,505,30,475,35
"23027","E01002489",2001,521,58,463,62
"23028","E01002490",2001,621,41,580,68
"23029","E01002492",2001,490,43,447,60
"23030","E01002527",2001,630,115,515,91
"23031","E01002446",2001,606,65,541,54
"23032","E01002447",2001,591,84,507,117
"23033","E01002444",2001,671,66,605,97
"23034","E01002448",2001,698,129,569,116
"23035","E01002449",2001,636,57,579,170
"23036","E01002443",2001,539,21,518,79
"23037","E01002493",2001,598,260,338,35
"23038","E01002491",2001,526,157,369,51
"23039","E01002569",2001,758,100,658,149
"23040","E01002570",2001,630,104,526,208
"23041","E01002573",2001,652,67,585,129
"23042","E01002574",2001,653,48,605,184
"23043","E01002575",2001,634,47,587,170
"23044","E01002687",2001,760,83,677,241
"23045","E01002688",2001,855,69,786,319
"23046","E01002691",2001,559,26,533,124
"23047","E01002692",2001,786,162,624,263
"23048","E01002693",2001,766,117,649,212
"23049","E01002685",2001,921,341,580,165
"23050","E01002562",2001,525,231,294,35
"23051","E01002564",2001,659,276,383,53
"23052","E01002566",2001,711,497,214,85
"23053","E01002568",2001,676,494,182,36
"23054","E01002620",2001,607,155,452,113
"23055","E01002625",2001,479,30,449,57
"23056","E01002626",2001,458,23,435,35
"23057","E01002627",2001,625,279,346,71
"23058","E01002631",2001,492,47,445,49
"23059","E01002637",2001,570,201,369,45
"23060","E01002638",2001,578,207,371,39
"23061","E01002633",2001,620,364,256,35
"23062","E01002634",2001,534,316,218,35
"23063","E01002684",2001,665,248,417,76
"23064","E01002686",2001,632,359,273,36
"23065","E01002567",2001,762,134,628,123
"23066","E01002565",2001,726,169,557,115
"23067","E01002563",2001,629,63,566,114
"23068","E01002571",2001,584,26,558,134
"23069","E01002572",2001,638,310,328,67
"23070","E01002577",2001,617,67,550,125
"23071","E01002578",2001,599,89,510,92
"23072","E01002689",2001,744,230,514,90
"23073","E01002690",2001,611,99,512,131
"23074","E01002579",2001,778,120,658,128
"23075","E01002580",2001,664,242,422,172
"23076","E01002581",2001,805,91,714,225
"23077","E01002582",2001,719,111,608,116
"23078","E01002576",2001,725,257,468,117
"23079","E01002675",2001,492,10,482,31
"23080","E01002678",2001,607,16,591,108
"23081","E01002679",2001,615,32,583,105
"23082","E01002680",2001,624,42,582,121
"23083","E01002635",2001,503,77,426,58
"23084","E01002636",2001,572,47,525,56
"23085","E01002622",2001,514,86,428,65
"23086","E01002619",2001,610,63,547,60
"23087","E01002632",2001,492,66,426,43
"23088","E01002618",2001,497,13,484,54
"23089","E01002623",2001,478,141,337,67
"23090","E01002621",2001,567,138,429,74
"23091","E01002628",2001,587,25,562,93
"23092","E01002629",2001,624,111,513,95
"23093","E01002630",2001,554,34,520,135
"23094","E01002639",2001,488,17,471,109
"23095","E01002640",2001,519,25,494,131
"23096","E01002676",2001,528,9,519,67
"23097","E01002674",2001,661,11,650,154
"23098","E01002583",2001,505,40,465,92
"23099","E01002584",2001,474,52,422,81
"23100","E01002585",2001,494,126,368,52
"23101","E01002586",2001,496,33,463,92
"23102","E01002589",2001,629,228,401,125
"23103","E01002681",2001,587,238,349,73
"23104","E01002682",2001,593,177,416,58
"23105","E01002683",2001,754,65,689,95
"23106","E01002668",2001,727,169,558,127
"23107","E01002669",2001,657,282,375,55
"23108","E01002645",2001,735,196,539,95
"23109","E01002658",2001,487,14,473,55
"23110","E01002677",2001,585,111,474,127
"23111","E01002642",2001,631,111,520,173
"23112","E01002643",2001,642,195,447,88
"23113","E01002660",2001,502,73,429,112
"23114","E01002661",2001,487,38,449,115
"23115","E01002665",2001,525,186,339,48
"23116","E01002587",2001,575,143,432,94
"23117","E01002588",2001,682,560,122,24
"23118","E01002662",2001,481,24,457,99
"23119","E01002663",2001,631,235,396,86
"23120","E01002664",2001,507,96,411,115
"23121","E01002646",2001,626,260,366,80
"23122","E01002624",2001,499,117,382,93
"23123","E01002644",2001,618,95,523,264
"23124","E01002641",2001,586,161,425,117
"23125","E01002648",2001,581,58,523,112
"23126","E01002649",2001,625,94,531,186
"23127","E01002657",2001,625,24,601,77
"23128","E01002659",2001,494,60,434,40
"23129","E01002653",2001,523,19,504,48
"23130","E01002654",2001,635,22,613,73
"23131","E01002655",2001,594,16,578,86
"23132","E01002656",2001,486,45,441,39
"23133","E01002667",2001,603,223,380,77
"23134","E01002670",2001,662,65,597,93
"23135","E01002671",2001,625,143,482,61
"23136","E01002672",2001,677,316,361,117
"23137","E01002673",2001,600,501,99,34
"23138","E01002666",2001,415,54,361,52
"23139","E01002647",2001,765,211,554,86
"23140","E01002650",2001,541,77,464,102
"23141","E01002651",2001,467,44,423,79
"23142","E01002652",2001,489,49,440,71
"23143","E01002590",2001,629,116,513,46
"23144","E01002592",2001,731,206,525,57
"23145","E01002595",2001,638,232,406,32
"23146","E01002555",2001,603,31,572,39
"23147","E01002556",2001,609,83,526,45
"23148","E01002557",2001,673,174,499,48
"23149","E01002558",2001,589,259,330,51
"23150","E01002559",2001,559,208,351,24
"23151","E01002560",2001,594,163,431,21
"23152","E01002561",2001,550,272,278,47
"23153","E01002593",2001,632,82,550,38
"23154","E01002594",2001,616,45,571,47
"23155","E01002591",2001,575,158,417,16
"23156","E01002611",2001,623,118,505,31
"23157","E01002612",2001,614,167,447,59
"23158","E01002613",2001,583,95,488,28
"23159","E01002597",2001,574,443,131,21
"23160","E01002598",2001,590,187,403,26
"23161","E01002599",2001,542,164,378,22
"23162","E01002600",2001,512,174,338,7
"23163","E01002603",2001,595,149,446,41
"23164","E01002604",2001,510,374,136,13
"23165","E01002605",2001,726,231,495,51
"23166","E01002606",2001,612,379,233,21
"23167","E01002607",2001,613,94,519,44
"23168","E01002615",2001,601,375,226,32
"23169","E01002616",2001,521,69,452,21
"23170","E01002601",2001,404,63,341,32
"23171","E01002602",2001,532,32,500,24
"23172","E01002614",2001,666,50,616,105
"23173","E01002596",2001,648,68,580,113
"23174","E01002608",2001,615,237,378,25
"23175","E01002609",2001,641,59,582,36
"23176","E01002610",2001,601,240,361,14
"23177","E01002617",2001,634,25,609,34
"23178","E01003006",2001,585,36,549,74
"23179","E01003007",2001,505,15,490,30
"23180","E01003008",2001,490,10,480,27
"23181","E01003009",2001,740,113,627,73
"23182","E01003010",2001,507,34,473,41
"23183","E01002952",2001,479,3,476,52
"23184","E01002953",2001,447,7,440,75
"23185","E01002955",2001,481,23,458,73
"23186","E01002956",2001,441,36,405,39
"23187","E01002959",2001,494,3,491,42
"23188","E01002957",2001,609,253,356,106
"23189","E01002954",2001,606,73,533,181
"23190","E01002951",2001,648,20,628,156
"23191","E01002935",2001,722,33,689,234
"23192","E01002938",2001,783,64,719,122
"23193","E01002936",2001,671,31,640,225
"23194","E01002937",2001,614,24,590,92
"23195","E01002933",2001,732,237,495,83
"23196","E01002934",2001,660,45,615,183
"23197","E01003011",2001,655,39,616,99
"23198","E01002964",2001,788,249,539,148
"23199","E01002969",2001,754,546,208,51
"23200","E01002971",2001,645,51,594,113
"23201","E01002972",2001,692,83,609,175
"23202","E01002974",2001,592,141,451,70
"23203","E01002973",2001,486,150,336,66
"23204","E01002970",2001,587,159,428,105
"23205","E01002932",2001,612,224,388,73
"23206","E01002960",2001,564,6,558,102
"23207","E01002962",2001,514,115,399,45
"23208","E01002963",2001,758,82,676,221
"23209","E01002929",2001,593,14,579,67
"23210","E01002930",2001,651,59,592,173
"23211","E01002931",2001,661,15,646,63
"23212","E01002985",2001,615,31,584,108
"23213","E01002986",2001,479,49,430,38
"23214","E01002927",2001,628,46,582,73
"23215","E01002928",2001,634,21,613,108
"23216","E01002961",2001,613,15,598,63
"23217","E01002958",2001,649,34,615,68
"23218","E01002990",2001,935,63,872,336
"23219","E01002991",2001,715,33,682,184
"23220","E01002965",2001,845,129,716,197
"23221","E01002967",2001,930,43,887,227
"23222","E01002968",2001,747,35,712,224
"23223","E01002966",2001,685,72,613,124
"23224","E01002992",2001,459,41,418,71
"23225","E01002922",2001,736,88,648,104
"23226","E01002926",2001,587,6,581,103
"23227","E01002987",2001,907,102,805,365
"23228","E01002988",2001,532,47,485,152
"23229","E01002989",2001,886,23,863,265
"23230","E01002921",2001,915,151,764,320
"23231","E01002975",2001,488,32,456,32
"23232","E01002977",2001,640,175,465,50
"23233","E01002980",2001,488,3,485,13
"23234","E01002981",2001,515,11,504,25
"23235","E01002984",2001,613,130,483,68
"23236","E01002999",2001,795,101,694,290
"23237","E01002993",2001,944,59,885,303
"23238","E01002995",2001,639,21,618,127
"23239","E01002925",2001,819,62,757,263
"23240","E01002923",2001,800,429,371,129
"23241","E01002924",2001,588,3,585,55
"23242","E01002920",2001,597,31,566,42
"23243","E01002915",2001,493,8,485,37
"23244","E01002916",2001,533,7,526,36
"23245","E01002917",2001,515,5,510,23
"23246","E01002982",2001,514,47,467,26
"23247","E01002983",2001,583,6,577,15
"23248","E01002978",2001,630,12,618,70
"23249","E01002979",2001,622,61,561,36
"23250","E01002976",2001,618,22,596,24
"23251","E01002996",2001,572,28,544,105
"23252","E01002997",2001,605,19,586,120
"23253","E01002998",2001,606,117,489,82
"23254","E01003002",2001,783,163,620,125
"23255","E01002994",2001,609,38,571,96
"23256","E01003003",2001,568,23,545,127
"23257","E01003000",2001,595,131,464,48
"23258","E01003001",2001,647,16,631,52
"23259","E01002918",2001,618,19,599,49
"23260","E01002919",2001,690,75,615,130
"23261","E01003004",2001,598,25,573,65
"23262","E01003005",2001,577,33,544,30
"23263","E01002939",2001,608,96,512,59
"23264","E01002941",2001,642,61,581,54
"23265","E01002942",2001,522,36,486,20
"23266","E01002944",2001,518,49,469,23
"23267","E01002945",2001,621,43,578,30
"23268","E01002946",2001,608,16,592,33
"23269","E01002947",2001,601,16,585,25
"23270","E01002948",2001,672,105,567,48
"23271","E01002949",2001,649,23,626,37
"23272","E01002950",2001,710,194,516,31
"23273","E01002943",2001,513,128,385,22
"23274","E01002940",2001,616,128,488,19
"23275","E01003472",2001,519,5,514,65
"23276","E01003473",2001,503,8,495,99
"23277","E01003474",2001,515,7,508,115
"23278","E01003475",2001,642,79,563,107
"23279","E01003478",2001,608,6,602,115
"23280","E01003460",2001,720,119,601,134
"23281","E01003462",2001,616,59,557,77
"23282","E01003464",2001,603,35,568,107
"23283","E01003465",2001,506,7,499,56
"23284","E01003454",2001,624,56,568,141
"23285","E01003456",2001,615,26,589,221
"23286","E01003400",2001,710,35,675,240
"23287","E01003476",2001,515,128,387,88
"23288","E01003477",2001,622,36,586,134
"23289","E01003401",2001,722,94,628,180
"23290","E01003402",2001,745,45,700,227
"23291","E01003403",2001,756,51,705,203
"23292","E01003404",2001,936,140,796,275
"23293","E01003461",2001,770,17,753,254
"23294","E01003455",2001,795,96,699,175
"23295","E01003367",2001,686,75,611,157
"23296","E01003369",2001,779,67,712,224
"23297","E01003370",2001,736,77,659,245
"23298","E01003371",2001,664,46,618,144
"23299","E01003359",2001,786,164,622,181
"23300","E01003360",2001,747,37,710,174
"23301","E01003457",2001,669,37,632,97
"23302","E01003458",2001,720,19,701,156
"23303","E01003459",2001,769,248,521,135
"23304","E01003394",2001,634,31,603,102
"23305","E01003395",2001,536,6,530,43
"23306","E01003396",2001,541,18,523,109
"23307","E01003397",2001,573,29,544,100
"23308","E01003398",2001,619,15,604,115
"23309","E01003393",2001,647,47,600,230
"23310","E01003406",2001,588,201,387,55
"23311","E01003407",2001,780,50,730,224
"23312","E01003368",2001,577,84,493,91
"23313","E01003372",2001,610,241,369,102
"23314","E01003383",2001,764,31,733,236
"23315","E01003384",2001,666,32,634,177
"23316","E01003358",2001,794,52,742,237
"23317","E01003355",2001,764,29,735,272
"23318","E01003356",2001,726,55,671,159
"23319","E01003463",2001,509,16,493,59
"23320","E01003442",2001,661,58,603,143
"23321","E01003443",2001,650,21,629,72
"23322","E01003444",2001,746,53,693,158
"23323","E01003445",2001,705,69,636,78
"23324","E01003382",2001,729,44,685,163
"23325","E01003399",2001,653,64,589,179
"23326","E01003423",2001,637,33,604,126
"23327","E01003385",2001,661,19,642,116
"23328","E01003380",2001,712,26,686,120
"23329","E01003376",2001,609,257,352,43
"23330","E01003377",2001,532,333,199,29
"23331","E01003357",2001,746,362,384,89
"23332","E01003410",2001,636,153,483,108
"23333","E01003408",2001,889,82,807,205
"23334","E01003409",2001,512,133,379,26
"23335","E01003392",2001,544,21,523,98
"23336","E01003388",2001,603,152,451,63
"23337","E01003389",2001,595,37,558,100
"23338","E01003386",2001,512,14,498,71
"23339","E01003387",2001,636,210,426,45
"23340","E01003391",2001,550,288,262,33
"23341","E01003411",2001,703,82,621,87
"23342","E01003412",2001,605,141,464,54
"23343","E01003435",2001,523,25,498,30
"23344","E01003424",2001,597,9,588,45
"23345","E01003425",2001,516,3,513,28
"23346","E01003426",2001,626,7,619,84
"23347","E01003428",2001,637,82,555,109
"23348","E01003361",2001,625,62,563,89
"23349","E01003366",2001,634,115,519,98
"23350","E01003381",2001,754,21,733,164
"23351","E01003446",2001,800,63,737,238
"23352","E01003447",2001,727,264,463,94
"23353","E01003471",2001,616,90,526,79
"23354","E01003434",2001,491,11,480,28
"23355","E01003413",2001,640,42,598,72
"23356","E01003414",2001,587,17,570,77
"23357","E01003415",2001,623,18,605,62
"23358","E01003416",2001,563,27,536,35
"23359","E01003405",2001,672,206,466,61
"23360","E01003390",2001,584,331,253,68
"23361","E01003378",2001,602,82,520,70
"23362","E01003379",2001,759,352,407,83
"23363","E01003373",2001,518,302,216,20
"23364","E01003429",2001,487,16,471,16
"23365","E01003430",2001,573,237,336,40
"23366","E01003431",2001,538,202,336,32
"23367","E01003432",2001,523,268,255,27
"23368","E01003433",2001,583,73,510,32
"23369","E01003466",2001,613,3,610,40
"23370","E01003467",2001,605,22,583,50
"23371","E01003468",2001,656,23,633,31
"23372","E01003469",2001,616,58,558,83
"23373","E01003470",2001,637,24,613,78
"23374","E01003421",2001,642,76,566,52
"23375","E01003362",2001,507,20,487,12
"23376","E01003363",2001,612,3,609,23
"23377","E01003364",2001,660,43,617,14
"23378","E01003365",2001,521,3,518,29
"23379","E01003374",2001,546,126,420,97
"23380","E01003375",2001,646,119,527,77
"23381","E01003437",2001,751,86,665,54
"23382","E01003440",2001,629,163,466,52
"23383","E01003441",2001,594,171,423,46
"23384","E01003439",2001,610,149,461,109
"23385","E01003436",2001,608,178,430,22
"23386","E01003448",2001,607,216,391,25
"23387","E01003427",2001,723,55,668,171
"23388","E01003453",2001,658,180,478,53
"23389","E01003449",2001,631,157,474,55
"23390","E01003450",2001,609,219,390,28
"23391","E01003451",2001,610,71,539,29
"23392","E01003452",2001,724,428,296,28
"23393","E01003438",2001,640,233,407,24
"23394","E01003422",2001,474,12,462,34
"23395","E01003417",2001,608,18,590,24
"23396","E01003418",2001,526,8,518,8
"23397","E01003419",2001,586,14,572,25
"23398","E01003420",2001,511,6,505,16
"23399","E01003744",2001,587,16,571,62
"23400","E01003745",2001,484,0,484,21
"23401","E01003746",2001,639,18,621,38
"23402","E01003747",2001,488,24,464,10
"23403","E01003748",2001,532,4,528,43
"23404","E01003749",2001,652,18,634,80
"23405","E01003750",2001,756,117,639,77
"23406","E01003726",2001,606,206,400,16
"23407","E01003722",2001,618,148,470,25
"23408","E01003723",2001,664,184,480,14
"23409","E01003720",2001,742,199,543,58
"23410","E01003721",2001,596,91,505,29
"23411","E01003724",2001,497,80,417,18
"23412","E01003725",2001,632,128,504,54
"23413","E01003727",2001,652,204,448,31
"23414","E01003654",2001,623,82,541,33
"23415","E01003655",2001,639,29,610,58
"23416","E01003660",2001,631,8,623,40
"23417","E01003658",2001,656,269,387,34
"23418","E01003659",2001,630,15,615,35
"23419","E01003656",2001,630,165,465,45
"23420","E01003657",2001,843,80,763,87
"23421","E01003698",2001,517,19,498,38
"23422","E01003699",2001,597,32,565,42
"23423","E01003700",2001,619,89,530,49
"23424","E01003701",2001,629,33,596,106
"23425","E01003702",2001,750,34,716,127
"23426","E01003703",2001,601,106,495,28
"23427","E01003704",2001,618,109,509,50
"23428","E01003668",2001,681,35,646,121
"23429","E01003669",2001,570,17,553,66
"23430","E01003670",2001,542,87,455,35
"23431","E01003671",2001,550,3,547,21
"23432","E01003672",2001,465,81,384,85
"23433","E01003673",2001,597,36,561,87
"23434","E01003674",2001,692,102,590,156
"23435","E01003707",2001,479,32,447,18
"23436","E01003708",2001,622,214,408,45
"23437","E01003709",2001,579,20,559,21
"23438","E01003710",2001,500,15,485,8
"23439","E01003759",2001,537,11,526,19
"23440","E01003760",2001,616,60,556,80
"23441","E01003761",2001,695,518,177,61
"23442","E01003762",2001,624,62,562,67
"23443","E01003763",2001,658,19,639,40
"23444","E01003764",2001,777,95,682,137
"23445","E01003765",2001,628,35,593,117
"23446","E01003711",2001,630,83,547,42
"23447","E01003712",2001,522,230,292,47
"23448","E01003705",2001,612,31,581,70
"23449","E01003706",2001,626,39,587,66
"23450","E01003678",2001,487,20,467,23
"23451","E01003679",2001,501,8,493,19
"23452","E01003680",2001,480,0,480,17
"23453","E01003681",2001,601,84,517,86
"23454","E01003651",2001,484,8,476,20
"23455","E01003646",2001,547,21,526,66
"23456","E01003648",2001,532,6,526,12
"23457","E01003649",2001,510,43,467,19
"23458","E01003639",2001,622,133,489,43
"23459","E01003640",2001,623,32,591,52
"23460","E01003641",2001,498,36,462,45
"23461","E01003642",2001,520,74,446,56
"23462","E01003774",2001,846,85,761,98
"23463","E01003775",2001,690,36,654,94
"23464","E01003776",2001,881,356,525,124
"23465","E01003777",2001,783,42,741,177
"23466","E01003778",2001,778,57,721,144
"23467","E01003779",2001,712,89,623,101
"23468","E01003780",2001,508,0,508,16
"23469","E01003650",2001,590,107,483,52
"23470","E01003647",2001,483,8,475,41
"23471","E01003652",2001,489,4,485,40
"23472","E01003653",2001,497,21,476,105
"23473","E01003682",2001,508,14,494,22
"23474","E01003675",2001,518,9,509,58
"23475","E01003676",2001,515,41,474,35
"23476","E01003677",2001,522,9,513,27
"23477","E01003643",2001,637,23,614,49
"23478","E01003644",2001,507,19,488,35
"23479","E01003645",2001,511,42,469,87
"23480","E01003638",2001,512,85,427,23
"23481","E01003789",2001,620,122,498,73
"23482","E01003794",2001,587,54,533,47
"23483","E01003795",2001,472,9,463,15
"23484","E01003796",2001,619,74,545,54
"23485","E01003661",2001,554,16,538,29
"23486","E01003662",2001,726,29,697,159
"23487","E01003663",2001,667,24,643,35
"23488","E01003664",2001,566,38,528,24
"23489","E01003665",2001,522,16,506,21
"23490","E01003666",2001,752,60,692,132
"23491","E01003667",2001,647,51,596,22
"23492","E01003757",2001,586,31,555,138
"23493","E01003753",2001,636,23,613,132
"23494","E01003754",2001,537,28,509,65
"23495","E01003751",2001,603,36,567,59
"23496","E01003694",2001,475,40,435,39
"23497","E01003696",2001,517,48,469,40
"23498","E01003690",2001,488,41,447,114
"23499","E01003692",2001,524,14,510,80
"23500","E01003769",2001,482,19,463,147
"23501","E01003770",2001,481,21,460,27
"23502","E01003771",2001,552,34,518,120
"23503","E01003773",2001,563,14,549,61
"23504","E01003758",2001,500,133,367,77
"23505","E01003755",2001,518,15,503,53
"23506","E01003756",2001,578,34,544,62
"23507","E01003752",2001,617,8,609,57
"23508","E01003766",2001,532,13,519,91
"23509","E01003767",2001,509,8,501,119
"23510","E01003768",2001,559,49,510,170
"23511","E01003772",2001,528,9,519,74
"23512","E01003697",2001,501,41,460,31
"23513","E01003695",2001,613,27,586,207
"23514","E01003693",2001,475,9,466,31
"23515","E01003691",2001,504,23,481,95
"23516","E01003781",2001,601,44,557,196
"23517","E01003782",2001,486,35,451,135
"23518","E01003786",2001,452,17,435,39
"23519","E01003787",2001,471,15,456,103
"23520","E01003790",2001,518,58,460,27
"23521","E01003791",2001,529,21,508,32
"23522","E01003792",2001,501,20,481,43
"23523","E01003793",2001,745,244,501,75
"23524","E01003713",2001,470,5,465,56
"23525","E01003714",2001,627,38,589,120
"23526","E01003715",2001,536,16,520,100
"23527","E01003716",2001,512,58,454,74
"23528","E01003717",2001,718,107,611,100
"23529","E01003718",2001,674,43,631,146
"23530","E01003719",2001,561,14,547,116
"23531","E01003783",2001,621,71,550,252
"23532","E01003784",2001,559,21,538,138
"23533","E01003785",2001,662,63,599,265
"23534","E01003788",2001,658,48,610,283
"23535","E01003683",2001,562,38,524,114
"23536","E01003684",2001,482,31,451,66
"23537","E01003685",2001,508,23,485,130
"23538","E01003686",2001,481,29,452,110
"23539","E01003687",2001,677,73,604,210
"23540","E01003688",2001,488,52,436,149
"23541","E01003689",2001,500,96,404,106
"23542","E01003737",2001,586,70,516,43
"23543","E01003738",2001,660,9,651,36
"23544","E01003739",2001,516,36,480,54
"23545","E01003740",2001,627,39,588,39
"23546","E01003741",2001,640,92,548,41
"23547","E01003742",2001,584,12,572,95
"23548","E01003743",2001,487,16,471,60
"23549","E01003728",2001,525,55,470,113
"23550","E01003729",2001,477,73,404,130
"23551","E01003730",2001,448,17,431,97
"23552","E01003732",2001,665,99,566,261
"23553","E01003733",2001,530,38,492,98
"23554","E01003734",2001,537,39,498,103
"23555","E01003735",2001,593,281,312,99
"23556","E01003736",2001,508,42,466,72
"23557","E01003731",2001,456,83,373,83
"23558","E01003797",2001,504,27,477,40
"23559","E01003798",2001,632,107,525,109
"23560","E01003799",2001,637,25,612,166
"23561","E01003800",2001,615,145,470,90
"23562","E01003801",2001,508,6,502,139
"23563","E01003802",2001,626,29,597,232
"23564","E01003803",2001,620,298,322,65
"23565","E01003846",2001,624,9,615,92
"23566","E01003847",2001,864,52,812,323
"23567","E01003849",2001,642,43,599,118
"23568","E01003851",2001,691,3,688,156
"23569","E01003860",2001,745,100,645,219
"23570","E01003864",2001,634,59,575,128
"23571","E01003852",2001,646,86,560,141
"23572","E01003853",2001,622,129,493,71
"23573","E01003854",2001,633,81,552,109
"23574","E01003855",2001,731,257,474,100
"23575","E01003856",2001,745,86,659,189
"23576","E01003857",2001,723,72,651,153
"23577","E01003858",2001,623,21,602,119
"23578","E01003865",2001,507,108,399,69
"23579","E01003861",2001,796,88,708,187
"23580","E01003862",2001,598,126,472,119
"23581","E01003863",2001,646,223,423,81
"23582","E01003850",2001,638,170,468,69
"23583","E01003848",2001,755,107,648,172
"23584","E01003859",2001,611,38,573,64
"23585","E01003804",2001,735,55,680,152
"23586","E01003807",2001,765,99,666,200
"23587","E01003808",2001,782,63,719,121
"23588","E01003809",2001,621,30,591,80
"23589","E01003873",2001,865,75,790,231
"23590","E01003874",2001,766,53,713,246
"23591","E01003875",2001,643,73,570,126
"23592","E01003878",2001,667,360,307,105
"23593","E01003868",2001,622,8,614,176
"23594","E01003871",2001,476,12,464,71
"23595","E01003872",2001,664,29,635,164
"23596","E01003866",2001,641,11,630,97
"23597","E01003821",2001,755,67,688,286
"23598","E01003876",2001,823,52,771,287
"23599","E01003877",2001,754,60,694,211
"23600","E01003879",2001,645,33,612,210
"23601","E01003892",2001,923,24,899,277
"23602","E01003893",2001,744,40,704,227
"23603","E01003894",2001,760,42,718,227
"23604","E01003895",2001,746,87,659,163
"23605","E01003905",2001,512,23,489,84
"23606","E01003906",2001,630,49,581,76
"23607","E01003907",2001,614,192,422,35
"23608","E01003908",2001,661,18,643,31
"23609","E01003909",2001,597,30,567,95
"23610","E01003910",2001,665,8,657,26
"23611","E01003869",2001,659,13,646,145
"23612","E01003870",2001,633,9,624,95
"23613","E01003867",2001,569,36,533,107
"23614","E01003816",2001,608,100,508,56
"23615","E01003817",2001,753,79,674,109
"23616","E01003805",2001,598,6,592,50
"23617","E01003806",2001,510,7,503,52
"23618","E01003840",2001,542,34,508,54
"23619","E01003841",2001,778,322,456,63
"23620","E01003842",2001,632,189,443,28
"23621","E01003843",2001,656,101,555,27
"23622","E01003844",2001,549,31,518,30
"23623","E01003845",2001,628,3,625,16
"23624","E01003882",2001,706,4,702,135
"23625","E01003883",2001,754,53,701,112
"23626","E01003896",2001,732,22,710,250
"23627","E01003897",2001,766,59,707,180
"23628","E01003898",2001,633,24,609,121
"23629","E01003899",2001,645,26,619,108
"23630","E01003900",2001,607,195,412,56
"23631","E01003901",2001,608,22,586,30
"23632","E01003902",2001,504,11,493,36
"23633","E01003903",2001,581,74,507,33
"23634","E01003904",2001,647,122,525,75
"23635","E01003880",2001,582,26,556,82
"23636","E01003881",2001,486,28,458,83
"23637","E01003884",2001,653,89,564,81
"23638","E01003885",2001,633,43,590,124
"23639","E01003818",2001,641,47,594,80
"23640","E01003819",2001,757,328,429,45
"23641","E01003820",2001,736,167,569,50
"23642","E01003811",2001,656,17,639,93
"23643","E01003812",2001,737,74,663,139
"23644","E01003890",2001,642,19,623,125
"23645","E01003891",2001,797,16,781,152
"23646","E01003813",2001,629,23,606,33
"23647","E01003814",2001,743,77,666,106
"23648","E01003815",2001,757,98,659,161
"23649","E01003810",2001,600,61,539,55
"23650","E01003828",2001,617,22,595,42
"23651","E01003829",2001,636,213,423,24
"23652","E01003830",2001,707,83,624,81
"23653","E01003831",2001,655,24,631,43
"23654","E01003832",2001,682,329,353,42
"23655","E01003833",2001,676,115,561,66
"23656","E01003886",2001,628,39,589,110
"23657","E01003887",2001,756,30,726,124
"23658","E01003888",2001,836,247,589,124
"23659","E01003889",2001,756,22,734,158
"23660","E01003834",2001,730,98,632,229
"23661","E01003835",2001,549,10,539,68
"23662","E01003836",2001,633,181,452,48
"23663","E01003837",2001,722,62,660,91
"23664","E01003838",2001,622,34,588,103
"23665","E01003839",2001,864,134,730,134
"23666","E01003822",2001,513,10,503,21
"23667","E01003823",2001,758,44,714,125
"23668","E01003824",2001,631,30,601,67
"23669","E01003825",2001,623,38,585,33
"23670","E01003826",2001,728,316,412,71
"23671","E01003827",2001,777,109,668,149
"23672","E01004125",2001,615,306,309,14
"23673","E01004183",2001,651,317,334,31
"23674","E01004184",2001,601,273,328,28
"23675","E01004185",2001,571,314,257,43
"23676","E01004189",2001,725,338,387,25
"23677","E01004126",2001,561,289,272,13
"23678","E01004123",2001,632,243,389,71
"23679","E01004124",2001,650,234,416,10
"23680","E01004128",2001,528,239,289,16
"23681","E01004129",2001,687,371,316,21
"23682","E01004130",2001,608,38,570,35
"23683","E01004131",2001,589,14,575,32
"23684","E01004134",2001,611,23,588,45
"23685","E01004135",2001,509,3,506,28
"23686","E01004136",2001,535,15,520,18
"23687","E01004164",2001,639,50,589,44
"23688","E01004166",2001,655,85,570,53
"23689","E01004169",2001,681,268,413,67
"23690","E01004188",2001,678,101,577,93
"23691","E01004186",2001,728,77,651,88
"23692","E01004187",2001,650,201,449,29
"23693","E01004167",2001,528,211,317,31
"23694","E01004165",2001,614,71,543,58
"23695","E01004163",2001,610,23,587,26
"23696","E01004127",2001,622,178,444,24
"23697","E01004121",2001,566,22,544,58
"23698","E01004117",2001,512,0,512,8
"23699","E01004195",2001,608,38,570,104
"23700","E01004192",2001,599,59,540,37
"23701","E01004193",2001,602,16,586,40
"23702","E01004144",2001,609,5,604,42
"23703","E01004145",2001,761,64,697,34
"23704","E01004146",2001,667,69,598,52
"23705","E01004147",2001,594,68,526,19
"23706","E01004116",2001,628,39,589,21
"23707","E01004122",2001,522,47,475,22
"23708","E01004194",2001,598,59,539,28
"23709","E01004196",2001,536,9,527,19
"23710","E01004190",2001,492,3,489,25
"23711","E01004191",2001,631,7,624,47
"23712","E01004132",2001,509,4,505,18
"23713","E01004133",2001,525,7,518,15
"23714","E01004118",2001,620,13,607,64
"23715","E01004119",2001,494,0,494,17
"23716","E01004115",2001,649,0,649,41
"23717","E01004175",2001,630,70,560,42
"23718","E01004176",2001,585,76,509,77
"23719","E01004171",2001,559,40,519,33
"23720","E01004172",2001,747,179,568,117
"23721","E01004173",2001,520,99,421,19
"23722","E01004076",2001,631,116,515,35
"23723","E01004077",2001,611,47,564,50
"23724","E01004078",2001,670,111,559,57
"23725","E01004079",2001,490,10,480,12
"23726","E01004080",2001,495,8,487,12
"23727","E01004081",2001,596,58,538,39
"23728","E01004082",2001,491,10,481,13
"23729","E01004149",2001,776,71,705,96
"23730","E01004137",2001,750,29,721,153
"23731","E01004140",2001,757,284,473,90
"23732","E01004141",2001,765,184,581,88
"23733","E01004142",2001,746,375,371,100
"23734","E01004138",2001,722,101,621,129
"23735","E01004139",2001,612,36,576,101
"23736","E01004103",2001,717,44,673,85
"23737","E01004168",2001,583,29,554,30
"23738","E01004101",2001,522,12,510,29
"23739","E01004148",2001,648,219,429,31
"23740","E01004159",2001,611,30,581,31
"23741","E01004160",2001,673,19,654,133
"23742","E01004161",2001,612,14,598,50
"23743","E01004143",2001,625,83,542,61
"23744","E01004102",2001,535,34,501,63
"23745","E01004097",2001,599,14,585,69
"23746","E01004098",2001,515,21,494,63
"23747","E01004099",2001,699,182,517,112
"23748","E01004100",2001,530,20,510,49
"23749","E01004110",2001,682,37,645,158
"23750","E01004111",2001,618,70,548,34
"23751","E01004112",2001,658,5,653,48
"23752","E01004120",2001,541,3,538,16
"23753","E01004157",2001,439,3,436,11
"23754","E01004174",2001,658,80,578,113
"23755","E01004170",2001,660,31,629,117
"23756","E01004087",2001,529,5,524,15
"23757","E01004178",2001,893,145,748,158
"23758","E01004179",2001,594,10,584,72
"23759","E01004158",2001,735,30,705,144
"23760","E01004162",2001,790,66,724,200
"23761","E01004152",2001,857,173,684,172
"23762","E01004155",2001,836,20,816,172
"23763","E01004156",2001,915,50,865,260
"23764","E01004088",2001,656,543,113,23
"23765","E01004089",2001,637,456,181,29
"23766","E01004086",2001,550,110,440,39
"23767","E01004083",2001,655,453,202,23
"23768","E01004182",2001,649,259,390,55
"23769","E01004180",2001,613,9,604,11
"23770","E01004181",2001,721,95,626,72
"23771","E01004177",2001,897,254,643,97
"23772","E01004107",2001,633,129,504,37
"23773","E01004104",2001,622,26,596,43
"23774","E01004096",2001,806,96,710,196
"23775","E01004153",2001,935,114,821,196
"23776","E01004150",2001,1001,269,732,288
"23777","E01004151",2001,761,65,696,189
"23778","E01004090",2001,564,328,236,34
"23779","E01004091",2001,475,5,470,6
"23780","E01004092",2001,608,12,596,51
"23781","E01004154",2001,548,23,525,26
"23782","E01004105",2001,641,58,583,43
"23783","E01004106",2001,516,0,516,6
"23784","E01004113",2001,602,0,602,14
"23785","E01004114",2001,589,3,586,11
"23786","E01004093",2001,606,8,598,52
"23787","E01004094",2001,691,18,673,79
"23788","E01004095",2001,598,6,592,72
"23789","E01004084",2001,498,10,488,6
"23790","E01004085",2001,594,13,581,32
"23791","E01004108",2001,497,44,453,27
"23792","E01004109",2001,634,172,462,16
"23793","E01004349",2001,532,165,367,14
"23794","E01004350",2001,876,318,558,54
"23795","E01004351",2001,630,46,584,26
"23796","E01004356",2001,597,126,471,26
"23797","E01004357",2001,562,84,478,21
"23798","E01004358",2001,768,154,614,74
"23799","E01004359",2001,583,70,513,34
"23800","E01004352",2001,707,31,676,70
"23801","E01004353",2001,767,78,689,65
"23802","E01004354",2001,665,37,628,82
"23803","E01004384",2001,630,230,400,28
"23804","E01004385",2001,623,257,366,45
"23805","E01004386",2001,622,21,601,8
"23806","E01004389",2001,675,237,438,32
"23807","E01004390",2001,641,252,389,25
"23808","E01004415",2001,584,127,457,23
"23809","E01004416",2001,635,102,533,27
"23810","E01004355",2001,670,148,522,43
"23811","E01004360",2001,487,17,470,10
"23812","E01004413",2001,691,260,431,27
"23813","E01004414",2001,586,20,566,38
"23814","E01004451",2001,617,86,531,12
"23815","E01004452",2001,632,93,539,59
"23816","E01004361",2001,489,10,479,18
"23817","E01004417",2001,607,107,500,56
"23818","E01004453",2001,656,43,613,75
"23819","E01004454",2001,632,68,564,47
"23820","E01004455",2001,595,155,440,63
"23821","E01004456",2001,492,340,152,30
"23822","E01004450",2001,589,14,575,16
"23823","E01004387",2001,498,7,491,20
"23824","E01004388",2001,592,109,483,75
"23825","E01004383",2001,523,59,464,13
"23826","E01004379",2001,518,16,502,40
"23827","E01004380",2001,604,157,447,29
"23828","E01004381",2001,621,59,562,60
"23829","E01004382",2001,502,282,220,23
"23830","E01004343",2001,629,39,590,42
"23831","E01004344",2001,612,157,455,57
"23832","E01004418",2001,591,78,513,51
"23833","E01004419",2001,637,25,612,93
"23834","E01004402",2001,643,200,443,81
"23835","E01004403",2001,597,194,403,47
"23836","E01004398",2001,619,360,259,40
"23837","E01004399",2001,583,384,199,29
"23838","E01004400",2001,620,137,483,96
"23839","E01004348",2001,663,67,596,104
"23840","E01004345",2001,597,63,534,73
"23841","E01004377",2001,531,19,512,15
"23842","E01004378",2001,621,137,484,62
"23843","E01004346",2001,545,77,468,35
"23844","E01004347",2001,766,111,655,105
"23845","E01004342",2001,633,179,454,58
"23846","E01004462",2001,576,97,479,130
"23847","E01004460",2001,610,153,457,83
"23848","E01004463",2001,832,103,729,181
"23849","E01004457",2001,715,140,575,146
"23850","E01004458",2001,629,91,538,99
"23851","E01004459",2001,511,365,146,45
"23852","E01004396",2001,637,62,575,128
"23853","E01004407",2001,591,390,201,56
"23854","E01004410",2001,691,324,367,105
"23855","E01004464",2001,623,381,242,60
"23856","E01004469",2001,653,379,274,39
"23857","E01004470",2001,568,174,394,101
"23858","E01004471",2001,650,241,409,94
"23859","E01004461",2001,710,49,661,139
"23860","E01004404",2001,768,293,475,138
"23861","E01004393",2001,780,288,492,170
"23862","E01004401",2001,650,99,551,95
"23863","E01004391",2001,802,155,647,182
"23864","E01004412",2001,649,140,509,119
"23865","E01004465",2001,531,81,450,59
"23866","E01004466",2001,599,95,504,86
"23867","E01004467",2001,744,339,405,159
"23868","E01004468",2001,643,60,583,75
"23869","E01004447",2001,628,70,558,106
"23870","E01004443",2001,502,86,416,128
"23871","E01004406",2001,653,118,535,196
"23872","E01004411",2001,588,109,479,166
"23873","E01004408",2001,601,98,503,82
"23874","E01004409",2001,692,177,515,144
"23875","E01004397",2001,681,112,569,223
"23876","E01004392",2001,748,84,664,203
"23877","E01004394",2001,735,306,429,119
"23878","E01004444",2001,770,262,508,179
"23879","E01004446",2001,659,114,545,139
"23880","E01004448",2001,689,169,520,99
"23881","E01004449",2001,535,359,176,49
"23882","E01004445",2001,603,146,457,105
"23883","E01004421",2001,565,71,494,77
"23884","E01004395",2001,568,87,481,90
"23885","E01004363",2001,500,51,449,68
"23886","E01004364",2001,589,183,406,77
"23887","E01004366",2001,615,47,568,118
"23888","E01004367",2001,510,74,436,118
"23889","E01004368",2001,640,79,561,194
"23890","E01004365",2001,511,77,434,146
"23891","E01004405",2001,539,144,395,104
"23892","E01004420",2001,617,142,475,147
"23893","E01004431",2001,478,357,121,46
"23894","E01004433",2001,579,371,208,61
"23895","E01004423",2001,613,199,414,143
"23896","E01004442",2001,627,71,556,146
"23897","E01004436",2001,602,106,496,173
"23898","E01004437",2001,666,159,507,189
"23899","E01004439",2001,604,134,470,158
"23900","E01004362",2001,623,119,504,176
"23901","E01004424",2001,585,176,409,134
"23902","E01004425",2001,771,154,617,208
"23903","E01004426",2001,568,72,496,93
"23904","E01004427",2001,788,62,726,279
"23905","E01004422",2001,527,26,501,82
"23906","E01004432",2001,643,82,561,144
"23907","E01004435",2001,677,161,516,192
"23908","E01004369",2001,626,90,536,228
"23909","E01004370",2001,580,39,541,168
"23910","E01004372",2001,700,55,645,256
"23911","E01004333",2001,546,228,318,77
"23912","E01004334",2001,650,433,217,57
"23913","E01004440",2001,615,85,530,186
"23914","E01004441",2001,619,75,544,119
"23915","E01004438",2001,570,79,491,119
"23916","E01004373",2001,558,81,477,151
"23917","E01004374",2001,630,84,546,141
"23918","E01004375",2001,604,83,521,188
"23919","E01004376",2001,573,94,479,151
"23920","E01004371",2001,552,60,492,134
"23921","E01004434",2001,663,188,475,111
"23922","E01004428",2001,610,458,152,44
"23923","E01004429",2001,567,216,351,100
"23924","E01004430",2001,646,85,561,205
"23925","E01004336",2001,529,111,418,141
"23926","E01004337",2001,650,284,366,99
"23927","E01004338",2001,579,78,501,167
"23928","E01004339",2001,606,129,477,130
"23929","E01004340",2001,630,317,313,107
"23930","E01004341",2001,636,338,298,120
"23931","E01004335",2001,564,434,130,48
"23932","E01004327",2001,458,196,262,48
"23933","E01004328",2001,608,104,504,159
"23934","E01004329",2001,615,104,511,112
"23935","E01004330",2001,601,56,545,101
"23936","E01004331",2001,593,116,477,112
"23937","E01004332",2001,570,169,401,109
"23938","E01016244",2001,662,4,658,31
"23939","E01016251",2001,534,39,495,46
"23940","E01016252",2001,646,10,636,107
"23941","E01016253",2001,530,12,518,36
"23942","E01016184",2001,654,20,634,67
"23943","E01016185",2001,618,20,598,146
"23944","E01016186",2001,649,61,588,93
"23945","E01016187",2001,649,26,623,37
"23946","E01016188",2001,666,53,613,55
"23947","E01016190",2001,592,116,476,22
"23948","E01016245",2001,742,3,739,64
"23949","E01016246",2001,618,4,614,55
"23950","E01016247",2001,695,43,652,46
"23951","E01016243",2001,603,74,529,51
"23952","E01016238",2001,470,92,378,24
"23953","E01016239",2001,614,191,423,17
"23954","E01016240",2001,636,247,389,27
"23955","E01016241",2001,622,252,370,9
"23956","E01016242",2001,766,326,440,68
"23957","E01016222",2001,520,3,517,52
"23958","E01016180",2001,504,97,407,24
"23959","E01016181",2001,493,3,490,57
"23960","E01016182",2001,532,29,503,30
"23961","E01016183",2001,508,14,494,31
"23962","E01016191",2001,639,155,484,23
"23963","E01016189",2001,874,330,544,72
"23964","E01016223",2001,668,209,459,73
"23965","E01016224",2001,651,246,405,42
"23966","E01016226",2001,646,182,464,35
"23967","E01016225",2001,586,163,423,41
"23968","E01016233",2001,732,291,441,59
"23969","E01016248",2001,576,166,410,18
"23970","E01016249",2001,842,449,393,86
"23971","E01016250",2001,703,121,582,74
"23972","E01016200",2001,594,40,554,89
"23973","E01016201",2001,587,45,542,81
"23974","E01016202",2001,676,6,670,135
"23975","E01016203",2001,600,264,336,17
"23976","E01016204",2001,491,121,370,27
"23977","E01016209",2001,554,101,453,17
"23978","E01016210",2001,519,211,308,22
"23979","E01016211",2001,561,176,385,21
"23980","E01016213",2001,441,52,389,12
"23981","E01016214",2001,514,14,500,9
"23982","E01016215",2001,489,177,312,18
"23983","E01016217",2001,608,130,478,60
"23984","E01016218",2001,658,204,454,41
"23985","E01016231",2001,594,190,404,25
"23986","E01016232",2001,630,107,523,45
"23987","E01016205",2001,555,159,396,42
"23988","E01016219",2001,554,95,459,29
"23989","E01016220",2001,587,141,446,45
"23990","E01016221",2001,606,78,528,39
"23991","E01016216",2001,593,127,466,40
"23992","E01016212",2001,509,143,366,14
"23993","E01016229",2001,475,11,464,19
"23994","E01016230",2001,411,10,401,66
"23995","E01016208",2001,781,84,697,110
"23996","E01016206",2001,637,33,604,52
"23997","E01016207",2001,505,110,395,42
"23998","E01016234",2001,475,5,470,31
"23999","E01016235",2001,497,19,478,23
"24000","E01016236",2001,606,149,457,28
"24001","E01016237",2001,488,12,476,22
"24002","E01016227",2001,480,40,440,16
"24003","E01016228",2001,533,15,518,25
"24004","E01016194",2001,516,6,510,20
"24005","E01016195",2001,499,60,439,39
"24006","E01016192",2001,613,107,506,85
"24007","E01016193",2001,551,64,487,45
"24008","E01016196",2001,508,37,471,181
"24009","E01016197",2001,490,104,386,9
"24010","E01016198",2001,484,4,480,41
"24011","E01016199",2001,499,3,496,38
"24012","E01016924",2001,590,6,584,30
"24013","E01016926",2001,641,232,409,20
"24014","E01016927",2001,617,55,562,29
"24015","E01016929",2001,631,76,555,35
"24016","E01016931",2001,639,3,636,20
"24017","E01016914",2001,483,268,215,21
"24018","E01016915",2001,484,320,164,28
"24019","E01016898",2001,702,147,555,26
"24020","E01016899",2001,421,91,330,39
"24021","E01016928",2001,648,13,635,79
"24022","E01016923",2001,660,98,562,53
"24023","E01016998",2001,594,6,588,21
"24024","E01016999",2001,570,3,567,20
"24025","E01017000",2001,782,71,711,95
"24026","E01017001",2001,596,34,562,34
"24027","E01017003",2001,661,40,621,80
"24028","E01016925",2001,608,124,484,21
"24029","E01016930",2001,751,19,732,30
"24030","E01016916",2001,623,23,600,38
"24031","E01016917",2001,583,9,574,19
"24032","E01016918",2001,597,248,349,17
"24033","E01016919",2001,557,182,375,21
"24034","E01016920",2001,629,9,620,39
"24035","E01016882",2001,642,187,455,38
"24036","E01016883",2001,662,41,621,14
"24037","E01016884",2001,636,128,508,39
"24038","E01016885",2001,645,334,311,33
"24039","E01016886",2001,625,82,543,26
"24040","E01016982",2001,505,7,498,39
"24041","E01016983",2001,508,5,503,15
"24042","E01016984",2001,579,6,573,28
"24043","E01016985",2001,624,22,602,142
"24044","E01016980",2001,508,16,492,45
"24045","E01016904",2001,596,325,271,46
"24046","E01016905",2001,780,356,424,75
"24047","E01016909",2001,628,161,467,85
"24048","E01016900",2001,731,466,265,28
"24049","E01016902",2001,559,112,447,24
"24050","E01016910",2001,486,260,226,49
"24051","E01016911",2001,505,100,405,31
"24052","E01016906",2001,590,268,322,9
"24053","E01016907",2001,597,141,456,61
"24054","E01016908",2001,586,339,247,20
"24055","E01016934",2001,530,15,515,81
"24056","E01016939",2001,588,5,583,87
"24057","E01016940",2001,609,9,600,112
"24058","E01016903",2001,651,26,625,156
"24059","E01016901",2001,590,15,575,85
"24060","E01016981",2001,624,10,614,53
"24061","E01017002",2001,752,17,735,124
"24062","E01017004",2001,734,71,663,192
"24063","E01017005",2001,694,4,690,164
"24064","E01017006",2001,760,21,739,196
"24065","E01016921",2001,618,161,457,28
"24066","E01016922",2001,553,123,430,30
"24067","E01016977",2001,620,125,495,30
"24068","E01016978",2001,731,163,568,112
"24069","E01016973",2001,622,57,565,44
"24070","E01016976",2001,626,11,615,45
"24071","E01016879",2001,501,148,353,17
"24072","E01016880",2001,478,278,200,22
"24073","E01016881",2001,570,168,402,47
"24074","E01016887",2001,625,37,588,36
"24075","E01016888",2001,554,15,539,27
"24076","E01016935",2001,744,125,619,171
"24077","E01016936",2001,651,18,633,176
"24078","E01016937",2001,863,42,821,429
"24079","E01016932",2001,695,65,630,153
"24080","E01016933",2001,609,32,577,146
"24081","E01016970",2001,657,61,596,164
"24082","E01016971",2001,683,38,645,278
"24083","E01016972",2001,774,12,762,284
"24084","E01016966",2001,711,123,588,238
"24085","E01016890",2001,752,76,676,333
"24086","E01016979",2001,613,14,599,91
"24087","E01016996",2001,660,28,632,143
"24088","E01016990",2001,733,124,609,138
"24089","E01016991",2001,755,43,712,222
"24090","E01017007",2001,612,196,416,55
"24091","E01017008",2001,685,6,679,41
"24092","E01017009",2001,606,69,537,30
"24093","E01017010",2001,685,27,658,25
"24094","E01017011",2001,535,233,302,14
"24095","E01017012",2001,702,69,633,23
"24096","E01016946",2001,605,10,595,136
"24097","E01016912",2001,667,53,614,212
"24098","E01016913",2001,584,8,576,136
"24099","E01016892",2001,620,38,582,147
"24100","E01016893",2001,743,11,732,149
"24101","E01016871",2001,995,95,900,473
"24102","E01016872",2001,880,43,837,355
"24103","E01016873",2001,947,213,734,297
"24104","E01016878",2001,756,55,701,156
"24105","E01016860",2001,724,65,659,329
"24106","E01016870",2001,622,18,604,170
"24107","E01016874",2001,965,50,915,225
"24108","E01016875",2001,611,10,601,149
"24109","E01016876",2001,799,45,754,262
"24110","E01016877",2001,791,56,735,202
"24111","E01016974",2001,640,41,599,135
"24112","E01016975",2001,588,171,417,57
"24113","E01016992",2001,644,11,633,53
"24114","E01016997",2001,625,30,595,89
"24115","E01016994",2001,645,32,613,164
"24116","E01016889",2001,663,28,635,240
"24117","E01016894",2001,610,116,494,154
"24118","E01016891",2001,763,150,613,223
"24119","E01016896",2001,679,24,655,181
"24120","E01016897",2001,707,61,646,145
"24121","E01016995",2001,600,8,592,64
"24122","E01016993",2001,722,330,392,43
"24123","E01016987",2001,670,35,635,144
"24124","E01016989",2001,669,46,623,156
"24125","E01016967",2001,1032,41,991,523
"24126","E01016968",2001,890,49,841,434
"24127","E01016950",2001,947,12,935,440
"24128","E01016951",2001,824,144,680,328
"24129","E01016938",2001,854,32,822,335
"24130","E01016895",2001,554,285,269,40
"24131","E01016864",2001,593,281,312,18
"24132","E01016865",2001,564,444,120,29
"24133","E01016866",2001,547,355,192,33
"24134","E01016867",2001,651,357,294,36
"24135","E01016868",2001,702,509,193,42
"24136","E01016849",2001,854,15,839,397
"24137","E01016855",2001,953,39,914,453
"24138","E01016856",2001,868,78,790,376
"24139","E01016852",2001,913,37,876,506
"24140","E01016853",2001,967,38,929,423
"24141","E01016952",2001,539,18,521,255
"24142","E01016953",2001,819,15,804,345
"24143","E01016964",2001,793,234,559,289
"24144","E01016965",2001,787,61,726,239
"24145","E01016969",2001,829,146,683,248
"24146","E01016986",2001,789,84,705,228
"24147","E01016988",2001,700,60,640,195
"24148","E01016857",2001,768,53,715,294
"24149","E01016858",2001,843,21,822,402
"24150","E01016859",2001,892,51,841,197
"24151","E01016850",2001,853,41,812,425
"24152","E01016851",2001,848,13,835,420
"24153","E01016854",2001,989,150,839,462
"24154","E01016954",2001,905,51,854,525
"24155","E01016955",2001,945,52,893,491
"24156","E01016947",2001,866,464,402,188
"24157","E01016948",2001,716,127,589,152
"24158","E01016949",2001,857,345,512,148
"24159","E01016945",2001,877,57,820,444
"24160","E01016941",2001,931,210,721,374
"24161","E01016942",2001,1045,665,380,71
"24162","E01016943",2001,682,39,643,231
"24163","E01016944",2001,835,44,791,422
"24164","E01016861",2001,910,34,876,386
"24165","E01016862",2001,804,71,733,275
"24166","E01016863",2001,913,359,554,192
"24167","E01016869",2001,786,162,624,107
"24168","E01016957",2001,855,89,766,231
"24169","E01016963",2001,876,65,811,229
"24170","E01016958",2001,818,38,780,42
"24171","E01016959",2001,580,17,563,34
"24172","E01016960",2001,712,35,677,110
"24173","E01016961",2001,635,12,623,65
"24174","E01016962",2001,740,31,709,39
"24175","E01016956",2001,689,4,685,29
"24176","E01017300",2001,1205,97,1108,229
"24177","E01017303",2001,538,6,532,85
"24178","E01017305",2001,611,66,545,127
"24179","E01017306",2001,515,102,413,45
"24180","E01017309",2001,652,46,606,113
"24181","E01017304",2001,515,72,443,32
"24182","E01017316",2001,775,23,752,46
"24183","E01017329",2001,937,53,884,31
"24184","E01017301",2001,502,6,496,13
"24185","E01017302",2001,472,9,463,26
"24186","E01017330",2001,921,201,720,64
"24187","E01017307",2001,773,14,759,56
"24188","E01017308",2001,643,113,530,52
"24189","E01017335",2001,770,52,718,236
"24190","E01017336",2001,767,40,727,339
"24191","E01017337",2001,762,47,715,221
"24192","E01017346",2001,652,58,594,174
"24193","E01017367",2001,874,5,869,41
"24194","E01017368",2001,752,107,645,97
"24195","E01017286",2001,689,27,662,43
"24196","E01017287",2001,727,5,722,29
"24197","E01017282",2001,569,77,492,52
"24198","E01017283",2001,655,24,631,57
"24199","E01017341",2001,621,172,449,32
"24200","E01017342",2001,641,66,575,90
"24201","E01017338",2001,643,26,617,66
"24202","E01017339",2001,643,45,598,81
"24203","E01017340",2001,745,86,659,151
"24204","E01017343",2001,525,142,383,30
"24205","E01017344",2001,645,12,633,46
"24206","E01017345",2001,626,192,434,92
"24207","E01017334",2001,502,51,451,52
"24208","E01017331",2001,651,185,466,44
"24209","E01017332",2001,527,232,295,21
"24210","E01017310",2001,505,4,501,25
"24211","E01017311",2001,639,68,571,60
"24212","E01017333",2001,617,37,580,52
"24213","E01017328",2001,607,78,529,132
"24214","E01017325",2001,605,125,480,63
"24215","E01017326",2001,596,130,466,149
"24216","E01017295",2001,545,91,454,56
"24217","E01017288",2001,612,31,581,65
"24218","E01017284",2001,834,5,829,75
"24219","E01017285",2001,943,93,850,58
"24220","E01017351",2001,723,14,709,111
"24221","E01017352",2001,626,4,622,17
"24222","E01017327",2001,590,14,576,56
"24223","E01017321",2001,494,36,458,33
"24224","E01017322",2001,601,231,370,58
"24225","E01017296",2001,513,20,493,46
"24226","E01017292",2001,523,31,492,47
"24227","E01017293",2001,532,4,528,13
"24228","E01017312",2001,645,99,546,69
"24229","E01017313",2001,650,10,640,55
"24230","E01017314",2001,501,17,484,34
"24231","E01017315",2001,641,187,454,24
"24232","E01017354",2001,570,65,505,55
"24233","E01017361",2001,645,30,615,48
"24234","E01017362",2001,621,81,540,134
"24235","E01017353",2001,520,40,480,21
"24236","E01017294",2001,638,13,625,58
"24237","E01017290",2001,547,23,524,48
"24238","E01017291",2001,566,37,529,24
"24239","E01017289",2001,883,121,762,48
"24240","E01017347",2001,744,83,661,75
"24241","E01017348",2001,526,17,509,126
"24242","E01017349",2001,789,20,769,197
"24243","E01017350",2001,647,110,537,59
"24244","E01017358",2001,601,64,537,23
"24245","E01017355",2001,597,37,560,27
"24246","E01017317",2001,633,59,574,51
"24247","E01017320",2001,531,6,525,31
"24248","E01017323",2001,478,17,461,13
"24249","E01017324",2001,615,31,584,49
"24250","E01017318",2001,483,129,354,25
"24251","E01017319",2001,655,110,545,42
"24252","E01017356",2001,629,59,570,136
"24253","E01017357",2001,617,144,473,58
"24254","E01017359",2001,618,5,613,86
"24255","E01017360",2001,720,18,702,188
"24256","E01017369",2001,627,65,562,45
"24257","E01017297",2001,601,59,542,65
"24258","E01017298",2001,655,20,635,39
"24259","E01017299",2001,556,81,475,69
"24260","E01017370",2001,782,115,667,42
"24261","E01017363",2001,756,129,627,186
"24262","E01017364",2001,727,27,700,123
"24263","E01017365",2001,754,40,714,99
"24264","E01017366",2001,621,142,479,44
"24265","E01016070",2001,682,47,635,59
"24266","E01016071",2001,612,69,543,53
"24267","E01016072",2001,505,96,409,29
"24268","E01016074",2001,716,57,659,72
"24269","E01016142",2001,487,10,477,34
"24270","E01016144",2001,537,29,508,36
"24271","E01016145",2001,490,25,465,6
"24272","E01016149",2001,522,112,410,40
"24273","E01016143",2001,575,167,408,47
"24274","E01016075",2001,568,64,504,6
"24275","E01016076",2001,576,22,554,26
"24276","E01016077",2001,633,134,499,42
"24277","E01016073",2001,760,37,723,23
"24278","E01016146",2001,696,192,504,37
"24279","E01016147",2001,721,17,704,36
"24280","E01016148",2001,607,33,574,19
"24281","E01016138",2001,591,6,585,20
"24282","E01016139",2001,616,22,594,30
"24283","E01016133",2001,533,6,527,0
"24284","E01016134",2001,516,58,458,14
"24285","E01016135",2001,609,39,570,55
"24286","E01016136",2001,603,147,456,65
"24287","E01016137",2001,605,49,556,88
"24288","E01016140",2001,540,74,466,95
"24289","E01016141",2001,638,12,626,119
"24290","E01016108",2001,428,173,255,152
"24291","E01016109",2001,685,288,397,190
"24292","E01016112",2001,531,12,519,29
"24293","E01016035",2001,644,108,536,124
"24294","E01016151",2001,636,63,573,72
"24295","E01016152",2001,634,207,427,38
"24296","E01016153",2001,613,252,361,45
"24297","E01016155",2001,614,151,463,17
"24298","E01016036",2001,603,36,567,101
"24299","E01016037",2001,672,45,627,135
"24300","E01016033",2001,511,269,242,36
"24301","E01016039",2001,649,32,617,140
"24302","E01016034",2001,656,12,644,72
"24303","E01016038",2001,566,45,521,84
"24304","E01016030",2001,486,162,324,14
"24305","E01016032",2001,469,259,210,40
"24306","E01016156",2001,663,65,598,34
"24307","E01016157",2001,608,72,536,41
"24308","E01016158",2001,668,78,590,29
"24309","E01016150",2001,599,164,435,36
"24310","E01016154",2001,603,51,552,96
"24311","E01016049",2001,743,132,611,193
"24312","E01016031",2001,776,248,528,168
"24313","E01016041",2001,638,25,613,170
"24314","E01016045",2001,605,26,579,92
"24315","E01016042",2001,527,25,502,84
"24316","E01016043",2001,539,62,477,33
"24317","E01016040",2001,609,36,573,125
"24318","E01016177",2001,608,60,548,58
"24319","E01016178",2001,518,3,515,48
"24320","E01016129",2001,795,251,544,112
"24321","E01016130",2001,781,85,696,193
"24322","E01016131",2001,720,136,584,83
"24323","E01016117",2001,738,262,476,145
"24324","E01016110",2001,627,134,493,213
"24325","E01016111",2001,645,238,407,183
"24326","E01016019",2001,617,68,549,146
"24327","E01016016",2001,647,168,479,60
"24328","E01016017",2001,762,229,533,197
"24329","E01016044",2001,623,14,609,134
"24330","E01016046",2001,592,16,576,127
"24331","E01016047",2001,619,13,606,143
"24332","E01016048",2001,601,5,596,84
"24333","E01016113",2001,584,43,541,44
"24334","E01016114",2001,645,126,519,113
"24335","E01016115",2001,633,129,504,34
"24336","E01016118",2001,746,18,728,117
"24337","E01016160",2001,615,220,395,22
"24338","E01016161",2001,739,364,375,32
"24339","E01016162",2001,630,29,601,35
"24340","E01016163",2001,495,81,414,21
"24341","E01016164",2001,656,177,479,32
"24342","E01016165",2001,518,49,469,22
"24343","E01016179",2001,497,12,485,21
"24344","E01016174",2001,512,12,500,95
"24345","E01016175",2001,642,17,625,20
"24346","E01016159",2001,508,228,280,23
"24347","E01016061",2001,655,32,623,156
"24348","E01016063",2001,706,205,501,112
"24349","E01016064",2001,657,153,504,93
"24350","E01016069",2001,653,82,571,194
"24351","E01016125",2001,613,15,598,73
"24352","E01016020",2001,516,95,421,71
"24353","E01016021",2001,583,27,556,102
"24354","E01016022",2001,474,50,424,84
"24355","E01016023",2001,586,282,304,42
"24356","E01016024",2001,676,39,637,119
"24357","E01016018",2001,590,50,540,113
"24358","E01016062",2001,613,141,472,55
"24359","E01016093",2001,623,3,620,17
"24360","E01016096",2001,647,16,631,22
"24361","E01016166",2001,589,45,544,15
"24362","E01016167",2001,588,82,506,9
"24363","E01016132",2001,620,9,611,45
"24364","E01016127",2001,644,109,535,66
"24365","E01016128",2001,558,100,458,35
"24366","E01016116",2001,752,237,515,29
"24367","E01016097",2001,623,98,525,53
"24368","E01016098",2001,616,124,492,118
"24369","E01016102",2001,603,229,374,30
"24370","E01016094",2001,601,23,578,42
"24371","E01016095",2001,530,30,500,19
"24372","E01016126",2001,606,26,580,22
"24373","E01016119",2001,503,11,492,15
"24374","E01016120",2001,589,178,411,23
"24375","E01016124",2001,660,36,624,38
"24376","E01016065",2001,634,87,547,27
"24377","E01016066",2001,603,152,451,39
"24378","E01016067",2001,644,130,514,32
"24379","E01016068",2001,635,263,372,16
"24380","E01016025",2001,615,203,412,33
"24381","E01016026",2001,514,29,485,41
"24382","E01016027",2001,507,11,496,12
"24383","E01016028",2001,606,38,568,26
"24384","E01016029",2001,502,76,426,64
"24385","E01016087",2001,620,6,614,47
"24386","E01016088",2001,602,122,480,12
"24387","E01016089",2001,653,64,589,28
"24388","E01016090",2001,628,6,622,26
"24389","E01016091",2001,604,33,571,16
"24390","E01016085",2001,656,6,650,18
"24391","E01016086",2001,505,7,498,12
"24392","E01016176",2001,580,7,573,22
"24393","E01016058",2001,615,20,595,26
"24394","E01016059",2001,494,129,365,24
"24395","E01016083",2001,562,267,295,39
"24396","E01016084",2001,506,161,345,24
"24397","E01016079",2001,486,41,445,19
"24398","E01016103",2001,572,3,569,17
"24399","E01016104",2001,569,3,566,29
"24400","E01016101",2001,572,8,564,34
"24401","E01016107",2001,600,7,593,35
"24402","E01016121",2001,638,13,625,18
"24403","E01016122",2001,614,3,611,24
"24404","E01016123",2001,616,59,557,17
"24405","E01016173",2001,623,156,467,34
"24406","E01016080",2001,624,62,562,45
"24407","E01016081",2001,504,4,500,28
"24408","E01016082",2001,582,8,574,27
"24409","E01016078",2001,661,17,644,81
"24410","E01016050",2001,665,9,656,30
"24411","E01016051",2001,588,7,581,29
"24412","E01016052",2001,626,0,626,10
"24413","E01016053",2001,622,12,610,24
"24414","E01016054",2001,589,3,586,36
"24415","E01016105",2001,593,12,581,32
"24416","E01016106",2001,595,36,559,30
"24417","E01016099",2001,625,16,609,46
"24418","E01016100",2001,660,137,523,31
"24419","E01016092",2001,625,6,619,25
"24420","E01016171",2001,634,212,422,28
"24421","E01016172",2001,519,3,516,29
"24422","E01016168",2001,641,134,507,29
"24423","E01016169",2001,623,10,613,23
"24424","E01016170",2001,619,30,589,67
"24425","E01016055",2001,625,91,534,26
"24426","E01016056",2001,637,74,563,50
"24427","E01016057",2001,639,39,600,17
"24428","E01016060",2001,624,5,619,15
"24429","E01016796",2001,619,15,604,85
"24430","E01016797",2001,690,49,641,101
"24431","E01016798",2001,714,8,706,52
"24432","E01016799",2001,672,147,525,43
"24433","E01016800",2001,646,71,575,65
"24434","E01016801",2001,552,94,458,36
"24435","E01016802",2001,521,34,487,33
"24436","E01016803",2001,507,60,447,63
"24437","E01016759",2001,542,125,417,36
"24438","E01016760",2001,571,29,542,26
"24439","E01016761",2001,540,3,537,34
"24440","E01016786",2001,623,13,610,35
"24441","E01016787",2001,604,153,451,35
"24442","E01016788",2001,593,3,590,36
"24443","E01016789",2001,499,36,463,33
"24444","E01016790",2001,502,15,487,13
"24445","E01016791",2001,569,27,542,20
"24446","E01016792",2001,528,3,525,36
"24447","E01016793",2001,614,73,541,26
"24448","E01016794",2001,654,29,625,100
"24449","E01016795",2001,624,65,559,67
"24450","E01016771",2001,494,117,377,25
"24451","E01016762",2001,507,114,393,23
"24452","E01016764",2001,604,59,545,45
"24453","E01016766",2001,537,133,404,25
"24454","E01016767",2001,517,8,509,21
"24455","E01016806",2001,592,323,269,22
"24456","E01016807",2001,632,97,535,29
"24457","E01016809",2001,517,58,459,27
"24458","E01016835",2001,616,284,332,30
"24459","E01016769",2001,582,27,555,48
"24460","E01016770",2001,588,52,536,45
"24461","E01016763",2001,620,66,554,37
"24462","E01016773",2001,510,6,504,21
"24463","E01016836",2001,617,38,579,50
"24464","E01016837",2001,660,66,594,79
"24465","E01016838",2001,594,145,449,17
"24466","E01016841",2001,721,145,576,84
"24467","E01016772",2001,506,177,329,26
"24468","E01016765",2001,631,209,422,20
"24469","E01016804",2001,701,284,417,70
"24470","E01016721",2001,588,152,436,44
"24471","E01016812",2001,645,53,592,28
"24472","E01016817",2001,664,109,555,49
"24473","E01016818",2001,765,80,685,118
"24474","E01016840",2001,600,23,577,31
"24475","E01016805",2001,609,7,602,58
"24476","E01016808",2001,514,17,497,32
"24477","E01016722",2001,621,73,548,33
"24478","E01016719",2001,641,76,565,40
"24479","E01016810",2001,575,318,257,28
"24480","E01016811",2001,476,309,167,21
"24481","E01016819",2001,498,244,254,23
"24482","E01016839",2001,627,307,320,44
"24483","E01016720",2001,605,302,303,44
"24484","E01016717",2001,638,136,502,52
"24485","E01016723",2001,628,35,593,37
"24486","E01016724",2001,607,173,434,78
"24487","E01016718",2001,610,302,308,98
"24488","E01016729",2001,642,244,398,90
"24489","E01016730",2001,785,275,510,276
"24490","E01016768",2001,598,171,427,73
"24491","E01016776",2001,534,8,526,31
"24492","E01016813",2001,635,29,606,211
"24493","E01016815",2001,517,39,478,52
"24494","E01016816",2001,587,4,583,23
"24495","E01016782",2001,400,33,367,17
"24496","E01016784",2001,643,190,453,52
"24497","E01016731",2001,628,113,515,36
"24498","E01016732",2001,499,49,450,31
"24499","E01016785",2001,573,55,518,23
"24500","E01016783",2001,655,89,566,42
"24501","E01016820",2001,586,112,474,51
"24502","E01016821",2001,486,31,455,88
"24503","E01016823",2001,770,25,745,239
"24504","E01016845",2001,554,401,153,22
"24505","E01016846",2001,636,128,508,39
"24506","E01016848",2001,585,200,385,35
"24507","E01016733",2001,499,189,310,57
"24508","E01016726",2001,506,258,248,55
"24509","E01016814",2001,715,63,652,39
"24510","E01016779",2001,459,184,275,52
"24511","E01016780",2001,620,37,583,48
"24512","E01016781",2001,531,55,476,18
"24513","E01016777",2001,618,53,565,57
"24514","E01016778",2001,623,92,531,85
"24515","E01016774",2001,602,97,505,30
"24516","E01016775",2001,662,95,567,73
"24517","E01016847",2001,598,398,200,26
"24518","E01016727",2001,621,165,456,34
"24519","E01016728",2001,645,51,594,119
"24520","E01016725",2001,513,189,324,52
"24521","E01016822",2001,641,251,390,58
"24522","E01016824",2001,636,157,479,39
"24523","E01016825",2001,621,93,528,87
"24524","E01016827",2001,664,83,581,76
"24525","E01016828",2001,586,30,556,48
"24526","E01016842",2001,593,426,167,39
"24527","E01016843",2001,489,281,208,45
"24528","E01016844",2001,619,384,235,12
"24529","E01016712",2001,816,301,515,115
"24530","E01016734",2001,514,73,441,39
"24531","E01016735",2001,602,46,556,61
"24532","E01016736",2001,580,49,531,46
"24533","E01016826",2001,509,8,501,15
"24534","E01016752",2001,600,134,466,29
"24535","E01016753",2001,644,191,453,53
"24536","E01016755",2001,635,101,534,68
"24537","E01016747",2001,507,88,419,23
"24538","E01016756",2001,732,323,409,47
"24539","E01016757",2001,581,36,545,32
"24540","E01016758",2001,639,94,545,69
"24541","E01016754",2001,725,124,601,64
"24542","E01016737",2001,506,100,406,17
"24543","E01016738",2001,651,313,338,15
"24544","E01016739",2001,597,37,560,34
"24545","E01016740",2001,563,9,554,23
"24546","E01016741",2001,677,269,408,23
"24547","E01016748",2001,668,82,586,68
"24548","E01016749",2001,584,26,558,26
"24549","E01016750",2001,633,46,587,38
"24550","E01016751",2001,612,69,543,36
"24551","E01016829",2001,605,204,401,25
"24552","E01016831",2001,611,48,563,26
"24553","E01016832",2001,495,94,401,13
"24554","E01016833",2001,501,25,476,11
"24555","E01016834",2001,660,264,396,20
"24556","E01016716",2001,738,123,615,56
"24557","E01016745",2001,620,27,593,22
"24558","E01016714",2001,624,41,583,92
"24559","E01016710",2001,744,228,516,14
"24560","E01016711",2001,635,18,617,18
"24561","E01016715",2001,622,198,424,15
"24562","E01016713",2001,633,19,614,32
"24563","E01016830",2001,511,14,497,29
"24564","E01016746",2001,653,179,474,30
"24565","E01016742",2001,597,417,180,15
"24566","E01016743",2001,621,309,312,26
"24567","E01016744",2001,482,260,222,14
"24568","E01017112",2001,638,326,312,17
"24569","E01017115",2001,467,189,278,8
"24570","E01017117",2001,580,201,379,21
"24571","E01017119",2001,632,238,394,16
"24572","E01017120",2001,674,389,285,22
"24573","E01017118",2001,560,312,248,22
"24574","E01017051",2001,593,203,390,58
"24575","E01017052",2001,557,179,378,18
"24576","E01017053",2001,575,302,273,20
"24577","E01017050",2001,616,99,517,18
"24578","E01017061",2001,652,4,648,30
"24579","E01017063",2001,630,5,625,18
"24580","E01017064",2001,616,12,604,38
"24581","E01017116",2001,619,268,351,96
"24582","E01017113",2001,601,46,555,38
"24583","E01017114",2001,737,31,706,116
"24584","E01017054",2001,618,130,488,37
"24585","E01017065",2001,596,18,578,31
"24586","E01017066",2001,665,48,617,25
"24587","E01017062",2001,616,13,603,127
"24588","E01017059",2001,632,37,595,17
"24589","E01017060",2001,630,5,625,23
"24590","E01017055",2001,678,67,611,44
"24591","E01017056",2001,506,7,499,35
"24592","E01017057",2001,567,7,560,33
"24593","E01017058",2001,583,176,407,22
"24594","E01017089",2001,504,191,313,39
"24595","E01017090",2001,563,109,454,144
"24596","E01017091",2001,684,325,359,106
"24597","E01017092",2001,605,25,580,64
"24598","E01017086",2001,502,3,499,19
"24599","E01017085",2001,661,85,576,44
"24600","E01017046",2001,790,15,775,64
"24601","E01017047",2001,637,18,619,51
"24602","E01017048",2001,594,6,588,38
"24603","E01017014",2001,632,17,615,48
"24604","E01017084",2001,578,14,564,103
"24605","E01017087",2001,601,14,587,111
"24606","E01017088",2001,637,39,598,86
"24607","E01017105",2001,648,132,516,65
"24608","E01017107",2001,632,32,600,126
"24609","E01017108",2001,709,129,580,95
"24610","E01017109",2001,628,112,516,90
"24611","E01017106",2001,641,127,514,63
"24612","E01017104",2001,496,57,439,46
"24613","E01017110",2001,590,17,573,76
"24614","E01017111",2001,602,43,559,126
"24615","E01017049",2001,590,12,578,18
"24616","E01017041",2001,510,8,502,34
"24617","E01017043",2001,511,4,507,65
"24618","E01017044",2001,600,15,585,96
"24619","E01017045",2001,514,19,495,33
"24620","E01017042",2001,487,27,460,51
"24621","E01017013",2001,626,20,606,66
"24622","E01017082",2001,647,29,618,143
"24623","E01017083",2001,664,28,636,82
"24624","E01017075",2001,608,32,576,114
"24625","E01017102",2001,662,346,316,44
"24626","E01017103",2001,531,381,150,19
"24627","E01017036",2001,518,269,249,36
"24628","E01017037",2001,656,539,117,11
"24629","E01017038",2001,794,620,174,43
"24630","E01017015",2001,635,102,533,46
"24631","E01017016",2001,610,8,602,68
"24632","E01017017",2001,559,6,553,29
"24633","E01017018",2001,615,15,600,28
"24634","E01017019",2001,600,90,510,58
"24635","E01017020",2001,692,186,506,33
"24636","E01017076",2001,719,50,669,93
"24637","E01017077",2001,802,317,485,96
"24638","E01017078",2001,649,27,622,87
"24639","E01017079",2001,593,63,530,72
"24640","E01017080",2001,685,107,578,126
"24641","E01017081",2001,644,31,613,99
"24642","E01017039",2001,607,320,287,52
"24643","E01017040",2001,606,500,106,17
"24644","E01017031",2001,739,501,238,67
"24645","E01017032",2001,399,281,118,41
"24646","E01017033",2001,669,494,175,28
"24647","E01017034",2001,465,373,92,32
"24648","E01017021",2001,596,48,548,22
"24649","E01017096",2001,655,30,625,62
"24650","E01017093",2001,427,105,322,22
"24651","E01017099",2001,594,82,512,82
"24652","E01017100",2001,510,17,493,38
"24653","E01017101",2001,617,31,586,66
"24654","E01017128",2001,634,46,588,311
"24655","E01017129",2001,605,78,527,246
"24656","E01017130",2001,761,582,179,42
"24657","E01017132",2001,756,512,244,59
"24658","E01017133",2001,839,249,590,178
"24659","E01017035",2001,689,552,137,6
"24660","E01017025",2001,738,26,712,187
"24661","E01017026",2001,700,68,632,138
"24662","E01017023",2001,646,9,637,130
"24663","E01017029",2001,676,38,638,133
"24664","E01017030",2001,658,19,639,163
"24665","E01017024",2001,683,18,665,189
"24666","E01017027",2001,612,29,583,188
"24667","E01017028",2001,627,36,591,226
"24668","E01017022",2001,608,75,533,185
"24669","E01017124",2001,717,50,667,211
"24670","E01017094",2001,600,16,584,76
"24671","E01017095",2001,672,15,657,105
"24672","E01017097",2001,664,12,652,111
"24673","E01017098",2001,626,95,531,122
"24674","E01017125",2001,750,206,544,126
"24675","E01017127",2001,923,71,852,413
"24676","E01017122",2001,749,48,701,307
"24677","E01017135",2001,760,156,604,200
"24678","E01017074",2001,692,41,651,368
"24679","E01017067",2001,634,73,561,69
"24680","E01017068",2001,849,32,817,129
"24681","E01017069",2001,657,20,637,86
"24682","E01017070",2001,740,71,669,205
"24683","E01017073",2001,791,93,698,320
"24684","E01017131",2001,636,84,552,176
"24685","E01017123",2001,976,38,938,381
"24686","E01017134",2001,896,74,822,147
"24687","E01017121",2001,746,21,725,300
"24688","E01017126",2001,749,22,727,200
"24689","E01017071",2001,665,24,641,294
"24690","E01017072",2001,609,16,593,136
"24691","E01016410",2001,510,12,498,24
"24692","E01016411",2001,660,38,622,13
"24693","E01016412",2001,596,5,591,37
"24694","E01016407",2001,625,34,591,49
"24695","E01016408",2001,601,12,589,50
"24696","E01016386",2001,611,6,605,26
"24697","E01016387",2001,606,0,606,20
"24698","E01016430",2001,494,4,490,15
"24699","E01016425",2001,603,12,591,16
"24700","E01016426",2001,505,3,502,20
"24701","E01016427",2001,638,91,547,49
"24702","E01016428",2001,649,75,574,26
"24703","E01016429",2001,615,6,609,29
"24704","E01016364",2001,599,9,590,69
"24705","E01016409",2001,674,108,566,23
"24706","E01016365",2001,753,17,736,148
"24707","E01016366",2001,653,99,554,63
"24708","E01016367",2001,708,122,586,59
"24709","E01016362",2001,800,62,738,199
"24710","E01016363",2001,514,242,272,27
"24711","E01016431",2001,611,17,594,34
"24712","E01016432",2001,614,12,602,21
"24713","E01016380",2001,659,12,647,46
"24714","E01016383",2001,673,58,615,25
"24715","E01016384",2001,606,6,600,30
"24716","E01016385",2001,607,24,583,39
"24717","E01016381",2001,523,116,407,24
"24718","E01016382",2001,596,182,414,54
"24719","E01016396",2001,575,234,341,13
"24720","E01016397",2001,616,297,319,30
"24721","E01016355",2001,735,34,701,199
"24722","E01016358",2001,703,95,608,217
"24723","E01016359",2001,676,41,635,122
"24724","E01016360",2001,625,21,604,197
"24725","E01016361",2001,720,21,699,125
"24726","E01016356",2001,668,112,556,158
"24727","E01016357",2001,654,21,633,163
"24728","E01016398",2001,590,36,554,109
"24729","E01016399",2001,581,36,545,67
"24730","E01016400",2001,649,39,610,147
"24731","E01016395",2001,493,33,460,34
"24732","E01016394",2001,566,310,256,5
"24733","E01016433",2001,624,80,544,57
"24734","E01016434",2001,682,27,655,55
"24735","E01016435",2001,615,198,417,18
"24736","E01016436",2001,649,140,509,27
"24737","E01016402",2001,617,11,606,222
"24738","E01016404",2001,656,68,588,144
"24739","E01016405",2001,634,19,615,183
"24740","E01016406",2001,489,9,480,210
"24741","E01016352",2001,959,324,635,238
"24742","E01016353",2001,723,119,604,274
"24743","E01016354",2001,869,87,782,385
"24744","E01016351",2001,909,115,794,382
"24745","E01016391",2001,712,177,535,148
"24746","E01016378",2001,587,111,476,171
"24747","E01016401",2001,567,13,554,171
"24748","E01016403",2001,586,0,586,129
"24749","E01016416",2001,632,33,599,304
"24750","E01016417",2001,587,27,560,255
"24751","E01016418",2001,601,10,591,205
"24752","E01016392",2001,886,38,848,244
"24753","E01016393",2001,645,89,556,65
"24754","E01016388",2001,634,117,517,54
"24755","E01016389",2001,638,370,268,31
"24756","E01016390",2001,742,10,732,243
"24757","E01016379",2001,649,37,612,246
"24758","E01016374",2001,646,42,604,146
"24759","E01016375",2001,492,133,359,102
"24760","E01016376",2001,630,48,582,287
"24761","E01016413",2001,485,84,401,85
"24762","E01016414",2001,619,98,521,208
"24763","E01016419",2001,734,177,557,83
"24764","E01016420",2001,592,326,266,26
"24765","E01016421",2001,534,60,474,14
"24766","E01016422",2001,668,279,389,26
"24767","E01016423",2001,596,205,391,14
"24768","E01016424",2001,485,14,471,13
"24769","E01016415",2001,644,275,369,53
"24770","E01016373",2001,493,192,301,47
"24771","E01016370",2001,483,68,415,78
"24772","E01016371",2001,640,97,543,65
"24773","E01016372",2001,489,227,262,15
"24774","E01016368",2001,544,293,251,13
"24775","E01016377",2001,590,147,443,95
"24776","E01016438",2001,528,228,300,28
"24777","E01016442",2001,558,213,345,45
"24778","E01016443",2001,558,265,293,20
"24779","E01016439",2001,549,113,436,25
"24780","E01016440",2001,544,142,402,41
"24781","E01016441",2001,593,311,282,17
"24782","E01016437",2001,494,84,410,42
"24783","E01016369",2001,640,70,570,28
"24784","E01016450",2001,552,283,269,20
"24785","E01016451",2001,613,421,192,30
"24786","E01016452",2001,623,213,410,23
"24787","E01016453",2001,676,199,477,25
"24788","E01016454",2001,613,228,385,20
"24789","E01016455",2001,524,146,378,32
"24790","E01016483",2001,495,18,477,92
"24791","E01016484",2001,476,48,428,67
"24792","E01016485",2001,498,39,459,51
"24793","E01016486",2001,615,261,354,54
"24794","E01016487",2001,469,43,426,43
"24795","E01016488",2001,640,29,611,81
"24796","E01016493",2001,488,49,439,48
"24797","E01016494",2001,657,60,597,94
"24798","E01016495",2001,643,75,568,100
"24799","E01016496",2001,575,229,346,47
"24800","E01016497",2001,506,31,475,28
"24801","E01016498",2001,615,156,459,50
"24802","E01016499",2001,503,281,222,42
"24803","E01016444",2001,497,153,344,43
"24804","E01016445",2001,516,206,310,24
"24805","E01016446",2001,468,75,393,43
"24806","E01016447",2001,486,27,459,69
"24807","E01016448",2001,527,52,475,70
"24808","E01016449",2001,645,218,427,57
"24809","E01016516",2001,483,94,389,48
"24810","E01016517",2001,480,115,365,60
"24811","E01016518",2001,621,45,576,83
"24812","E01016519",2001,633,211,422,29
"24813","E01016520",2001,581,274,307,33
"24814","E01016521",2001,603,206,397,31
"24815","E01016467",2001,512,84,428,53
"24816","E01016468",2001,515,16,499,31
"24817","E01016469",2001,621,100,521,90
"24818","E01016470",2001,653,28,625,94
"24819","E01016471",2001,488,68,420,31
"24820","E01016472",2001,594,167,427,16
"24821","E01016456",2001,606,118,488,122
"24822","E01016457",2001,493,19,474,89
"24823","E01016458",2001,498,200,298,51
"24824","E01016459",2001,532,101,431,99
"24825","E01016460",2001,517,33,484,58
"24826","E01016461",2001,638,37,601,151
"24827","E01016473",2001,588,45,543,42
"24828","E01016474",2001,745,231,514,66
"24829","E01016475",2001,514,87,427,40
"24830","E01016476",2001,637,145,492,46
"24831","E01016477",2001,757,46,711,178
"24832","E01016478",2001,630,60,570,95
"24833","E01016462",2001,494,24,470,101
"24834","E01016463",2001,497,136,361,57
"24835","E01016464",2001,494,70,424,83
"24836","E01016465",2001,614,81,533,95
"24837","E01016466",2001,734,203,531,136
"24838","E01016506",2001,694,67,627,145
"24839","E01016507",2001,615,132,483,46
"24840","E01016508",2001,490,28,462,33
"24841","E01016509",2001,593,49,544,69
"24842","E01016510",2001,455,3,452,19
"24843","E01016511",2001,664,119,545,162
"24844","E01016512",2001,665,87,578,173
"24845","E01016513",2001,588,16,572,45
"24846","E01016514",2001,782,148,634,162
"24847","E01016515",2001,464,3,461,20
"24848","E01016500",2001,492,60,432,31
"24849","E01016501",2001,615,335,280,23
"24850","E01016502",2001,520,144,376,19
"24851","E01016503",2001,625,203,422,25
"24852","E01016504",2001,479,36,443,43
"24853","E01016505",2001,625,242,383,37
"24854","E01016489",2001,740,179,561,37
"24855","E01016490",2001,773,501,272,30
"24856","E01016491",2001,646,62,584,40
"24857","E01016492",2001,579,96,483,37
"24858","E01016479",2001,469,17,452,61
"24859","E01016480",2001,489,140,349,29
"24860","E01016481",2001,634,114,520,141
"24861","E01016482",2001,639,22,617,100
"24862","E01017144",2001,413,52,361,68
"24863","E01017145",2001,634,45,589,76
"24864","E01017146",2001,649,27,622,108
"24865","E01017148",2001,399,3,396,27
"24866","E01017149",2001,460,157,303,107
"24867","E01017187",2001,665,146,519,44
"24868","E01017180",2001,584,28,556,18
"24869","E01017181",2001,554,238,316,15
"24870","E01017183",2001,657,54,603,38
"24871","E01017185",2001,741,235,506,45
"24872","E01017264",2001,489,243,246,97
"24873","E01017265",2001,750,388,362,33
"24874","E01017270",2001,597,238,359,64
"24875","E01017271",2001,492,31,461,87
"24876","E01017186",2001,704,336,368,36
"24877","E01017184",2001,588,199,389,20
"24878","E01017182",2001,757,435,322,19
"24879","E01017188",2001,588,296,292,40
"24880","E01017272",2001,505,207,298,34
"24881","E01017266",2001,510,197,313,109
"24882","E01017267",2001,440,85,355,148
"24883","E01017268",2001,403,47,356,209
"24884","E01017269",2001,546,84,462,234
"24885","E01017150",2001,624,69,555,73
"24886","E01017151",2001,709,198,511,51
"24887","E01017152",2001,617,102,515,119
"24888","E01017147",2001,606,28,578,118
"24889","E01017241",2001,637,336,301,15
"24890","E01017242",2001,738,175,563,86
"24891","E01017243",2001,621,53,568,43
"24892","E01017244",2001,517,158,359,26
"24893","E01017238",2001,568,223,345,24
"24894","E01017179",2001,643,224,419,87
"24895","E01017174",2001,556,36,520,29
"24896","E01017175",2001,615,19,596,86
"24897","E01017176",2001,631,17,614,108
"24898","E01017226",2001,860,127,733,204
"24899","E01017229",2001,467,13,454,220
"24900","E01017230",2001,495,10,485,152
"24901","E01017231",2001,602,48,554,217
"24902","E01017232",2001,565,30,535,179
"24903","E01017250",2001,726,405,321,66
"24904","E01017251",2001,606,191,415,124
"24905","E01017246",2001,774,53,721,192
"24906","E01017253",2001,625,155,470,46
"24907","E01017254",2001,607,111,496,85
"24908","E01017247",2001,597,12,585,74
"24909","E01017248",2001,607,24,583,75
"24910","E01017249",2001,500,6,494,39
"24911","E01017252",2001,648,26,622,67
"24912","E01017239",2001,663,207,456,64
"24913","E01017240",2001,616,373,243,29
"24914","E01017236",2001,601,303,298,15
"24915","E01017237",2001,597,340,257,17
"24916","E01017245",2001,634,472,162,16
"24917","E01017227",2001,494,52,442,279
"24918","E01017228",2001,658,148,510,148
"24919","E01017233",2001,672,145,527,129
"24920","E01017234",2001,606,127,479,215
"24921","E01017235",2001,616,57,559,380
"24922","E01017177",2001,741,40,701,178
"24923","E01017178",2001,611,12,599,112
"24924","E01017171",2001,782,78,704,255
"24925","E01017172",2001,617,29,588,176
"24926","E01017173",2001,611,73,538,64
"24927","E01017207",2001,677,447,230,20
"24928","E01017211",2001,836,238,598,181
"24929","E01017212",2001,522,46,476,59
"24930","E01017213",2001,712,39,673,169
"24931","E01017209",2001,610,19,591,165
"24932","E01017200",2001,724,43,681,52
"24933","E01017201",2001,646,262,384,87
"24934","E01017202",2001,713,345,368,61
"24935","E01017203",2001,628,85,543,48
"24936","E01017204",2001,619,28,591,52
"24937","E01017157",2001,550,81,469,296
"24938","E01017158",2001,652,111,541,281
"24939","E01017159",2001,453,32,421,240
"24940","E01017160",2001,634,55,579,198
"24941","E01017205",2001,616,367,249,23
"24942","E01017206",2001,616,122,494,23
"24943","E01017198",2001,671,181,490,34
"24944","E01017199",2001,734,162,572,64
"24945","E01017208",2001,589,285,304,37
"24946","E01017214",2001,507,29,478,70
"24947","E01017215",2001,631,9,622,45
"24948","E01017216",2001,605,116,489,98
"24949","E01017210",2001,603,373,230,25
"24950","E01017189",2001,709,44,665,353
"24951","E01017190",2001,611,14,597,199
"24952","E01017191",2001,730,44,686,329
"24953","E01017196",2001,826,86,740,302
"24954","E01017197",2001,553,24,529,107
"24955","E01017192",2001,740,73,667,157
"24956","E01017193",2001,786,122,664,159
"24957","E01017194",2001,731,160,571,182
"24958","E01017195",2001,817,61,756,176
"24959","E01017161",2001,768,150,618,408
"24960","E01017153",2001,472,118,354,161
"24961","E01017154",2001,760,490,270,113
"24962","E01017155",2001,489,91,398,177
"24963","E01017156",2001,469,75,394,152
"24964","E01017140",2001,808,433,375,189
"24965","E01017136",2001,607,86,521,279
"24966","E01017137",2001,466,17,449,319
"24967","E01017138",2001,537,95,442,238
"24968","E01017217",2001,647,71,576,55
"24969","E01017223",2001,635,5,630,69
"24970","E01017224",2001,542,13,529,68
"24971","E01017225",2001,604,132,472,55
"24972","E01017162",2001,597,112,485,19
"24973","E01017163",2001,624,452,172,11
"24974","E01017164",2001,616,95,521,28
"24975","E01017165",2001,605,261,344,20
"24976","E01017166",2001,628,431,197,18
"24977","E01017256",2001,645,22,623,43
"24978","E01017257",2001,745,80,665,156
"24979","E01017259",2001,619,34,585,36
"24980","E01017260",2001,653,119,534,49
"24981","E01017262",2001,512,146,366,19
"24982","E01017167",2001,656,489,167,25
"24983","E01017168",2001,750,369,381,27
"24984","E01017169",2001,630,344,286,25
"24985","E01017170",2001,659,196,463,28
"24986","E01017218",2001,493,190,303,38
"24987","E01017219",2001,784,293,491,116
"24988","E01017220",2001,735,177,558,82
"24989","E01017221",2001,621,6,615,81
"24990","E01017222",2001,600,28,572,73
"24991","E01017141",2001,569,440,129,66
"24992","E01017142",2001,484,32,452,198
"24993","E01017143",2001,743,233,510,189
"24994","E01017139",2001,562,378,184,64
"24995","E01017263",2001,632,168,464,33
"24996","E01017261",2001,692,22,670,50
"24997","E01017258",2001,619,133,486,56
"24998","E01017255",2001,641,11,630,68
"24999","E01017273",2001,578,21,557,58
"25000","E01017278",2001,621,22,599,97
"25001","E01017279",2001,669,72,597,63
"25002","E01017275",2001,675,81,594,89
"25003","E01017276",2001,638,148,490,112
"25004","E01017277",2001,599,123,476,43
"25005","E01017280",2001,673,359,314,49
"25006","E01017281",2001,748,623,125,28
"25007","E01017274",2001,615,353,262,20
"25008","E01016277",2001,509,71,438,53
"25009","E01016286",2001,554,123,431,62
"25010","E01016287",2001,560,87,473,111
"25011","E01016288",2001,636,123,513,62
"25012","E01016303",2001,599,75,524,60
"25013","E01016304",2001,644,126,518,73
"25014","E01016305",2001,523,63,460,106
"25015","E01016306",2001,506,157,349,14
"25016","E01016313",2001,668,97,571,43
"25017","E01016314",2001,509,7,502,75
"25018","E01016256",2001,585,46,539,38
"25019","E01016257",2001,497,27,470,58
"25020","E01016315",2001,695,3,692,39
"25021","E01016316",2001,644,13,631,23
"25022","E01016317",2001,512,65,447,12
"25023","E01016318",2001,628,9,619,15
"25024","E01016349",2001,476,3,473,6
"25025","E01016350",2001,597,3,594,8
"25026","E01016258",2001,711,9,702,31
"25027","E01016261",2001,555,3,552,10
"25028","E01016262",2001,542,7,535,24
"25029","E01016272",2001,579,9,570,28
"25030","E01016273",2001,619,265,354,25
"25031","E01016259",2001,585,14,571,14
"25032","E01016260",2001,602,7,595,20
"25033","E01016278",2001,413,18,395,120
"25034","E01016263",2001,571,33,538,75
"25035","E01016283",2001,503,7,496,26
"25036","E01016284",2001,496,40,456,24
"25037","E01016285",2001,623,87,536,160
"25038","E01016271",2001,603,211,392,23
"25039","E01016274",2001,510,51,459,14
"25040","E01016275",2001,660,44,616,45
"25041","E01016276",2001,580,5,575,36
"25042","E01016327",2001,462,53,409,38
"25043","E01016328",2001,641,132,509,97
"25044","E01016344",2001,721,258,463,49
"25045","E01016345",2001,494,25,469,39
"25046","E01016296",2001,732,110,622,75
"25047","E01016297",2001,594,194,400,15
"25048","E01016298",2001,514,29,485,104
"25049","E01016299",2001,617,18,599,81
"25050","E01016339",2001,611,32,579,58
"25051","E01016264",2001,426,27,399,91
"25052","E01016265",2001,531,56,475,36
"25053","E01016266",2001,523,64,459,30
"25054","E01016254",2001,580,25,555,49
"25055","E01016255",2001,511,66,445,85
"25056","E01016310",2001,632,241,391,32
"25057","E01016311",2001,816,86,730,152
"25058","E01016323",2001,583,92,491,30
"25059","E01016324",2001,555,90,465,42
"25060","E01016325",2001,651,239,412,32
"25061","E01016279",2001,641,158,483,61
"25062","E01016280",2001,600,215,385,44
"25063","E01016281",2001,534,59,475,33
"25064","E01016282",2001,520,35,485,46
"25065","E01016329",2001,602,8,594,35
"25066","E01016340",2001,611,130,481,25
"25067","E01016341",2001,500,95,405,10
"25068","E01016342",2001,642,34,608,43
"25069","E01016343",2001,583,16,567,15
"25070","E01016267",2001,537,16,521,25
"25071","E01016268",2001,600,174,426,15
"25072","E01016269",2001,587,27,560,54
"25073","E01016270",2001,501,12,489,149
"25074","E01016334",2001,487,115,372,42
"25075","E01016336",2001,488,212,276,9
"25076","E01016330",2001,661,102,559,59
"25077","E01016331",2001,578,167,411,27
"25078","E01016332",2001,700,180,520,41
"25079","E01016333",2001,479,7,472,35
"25080","E01016337",2001,621,128,493,45
"25081","E01016338",2001,757,34,723,58
"25082","E01016335",2001,542,25,517,34
"25083","E01016326",2001,546,47,499,104
"25084","E01016300",2001,604,113,491,48
"25085","E01016301",2001,759,70,689,134
"25086","E01016302",2001,542,99,443,33
"25087","E01016293",2001,599,126,473,24
"25088","E01016346",2001,670,185,485,152
"25089","E01016347",2001,743,203,540,153
"25090","E01016348",2001,736,30,706,124
"25091","E01016312",2001,775,179,596,70
"25092","E01016294",2001,650,15,635,64
"25093","E01016295",2001,607,345,262,34
"25094","E01016319",2001,642,147,495,46
"25095","E01016320",2001,646,97,549,99
"25096","E01016321",2001,513,110,403,24
"25097","E01016322",2001,497,5,492,23
"25098","E01016289",2001,533,42,491,12
"25099","E01016290",2001,618,11,607,56
"25100","E01016291",2001,599,21,578,38
"25101","E01016292",2001,588,113,475,26
"25102","E01016307",2001,667,187,480,39
"25103","E01016308",2001,625,24,601,69
"25104","E01016309",2001,753,69,684,80
"25105","E01016570",2001,613,3,610,44
"25106","E01016572",2001,546,48,498,27
"25107","E01016600",2001,431,0,431,32
"25108","E01016582",2001,474,24,450,73
"25109","E01016578",2001,571,18,553,100
"25110","E01016579",2001,651,101,550,92
"25111","E01016581",2001,551,45,506,52
"25112","E01016530",2001,636,181,455,21
"25113","E01016531",2001,601,5,596,80
"25114","E01016532",2001,781,11,770,94
"25115","E01016533",2001,737,20,717,62
"25116","E01016573",2001,520,267,253,31
"25117","E01016574",2001,599,104,495,38
"25118","E01016571",2001,531,42,489,27
"25119","E01016599",2001,560,241,319,40
"25120","E01016583",2001,620,9,611,65
"25121","E01016585",2001,737,30,707,191
"25122","E01016586",2001,512,7,505,43
"25123","E01016591",2001,582,3,579,42
"25124","E01016592",2001,630,38,592,92
"25125","E01016525",2001,598,6,592,86
"25126","E01016536",2001,684,110,574,132
"25127","E01016528",2001,625,6,619,75
"25128","E01016529",2001,655,291,364,94
"25129","E01016584",2001,624,153,471,74
"25130","E01016590",2001,748,237,511,131
"25131","E01016598",2001,490,6,484,19
"25132","E01016526",2001,644,7,637,100
"25133","E01016527",2001,640,68,572,106
"25134","E01016534",2001,566,3,563,47
"25135","E01016601",2001,576,96,480,66
"25136","E01016602",2001,601,3,598,28
"25137","E01016593",2001,636,246,390,38
"25138","E01016594",2001,505,205,300,28
"25139","E01016535",2001,496,6,490,74
"25140","E01016537",2001,468,46,422,67
"25141","E01016538",2001,597,14,583,94
"25142","E01016559",2001,530,7,523,18
"25143","E01016560",2001,619,251,368,34
"25144","E01016561",2001,601,11,590,29
"25145","E01016562",2001,510,6,504,26
"25146","E01016563",2001,495,0,495,20
"25147","E01016580",2001,625,261,364,41
"25148","E01016539",2001,619,31,588,51
"25149","E01016540",2001,564,21,543,48
"25150","E01016541",2001,501,3,498,24
"25151","E01016542",2001,481,108,373,23
"25152","E01016543",2001,609,11,598,65
"25153","E01016544",2001,760,78,682,228
"25154","E01016567",2001,763,99,664,204
"25155","E01016568",2001,507,90,417,29
"25156","E01016569",2001,508,87,421,78
"25157","E01016577",2001,627,103,524,75
"25158","E01016564",2001,625,120,505,46
"25159","E01016565",2001,607,3,604,65
"25160","E01016566",2001,746,158,588,126
"25161","E01016547",2001,758,30,728,130
"25162","E01016552",2001,634,13,621,75
"25163","E01016545",2001,867,165,702,210
"25164","E01016550",2001,507,93,414,85
"25165","E01016551",2001,609,8,601,28
"25166","E01016557",2001,823,145,678,42
"25167","E01016558",2001,547,136,411,261
"25168","E01016553",2001,667,23,644,35
"25169","E01016554",2001,639,228,411,23
"25170","E01016555",2001,591,271,320,36
"25171","E01016556",2001,764,234,530,57
"25172","E01016548",2001,610,18,592,58
"25173","E01016549",2001,714,207,507,48
"25174","E01016546",2001,735,17,718,208
"25175","E01016595",2001,641,88,553,94
"25176","E01016596",2001,744,43,701,181
"25177","E01016597",2001,610,10,600,73
"25178","E01016587",2001,626,45,581,27
"25179","E01016588",2001,780,165,615,198
"25180","E01016589",2001,624,3,621,53
"25181","E01016575",2001,629,3,626,28
"25182","E01016576",2001,590,23,567,61
"25183","E01016522",2001,596,8,588,57
"25184","E01016523",2001,528,27,501,88
"25185","E01016524",2001,617,54,563,91
"25186","E01016609",2001,720,221,499,51
"25187","E01016603",2001,654,6,648,106
"25188","E01016604",2001,628,17,611,76
"25189","E01016605",2001,627,118,509,77
"25190","E01016606",2001,614,17,597,65
"25191","E01016607",2001,505,3,502,40
"25192","E01016608",2001,749,154,595,101
"25193","E01016675",2001,478,25,453,94
"25194","E01016676",2001,631,3,628,44
"25195","E01016677",2001,607,142,465,37
"25196","E01016678",2001,537,100,437,60
"25197","E01016619",2001,564,23,541,21
"25198","E01016620",2001,512,77,435,31
"25199","E01016692",2001,623,103,520,32
"25200","E01016693",2001,621,5,616,89
"25201","E01016694",2001,632,45,587,95
"25202","E01016695",2001,567,10,557,21
"25203","E01016684",2001,526,8,518,20
"25204","E01016685",2001,590,89,501,43
"25205","E01016621",2001,599,25,574,51
"25206","E01016623",2001,612,14,598,25
"25207","E01016624",2001,518,0,518,19
"25208","E01016622",2001,473,8,465,21
"25209","E01016657",2001,564,15,549,44
"25210","E01016658",2001,494,18,476,36
"25211","E01016659",2001,673,8,665,83
"25212","E01016660",2001,631,3,628,30
"25213","E01016662",2001,658,335,323,27
"25214","E01016615",2001,593,221,372,16
"25215","E01016616",2001,613,88,525,44
"25216","E01016617",2001,485,27,458,15
"25217","E01016618",2001,479,84,395,25
"25218","E01016613",2001,484,47,437,48
"25219","E01016614",2001,489,6,483,36
"25220","E01016664",2001,481,4,477,19
"25221","E01016668",2001,593,22,571,50
"25222","E01016669",2001,609,3,606,35
"25223","E01016663",2001,588,9,579,34
"25224","E01016661",2001,504,3,501,23
"25225","E01016686",2001,503,8,495,39
"25226","E01016687",2001,502,5,497,24
"25227","E01016688",2001,457,0,457,30
"25228","E01016689",2001,590,3,587,7
"25229","E01016650",2001,637,15,622,17
"25230","E01016652",2001,493,6,487,29
"25231","E01016653",2001,439,19,420,21
"25232","E01016665",2001,643,7,636,49
"25233","E01016666",2001,522,0,522,32
"25234","E01016667",2001,410,3,407,24
"25235","E01016647",2001,468,48,420,14
"25236","E01016701",2001,596,16,580,24
"25237","E01016702",2001,622,21,601,49
"25238","E01016703",2001,525,54,471,50
"25239","E01016704",2001,574,191,383,34
"25240","E01016656",2001,519,42,477,65
"25241","E01016700",2001,643,9,634,41
"25242","E01016627",2001,595,30,565,42
"25243","E01016628",2001,608,6,602,25
"25244","E01016648",2001,658,6,652,85
"25245","E01016649",2001,652,9,643,63
"25246","E01016644",2001,553,20,533,34
"25247","E01016645",2001,783,9,774,154
"25248","E01016646",2001,628,6,622,43
"25249","E01016654",2001,609,6,603,32
"25250","E01016655",2001,532,6,526,43
"25251","E01016651",2001,608,28,580,68
"25252","E01016679",2001,482,93,389,14
"25253","E01016680",2001,469,112,357,54
"25254","E01016681",2001,640,80,560,52
"25255","E01016671",2001,760,72,688,73
"25256","E01016626",2001,710,111,599,114
"25257","E01016673",2001,754,349,405,57
"25258","E01016674",2001,584,119,465,25
"25259","E01016696",2001,733,83,650,185
"25260","E01016697",2001,502,6,496,42
"25261","E01016698",2001,397,49,348,19
"25262","E01016672",2001,713,6,707,33
"25263","E01016670",2001,657,24,633,54
"25264","E01016635",2001,514,7,507,31
"25265","E01016629",2001,484,3,481,7
"25266","E01016630",2001,585,3,582,26
"25267","E01016612",2001,775,9,766,43
"25268","E01016631",2001,571,88,483,40
"25269","E01016632",2001,586,0,586,42
"25270","E01016625",2001,639,4,635,35
"25271","E01016634",2001,580,23,557,33
"25272","E01016699",2001,611,59,552,60
"25273","E01016690",2001,563,68,495,62
"25274","E01016691",2001,457,32,425,44
"25275","E01016682",2001,621,22,599,85
"25276","E01016683",2001,726,45,681,48
"25277","E01016641",2001,537,10,527,31
"25278","E01016642",2001,453,196,257,16
"25279","E01016610",2001,717,62,655,170
"25280","E01016611",2001,436,45,391,207
"25281","E01016643",2001,503,5,498,19
"25282","E01016636",2001,530,3,527,14
"25283","E01016637",2001,398,0,398,9
"25284","E01016638",2001,498,3,495,20
"25285","E01016639",2001,620,81,539,28
"25286","E01016640",2001,591,32,559,36
"25287","E01016633",2001,478,11,467,16
"25288","E01016705",2001,477,43,434,61
"25289","E01016706",2001,636,0,636,27
"25290","E01016707",2001,635,21,614,20
"25291","E01016708",2001,641,8,633,41
"25292","E01016709",2001,618,7,611,17
"25293","E01017648",2001,620,10,610,38
"25294","E01017649",2001,713,130,583,47
"25295","E01017650",2001,541,7,534,34
"25296","E01017685",2001,412,49,363,67
"25297","E01017686",2001,614,63,551,66
"25298","E01017644",2001,667,19,648,90
"25299","E01017645",2001,600,119,481,168
"25300","E01017646",2001,714,209,505,34
"25301","E01017647",2001,606,4,602,21
"25302","E01017671",2001,535,71,464,23
"25303","E01017672",2001,548,32,516,46
"25304","E01017695",2001,508,62,446,4
"25305","E01017696",2001,502,57,445,25
"25306","E01017693",2001,449,66,383,63
"25307","E01017694",2001,505,49,456,39
"25308","E01017717",2001,641,99,542,67
"25309","E01017718",2001,576,48,528,67
"25310","E01017713",2001,582,106,476,31
"25311","E01017714",2001,496,28,468,50
"25312","E01017735",2001,529,55,474,63
"25313","E01017736",2001,612,169,443,38
"25314","E01017737",2001,618,8,610,37
"25315","E01017738",2001,627,34,593,64
"25316","E01017715",2001,473,35,438,87
"25317","E01017716",2001,680,91,589,33
"25318","E01017669",2001,584,99,485,27
"25319","E01017670",2001,616,82,534,34
"25320","E01017641",2001,694,53,641,48
"25321","E01017731",2001,587,149,438,21
"25322","E01017732",2001,557,16,541,44
"25323","E01017733",2001,492,94,398,36
"25324","E01017734",2001,530,18,512,30
"25325","E01017725",2001,634,65,569,49
"25326","E01017719",2001,494,124,370,33
"25327","E01017720",2001,535,37,498,118
"25328","E01017703",2001,490,44,446,47
"25329","E01017704",2001,460,31,429,20
"25330","E01017701",2001,573,48,525,26
"25331","E01017702",2001,601,134,467,32
"25332","E01017657",2001,599,40,559,26
"25333","E01017658",2001,567,39,528,41
"25334","E01017651",2001,610,39,571,21
"25335","E01017652",2001,626,77,549,38
"25336","E01017642",2001,536,63,473,45
"25337","E01017643",2001,527,51,476,69
"25338","E01017673",2001,472,42,430,11
"25339","E01017674",2001,494,24,470,35
"25340","E01017664",2001,618,6,612,114
"25341","E01017659",2001,608,203,405,24
"25342","E01017660",2001,764,74,690,104
"25343","E01017661",2001,621,229,392,28
"25344","E01017705",2001,493,7,486,41
"25345","E01017706",2001,515,205,310,6
"25346","E01017707",2001,477,307,170,6
"25347","E01017708",2001,606,218,388,35
"25348","E01017665",2001,587,198,389,24
"25349","E01017666",2001,649,31,618,90
"25350","E01017667",2001,504,172,332,13
"25351","E01017668",2001,631,105,526,31
"25352","E01017697",2001,624,29,595,63
"25353","E01017698",2001,499,118,381,20
"25354","E01017699",2001,405,26,379,65
"25355","E01017700",2001,615,7,608,45
"25356","E01017662",2001,549,100,449,80
"25357","E01017663",2001,597,134,463,79
"25358","E01017633",2001,770,214,556,123
"25359","E01017634",2001,533,16,517,103
"25360","E01017653",2001,617,37,580,35
"25361","E01017654",2001,621,316,305,27
"25362","E01017655",2001,744,15,729,63
"25363","E01017656",2001,726,7,719,45
"25364","E01017635",2001,635,7,628,64
"25365","E01017636",2001,658,7,651,18
"25366","E01017637",2001,456,25,431,22
"25367","E01017638",2001,525,10,515,44
"25368","E01017639",2001,607,4,603,25
"25369","E01017640",2001,640,47,593,20
"25370","E01017709",2001,525,270,255,15
"25371","E01017710",2001,509,155,354,16
"25372","E01017711",2001,635,350,285,23
"25373","E01017712",2001,518,283,235,15
"25374","E01017687",2001,527,161,366,45
"25375","E01017688",2001,523,41,482,52
"25376","E01017689",2001,537,12,525,20
"25377","E01017690",2001,498,40,458,35
"25378","E01017691",2001,534,4,530,31
"25379","E01017692",2001,627,25,602,90
"25380","E01017721",2001,796,76,720,87
"25381","E01017722",2001,633,41,592,50
"25382","E01017723",2001,506,236,270,18
"25383","E01017724",2001,506,196,310,20
"25384","E01017627",2001,622,124,498,51
"25385","E01017628",2001,502,8,494,15
"25386","E01017629",2001,601,19,582,26
"25387","E01017630",2001,624,67,557,23
"25388","E01017631",2001,634,87,547,32
"25389","E01017632",2001,590,9,581,42
"25390","E01017675",2001,598,7,591,35
"25391","E01017676",2001,559,15,544,26
"25392","E01017677",2001,618,18,600,47
"25393","E01017678",2001,506,31,475,76
"25394","E01017679",2001,551,104,447,12
"25395","E01017680",2001,466,170,296,19
"25396","E01017681",2001,538,186,352,13
"25397","E01017682",2001,473,8,465,29
"25398","E01017683",2001,660,91,569,47
"25399","E01017684",2001,451,54,397,29
"25400","E01017726",2001,549,87,462,68
"25401","E01017727",2001,643,10,633,29
"25402","E01017728",2001,489,78,411,284
"25403","E01017729",2001,686,46,640,25
"25404","E01017730",2001,759,250,509,40
"25405","E01017750",2001,858,68,790,65
"25406","E01017752",2001,865,48,817,55
"25407","E01017766",2001,897,41,856,59
"25408","E01017778",2001,497,63,434,24
"25409","E01017795",2001,805,164,641,36
"25410","E01017747",2001,499,75,424,29
"25411","E01017748",2001,611,274,337,11
"25412","E01017749",2001,602,3,599,18
"25413","E01017789",2001,493,136,357,10
"25414","E01017790",2001,486,259,227,7
"25415","E01017780",2001,477,12,465,31
"25416","E01017781",2001,406,111,295,51
"25417","E01017771",2001,621,8,613,23
"25418","E01017769",2001,613,7,606,42
"25419","E01017770",2001,640,121,519,80
"25420","E01017791",2001,617,166,451,52
"25421","E01017792",2001,755,180,575,75
"25422","E01017793",2001,598,157,441,21
"25423","E01017768",2001,938,120,818,94
"25424","E01017779",2001,401,22,379,15
"25425","E01017785",2001,653,6,647,19
"25426","E01017786",2001,595,32,563,30
"25427","E01017787",2001,609,7,602,36
"25428","E01017788",2001,714,200,514,34
"25429","E01017763",2001,662,13,649,83
"25430","E01017764",2001,595,7,588,14
"25431","E01017765",2001,621,3,618,26
"25432","E01017741",2001,638,159,479,28
"25433","E01017742",2001,665,35,630,78
"25434","E01017743",2001,628,284,344,32
"25435","E01017744",2001,532,76,456,33
"25436","E01017745",2001,759,114,645,116
"25437","E01017746",2001,580,51,529,43
"25438","E01017739",2001,472,0,472,43
"25439","E01017740",2001,485,57,428,57
"25440","E01017762",2001,508,3,505,21
"25441","E01017775",2001,656,174,482,37
"25442","E01017776",2001,645,210,435,37
"25443","E01017777",2001,631,0,631,21
"25444","E01017772",2001,487,99,388,13
"25445","E01017773",2001,605,41,564,29
"25446","E01017774",2001,491,5,486,10
"25447","E01017782",2001,501,0,501,19
"25448","E01017783",2001,578,50,528,49
"25449","E01017784",2001,593,39,554,38
"25450","E01017759",2001,723,147,576,77
"25451","E01017760",2001,626,34,592,24
"25452","E01017761",2001,839,45,794,36
"25453","E01017794",2001,852,62,790,47
"25454","E01017754",2001,509,22,487,19
"25455","E01017755",2001,625,35,590,109
"25456","E01017756",2001,569,6,563,23
"25457","E01017757",2001,463,62,401,22
"25458","E01017758",2001,405,7,398,43
"25459","E01017753",2001,512,167,345,25
"25460","E01017751",2001,754,3,751,46
"25461","E01017767",2001,841,155,686,51
"25462","E01017796",2001,636,145,491,79
"25463","E01017797",2001,515,3,512,21
"25464","E01017798",2001,644,24,620,38
"25465","E01017799",2001,669,45,624,96
"25466","E01017800",2001,635,162,473,125
"25467","E01017801",2001,529,8,521,28
"25468","E01017802",2001,647,183,464,22
"25469","E01017818",2001,673,66,607,60
"25470","E01017819",2001,499,9,490,42
"25471","E01017820",2001,619,32,587,92
"25472","E01017821",2001,485,0,485,51
"25473","E01017822",2001,620,0,620,33
"25474","E01017810",2001,742,299,443,58
"25475","E01017811",2001,485,70,415,22
"25476","E01017812",2001,642,108,534,36
"25477","E01017813",2001,715,9,706,39
"25478","E01017823",2001,556,73,483,33
"25479","E01017815",2001,633,33,600,38
"25480","E01017816",2001,659,85,574,46
"25481","E01017817",2001,645,101,544,33
"25482","E01017830",2001,734,139,595,49
"25483","E01017831",2001,639,9,630,40
"25484","E01017832",2001,577,73,504,36
"25485","E01017834",2001,549,83,466,30
"25486","E01017835",2001,698,29,669,52
"25487","E01017833",2001,725,21,704,103
"25488","E01017814",2001,572,38,534,51
"25489","E01017806",2001,642,25,617,25
"25490","E01017803",2001,491,16,475,27
"25491","E01017804",2001,631,98,533,59
"25492","E01017805",2001,753,293,460,38
"25493","E01017807",2001,601,19,582,42
"25494","E01017808",2001,637,117,520,49
"25495","E01017809",2001,587,164,423,34
"25496","E01017824",2001,651,89,562,26
"25497","E01017825",2001,603,19,584,31
"25498","E01017826",2001,607,179,428,11
"25499","E01017827",2001,621,88,533,43
"25500","E01017828",2001,605,176,429,21
"25501","E01017829",2001,613,3,610,38
"25502","E01017929",2001,766,300,466,67
"25503","E01017930",2001,706,9,697,50
"25504","E01017931",2001,564,94,470,28
"25505","E01017932",2001,621,46,575,31
"25506","E01017933",2001,690,103,587,19
"25507","E01017885",2001,604,40,564,48
"25508","E01017886",2001,594,41,553,36
"25509","E01017887",2001,455,20,435,16
"25510","E01017888",2001,559,24,535,167
"25511","E01017869",2001,492,3,489,10
"25512","E01017870",2001,481,6,475,22
"25513","E01017871",2001,578,9,569,15
"25514","E01017872",2001,619,13,606,34
"25515","E01017873",2001,509,4,505,12
"25516","E01017874",2001,513,57,456,234
"25517","E01017915",2001,500,64,436,37
"25518","E01017916",2001,468,25,443,38
"25519","E01017917",2001,549,15,534,62
"25520","E01017918",2001,675,156,519,56
"25521","E01017879",2001,629,36,593,23
"25522","E01017880",2001,519,7,512,6
"25523","E01017881",2001,667,32,635,37
"25524","E01017882",2001,622,35,587,39
"25525","E01017883",2001,511,18,493,21
"25526","E01017884",2001,630,102,528,27
"25527","E01017857",2001,624,303,321,45
"25528","E01017858",2001,597,133,464,87
"25529","E01017859",2001,505,19,486,20
"25530","E01017860",2001,479,107,372,25
"25531","E01017861",2001,584,7,577,20
"25532","E01017862",2001,635,49,586,53
"25533","E01017863",2001,621,3,618,9
"25534","E01017853",2001,502,39,463,79
"25535","E01017854",2001,496,26,470,40
"25536","E01017842",2001,1028,89,939,119
"25537","E01017878",2001,1065,44,1021,169
"25538","E01017920",2001,477,29,448,23
"25539","E01017921",2001,630,28,602,96
"25540","E01017922",2001,641,103,538,95
"25541","E01017923",2001,651,125,526,208
"25542","E01017924",2001,502,13,489,43
"25543","E01017937",2001,542,13,529,23
"25544","E01017938",2001,469,6,463,11
"25545","E01017942",2001,572,48,524,8
"25546","E01017940",2001,663,33,630,62
"25547","E01017919",2001,611,121,490,93
"25548","E01017850",2001,490,185,305,33
"25549","E01017851",2001,644,127,517,75
"25550","E01017852",2001,728,32,696,68
"25551","E01017925",2001,506,97,409,25
"25552","E01017926",2001,507,255,252,36
"25553","E01017927",2001,599,74,525,22
"25554","E01017928",2001,608,154,454,31
"25555","E01017911",2001,636,190,446,32
"25556","E01017912",2001,490,11,479,49
"25557","E01017913",2001,615,84,531,145
"25558","E01017914",2001,497,35,462,12
"25559","E01017903",2001,505,119,386,64
"25560","E01017904",2001,501,61,440,79
"25561","E01017905",2001,754,124,630,183
"25562","E01017906",2001,492,220,272,43
"25563","E01017907",2001,607,217,390,30
"25564","E01017899",2001,640,204,436,31
"25565","E01017900",2001,509,186,323,36
"25566","E01017901",2001,463,187,276,20
"25567","E01017902",2001,616,240,376,33
"25568","E01017836",2001,539,33,506,51
"25569","E01017837",2001,500,112,388,140
"25570","E01017838",2001,506,19,487,43
"25571","E01017839",2001,399,31,368,70
"25572","E01017840",2001,630,42,588,35
"25573","E01017841",2001,478,20,458,30
"25574","E01017908",2001,806,263,543,80
"25575","E01017909",2001,629,28,601,74
"25576","E01017910",2001,718,128,590,92
"25577","E01017941",2001,641,117,524,65
"25578","E01017855",2001,627,101,526,41
"25579","E01017856",2001,523,190,333,18
"25580","E01017843",2001,644,55,589,14
"25581","E01017844",2001,623,187,436,18
"25582","E01017845",2001,667,170,497,36
"25583","E01017864",2001,504,3,501,11
"25584","E01017865",2001,610,4,606,18
"25585","E01017867",2001,607,169,438,24
"25586","E01017868",2001,611,9,602,35
"25587","E01017939",2001,518,40,478,44
"25588","E01017934",2001,719,219,500,51
"25589","E01017935",2001,741,88,653,81
"25590","E01017936",2001,649,16,633,47
"25591","E01017866",2001,559,9,550,46
"25592","E01017875",2001,491,28,463,160
"25593","E01017876",2001,765,13,752,24
"25594","E01017877",2001,629,93,536,23
"25595","E01017846",2001,617,190,427,37
"25596","E01017847",2001,658,52,606,58
"25597","E01017848",2001,464,6,458,13
"25598","E01017849",2001,642,11,631,67
"25599","E01017889",2001,519,143,376,34
"25600","E01017890",2001,499,8,491,13
"25601","E01017891",2001,621,25,596,44
"25602","E01017892",2001,607,6,601,23
"25603","E01017893",2001,782,263,519,95
"25604","E01017894",2001,625,21,604,54
"25605","E01017895",2001,590,117,473,70
"25606","E01017896",2001,625,11,614,59
"25607","E01017897",2001,632,55,577,61
"25608","E01017898",2001,482,109,373,44
"25609","E01020924",2001,524,94,430,29
"25610","E01020925",2001,598,286,312,32
"25611","E01020927",2001,557,126,431,32
"25612","E01020928",2001,800,93,707,62
"25613","E01020930",2001,499,256,243,26
"25614","E01020917",2001,573,313,260,18
"25615","E01020918",2001,631,75,556,50
"25616","E01020919",2001,599,111,488,90
"25617","E01020949",2001,692,60,632,24
"25618","E01020923",2001,575,340,235,33
"25619","E01020955",2001,693,232,461,24
"25620","E01020956",2001,831,22,809,24
"25621","E01020957",2001,648,129,519,36
"25622","E01020929",2001,773,335,438,40
"25623","E01020926",2001,608,97,511,12
"25624","E01020920",2001,765,341,424,108
"25625","E01020921",2001,599,162,437,33
"25626","E01020922",2001,598,229,369,83
"25627","E01020950",2001,715,77,638,17
"25628","E01020945",2001,745,9,736,27
"25629","E01020951",2001,632,101,531,95
"25630","E01020913",2001,832,197,635,98
"25631","E01020958",2001,574,212,362,50
"25632","E01020959",2001,590,52,538,47
"25633","E01020960",2001,703,24,679,183
"25634","E01020961",2001,661,7,654,19
"25635","E01020962",2001,720,45,675,69
"25636","E01020946",2001,721,12,709,33
"25637","E01020947",2001,721,190,531,35
"25638","E01020940",2001,609,32,577,46
"25639","E01020941",2001,621,277,344,23
"25640","E01020942",2001,626,23,603,25
"25641","E01020952",2001,702,188,514,84
"25642","E01020953",2001,570,6,564,14
"25643","E01020954",2001,567,9,558,22
"25644","E01020914",2001,777,35,742,165
"25645","E01020915",2001,780,79,701,163
"25646","E01020948",2001,808,133,675,125
"25647","E01020963",2001,605,30,575,92
"25648","E01020965",2001,879,30,849,342
"25649","E01020966",2001,745,87,658,155
"25650","E01020967",2001,868,211,657,95
"25651","E01020964",2001,901,69,832,170
"25652","E01020943",2001,739,94,645,112
"25653","E01020938",2001,621,117,504,43
"25654","E01020939",2001,627,23,604,51
"25655","E01020916",2001,762,47,715,183
"25656","E01020910",2001,744,183,561,179
"25657","E01020911",2001,843,67,776,407
"25658","E01020912",2001,824,139,685,376
"25659","E01020935",2001,868,75,793,313
"25660","E01020936",2001,875,41,834,179
"25661","E01020937",2001,630,24,606,240
"25662","E01020968",2001,855,70,785,286
"25663","E01020944",2001,605,32,573,25
"25664","E01020931",2001,754,49,705,86
"25665","E01020932",2001,875,67,808,96
"25666","E01020933",2001,410,8,402,32
"25667","E01020934",2001,646,29,617,137
"25668","E01020969",2001,652,84,568,17
"25669","E01020970",2001,657,3,654,20
"25670","E01020971",2001,737,186,551,40
"25671","E01020987",2001,752,26,726,73
"25672","E01020988",2001,729,9,720,22
"25673","E01020986",2001,581,6,575,41
"25674","E01020974",2001,623,43,580,15
"25675","E01021007",2001,626,10,616,9
"25676","E01021008",2001,769,181,588,95
"25677","E01021009",2001,792,10,782,36
"25678","E01020993",2001,610,322,288,57
"25679","E01020994",2001,616,265,351,45
"25680","E01020995",2001,584,285,299,44
"25681","E01020996",2001,546,213,333,24
"25682","E01021019",2001,837,473,364,45
"25683","E01021004",2001,751,39,712,72
"25684","E01021005",2001,642,344,298,30
"25685","E01021006",2001,737,25,712,145
"25686","E01021013",2001,586,16,570,82
"25687","E01021015",2001,714,435,279,80
"25688","E01020977",2001,720,34,686,249
"25689","E01020972",2001,758,561,197,34
"25690","E01020973",2001,722,145,577,34
"25691","E01021020",2001,757,293,464,31
"25692","E01021021",2001,634,19,615,73
"25693","E01021010",2001,640,6,634,49
"25694","E01021011",2001,609,34,575,90
"25695","E01021012",2001,705,158,547,134
"25696","E01021014",2001,766,103,663,195
"25697","E01021000",2001,593,14,579,104
"25698","E01021001",2001,488,7,481,54
"25699","E01021002",2001,602,60,542,76
"25700","E01021003",2001,892,126,766,249
"25701","E01020975",2001,801,103,698,178
"25702","E01020976",2001,815,9,806,207
"25703","E01020990",2001,640,25,615,234
"25704","E01020991",2001,605,18,587,186
"25705","E01020992",2001,725,80,645,250
"25706","E01020978",2001,845,56,789,389
"25707","E01020979",2001,959,148,811,470
"25708","E01020980",2001,743,95,648,299
"25709","E01020981",2001,646,31,615,140
"25710","E01020997",2001,620,123,497,41
"25711","E01020998",2001,841,30,811,341
"25712","E01020999",2001,710,12,698,45
"25713","E01021016",2001,716,77,639,161
"25714","E01021017",2001,621,22,599,73
"25715","E01021018",2001,653,52,601,32
"25716","E01020982",2001,877,124,753,427
"25717","E01020983",2001,844,271,573,252
"25718","E01020984",2001,872,38,834,381
"25719","E01020985",2001,883,45,838,344
"25720","E01020989",2001,736,29,707,369
"25721","E01021022",2001,799,113,686,81
"25722","E01021024",2001,459,124,335,17
"25723","E01021025",2001,588,14,574,53
"25724","E01021052",2001,496,3,493,17
"25725","E01021053",2001,450,104,346,40
"25726","E01021032",2001,816,50,766,83
"25727","E01021067",2001,425,45,380,10
"25728","E01021068",2001,418,26,392,54
"25729","E01021026",2001,816,72,744,57
"25730","E01021023",2001,734,59,675,44
"25731","E01021033",2001,709,124,585,46
"25732","E01021034",2001,534,104,430,29
"25733","E01021035",2001,789,106,683,162
"25734","E01021036",2001,588,98,490,37
"25735","E01021037",2001,602,310,292,10
"25736","E01021038",2001,750,82,668,117
"25737","E01021054",2001,595,76,519,116
"25738","E01021055",2001,756,125,631,38
"25739","E01021056",2001,625,6,619,39
"25740","E01021057",2001,739,202,537,185
"25741","E01021039",2001,661,55,606,97
"25742","E01021040",2001,650,73,577,76
"25743","E01021041",2001,630,103,527,8
"25744","E01021042",2001,483,38,445,14
"25745","E01021043",2001,598,143,455,37
"25746","E01021027",2001,646,6,640,25
"25747","E01021028",2001,602,32,570,25
"25748","E01021029",2001,603,6,597,29
"25749","E01021030",2001,589,9,580,43
"25750","E01021031",2001,673,101,572,83
"25751","E01021061",2001,580,6,574,33
"25752","E01021063",2001,685,26,659,23
"25753","E01021064",2001,759,18,741,70
"25754","E01021065",2001,628,99,529,109
"25755","E01021066",2001,630,32,598,38
"25756","E01021045",2001,657,81,576,45
"25757","E01021046",2001,595,3,592,22
"25758","E01021047",2001,604,39,565,44
"25759","E01021048",2001,630,31,599,139
"25760","E01021049",2001,622,65,557,143
"25761","E01021050",2001,532,151,381,20
"25762","E01021051",2001,515,41,474,35
"25763","E01021044",2001,527,206,321,24
"25764","E01021058",2001,647,10,637,67
"25765","E01021059",2001,645,20,625,53
"25766","E01021060",2001,621,134,487,28
"25767","E01021062",2001,631,203,428,30
"25768","E01021069",2001,627,11,616,35
"25769","E01021077",2001,654,65,589,23
"25770","E01021081",2001,732,31,701,42
"25771","E01021082",2001,752,7,745,31
"25772","E01021083",2001,554,0,554,14
"25773","E01021075",2001,652,30,622,12
"25774","E01021076",2001,749,237,512,30
"25775","E01021078",2001,489,0,489,27
"25776","E01021072",2001,752,11,741,12
"25777","E01021073",2001,630,14,616,27
"25778","E01021074",2001,751,160,591,14
"25779","E01021070",2001,759,54,705,117
"25780","E01021071",2001,919,35,884,285
"25781","E01021079",2001,758,107,651,104
"25782","E01021080",2001,625,46,579,48
"25783","E01021132",2001,494,39,455,20
"25784","E01021133",2001,634,109,525,64
"25785","E01021134",2001,568,54,514,42
"25786","E01021139",2001,502,144,358,33
"25787","E01021140",2001,626,6,620,57
"25788","E01021141",2001,560,23,537,59
"25789","E01021114",2001,629,129,500,27
"25790","E01021115",2001,687,17,670,48
"25791","E01021116",2001,641,119,522,59
"25792","E01021103",2001,704,77,627,135
"25793","E01021104",2001,515,42,473,21
"25794","E01021105",2001,481,95,386,23
"25795","E01021098",2001,663,93,570,47
"25796","E01021099",2001,649,21,628,58
"25797","E01021100",2001,601,46,555,47
"25798","E01021101",2001,809,138,671,46
"25799","E01021102",2001,661,69,592,73
"25800","E01021117",2001,746,49,697,141
"25801","E01021118",2001,720,59,661,92
"25802","E01021119",2001,476,276,200,15
"25803","E01021109",2001,660,30,630,45
"25804","E01021110",2001,1040,47,993,24
"25805","E01021087",2001,680,12,668,51
"25806","E01021088",2001,636,43,593,28
"25807","E01021089",2001,608,124,484,26
"25808","E01021084",2001,863,210,653,111
"25809","E01021085",2001,619,9,610,36
"25810","E01021086",2001,639,66,573,29
"25811","E01021096",2001,465,35,430,84
"25812","E01021097",2001,529,28,501,39
"25813","E01021113",2001,611,97,514,70
"25814","E01021111",2001,481,112,369,31
"25815","E01021135",2001,669,196,473,74
"25816","E01021136",2001,541,292,249,23
"25817","E01021137",2001,628,212,416,31
"25818","E01021131",2001,586,117,469,55
"25819","E01021126",2001,581,26,555,75
"25820","E01021127",2001,651,104,547,52
"25821","E01021128",2001,750,26,724,29
"25822","E01021120",2001,757,26,731,57
"25823","E01021112",2001,609,10,599,34
"25824","E01021095",2001,589,3,586,10
"25825","E01021093",2001,630,3,627,20
"25826","E01021129",2001,649,0,649,16
"25827","E01021138",2001,454,49,405,20
"25828","E01021123",2001,698,11,687,18
"25829","E01021124",2001,785,3,782,33
"25830","E01021125",2001,527,7,520,21
"25831","E01021130",2001,599,15,584,30
"25832","E01021094",2001,770,57,713,46
"25833","E01021106",2001,868,64,804,33
"25834","E01021107",2001,735,25,710,13
"25835","E01021108",2001,627,62,565,43
"25836","E01021090",2001,745,28,717,247
"25837","E01021091",2001,1020,55,965,339
"25838","E01021092",2001,935,181,754,258
"25839","E01021121",2001,766,21,745,111
"25840","E01021122",2001,763,22,741,209
"25841","E01021167",2001,867,158,709,91
"25842","E01021168",2001,628,11,617,101
"25843","E01021169",2001,478,8,470,66
"25844","E01021186",2001,464,47,417,36
"25845","E01021171",2001,703,56,647,77
"25846","E01021172",2001,686,63,623,50
"25847","E01021173",2001,530,15,515,77
"25848","E01021218",2001,464,0,464,29
"25849","E01021156",2001,636,10,626,48
"25850","E01021157",2001,651,4,647,8
"25851","E01021158",2001,722,36,686,26
"25852","E01021159",2001,889,31,858,30
"25853","E01021160",2001,740,91,649,60
"25854","E01021161",2001,618,10,608,40
"25855","E01021162",2001,612,6,606,29
"25856","E01021229",2001,597,10,587,67
"25857","E01021230",2001,652,7,645,51
"25858","E01021231",2001,748,165,583,50
"25859","E01021202",2001,494,44,450,77
"25860","E01021203",2001,590,21,569,42
"25861","E01021151",2001,629,11,618,22
"25862","E01021152",2001,483,183,300,20
"25863","E01021153",2001,847,63,784,92
"25864","E01021154",2001,611,192,419,15
"25865","E01021155",2001,453,13,440,50
"25866","E01021163",2001,785,7,778,50
"25867","E01021164",2001,696,71,625,41
"25868","E01021187",2001,548,16,532,40
"25869","E01021170",2001,1016,40,976,76
"25870","E01021144",2001,631,12,619,26
"25871","E01021145",2001,756,85,671,38
"25872","E01021217",2001,510,55,455,30
"25873","E01021219",2001,512,0,512,11
"25874","E01021220",2001,616,85,531,59
"25875","E01021223",2001,490,45,445,40
"25876","E01021224",2001,618,236,382,12
"25877","E01021225",2001,618,16,602,29
"25878","E01021226",2001,484,17,467,62
"25879","E01021150",2001,420,18,402,13
"25880","E01021191",2001,720,28,692,85
"25881","E01021192",2001,608,6,602,21
"25882","E01021193",2001,727,213,514,29
"25883","E01021194",2001,611,3,608,35
"25884","E01021189",2001,496,9,487,36
"25885","E01021190",2001,616,7,609,49
"25886","E01021149",2001,479,74,405,32
"25887","E01021200",2001,484,92,392,37
"25888","E01021201",2001,559,0,559,46
"25889","E01021227",2001,524,9,515,17
"25890","E01021228",2001,530,0,530,19
"25891","E01021221",2001,511,62,449,51
"25892","E01021222",2001,623,85,538,47
"25893","E01021146",2001,600,70,530,16
"25894","E01021147",2001,557,22,535,34
"25895","E01021148",2001,478,30,448,48
"25896","E01021165",2001,422,25,397,60
"25897","E01021188",2001,434,15,419,49
"25898","E01021198",2001,577,48,529,38
"25899","E01021199",2001,522,6,516,26
"25900","E01021204",2001,482,61,421,27
"25901","E01021205",2001,460,16,444,37
"25902","E01021174",2001,626,6,620,29
"25903","E01021175",2001,628,0,628,27
"25904","E01021176",2001,650,3,647,25
"25905","E01021177",2001,521,94,427,65
"25906","E01021180",2001,520,9,511,25
"25907","E01021181",2001,516,3,513,17
"25908","E01021182",2001,652,75,577,33
"25909","E01021183",2001,509,270,239,28
"25910","E01021184",2001,621,7,614,27
"25911","E01021185",2001,608,165,443,35
"25912","E01021178",2001,523,184,339,20
"25913","E01021179",2001,597,290,307,19
"25914","E01021166",2001,986,27,959,74
"25915","E01021195",2001,674,14,660,49
"25916","E01021196",2001,774,16,758,27
"25917","E01021197",2001,579,3,576,44
"25918","E01021142",2001,574,6,568,37
"25919","E01021143",2001,525,41,484,65
"25920","E01021212",2001,854,28,826,30
"25921","E01021213",2001,731,51,680,100
"25922","E01021214",2001,741,11,730,42
"25923","E01021215",2001,616,78,538,23
"25924","E01021216",2001,487,65,422,12
"25925","E01021206",2001,644,82,562,44
"25926","E01021207",2001,629,9,620,52
"25927","E01021208",2001,614,33,581,32
"25928","E01021209",2001,639,36,603,23
"25929","E01021210",2001,513,3,510,8
"25930","E01021211",2001,761,6,755,80
"25931","E01021232",2001,803,11,792,56
"25932","E01021233",2001,627,3,624,16
"25933","E01021234",2001,640,11,629,15
"25934","E01021235",2001,629,3,626,19
"25935","E01021236",2001,744,109,635,24
"25936","E01022553",2001,615,31,584,16
"25937","E01022554",2001,660,53,607,21
"25938","E01022555",2001,617,50,567,25
"25939","E01022556",2001,646,244,402,24
"25940","E01022560",2001,481,42,439,20
"25941","E01022557",2001,597,61,536,50
"25942","E01022558",2001,615,44,571,73
"25943","E01022559",2001,522,28,494,25
"25944","E01022493",2001,515,58,457,36
"25945","E01022536",2001,521,44,477,20
"25946","E01022537",2001,512,3,509,16
"25947","E01022499",2001,545,26,519,18
"25948","E01022500",2001,508,47,461,76
"25949","E01022488",2001,470,166,304,58
"25950","E01022489",2001,570,63,507,71
"25951","E01022513",2001,571,75,496,50
"25952","E01022472",2001,456,19,437,38
"25953","E01022473",2001,499,19,480,15
"25954","E01022520",2001,727,226,501,60
"25955","E01022521",2001,724,51,673,42
"25956","E01022522",2001,562,48,514,37
"25957","E01022546",2001,509,52,457,46
"25958","E01022547",2001,707,70,637,65
"25959","E01022490",2001,676,101,575,19
"25960","E01022491",2001,537,114,423,34
"25961","E01022492",2001,550,26,524,100
"25962","E01022495",2001,662,23,639,81
"25963","E01022496",2001,409,16,393,13
"25964","E01022497",2001,599,11,588,90
"25965","E01022498",2001,615,27,588,79
"25966","E01022538",2001,506,153,353,15
"25967","E01022539",2001,496,129,367,14
"25968","E01022540",2001,546,225,321,12
"25969","E01022541",2001,495,268,227,29
"25970","E01022542",2001,449,143,306,11
"25971","E01022543",2001,511,160,351,15
"25972","E01022544",2001,531,216,315,15
"25973","E01022523",2001,749,352,397,40
"25974","E01022494",2001,630,83,547,50
"25975","E01022470",2001,756,6,750,55
"25976","E01022471",2001,617,6,611,48
"25977","E01022524",2001,611,344,267,23
"25978","E01022525",2001,621,54,567,37
"25979","E01022526",2001,605,145,460,38
"25980","E01022527",2001,734,292,442,65
"25981","E01022545",2001,633,116,517,208
"25982","E01022566",2001,487,73,414,7
"25983","E01022567",2001,517,205,312,13
"25984","E01022568",2001,652,222,430,24
"25985","E01022570",2001,631,23,608,22
"25986","E01022506",2001,589,65,524,45
"25987","E01022507",2001,629,206,423,31
"25988","E01022501",2001,761,273,488,140
"25989","E01022502",2001,639,10,629,62
"25990","E01022503",2001,596,55,541,84
"25991","E01022481",2001,654,112,542,53
"25992","E01022482",2001,734,205,529,49
"25993","E01022483",2001,752,70,682,116
"25994","E01022484",2001,505,269,236,24
"25995","E01022485",2001,490,203,287,22
"25996","E01022486",2001,453,146,307,21
"25997","E01022487",2001,493,196,297,15
"25998","E01022569",2001,513,43,470,17
"25999","E01022548",2001,625,175,450,23
"26000","E01022549",2001,756,349,407,20
"26001","E01022550",2001,749,354,395,15
"26002","E01022551",2001,623,153,470,18
"26003","E01022552",2001,611,289,322,19
"26004","E01022528",2001,487,3,484,10
"26005","E01022529",2001,655,165,490,51
"26006","E01022530",2001,505,3,502,9
"26007","E01022531",2001,595,11,584,62
"26008","E01022480",2001,500,176,324,8
"26009","E01022475",2001,732,38,694,65
"26010","E01022476",2001,696,14,682,45
"26011","E01022504",2001,491,39,452,9
"26012","E01022505",2001,632,17,615,33
"26013","E01022561",2001,595,50,545,152
"26014","E01022562",2001,545,62,483,73
"26015","E01022467",2001,651,28,623,26
"26016","E01022468",2001,625,32,593,47
"26017","E01022469",2001,630,119,511,24
"26018","E01022515",2001,657,10,647,4
"26019","E01022516",2001,608,29,579,11
"26020","E01022517",2001,495,3,492,5
"26021","E01022518",2001,587,11,576,12
"26022","E01022519",2001,495,0,495,6
"26023","E01022509",2001,592,9,583,35
"26024","E01022477",2001,637,121,516,39
"26025","E01022478",2001,639,300,339,30
"26026","E01022479",2001,594,292,302,20
"26027","E01022474",2001,610,203,407,28
"26028","E01022563",2001,696,30,666,60
"26029","E01022564",2001,697,130,567,66
"26030","E01022565",2001,643,184,459,35
"26031","E01022514",2001,620,80,540,89
"26032","E01022510",2001,601,26,575,28
"26033","E01022511",2001,505,0,505,41
"26034","E01022512",2001,491,4,487,25
"26035","E01022508",2001,622,6,616,54
"26036","E01022532",2001,517,36,481,46
"26037","E01022533",2001,621,79,542,63
"26038","E01022534",2001,633,98,535,33
"26039","E01022535",2001,655,122,533,67
"26040","E01022581",2001,524,39,485,108
"26041","E01022582",2001,517,12,505,50
"26042","E01022604",2001,492,50,442,92
"26043","E01022605",2001,548,15,533,63
"26044","E01022579",2001,497,208,289,13
"26045","E01022574",2001,602,120,482,57
"26046","E01022575",2001,495,255,240,19
"26047","E01022576",2001,650,275,375,90
"26048","E01022577",2001,652,20,632,61
"26049","E01022578",2001,904,120,784,48
"26050","E01022580",2001,474,5,469,20
"26051","E01022571",2001,447,9,438,64
"26052","E01022572",2001,494,31,463,19
"26053","E01022573",2001,948,57,891,80
"26054","E01022603",2001,512,168,344,50
"26055","E01022634",2001,477,102,375,29
"26056","E01022639",2001,604,136,468,293
"26057","E01022640",2001,487,170,317,63
"26058","E01022598",2001,426,8,418,13
"26059","E01022599",2001,568,81,487,65
"26060","E01022600",2001,599,0,599,31
"26061","E01022601",2001,543,73,470,22
"26062","E01022602",2001,487,3,484,9
"26063","E01022615",2001,884,66,818,32
"26064","E01022641",2001,512,35,477,50
"26065","E01022635",2001,511,199,312,13
"26066","E01022636",2001,501,45,456,17
"26067","E01022633",2001,598,11,587,53
"26068","E01022627",2001,826,53,773,107
"26069","E01022593",2001,477,5,472,28
"26070","E01022594",2001,527,70,457,42
"26071","E01022595",2001,548,25,523,16
"26072","E01022596",2001,512,3,509,16
"26073","E01022591",2001,848,54,794,83
"26074","E01022630",2001,889,88,801,121
"26075","E01022637",2001,465,26,439,64
"26076","E01022638",2001,512,109,403,23
"26077","E01022642",2001,414,8,406,32
"26078","E01022583",2001,653,89,564,50
"26079","E01022584",2001,685,187,498,37
"26080","E01022585",2001,593,17,576,36
"26081","E01022586",2001,598,9,589,48
"26082","E01022587",2001,648,63,585,51
"26083","E01022616",2001,692,216,476,68
"26084","E01022617",2001,596,36,560,50
"26085","E01022618",2001,657,5,652,42
"26086","E01022631",2001,490,37,453,45
"26087","E01022632",2001,451,26,425,33
"26088","E01022619",2001,502,8,494,73
"26089","E01022624",2001,921,7,914,61
"26090","E01022625",2001,786,73,713,53
"26091","E01022592",2001,847,155,692,93
"26092","E01022597",2001,939,91,848,151
"26093","E01022626",2001,1199,178,1021,239
"26094","E01022620",2001,499,89,410,64
"26095","E01022621",2001,506,218,288,16
"26096","E01022622",2001,537,42,495,40
"26097","E01022623",2001,896,128,768,51
"26098","E01022607",2001,501,68,433,27
"26099","E01022608",2001,508,3,505,10
"26100","E01022588",2001,592,5,587,20
"26101","E01022589",2001,720,74,646,70
"26102","E01022590",2001,561,22,539,9
"26103","E01022606",2001,886,24,862,62
"26104","E01022611",2001,594,92,502,22
"26105","E01022613",2001,476,60,416,13
"26106","E01022614",2001,468,121,347,9
"26107","E01022612",2001,613,4,609,23
"26108","E01022628",2001,488,54,434,39
"26109","E01022629",2001,606,42,564,44
"26110","E01022609",2001,469,0,469,15
"26111","E01022610",2001,467,7,460,36
"26112","E01022705",2001,651,7,644,9
"26113","E01022706",2001,635,0,635,10
"26114","E01022707",2001,628,3,625,12
"26115","E01022708",2001,728,6,722,64
"26116","E01022709",2001,621,4,617,36
"26117","E01022675",2001,560,3,557,20
"26118","E01022676",2001,573,32,541,19
"26119","E01022659",2001,615,6,609,35
"26120","E01022660",2001,620,90,530,34
"26121","E01022704",2001,743,10,733,24
"26122","E01022661",2001,732,9,723,29
"26123","E01022662",2001,500,5,495,13
"26124","E01022663",2001,490,11,479,21
"26125","E01022664",2001,630,5,625,47
"26126","E01022665",2001,583,85,498,47
"26127","E01022667",2001,517,26,491,21
"26128","E01022648",2001,566,110,456,42
"26129","E01022672",2001,612,134,478,20
"26130","E01022673",2001,628,87,541,39
"26131","E01022674",2001,606,68,538,36
"26132","E01022646",2001,608,34,574,38
"26133","E01022647",2001,596,12,584,24
"26134","E01022649",2001,606,357,249,18
"26135","E01022650",2001,444,26,418,31
"26136","E01022643",2001,608,56,552,19
"26137","E01022644",2001,493,53,440,18
"26138","E01022668",2001,476,138,338,24
"26139","E01022677",2001,619,256,363,15
"26140","E01022678",2001,603,117,486,30
"26141","E01022680",2001,784,362,422,24
"26142","E01022681",2001,654,279,375,26
"26143","E01022679",2001,650,76,574,67
"26144","E01022669",2001,515,41,474,66
"26145","E01022670",2001,597,259,338,48
"26146","E01022671",2001,658,162,496,80
"26147","E01022666",2001,611,32,579,110
"26148","E01022645",2001,494,4,490,9
"26149","E01022682",2001,503,3,500,11
"26150","E01022683",2001,528,19,509,26
"26151","E01022684",2001,568,0,568,34
"26152","E01022685",2001,512,66,446,35
"26153","E01022686",2001,509,21,488,24
"26154","E01022687",2001,623,11,612,31
"26155","E01022713",2001,661,60,601,42
"26156","E01022714",2001,707,36,671,20
"26157","E01022715",2001,711,63,648,45
"26158","E01022716",2001,721,90,631,86
"26159","E01022717",2001,517,7,510,39
"26160","E01022718",2001,603,51,552,32
"26161","E01022719",2001,623,39,584,26
"26162","E01022691",2001,633,10,623,39
"26163","E01022692",2001,532,38,494,26
"26164","E01022693",2001,536,0,536,25
"26165","E01022694",2001,502,17,485,21
"26166","E01022653",2001,569,30,539,35
"26167","E01022695",2001,577,80,497,40
"26168","E01022700",2001,642,157,485,23
"26169","E01022701",2001,408,52,356,3
"26170","E01022652",2001,733,184,549,23
"26171","E01022703",2001,628,73,555,24
"26172","E01022702",2001,487,9,478,23
"26173","E01022696",2001,626,0,626,16
"26174","E01022697",2001,576,27,549,18
"26175","E01022698",2001,567,5,562,17
"26176","E01022699",2001,621,5,616,30
"26177","E01022651",2001,809,10,799,48
"26178","E01022654",2001,581,39,542,58
"26179","E01022655",2001,557,406,151,16
"26180","E01022656",2001,551,74,477,19
"26181","E01022657",2001,657,63,594,69
"26182","E01022658",2001,652,35,617,51
"26183","E01022710",2001,874,163,711,98
"26184","E01022711",2001,729,317,412,20
"26185","E01022712",2001,628,19,609,51
"26186","E01022688",2001,851,44,807,89
"26187","E01022689",2001,652,26,626,49
"26188","E01022690",2001,768,196,572,101
"26189","E01022758",2001,470,37,433,21
"26190","E01022771",2001,610,3,607,27
"26191","E01022772",2001,616,3,613,31
"26192","E01022773",2001,617,25,592,47
"26193","E01022774",2001,610,11,599,16
"26194","E01022780",2001,423,36,387,40
"26195","E01022753",2001,489,62,427,19
"26196","E01022754",2001,485,41,444,36
"26197","E01022749",2001,516,19,497,13
"26198","E01022787",2001,529,56,473,21
"26199","E01022788",2001,510,49,461,28
"26200","E01022730",2001,634,29,605,12
"26201","E01022731",2001,501,22,479,9
"26202","E01022732",2001,624,300,324,15
"26203","E01022733",2001,617,109,508,27
"26204","E01022734",2001,486,116,370,31
"26205","E01022729",2001,453,14,439,38
"26206","E01022743",2001,753,21,732,17
"26207","E01022725",2001,495,3,492,9
"26208","E01022726",2001,604,34,570,15
"26209","E01022727",2001,648,22,626,17
"26210","E01022720",2001,521,5,516,34
"26211","E01022750",2001,604,5,599,22
"26212","E01022751",2001,582,56,526,17
"26213","E01022752",2001,522,3,519,16
"26214","E01022757",2001,706,24,682,80
"26215","E01022790",2001,617,3,614,32
"26216","E01022791",2001,738,33,705,36
"26217","E01022792",2001,603,58,545,39
"26218","E01022793",2001,640,3,637,20
"26219","E01022755",2001,586,72,514,22
"26220","E01022756",2001,527,6,521,29
"26221","E01022781",2001,572,143,429,69
"26222","E01022782",2001,622,31,591,63
"26223","E01022785",2001,613,56,557,18
"26224","E01022786",2001,524,4,520,9
"26225","E01022789",2001,611,16,595,53
"26226","E01022769",2001,507,24,483,30
"26227","E01022766",2001,536,6,530,18
"26228","E01022737",2001,613,38,575,42
"26229","E01022721",2001,582,11,571,41
"26230","E01022722",2001,588,45,543,28
"26231","E01022723",2001,611,76,535,69
"26232","E01022724",2001,561,35,526,26
"26233","E01022740",2001,708,17,691,18
"26234","E01022741",2001,517,22,495,177
"26235","E01022742",2001,852,7,845,17
"26236","E01022783",2001,605,6,599,15
"26237","E01022784",2001,493,6,487,13
"26238","E01022770",2001,620,7,613,12
"26239","E01022763",2001,636,3,633,10
"26240","E01022765",2001,761,8,753,20
"26241","E01022759",2001,630,17,613,12
"26242","E01022768",2001,604,77,527,22
"26243","E01022728",2001,628,47,581,92
"26244","E01022738",2001,486,192,294,18
"26245","E01022739",2001,625,281,344,26
"26246","E01022735",2001,522,46,476,36
"26247","E01022736",2001,644,96,548,25
"26248","E01022760",2001,634,88,546,15
"26249","E01022761",2001,633,139,494,19
"26250","E01022762",2001,622,8,614,27
"26251","E01022767",2001,514,24,490,11
"26252","E01022764",2001,741,122,619,30
"26253","E01022775",2001,500,3,497,23
"26254","E01022776",2001,605,28,577,23
"26255","E01022777",2001,728,147,581,17
"26256","E01022778",2001,577,16,561,16
"26257","E01022779",2001,405,89,316,16
"26258","E01022744",2001,540,0,540,25
"26259","E01022745",2001,628,3,625,14
"26260","E01022746",2001,624,21,603,66
"26261","E01022747",2001,601,58,543,24
"26262","E01022748",2001,620,3,617,30
"26263","E01022836",2001,639,27,612,11
"26264","E01022800",2001,632,165,467,23
"26265","E01022801",2001,611,215,396,29
"26266","E01022802",2001,601,47,554,28
"26267","E01022803",2001,614,235,379,21
"26268","E01022804",2001,659,113,546,34
"26269","E01022805",2001,643,228,415,46
"26270","E01022834",2001,586,163,423,12
"26271","E01022835",2001,610,102,508,41
"26272","E01022840",2001,637,242,395,12
"26273","E01022823",2001,624,18,606,31
"26274","E01022825",2001,534,3,531,48
"26275","E01022813",2001,537,6,531,23
"26276","E01022814",2001,747,138,609,66
"26277","E01022815",2001,608,6,602,12
"26278","E01022819",2001,605,40,565,165
"26279","E01022820",2001,487,232,255,156
"26280","E01022821",2001,612,97,515,130
"26281","E01022822",2001,499,347,152,21
"26282","E01022841",2001,621,204,417,162
"26283","E01022842",2001,612,138,474,226
"26284","E01022816",2001,614,99,515,41
"26285","E01022817",2001,618,153,465,51
"26286","E01022818",2001,609,254,355,23
"26287","E01022824",2001,526,35,491,59
"26288","E01022807",2001,690,144,546,65
"26289","E01022826",2001,608,9,599,21
"26290","E01022827",2001,732,221,511,23
"26291","E01022828",2001,622,20,602,63
"26292","E01022829",2001,587,29,558,33
"26293","E01022830",2001,622,3,619,30
"26294","E01022808",2001,504,9,495,8
"26295","E01022809",2001,426,30,396,103
"26296","E01022806",2001,583,40,543,57
"26297","E01022832",2001,657,29,628,59
"26298","E01022839",2001,646,237,409,40
"26299","E01022833",2001,742,315,427,65
"26300","E01022843",2001,655,351,304,30
"26301","E01022844",2001,863,395,468,109
"26302","E01022810",2001,624,84,540,70
"26303","E01022811",2001,535,11,524,65
"26304","E01022794",2001,614,9,605,63
"26305","E01022795",2001,717,34,683,62
"26306","E01022796",2001,480,41,439,7
"26307","E01022837",2001,630,8,622,27
"26308","E01022838",2001,513,3,510,13
"26309","E01022845",2001,616,52,564,46
"26310","E01022797",2001,425,20,405,41
"26311","E01022798",2001,480,92,388,18
"26312","E01022799",2001,559,35,524,43
"26313","E01022812",2001,515,13,502,31
"26314","E01022831",2001,615,39,576,49
"26315","E01022890",2001,605,205,400,33
"26316","E01022891",2001,628,30,598,44
"26317","E01022892",2001,775,20,755,38
"26318","E01022893",2001,615,28,587,30
"26319","E01022894",2001,616,110,506,22
"26320","E01022895",2001,744,8,736,45
"26321","E01022896",2001,592,0,592,15
"26322","E01022897",2001,620,0,620,40
"26323","E01022898",2001,602,5,597,12
"26324","E01022859",2001,577,51,526,50
"26325","E01022846",2001,449,19,430,62
"26326","E01022847",2001,655,28,627,55
"26327","E01022848",2001,625,10,615,30
"26328","E01022874",2001,504,24,480,29
"26329","E01022875",2001,493,113,380,30
"26330","E01022876",2001,499,3,496,28
"26331","E01022877",2001,532,28,504,28
"26332","E01022878",2001,684,6,678,32
"26333","E01022879",2001,744,120,624,111
"26334","E01022880",2001,622,184,438,46
"26335","E01022858",2001,423,41,382,56
"26336","E01022860",2001,774,55,719,66
"26337","E01022862",2001,753,55,698,123
"26338","E01022866",2001,641,3,638,107
"26339","E01022867",2001,642,35,607,84
"26340","E01022881",2001,628,147,481,38
"26341","E01022882",2001,570,14,556,61
"26342","E01022883",2001,531,28,503,26
"26343","E01022884",2001,635,101,534,51
"26344","E01022885",2001,512,6,506,45
"26345","E01022865",2001,629,6,623,14
"26346","E01022868",2001,649,14,635,24
"26347","E01022870",2001,530,42,488,25
"26348","E01022863",2001,622,8,614,36
"26349","E01022861",2001,632,0,632,18
"26350","E01022864",2001,628,160,468,28
"26351","E01022871",2001,553,136,417,49
"26352","E01022872",2001,649,24,625,43
"26353","E01022873",2001,628,68,560,13
"26354","E01022887",2001,513,22,491,54
"26355","E01022869",2001,627,53,574,29
"26356","E01022853",2001,718,4,714,40
"26357","E01022849",2001,654,110,544,20
"26358","E01022850",2001,625,3,622,74
"26359","E01022851",2001,641,6,635,37
"26360","E01022852",2001,743,37,706,91
"26361","E01022854",2001,609,24,585,30
"26362","E01022855",2001,478,94,384,30
"26363","E01022856",2001,552,57,495,34
"26364","E01022857",2001,453,50,403,267
"26365","E01022888",2001,626,44,582,83
"26366","E01022889",2001,627,183,444,34
"26367","E01022886",2001,800,103,697,330
"26368","E01022919",2001,603,56,547,27
"26369","E01022932",2001,595,48,547,24
"26370","E01022933",2001,642,359,283,17
"26371","E01022934",2001,666,341,325,12
"26372","E01022923",2001,641,8,633,6
"26373","E01022920",2001,600,13,587,36
"26374","E01022921",2001,644,10,634,18
"26375","E01022918",2001,642,104,538,15
"26376","E01022935",2001,653,67,586,9
"26377","E01022930",2001,745,13,732,10
"26378","E01022931",2001,623,6,617,14
"26379","E01022975",2001,630,17,613,17
"26380","E01022976",2001,655,230,425,15
"26381","E01022971",2001,715,17,698,54
"26382","E01022972",2001,625,6,619,21
"26383","E01022974",2001,596,8,588,29
"26384","E01022922",2001,662,10,652,54
"26385","E01022973",2001,737,170,567,37
"26386","E01022962",2001,608,69,539,19
"26387","E01022959",2001,527,245,282,6
"26388","E01022965",2001,565,257,308,19
"26389","E01022966",2001,489,230,259,11
"26390","E01022967",2001,509,322,187,16
"26391","E01022901",2001,523,171,352,24
"26392","E01022902",2001,525,181,344,7
"26393","E01022960",2001,496,96,400,23
"26394","E01022961",2001,496,90,406,15
"26395","E01022963",2001,621,98,523,34
"26396","E01022964",2001,628,270,358,41
"26397","E01022968",2001,515,316,199,9
"26398","E01022969",2001,474,264,210,7
"26399","E01022903",2001,711,368,343,13
"26400","E01022906",2001,564,259,305,12
"26401","E01022913",2001,531,250,281,10
"26402","E01022914",2001,517,202,315,12
"26403","E01022915",2001,608,315,293,15
"26404","E01022916",2001,623,167,456,11
"26405","E01022917",2001,497,230,267,7
"26406","E01022908",2001,567,170,397,14
"26407","E01022904",2001,748,230,518,14
"26408","E01022905",2001,715,403,312,57
"26409","E01022900",2001,719,282,437,22
"26410","E01022970",2001,508,223,285,12
"26411","E01022947",2001,618,7,611,14
"26412","E01022948",2001,627,24,603,28
"26413","E01022949",2001,763,392,371,16
"26414","E01022950",2001,580,3,577,15
"26415","E01022951",2001,555,25,530,13
"26416","E01022952",2001,638,13,625,32
"26417","E01022907",2001,624,82,542,15
"26418","E01022909",2001,605,24,581,18
"26419","E01022910",2001,642,67,575,61
"26420","E01022911",2001,604,64,540,25
"26421","E01022912",2001,543,6,537,10
"26422","E01022899",2001,482,138,344,21
"26423","E01022924",2001,626,73,553,30
"26424","E01022925",2001,588,66,522,18
"26425","E01022926",2001,601,37,564,51
"26426","E01022927",2001,717,201,516,27
"26427","E01022928",2001,801,17,784,32
"26428","E01022929",2001,792,60,732,139
"26429","E01022953",2001,754,93,661,148
"26430","E01022954",2001,663,7,656,45
"26431","E01022955",2001,603,22,581,31
"26432","E01022956",2001,486,107,379,14
"26433","E01022957",2001,510,95,415,28
"26434","E01022958",2001,610,3,607,33
"26435","E01022937",2001,572,137,435,35
"26436","E01022943",2001,639,3,636,20
"26437","E01022944",2001,538,15,523,25
"26438","E01022946",2001,728,20,708,56
"26439","E01022942",2001,783,207,576,121
"26440","E01022945",2001,976,22,954,85
"26441","E01022940",2001,663,81,582,67
"26442","E01022941",2001,649,6,643,38
"26443","E01022938",2001,580,6,574,62
"26444","E01022939",2001,634,60,574,36
"26445","E01022936",2001,691,35,656,135
"26446","E01023011",2001,596,86,510,99
"26447","E01023012",2001,603,45,558,105
"26448","E01023021",2001,596,12,584,36
"26449","E01023022",2001,741,114,627,124
"26450","E01023023",2001,739,177,562,44
"26451","E01023024",2001,618,3,615,26
"26452","E01023025",2001,595,3,592,38
"26453","E01023076",2001,629,20,609,33
"26454","E01023082",2001,606,64,542,24
"26455","E01023083",2001,624,205,419,19
"26456","E01023088",2001,610,200,410,11
"26457","E01023089",2001,705,22,683,42
"26458","E01023090",2001,794,58,736,52
"26459","E01023080",2001,510,16,494,17
"26460","E01023081",2001,487,61,426,12
"26461","E01023073",2001,496,3,493,20
"26462","E01023074",2001,545,9,536,52
"26463","E01023077",2001,618,121,497,104
"26464","E01023078",2001,628,30,598,42
"26465","E01023079",2001,602,86,516,47
"26466","E01023085",2001,622,177,445,56
"26467","E01023086",2001,642,114,528,19
"26468","E01023087",2001,612,11,601,51
"26469","E01023084",2001,622,15,607,29
"26470","E01023075",2001,470,64,406,13
"26471","E01023072",2001,543,7,536,26
"26472","E01022977",2001,610,13,597,31
"26473","E01022978",2001,606,10,596,45
"26474","E01022979",2001,482,51,431,20
"26475","E01022980",2001,526,5,521,39
"26476","E01022992",2001,470,3,467,35
"26477","E01022993",2001,529,35,494,65
"26478","E01023045",2001,723,18,705,44
"26479","E01023046",2001,644,145,499,77
"26480","E01023047",2001,527,7,520,34
"26481","E01023048",2001,503,62,441,14
"26482","E01023049",2001,518,41,477,51
"26483","E01023050",2001,500,16,484,92
"26484","E01023007",2001,499,29,470,30
"26485","E01023010",2001,593,136,457,42
"26486","E01023008",2001,797,77,720,88
"26487","E01023009",2001,622,17,605,46
"26488","E01023038",2001,626,3,623,22
"26489","E01023039",2001,633,66,567,40
"26490","E01023040",2001,659,0,659,32
"26491","E01023066",2001,649,59,590,16
"26492","E01023067",2001,623,15,608,17
"26493","E01023062",2001,567,26,541,25
"26494","E01023064",2001,530,25,505,32
"26495","E01023026",2001,475,7,468,65
"26496","E01023028",2001,799,111,688,80
"26497","E01023003",2001,688,86,602,20
"26498","E01023004",2001,689,46,643,26
"26499","E01023005",2001,586,0,586,10
"26500","E01023006",2001,480,240,240,16
"26501","E01023037",2001,728,300,428,26
"26502","E01023065",2001,626,131,495,23
"26503","E01023068",2001,510,165,345,18
"26504","E01023069",2001,648,48,600,43
"26505","E01023070",2001,822,100,722,124
"26506","E01023071",2001,584,16,568,102
"26507","E01023029",2001,614,432,182,14
"26508","E01023030",2001,485,9,476,28
"26509","E01023032",2001,524,18,506,11
"26510","E01023033",2001,493,108,385,18
"26511","E01023031",2001,522,6,516,44
"26512","E01023027",2001,488,90,398,54
"26513","E01023013",2001,607,53,554,20
"26514","E01023014",2001,646,17,629,37
"26515","E01023015",2001,582,52,530,84
"26516","E01023016",2001,610,3,607,19
"26517","E01022998",2001,675,7,668,34
"26518","E01023000",2001,714,87,627,65
"26519","E01022991",2001,882,9,873,77
"26520","E01022989",2001,674,87,587,18
"26521","E01022994",2001,628,14,614,27
"26522","E01022995",2001,589,9,580,29
"26523","E01022996",2001,521,57,464,57
"26524","E01022997",2001,594,56,538,51
"26525","E01023063",2001,452,21,431,85
"26526","E01023041",2001,712,63,649,61
"26527","E01023042",2001,754,95,659,158
"26528","E01023043",2001,742,19,723,99
"26529","E01022990",2001,627,56,571,60
"26530","E01022999",2001,912,85,827,205
"26531","E01023034",2001,728,61,667,45
"26532","E01023035",2001,706,39,667,25
"26533","E01023036",2001,851,8,843,36
"26534","E01022984",2001,643,3,640,49
"26535","E01022985",2001,527,4,523,19
"26536","E01023020",2001,630,6,624,18
"26537","E01023058",2001,618,296,322,16
"26538","E01023060",2001,568,11,557,21
"26539","E01023061",2001,611,194,417,34
"26540","E01023001",2001,777,15,762,113
"26541","E01023002",2001,655,168,487,51
"26542","E01023017",2001,636,151,485,12
"26543","E01023018",2001,613,194,419,22
"26544","E01023019",2001,646,111,535,77
"26545","E01023055",2001,486,216,270,22
"26546","E01023056",2001,764,81,683,50
"26547","E01023057",2001,781,39,742,108
"26548","E01023054",2001,731,50,681,73
"26549","E01022986",2001,603,7,596,14
"26550","E01022988",2001,633,176,457,55
"26551","E01022987",2001,828,6,822,31
"26552","E01022981",2001,859,4,855,22
"26553","E01022982",2001,845,57,788,59
"26554","E01022983",2001,762,4,758,31
"26555","E01023059",2001,740,42,698,39
"26556","E01023044",2001,500,9,491,18
"26557","E01023051",2001,636,43,593,54
"26558","E01023052",2001,822,7,815,47
"26559","E01023053",2001,804,6,798,77
"26560","E01023099",2001,644,169,475,23
"26561","E01023104",2001,614,175,439,16
"26562","E01023106",2001,579,196,383,24
"26563","E01023121",2001,780,173,607,20
"26564","E01023122",2001,523,152,371,33
"26565","E01023119",2001,487,300,187,11
"26566","E01023120",2001,622,202,420,26
"26567","E01023146",2001,501,154,347,13
"26568","E01023105",2001,631,276,355,18
"26569","E01023100",2001,527,54,473,30
"26570","E01023101",2001,500,10,490,16
"26571","E01023102",2001,602,8,594,30
"26572","E01023147",2001,614,27,587,21
"26573","E01023134",2001,727,36,691,36
"26574","E01023103",2001,627,24,603,47
"26575","E01023096",2001,634,10,624,30
"26576","E01023097",2001,628,9,619,52
"26577","E01023111",2001,594,55,539,22
"26578","E01023112",2001,561,3,558,30
"26579","E01023092",2001,638,4,634,22
"26580","E01023093",2001,587,4,583,21
"26581","E01023135",2001,615,71,544,67
"26582","E01023132",2001,599,109,490,27
"26583","E01023133",2001,644,27,617,35
"26584","E01023148",2001,626,24,602,39
"26585","E01023149",2001,593,20,573,13
"26586","E01023094",2001,631,17,614,44
"26587","E01023095",2001,638,95,543,87
"26588","E01023091",2001,647,266,381,80
"26589","E01023098",2001,741,55,686,77
"26590","E01023113",2001,627,40,587,99
"26591","E01023114",2001,568,42,526,43
"26592","E01023136",2001,623,52,571,199
"26593","E01023137",2001,507,36,471,56
"26594","E01023138",2001,663,115,548,102
"26595","E01023139",2001,534,122,412,45
"26596","E01023140",2001,482,107,375,275
"26597","E01023141",2001,485,45,440,377
"26598","E01023142",2001,491,101,390,251
"26599","E01023143",2001,484,114,370,264
"26600","E01023144",2001,620,62,558,155
"26601","E01023124",2001,506,28,478,55
"26602","E01023125",2001,500,25,475,17
"26603","E01023126",2001,481,372,109,16
"26604","E01023127",2001,607,68,539,70
"26605","E01023118",2001,646,75,571,88
"26606","E01023128",2001,601,114,487,27
"26607","E01023129",2001,598,46,552,90
"26608","E01023130",2001,610,28,582,19
"26609","E01023131",2001,635,104,531,46
"26610","E01023145",2001,787,86,701,162
"26611","E01023109",2001,629,3,626,57
"26612","E01023115",2001,495,0,495,23
"26613","E01023116",2001,650,18,632,114
"26614","E01023117",2001,628,5,623,33
"26615","E01023107",2001,577,244,333,11
"26616","E01023108",2001,619,370,249,8
"26617","E01023110",2001,614,206,408,19
"26618","E01023123",2001,637,28,609,59
"26619","E01023169",2001,834,40,794,38
"26620","E01023165",2001,846,103,743,120
"26621","E01023181",2001,500,28,472,20
"26622","E01023182",2001,527,65,462,17
"26623","E01023153",2001,748,212,536,63
"26624","E01023154",2001,616,298,318,19
"26625","E01023156",2001,469,258,211,15
"26626","E01023157",2001,542,231,311,19
"26627","E01023205",2001,460,196,264,12
"26628","E01023201",2001,613,141,472,16
"26629","E01023202",2001,909,363,546,145
"26630","E01023215",2001,631,112,519,32
"26631","E01023219",2001,612,167,445,33
"26632","E01023155",2001,587,212,375,34
"26633","E01023183",2001,524,124,400,20
"26634","E01023179",2001,626,151,475,46
"26635","E01023190",2001,538,94,444,58
"26636","E01023203",2001,655,70,585,39
"26637","E01023204",2001,617,161,456,89
"26638","E01023196",2001,657,91,566,76
"26639","E01023186",2001,630,104,526,35
"26640","E01023189",2001,604,29,575,144
"26641","E01023180",2001,624,60,564,67
"26642","E01023161",2001,902,113,789,86
"26643","E01023187",2001,531,10,521,54
"26644","E01023188",2001,508,25,483,34
"26645","E01023216",2001,648,106,542,116
"26646","E01023217",2001,663,13,650,59
"26647","E01023218",2001,631,13,618,28
"26648","E01023197",2001,577,84,493,118
"26649","E01023198",2001,585,78,507,56
"26650","E01023195",2001,557,78,479,155
"26651","E01023159",2001,891,92,799,99
"26652","E01023160",2001,572,30,542,47
"26653","E01023168",2001,617,36,581,58
"26654","E01023178",2001,894,111,783,169
"26655","E01023177",2001,849,133,716,121
"26656","E01023184",2001,487,21,466,93
"26657","E01023185",2001,468,103,365,24
"26658","E01023166",2001,628,74,554,86
"26659","E01023167",2001,671,82,589,89
"26660","E01023174",2001,724,21,703,68
"26661","E01023175",2001,612,6,606,29
"26662","E01023176",2001,735,139,596,49
"26663","E01023207",2001,643,8,635,21
"26664","E01023208",2001,486,111,375,23
"26665","E01023209",2001,526,3,523,33
"26666","E01023206",2001,496,105,391,32
"26667","E01023150",2001,653,110,543,77
"26668","E01023151",2001,638,232,406,72
"26669","E01023152",2001,765,103,662,90
"26670","E01023158",2001,872,21,851,93
"26671","E01023191",2001,685,14,671,42
"26672","E01023192",2001,702,291,411,23
"26673","E01023193",2001,621,27,594,27
"26674","E01023194",2001,646,7,639,14
"26675","E01023200",2001,595,9,586,34
"26676","E01023199",2001,659,97,562,109
"26677","E01023162",2001,615,32,583,44
"26678","E01023163",2001,637,0,637,42
"26679","E01023164",2001,636,79,557,47
"26680","E01023210",2001,522,3,519,19
"26681","E01023211",2001,622,75,547,38
"26682","E01023212",2001,566,0,566,32
"26683","E01023213",2001,494,24,470,23
"26684","E01023214",2001,530,6,524,22
"26685","E01023170",2001,660,100,560,81
"26686","E01023171",2001,552,16,536,46
"26687","E01023172",2001,618,10,608,21
"26688","E01023173",2001,589,4,585,22
"26689","E01023286",2001,539,85,454,87
"26690","E01023287",2001,1027,34,993,222
"26691","E01023288",2001,492,41,451,82
"26692","E01023236",2001,797,51,746,137
"26693","E01023237",2001,495,241,254,4
"26694","E01023238",2001,532,12,520,14
"26695","E01023239",2001,605,27,578,37
"26696","E01023240",2001,889,60,829,122
"26697","E01023241",2001,493,20,473,25
"26698","E01023248",2001,605,7,598,12
"26699","E01023253",2001,659,116,543,32
"26700","E01023274",2001,615,73,542,101
"26701","E01023278",2001,642,49,593,26
"26702","E01023279",2001,611,22,589,42
"26703","E01023280",2001,586,77,509,67
"26704","E01023281",2001,735,168,567,59
"26705","E01023225",2001,833,73,760,172
"26706","E01023247",2001,613,126,487,26
"26707","E01023268",2001,486,14,472,65
"26708","E01023269",2001,462,20,442,60
"26709","E01023270",2001,477,100,377,53
"26710","E01023249",2001,508,146,362,22
"26711","E01023250",2001,617,253,364,19
"26712","E01023251",2001,610,290,320,94
"26713","E01023255",2001,722,292,430,72
"26714","E01023256",2001,678,411,267,62
"26715","E01023257",2001,696,248,448,81
"26716","E01023258",2001,530,222,308,47
"26717","E01023254",2001,713,135,578,107
"26718","E01023263",2001,518,51,467,101
"26719","E01023264",2001,638,113,525,175
"26720","E01023265",2001,772,156,616,116
"26721","E01023252",2001,756,185,571,235
"26722","E01023267",2001,514,83,431,124
"26723","E01023260",2001,509,341,168,42
"26724","E01023261",2001,634,359,275,62
"26725","E01023262",2001,501,219,282,48
"26726","E01023266",2001,501,104,397,58
"26727","E01023259",2001,540,91,449,31
"26728","E01023242",2001,515,9,506,55
"26729","E01023243",2001,623,11,612,132
"26730","E01023244",2001,641,14,627,30
"26731","E01023229",2001,756,108,648,85
"26732","E01023230",2001,702,5,697,57
"26733","E01023226",2001,613,73,540,72
"26734","E01023227",2001,685,204,481,27
"26735","E01023228",2001,903,6,897,43
"26736","E01023246",2001,553,61,492,49
"26737","E01023235",2001,811,85,726,92
"26738","E01023275",2001,545,82,463,40
"26739","E01023276",2001,511,8,503,18
"26740","E01023277",2001,468,12,456,27
"26741","E01023282",2001,765,91,674,100
"26742","E01023272",2001,523,6,517,23
"26743","E01023273",2001,535,20,515,24
"26744","E01023220",2001,766,27,739,48
"26745","E01023221",2001,756,160,596,40
"26746","E01023222",2001,560,4,556,56
"26747","E01023223",2001,569,191,378,13
"26748","E01023245",2001,821,48,773,53
"26749","E01023271",2001,426,48,378,34
"26750","E01023283",2001,916,26,890,87
"26751","E01023284",2001,486,19,467,48
"26752","E01023285",2001,640,212,428,42
"26753","E01023224",2001,484,49,435,202
"26754","E01023231",2001,587,7,580,14
"26755","E01023232",2001,578,6,572,38
"26756","E01023233",2001,627,15,612,20
"26757","E01023234",2001,632,174,458,29
"26758","E01023987",2001,427,81,346,32
"26759","E01023988",2001,543,18,525,78
"26760","E01023982",2001,762,120,642,55
"26761","E01024040",2001,496,177,319,52
"26762","E01024041",2001,511,15,496,87
"26763","E01024033",2001,688,82,606,53
"26764","E01024035",2001,444,42,402,30
"26765","E01023985",2001,499,29,470,38
"26766","E01023986",2001,520,152,368,40
"26767","E01023989",2001,445,17,428,12
"26768","E01023990",2001,510,126,384,65
"26769","E01023983",2001,587,0,587,25
"26770","E01023999",2001,905,22,883,63
"26771","E01024000",2001,802,141,661,18
"26772","E01024021",2001,647,74,573,124
"26773","E01024022",2001,621,102,519,25
"26774","E01023984",2001,487,196,291,27
"26775","E01023980",2001,513,93,420,19
"26776","E01023981",2001,502,185,317,18
"26777","E01023991",2001,490,7,483,37
"26778","E01023992",2001,525,91,434,70
"26779","E01023993",2001,524,7,517,36
"26780","E01023973",2001,641,334,307,41
"26781","E01024023",2001,952,157,795,109
"26782","E01024027",2001,605,70,535,152
"26783","E01024029",2001,907,197,710,40
"26784","E01024002",2001,505,24,481,76
"26785","E01024003",2001,712,42,670,25
"26786","E01024004",2001,613,8,605,52
"26787","E01024005",2001,615,54,561,51
"26788","E01023972",2001,497,195,302,18
"26789","E01023995",2001,478,11,467,20
"26790","E01023996",2001,477,9,468,38
"26791","E01023977",2001,528,17,511,49
"26792","E01023974",2001,516,192,324,26
"26793","E01023975",2001,614,256,358,18
"26794","E01024016",2001,638,4,634,106
"26795","E01024017",2001,457,44,413,61
"26796","E01024028",2001,698,338,360,26
"26797","E01024019",2001,489,198,291,30
"26798","E01024020",2001,627,360,267,25
"26799","E01024030",2001,863,124,739,52
"26800","E01023976",2001,640,264,376,17
"26801","E01024018",2001,844,154,690,72
"26802","E01024001",2001,618,216,402,39
"26803","E01024006",2001,449,0,449,16
"26804","E01024007",2001,482,3,479,24
"26805","E01024008",2001,456,7,449,21
"26806","E01024013",2001,660,90,570,44
"26807","E01024014",2001,612,12,600,37
"26808","E01024015",2001,643,16,627,47
"26809","E01024034",2001,748,41,707,68
"26810","E01024036",2001,480,61,419,15
"26811","E01024032",2001,569,63,506,27
"26812","E01023978",2001,507,5,502,33
"26813","E01023979",2001,500,113,387,15
"26814","E01023994",2001,725,77,648,66
"26815","E01024031",2001,579,75,504,56
"26816","E01024038",2001,775,66,709,43
"26817","E01024039",2001,549,35,514,15
"26818","E01024024",2001,1020,148,872,66
"26819","E01024025",2001,506,140,366,42
"26820","E01024009",2001,457,20,437,48
"26821","E01024010",2001,546,114,432,47
"26822","E01024011",2001,493,22,471,32
"26823","E01024012",2001,477,68,409,13
"26824","E01024026",2001,496,50,446,15
"26825","E01024037",2001,685,67,618,45
"26826","E01023997",2001,566,108,458,41
"26827","E01023998",2001,475,73,402,22
"26828","E01024080",2001,607,53,554,241
"26829","E01024081",2001,753,146,607,241
"26830","E01024082",2001,602,30,572,141
"26831","E01024078",2001,761,20,741,314
"26832","E01024095",2001,604,8,596,127
"26833","E01024096",2001,626,17,609,41
"26834","E01024097",2001,748,113,635,35
"26835","E01024098",2001,642,4,638,27
"26836","E01024094",2001,681,9,672,28
"26837","E01024118",2001,747,31,716,74
"26838","E01024079",2001,619,6,613,36
"26839","E01024083",2001,613,242,371,44
"26840","E01024064",2001,656,17,639,44
"26841","E01024066",2001,607,188,419,25
"26842","E01024065",2001,772,6,766,47
"26843","E01024059",2001,710,226,484,45
"26844","E01024119",2001,593,148,445,42
"26845","E01024120",2001,736,5,731,38
"26846","E01024117",2001,633,14,619,39
"26847","E01024114",2001,747,3,744,56
"26848","E01024115",2001,630,4,626,24
"26849","E01024056",2001,724,0,724,19
"26850","E01024057",2001,759,0,759,34
"26851","E01024058",2001,630,3,627,48
"26852","E01024073",2001,619,8,611,26
"26853","E01024074",2001,521,0,521,15
"26854","E01024075",2001,625,47,578,28
"26855","E01024076",2001,635,7,628,48
"26856","E01024077",2001,510,6,504,32
"26857","E01024061",2001,618,346,272,37
"26858","E01024055",2001,682,12,670,29
"26859","E01024116",2001,607,22,585,65
"26860","E01024071",2001,615,94,521,54
"26861","E01024063",2001,626,3,623,34
"26862","E01024072",2001,638,11,627,205
"26863","E01024106",2001,656,10,646,58
"26864","E01024060",2001,633,17,616,112
"26865","E01024069",2001,610,34,576,117
"26866","E01024070",2001,729,61,668,180
"26867","E01024062",2001,517,22,495,40
"26868","E01024107",2001,508,7,501,20
"26869","E01024108",2001,496,160,336,27
"26870","E01024109",2001,680,6,674,24
"26871","E01024105",2001,658,4,654,23
"26872","E01024084",2001,444,121,323,28
"26873","E01024085",2001,621,33,588,70
"26874","E01024086",2001,572,119,453,43
"26875","E01024087",2001,463,20,443,35
"26876","E01024091",2001,510,204,306,45
"26877","E01024110",2001,547,16,531,47
"26878","E01024111",2001,593,180,413,37
"26879","E01024112",2001,660,3,657,24
"26880","E01024113",2001,530,45,485,41
"26881","E01024123",2001,611,34,577,56
"26882","E01024067",2001,437,6,431,42
"26883","E01024068",2001,607,42,565,56
"26884","E01024050",2001,693,42,651,47
"26885","E01024051",2001,449,31,418,231
"26886","E01024099",2001,562,218,344,105
"26887","E01024100",2001,506,56,450,102
"26888","E01024101",2001,575,91,484,114
"26889","E01024102",2001,636,47,589,116
"26890","E01024103",2001,583,285,298,82
"26891","E01024092",2001,627,252,375,154
"26892","E01024093",2001,611,285,326,110
"26893","E01024090",2001,642,218,424,111
"26894","E01024049",2001,518,280,238,35
"26895","E01024047",2001,504,187,317,218
"26896","E01024104",2001,750,35,715,196
"26897","E01024124",2001,488,21,467,174
"26898","E01024125",2001,752,118,634,218
"26899","E01024126",2001,509,211,298,38
"26900","E01024128",2001,632,280,352,96
"26901","E01024129",2001,659,67,592,193
"26902","E01024130",2001,735,215,520,91
"26903","E01024121",2001,623,22,601,162
"26904","E01024122",2001,625,175,450,70
"26905","E01024131",2001,659,12,647,126
"26906","E01024048",2001,506,148,358,126
"26907","E01024044",2001,740,42,698,207
"26908","E01024045",2001,635,57,578,73
"26909","E01024046",2001,659,65,594,83
"26910","E01024052",2001,598,221,377,30
"26911","E01024053",2001,710,4,706,92
"26912","E01024054",2001,705,54,651,70
"26913","E01024127",2001,644,46,598,32
"26914","E01024088",2001,602,45,557,104
"26915","E01024089",2001,450,16,434,53
"26916","E01024042",2001,493,71,422,37
"26917","E01024043",2001,531,12,519,33
"26918","E01024148",2001,857,524,333,27
"26919","E01024149",2001,865,296,569,25
"26920","E01024154",2001,515,233,282,16
"26921","E01024155",2001,590,315,275,15
"26922","E01024179",2001,745,165,580,126
"26923","E01024143",2001,471,22,449,27
"26924","E01024140",2001,564,21,543,67
"26925","E01024141",2001,596,44,552,43
"26926","E01024180",2001,655,41,614,124
"26927","E01024181",2001,450,13,437,48
"26928","E01024182",2001,615,107,508,128
"26929","E01024183",2001,505,15,490,30
"26930","E01024184",2001,502,11,491,37
"26931","E01024185",2001,600,37,563,71
"26932","E01024176",2001,746,157,589,71
"26933","E01024177",2001,620,350,270,21
"26934","E01024178",2001,592,169,423,24
"26935","E01024142",2001,637,193,444,83
"26936","E01024156",2001,766,84,682,155
"26937","E01024161",2001,770,43,727,81
"26938","E01024162",2001,748,34,714,141
"26939","E01024163",2001,664,24,640,58
"26940","E01024164",2001,765,18,747,143
"26941","E01024169",2001,631,206,425,54
"26942","E01024170",2001,641,279,362,42
"26943","E01024171",2001,595,115,480,85
"26944","E01024172",2001,846,64,782,260
"26945","E01024186",2001,517,7,510,31
"26946","E01024144",2001,535,6,529,18
"26947","E01024145",2001,579,3,576,25
"26948","E01024146",2001,529,8,521,16
"26949","E01024147",2001,635,15,620,24
"26950","E01024133",2001,469,16,453,29
"26951","E01024136",2001,656,35,621,109
"26952","E01024137",2001,505,4,501,34
"26953","E01024138",2001,591,90,501,30
"26954","E01024139",2001,697,14,683,14
"26955","E01024165",2001,638,399,239,17
"26956","E01024166",2001,600,244,356,28
"26957","E01024167",2001,718,139,579,81
"26958","E01024168",2001,493,115,378,26
"26959","E01024150",2001,632,6,626,16
"26960","E01024151",2001,610,6,604,10
"26961","E01024152",2001,472,48,424,35
"26962","E01024153",2001,525,12,513,3
"26963","E01024173",2001,681,32,649,28
"26964","E01024187",2001,407,27,380,8
"26965","E01024188",2001,508,39,469,10
"26966","E01024189",2001,627,117,510,16
"26967","E01024174",2001,481,141,340,18
"26968","E01024175",2001,502,54,448,26
"26969","E01024134",2001,651,123,528,38
"26970","E01024135",2001,511,172,339,52
"26971","E01024132",2001,493,141,352,9
"26972","E01024157",2001,654,73,581,34
"26973","E01024158",2001,600,73,527,37
"26974","E01024159",2001,620,9,611,9
"26975","E01024160",2001,554,3,551,9
"26976","E01024206",2001,642,87,555,51
"26977","E01024207",2001,597,32,565,83
"26978","E01024208",2001,627,144,483,74
"26979","E01024209",2001,680,55,625,75
"26980","E01024202",2001,700,180,520,39
"26981","E01024242",2001,687,25,662,51
"26982","E01024243",2001,726,203,523,26
"26983","E01024244",2001,864,56,808,165
"26984","E01024245",2001,702,54,648,56
"26985","E01024229",2001,726,158,568,69
"26986","E01024219",2001,530,93,437,18
"26987","E01024220",2001,675,29,646,54
"26988","E01024221",2001,623,9,614,35
"26989","E01024227",2001,633,62,571,117
"26990","E01024228",2001,763,45,718,157
"26991","E01024230",2001,752,26,726,118
"26992","E01024231",2001,705,19,686,189
"26993","E01024252",2001,868,8,860,202
"26994","E01024225",2001,637,41,596,58
"26995","E01024226",2001,621,149,472,23
"26996","E01024217",2001,648,101,547,69
"26997","E01024223",2001,580,127,453,21
"26998","E01024201",2001,579,35,544,71
"26999","E01024204",2001,625,167,458,34
"27000","E01024190",2001,528,86,442,77
"27001","E01024191",2001,672,141,531,21
"27002","E01024192",2001,631,298,333,21
"27003","E01024222",2001,619,176,443,57
"27004","E01024224",2001,627,69,558,34
"27005","E01024218",2001,500,176,324,42
"27006","E01024250",2001,754,122,632,43
"27007","E01024251",2001,714,148,566,57
"27008","E01024255",2001,644,32,612,21
"27009","E01024205",2001,594,91,503,27
"27010","E01024200",2001,673,29,644,62
"27011","E01024203",2001,602,20,582,61
"27012","E01024232",2001,862,67,795,40
"27013","E01024236",2001,704,76,628,61
"27014","E01024237",2001,708,27,681,42
"27015","E01024253",2001,729,6,723,45
"27016","E01024254",2001,497,123,374,26
"27017","E01024233",2001,641,7,634,16
"27018","E01024235",2001,631,28,603,45
"27019","E01024256",2001,626,29,597,13
"27020","E01024210",2001,523,41,482,38
"27021","E01024211",2001,406,3,403,20
"27022","E01024193",2001,649,310,339,45
"27023","E01024194",2001,625,63,562,91
"27024","E01024195",2001,518,140,378,20
"27025","E01024196",2001,616,312,304,20
"27026","E01024197",2001,642,143,499,57
"27027","E01024248",2001,716,240,476,88
"27028","E01024240",2001,607,357,250,44
"27029","E01024241",2001,725,142,583,119
"27030","E01024247",2001,750,184,566,176
"27031","E01024238",2001,466,62,404,172
"27032","E01024239",2001,778,160,618,129
"27033","E01024199",2001,1121,213,908,249
"27034","E01024214",2001,623,101,522,105
"27035","E01024215",2001,538,43,495,167
"27036","E01024216",2001,596,10,586,67
"27037","E01024246",2001,745,96,649,183
"27038","E01024249",2001,862,428,434,70
"27039","E01024234",2001,537,28,509,24
"27040","E01024212",2001,608,30,578,60
"27041","E01024213",2001,564,0,564,25
"27042","E01024198",2001,953,62,891,44
"27043","E01024276",2001,542,23,519,63
"27044","E01024277",2001,770,293,477,102
"27045","E01024278",2001,848,427,421,75
"27046","E01024279",2001,649,98,551,92
"27047","E01024289",2001,921,129,792,314
"27048","E01024290",2001,516,48,468,86
"27049","E01024291",2001,724,125,599,145
"27050","E01024295",2001,815,297,518,157
"27051","E01024257",2001,722,262,460,165
"27052","E01024258",2001,601,60,541,91
"27053","E01024261",2001,950,23,927,92
"27054","E01024296",2001,767,128,639,97
"27055","E01024293",2001,549,59,490,48
"27056","E01024294",2001,555,268,287,28
"27057","E01024282",2001,511,19,492,88
"27058","E01024283",2001,496,37,459,31
"27059","E01024284",2001,611,69,542,92
"27060","E01024262",2001,721,174,547,59
"27061","E01024263",2001,619,320,299,21
"27062","E01024259",2001,553,6,547,23
"27063","E01024260",2001,743,38,705,81
"27064","E01024292",2001,516,24,492,74
"27065","E01024317",2001,648,79,569,52
"27066","E01024318",2001,648,16,632,62
"27067","E01024313",2001,599,68,531,40
"27068","E01024287",2001,675,250,425,12
"27069","E01024288",2001,500,12,488,5
"27070","E01024285",2001,542,83,459,16
"27071","E01024280",2001,500,237,263,20
"27072","E01024281",2001,539,74,465,32
"27073","E01024308",2001,636,370,266,12
"27074","E01024314",2001,486,28,458,29
"27075","E01024315",2001,629,232,397,23
"27076","E01024310",2001,654,235,419,13
"27077","E01024311",2001,491,187,304,16
"27078","E01024312",2001,485,81,404,32
"27079","E01024309",2001,474,180,294,7
"27080","E01024297",2001,578,8,570,16
"27081","E01024298",2001,546,9,537,11
"27082","E01024299",2001,555,5,550,24
"27083","E01024286",2001,635,42,593,16
"27084","E01024264",2001,618,275,343,12
"27085","E01024316",2001,564,7,557,43
"27086","E01024319",2001,558,132,426,11
"27087","E01024265",2001,502,10,492,18
"27088","E01024266",2001,481,141,340,9
"27089","E01024267",2001,593,42,551,23
"27090","E01024300",2001,563,15,548,16
"27091","E01024301",2001,521,64,457,32
"27092","E01024303",2001,679,99,580,53
"27093","E01024304",2001,619,148,471,20
"27094","E01024305",2001,577,334,243,10
"27095","E01024306",2001,521,350,171,7
"27096","E01024307",2001,642,201,441,10
"27097","E01024268",2001,627,0,627,17
"27098","E01024269",2001,757,14,743,27
"27099","E01024270",2001,586,7,579,17
"27100","E01024271",2001,566,92,474,28
"27101","E01024272",2001,587,21,566,13
"27102","E01024273",2001,515,3,512,31
"27103","E01024274",2001,595,24,571,17
"27104","E01024275",2001,529,8,521,19
"27105","E01024302",2001,575,75,500,29
"27106","E01024333",2001,509,9,500,32
"27107","E01024334",2001,415,6,409,16
"27108","E01024335",2001,553,21,532,50
"27109","E01024347",2001,607,38,569,43
"27110","E01024338",2001,505,3,502,14
"27111","E01024353",2001,644,3,641,29
"27112","E01024354",2001,608,0,608,37
"27113","E01024355",2001,750,17,733,93
"27114","E01024385",2001,622,83,539,10
"27115","E01024386",2001,640,23,617,56
"27116","E01024341",2001,603,6,597,25
"27117","E01024320",2001,490,3,487,5
"27118","E01024321",2001,626,0,626,9
"27119","E01024322",2001,499,3,496,16
"27120","E01024323",2001,596,9,587,25
"27121","E01024324",2001,617,3,614,23
"27122","E01024370",2001,899,276,623,168
"27123","E01024352",2001,744,225,519,112
"27124","E01024382",2001,542,36,506,138
"27125","E01024383",2001,614,73,541,160
"27126","E01024384",2001,733,205,528,33
"27127","E01024351",2001,644,52,592,34
"27128","E01024348",2001,507,3,504,27
"27129","E01024336",2001,589,8,581,37
"27130","E01024337",2001,600,3,597,28
"27131","E01024330",2001,601,0,601,12
"27132","E01024339",2001,751,114,637,168
"27133","E01024340",2001,623,15,608,116
"27134","E01024356",2001,613,22,591,140
"27135","E01024359",2001,749,63,686,172
"27136","E01024373",2001,621,118,503,71
"27137","E01024349",2001,592,7,585,58
"27138","E01024326",2001,765,8,757,20
"27139","E01024327",2001,641,17,624,17
"27140","E01024328",2001,622,52,570,39
"27141","E01024329",2001,627,4,623,16
"27142","E01024367",2001,514,62,452,59
"27143","E01024368",2001,596,158,438,119
"27144","E01024369",2001,618,6,612,50
"27145","E01024357",2001,603,36,567,107
"27146","E01024358",2001,739,285,454,47
"27147","E01024360",2001,623,46,577,52
"27148","E01024374",2001,480,239,241,22
"27149","E01024372",2001,647,50,597,131
"27150","E01024403",2001,587,26,561,30
"27151","E01024401",2001,599,69,530,48
"27152","E01024395",2001,497,143,354,10
"27153","E01024396",2001,621,224,397,9
"27154","E01024392",2001,598,181,417,13
"27155","E01024393",2001,534,125,409,22
"27156","E01024371",2001,645,75,570,25
"27157","E01024361",2001,698,104,594,29
"27158","E01024362",2001,664,54,610,84
"27159","E01024363",2001,696,68,628,55
"27160","E01024387",2001,940,65,875,112
"27161","E01024394",2001,503,14,489,13
"27162","E01024404",2001,595,3,592,13
"27163","E01024405",2001,618,44,574,15
"27164","E01024402",2001,549,18,531,13
"27165","E01024331",2001,554,27,527,31
"27166","E01024397",2001,634,321,313,3
"27167","E01024398",2001,607,291,316,15
"27168","E01024399",2001,626,284,342,10
"27169","E01024400",2001,509,40,469,10
"27170","E01024389",2001,756,522,234,18
"27171","E01024390",2001,514,288,226,10
"27172","E01024391",2001,474,246,228,16
"27173","E01024325",2001,953,37,916,35
"27174","E01024346",2001,531,41,490,83
"27175","E01024377",2001,627,81,546,99
"27176","E01024378",2001,552,108,444,52
"27177","E01024375",2001,897,83,814,45
"27178","E01024332",2001,460,41,419,55
"27179","E01024350",2001,557,50,507,35
"27180","E01024388",2001,493,126,367,9
"27181","E01024410",2001,594,72,522,30
"27182","E01024342",2001,589,155,434,34
"27183","E01024343",2001,503,29,474,18
"27184","E01024344",2001,608,8,600,18
"27185","E01024376",2001,913,80,833,39
"27186","E01024364",2001,647,97,550,48
"27187","E01024365",2001,680,14,666,41
"27188","E01024366",2001,585,44,541,54
"27189","E01024411",2001,426,60,366,44
"27190","E01024379",2001,592,32,560,64
"27191","E01024380",2001,648,8,640,75
"27192","E01024381",2001,612,180,432,34
"27193","E01024345",2001,580,41,539,66
"27194","E01024406",2001,526,48,478,42
"27195","E01024407",2001,523,3,520,33
"27196","E01024408",2001,582,15,567,17
"27197","E01024409",2001,590,52,538,37
"27198","E01024445",2001,498,14,484,13
"27199","E01024446",2001,573,7,566,28
"27200","E01024447",2001,574,91,483,6
"27201","E01024472",2001,518,111,407,17
"27202","E01024479",2001,585,21,564,18
"27203","E01024480",2001,780,345,435,26
"27204","E01024481",2001,655,259,396,8
"27205","E01024482",2001,669,256,413,28
"27206","E01024476",2001,597,322,275,8
"27207","E01024477",2001,614,277,337,20
"27208","E01024478",2001,586,82,504,9
"27209","E01024473",2001,605,18,587,28
"27210","E01024474",2001,479,3,476,10
"27211","E01024475",2001,613,44,569,35
"27212","E01024421",2001,765,114,651,46
"27213","E01024441",2001,630,8,622,14
"27214","E01024442",2001,552,8,544,16
"27215","E01024443",2001,619,14,605,27
"27216","E01024444",2001,511,203,308,14
"27217","E01024431",2001,769,60,709,53
"27218","E01024432",2001,568,90,478,39
"27219","E01024433",2001,539,43,496,39
"27220","E01024434",2001,674,98,576,37
"27221","E01024412",2001,631,29,602,22
"27222","E01024413",2001,722,146,576,59
"27223","E01024414",2001,614,30,584,31
"27224","E01024415",2001,507,4,503,5
"27225","E01024435",2001,520,25,495,24
"27226","E01024436",2001,648,24,624,42
"27227","E01024437",2001,604,97,507,35
"27228","E01024438",2001,597,8,589,13
"27229","E01024439",2001,607,63,544,22
"27230","E01024440",2001,717,27,690,97
"27231","E01024452",2001,600,86,514,71
"27232","E01024422",2001,623,91,532,47
"27233","E01024423",2001,715,67,648,96
"27234","E01024453",2001,614,11,603,21
"27235","E01024454",2001,606,96,510,29
"27236","E01024448",2001,500,64,436,28
"27237","E01024449",2001,531,15,516,10
"27238","E01024450",2001,595,110,485,33
"27239","E01024457",2001,481,136,345,21
"27240","E01024460",2001,600,132,468,32
"27241","E01024461",2001,978,128,850,114
"27242","E01024465",2001,602,110,492,101
"27243","E01024466",2001,491,138,353,27
"27244","E01024468",2001,610,42,568,89
"27245","E01024467",2001,629,29,600,35
"27246","E01024463",2001,509,36,473,22
"27247","E01024464",2001,520,23,497,38
"27248","E01024418",2001,493,24,469,11
"27249","E01024424",2001,467,14,453,20
"27250","E01024416",2001,589,28,561,44
"27251","E01024462",2001,633,130,503,12
"27252","E01024458",2001,514,8,506,60
"27253","E01024459",2001,596,70,526,64
"27254","E01024469",2001,627,32,595,153
"27255","E01024470",2001,607,86,521,47
"27256","E01024471",2001,650,156,494,78
"27257","E01024483",2001,614,23,591,83
"27258","E01024484",2001,500,18,482,48
"27259","E01024485",2001,672,220,452,30
"27260","E01024419",2001,653,30,623,78
"27261","E01024417",2001,647,127,520,63
"27262","E01024425",2001,515,97,418,39
"27263","E01024426",2001,639,3,636,49
"27264","E01024427",2001,503,176,327,7
"27265","E01024428",2001,479,129,350,9
"27266","E01024429",2001,590,238,352,29
"27267","E01024430",2001,525,11,514,64
"27268","E01024420",2001,776,96,680,97
"27269","E01024451",2001,789,114,675,120
"27270","E01024455",2001,416,52,364,49
"27271","E01024456",2001,497,50,447,35
"27272","E01024490",2001,838,27,811,72
"27273","E01024544",2001,545,21,524,32
"27274","E01024545",2001,557,7,550,35
"27275","E01024547",2001,607,93,514,28
"27276","E01024541",2001,572,221,351,21
"27277","E01024542",2001,628,8,620,19
"27278","E01024543",2001,538,4,534,25
"27279","E01024492",2001,601,109,492,33
"27280","E01024496",2001,666,243,423,61
"27281","E01024497",2001,595,136,459,41
"27282","E01024498",2001,621,347,274,19
"27283","E01024503",2001,742,172,570,52
"27284","E01024518",2001,641,78,563,23
"27285","E01024499",2001,628,60,568,129
"27286","E01024500",2001,497,149,348,60
"27287","E01024501",2001,606,18,588,134
"27288","E01024502",2001,491,60,431,128
"27289","E01024505",2001,754,176,578,107
"27290","E01024493",2001,523,139,384,38
"27291","E01024494",2001,626,152,474,44
"27292","E01024495",2001,602,115,487,111
"27293","E01024491",2001,524,23,501,80
"27294","E01024520",2001,536,146,390,36
"27295","E01024528",2001,502,97,405,65
"27296","E01024521",2001,714,31,683,110
"27297","E01024519",2001,518,6,512,96
"27298","E01024511",2001,516,0,516,60
"27299","E01024512",2001,611,12,599,110
"27300","E01024513",2001,612,38,574,104
"27301","E01024514",2001,469,0,469,49
"27302","E01024515",2001,632,3,629,31
"27303","E01024516",2001,529,70,459,8
"27304","E01024517",2001,614,18,596,224
"27305","E01024504",2001,744,118,626,310
"27306","E01024506",2001,916,115,801,373
"27307","E01024507",2001,761,233,528,257
"27308","E01024508",2001,860,46,814,385
"27309","E01024509",2001,652,43,609,210
"27310","E01024510",2001,746,13,733,272
"27311","E01024523",2001,645,4,641,36
"27312","E01024526",2001,624,8,616,26
"27313","E01024527",2001,617,13,604,61
"27314","E01024550",2001,813,43,770,80
"27315","E01024546",2001,559,49,510,47
"27316","E01024530",2001,574,15,559,30
"27317","E01024536",2001,746,22,724,37
"27318","E01024489",2001,728,8,720,22
"27319","E01024531",2001,638,113,525,50
"27320","E01024529",2001,645,148,497,35
"27321","E01024524",2001,746,289,457,63
"27322","E01024525",2001,780,23,757,228
"27323","E01024522",2001,630,34,596,100
"27324","E01024486",2001,851,141,710,55
"27325","E01024487",2001,524,8,516,44
"27326","E01024488",2001,658,73,585,25
"27327","E01024548",2001,460,100,360,34
"27328","E01024549",2001,401,57,344,34
"27329","E01024537",2001,678,12,666,67
"27330","E01024538",2001,697,5,692,34
"27331","E01024539",2001,836,246,590,84
"27332","E01024540",2001,613,13,600,25
"27333","E01024532",2001,514,0,514,34
"27334","E01024533",2001,524,8,516,84
"27335","E01024534",2001,595,216,379,31
"27336","E01024535",2001,743,42,701,106
"27337","E01024609",2001,539,83,456,234
"27338","E01024610",2001,608,28,580,172
"27339","E01024611",2001,607,41,566,132
"27340","E01024612",2001,630,48,582,115
"27341","E01024613",2001,611,150,461,158
"27342","E01024614",2001,627,304,323,62
"27343","E01024615",2001,613,354,259,31
"27344","E01024616",2001,632,188,444,25
"27345","E01024585",2001,590,204,386,30
"27346","E01024587",2001,510,13,497,32
"27347","E01024588",2001,511,3,508,29
"27348","E01024589",2001,609,11,598,24
"27349","E01024598",2001,607,50,557,45
"27350","E01024617",2001,698,16,682,65
"27351","E01024595",2001,622,26,596,43
"27352","E01024619",2001,591,22,569,49
"27353","E01024621",2001,470,261,209,12
"27354","E01024620",2001,504,21,483,33
"27355","E01024596",2001,678,72,606,100
"27356","E01024597",2001,611,225,386,68
"27357","E01024594",2001,601,9,592,20
"27358","E01024586",2001,619,19,600,49
"27359","E01024618",2001,591,83,508,70
"27360","E01024580",2001,719,64,655,136
"27361","E01024581",2001,550,27,523,68
"27362","E01024583",2001,627,104,523,39
"27363","E01024574",2001,438,55,383,34
"27364","E01024576",2001,622,6,616,75
"27365","E01024577",2001,512,93,419,14
"27366","E01024578",2001,658,56,602,50
"27367","E01024579",2001,498,238,260,17
"27368","E01024575",2001,463,25,438,16
"27369","E01024570",2001,661,136,525,31
"27370","E01024571",2001,661,52,609,84
"27371","E01024572",2001,442,10,432,36
"27372","E01024573",2001,511,52,459,25
"27373","E01024561",2001,501,16,485,54
"27374","E01024554",2001,842,67,775,55
"27375","E01024567",2001,651,219,432,31
"27376","E01024568",2001,688,27,661,41
"27377","E01024582",2001,608,61,547,38
"27378","E01024584",2001,740,328,412,42
"27379","E01024590",2001,635,358,277,39
"27380","E01024559",2001,644,108,536,89
"27381","E01024599",2001,806,78,728,123
"27382","E01024608",2001,662,110,552,94
"27383","E01024600",2001,608,212,396,9
"27384","E01024601",2001,725,153,572,27
"27385","E01024591",2001,517,87,430,37
"27386","E01024592",2001,525,16,509,42
"27387","E01024593",2001,498,41,457,30
"27388","E01024569",2001,663,34,629,39
"27389","E01024560",2001,507,93,414,36
"27390","E01024562",2001,531,8,523,55
"27391","E01024630",2001,733,77,656,27
"27392","E01024632",2001,645,7,638,6
"27393","E01024631",2001,634,14,620,13
"27394","E01024628",2001,588,48,540,61
"27395","E01024629",2001,404,22,382,16
"27396","E01024606",2001,525,41,484,33
"27397","E01024607",2001,608,55,553,12
"27398","E01024603",2001,499,14,485,37
"27399","E01024604",2001,459,189,270,40
"27400","E01024605",2001,581,27,554,23
"27401","E01024626",2001,605,23,582,48
"27402","E01024627",2001,761,280,481,48
"27403","E01024564",2001,414,24,390,19
"27404","E01024563",2001,647,315,332,39
"27405","E01024625",2001,644,33,611,38
"27406","E01024602",2001,658,82,576,79
"27407","E01024551",2001,790,68,722,100
"27408","E01024552",2001,619,237,382,33
"27409","E01024553",2001,765,80,685,145
"27410","E01024622",2001,653,99,554,65
"27411","E01024623",2001,774,147,627,39
"27412","E01024624",2001,621,97,524,119
"27413","E01024565",2001,484,53,431,65
"27414","E01024566",2001,578,96,482,50
"27415","E01024555",2001,479,51,428,43
"27416","E01024556",2001,462,52,410,71
"27417","E01024557",2001,591,149,442,30
"27418","E01024558",2001,627,36,591,41
"27419","E01024657",2001,626,37,589,360
"27420","E01024658",2001,751,168,583,298
"27421","E01024659",2001,610,40,570,190
"27422","E01024660",2001,483,50,433,196
"27423","E01024678",2001,875,205,670,393
"27424","E01024675",2001,790,5,785,45
"27425","E01024653",2001,748,13,735,40
"27426","E01024654",2001,752,66,686,50
"27427","E01024655",2001,624,3,621,21
"27428","E01024656",2001,733,16,717,111
"27429","E01024676",2001,760,182,578,294
"27430","E01024677",2001,680,75,605,153
"27431","E01024695",2001,473,14,459,92
"27432","E01024697",2001,487,181,306,75
"27433","E01024710",2001,504,8,496,222
"27434","E01024694",2001,633,162,471,46
"27435","E01024696",2001,522,36,486,50
"27436","E01024661",2001,523,24,499,162
"27437","E01024664",2001,619,158,461,48
"27438","E01024665",2001,622,51,571,71
"27439","E01024672",2001,592,260,332,36
"27440","E01024673",2001,786,54,732,120
"27441","E01024674",2001,607,17,590,22
"27442","E01024711",2001,503,0,503,36
"27443","E01024712",2001,646,6,640,35
"27444","E01024666",2001,739,359,380,39
"27445","E01024662",2001,610,202,408,24
"27446","E01024663",2001,617,388,229,30
"27447","E01024633",2001,630,196,434,39
"27448","E01024634",2001,513,142,371,28
"27449","E01024641",2001,720,196,524,50
"27450","E01024713",2001,606,186,420,63
"27451","E01024714",2001,693,61,632,124
"27452","E01024715",2001,763,26,737,329
"27453","E01024716",2001,776,54,722,74
"27454","E01024636",2001,1008,10,998,89
"27455","E01024637",2001,753,9,744,25
"27456","E01024638",2001,739,40,699,62
"27457","E01024639",2001,765,20,745,89
"27458","E01024640",2001,755,56,699,47
"27459","E01024642",2001,732,7,725,47
"27460","E01024644",2001,607,4,603,28
"27461","E01024635",2001,654,45,609,34
"27462","E01024692",2001,749,102,647,80
"27463","E01024693",2001,593,3,590,60
"27464","E01024643",2001,621,60,561,168
"27465","E01024705",2001,608,29,579,200
"27466","E01024706",2001,631,9,622,115
"27467","E01024707",2001,610,4,606,83
"27468","E01024708",2001,630,5,625,19
"27469","E01024688",2001,744,71,673,50
"27470","E01024689",2001,503,6,497,34
"27471","E01024690",2001,608,77,531,25
"27472","E01024691",2001,489,8,481,29
"27473","E01024686",2001,728,169,559,32
"27474","E01024669",2001,635,10,625,107
"27475","E01024698",2001,612,33,579,87
"27476","E01024699",2001,770,271,499,41
"27477","E01024700",2001,602,23,579,52
"27478","E01024709",2001,613,56,557,19
"27479","E01024687",2001,628,332,296,39
"27480","E01024682",2001,634,350,284,25
"27481","E01024683",2001,644,351,293,13
"27482","E01024684",2001,656,67,589,80
"27483","E01024685",2001,727,155,572,42
"27484","E01024701",2001,611,25,586,97
"27485","E01024702",2001,616,163,453,45
"27486","E01024703",2001,686,83,603,80
"27487","E01024704",2001,646,41,605,30
"27488","E01024668",2001,471,28,443,99
"27489","E01024681",2001,619,20,599,119
"27490","E01024670",2001,622,44,578,146
"27491","E01024645",2001,618,72,546,67
"27492","E01024647",2001,619,18,601,139
"27493","E01024648",2001,709,95,614,217
"27494","E01024649",2001,758,81,677,267
"27495","E01024667",2001,830,363,467,186
"27496","E01024646",2001,740,86,654,215
"27497","E01024671",2001,794,45,749,320
"27498","E01024679",2001,625,67,558,14
"27499","E01024680",2001,603,18,585,32
"27500","E01024650",2001,626,0,626,25
"27501","E01024651",2001,620,76,544,108
"27502","E01024652",2001,723,7,716,26
"27503","E01024727",2001,928,45,883,102
"27504","E01024728",2001,670,138,532,23
"27505","E01024719",2001,630,117,513,34
"27506","E01024720",2001,539,16,523,7
"27507","E01024721",2001,501,9,492,24
"27508","E01024722",2001,545,9,536,14
"27509","E01024769",2001,598,281,317,27
"27510","E01024770",2001,409,130,279,10
"27511","E01024771",2001,648,147,501,73
"27512","E01024772",2001,615,50,565,30
"27513","E01024773",2001,735,16,719,20
"27514","E01024774",2001,738,129,609,77
"27515","E01024761",2001,581,74,507,12
"27516","E01024762",2001,733,33,700,32
"27517","E01024763",2001,518,66,452,9
"27518","E01024764",2001,514,111,403,22
"27519","E01024765",2001,520,24,496,12
"27520","E01024741",2001,512,293,219,6
"27521","E01024785",2001,623,89,534,24
"27522","E01024782",2001,486,3,483,16
"27523","E01024783",2001,618,169,449,51
"27524","E01024784",2001,536,24,512,36
"27525","E01024742",2001,641,273,368,28
"27526","E01024738",2001,433,58,375,40
"27527","E01024739",2001,968,76,892,66
"27528","E01024740",2001,649,59,590,62
"27529","E01024735",2001,610,21,589,20
"27530","E01024736",2001,604,168,436,23
"27531","E01024737",2001,603,17,586,32
"27532","E01024717",2001,643,345,298,51
"27533","E01024718",2001,519,7,512,3
"27534","E01024723",2001,574,59,515,44
"27535","E01024724",2001,690,30,660,52
"27536","E01024725",2001,614,9,605,62
"27537","E01024726",2001,712,174,538,23
"27538","E01024755",2001,723,31,692,39
"27539","E01024786",2001,759,209,550,48
"27540","E01024781",2001,772,52,720,63
"27541","E01024759",2001,550,8,542,15
"27542","E01024760",2001,509,90,419,11
"27543","E01024746",2001,410,34,376,57
"27544","E01024747",2001,623,287,336,12
"27545","E01024743",2001,705,156,549,41
"27546","E01024744",2001,743,32,711,63
"27547","E01024745",2001,690,45,645,53
"27548","E01024775",2001,630,372,258,9
"27549","E01024776",2001,510,205,305,4
"27550","E01024777",2001,499,213,286,11
"27551","E01024730",2001,525,26,499,22
"27552","E01024731",2001,485,4,481,10
"27553","E01024734",2001,651,88,563,27
"27554","E01024752",2001,634,11,623,10
"27555","E01024753",2001,616,73,543,24
"27556","E01024754",2001,567,26,541,46
"27557","E01024748",2001,518,3,515,10
"27558","E01024749",2001,617,270,347,15
"27559","E01024750",2001,625,122,503,8
"27560","E01024751",2001,644,6,638,17
"27561","E01024729",2001,649,228,421,4
"27562","E01024732",2001,503,32,471,124
"27563","E01024733",2001,652,24,628,112
"27564","E01024756",2001,610,138,472,91
"27565","E01024766",2001,632,158,474,46
"27566","E01024767",2001,520,220,300,8
"27567","E01024768",2001,501,28,473,75
"27568","E01024778",2001,630,6,624,96
"27569","E01024779",2001,734,140,594,91
"27570","E01024780",2001,599,172,427,35
"27571","E01024757",2001,631,32,599,68
"27572","E01024758",2001,611,115,496,30
"27573","E01024798",2001,858,116,742,89
"27574","E01024811",2001,484,28,456,6
"27575","E01024812",2001,496,59,437,31
"27576","E01024813",2001,722,172,550,85
"27577","E01024814",2001,499,25,474,15
"27578","E01024815",2001,493,129,364,13
"27579","E01024816",2001,494,102,392,11
"27580","E01024837",2001,608,62,546,29
"27581","E01024844",2001,607,68,539,82
"27582","E01024846",2001,635,160,475,44
"27583","E01024849",2001,631,63,568,64
"27584","E01024850",2001,425,3,422,12
"27585","E01024847",2001,661,141,520,60
"27586","E01024848",2001,613,217,396,33
"27587","E01024845",2001,505,95,410,11
"27588","E01024839",2001,723,40,683,55
"27589","E01024836",2001,645,151,494,85
"27590","E01024825",2001,505,6,499,30
"27591","E01024826",2001,625,119,506,31
"27592","E01024827",2001,596,107,489,12
"27593","E01024828",2001,621,169,452,36
"27594","E01024793",2001,641,81,560,52
"27595","E01024840",2001,618,283,335,44
"27596","E01024841",2001,777,376,401,24
"27597","E01024842",2001,642,217,425,27
"27598","E01024843",2001,519,175,344,27
"27599","E01024829",2001,641,51,590,62
"27600","E01024851",2001,602,79,523,44
"27601","E01024852",2001,500,7,493,4
"27602","E01024853",2001,534,63,471,28
"27603","E01024854",2001,527,31,496,39
"27604","E01024838",2001,634,29,605,86
"27605","E01024835",2001,752,16,736,148
"27606","E01024799",2001,696,41,655,106
"27607","E01024800",2001,605,7,598,56
"27608","E01024801",2001,898,73,825,380
"27609","E01024802",2001,874,34,840,323
"27610","E01024823",2001,774,29,745,267
"27611","E01024833",2001,864,290,574,186
"27612","E01024834",2001,624,43,581,73
"27613","E01024824",2001,617,20,597,39
"27614","E01024832",2001,646,35,611,132
"27615","E01024821",2001,864,172,692,89
"27616","E01024822",2001,704,61,643,47
"27617","E01024795",2001,611,328,283,32
"27618","E01024796",2001,605,132,473,71
"27619","E01024830",2001,764,274,490,43
"27620","E01024831",2001,609,210,399,52
"27621","E01024804",2001,530,38,492,84
"27622","E01024805",2001,611,69,542,97
"27623","E01024806",2001,614,140,474,47
"27624","E01024794",2001,585,88,497,49
"27625","E01024792",2001,666,32,634,47
"27626","E01024797",2001,616,53,563,72
"27627","E01024817",2001,625,15,610,41
"27628","E01024818",2001,627,87,540,27
"27629","E01024819",2001,743,76,667,201
"27630","E01024820",2001,639,4,635,67
"27631","E01024803",2001,816,94,722,82
"27632","E01024787",2001,434,42,392,28
"27633","E01024788",2001,595,206,389,28
"27634","E01024790",2001,482,173,309,48
"27635","E01024791",2001,533,17,516,37
"27636","E01024789",2001,738,101,637,101
"27637","E01024807",2001,612,213,399,40
"27638","E01024808",2001,602,25,577,61
"27639","E01024809",2001,533,64,469,39
"27640","E01024810",2001,533,36,497,38
"27641","E01028479",2001,543,19,524,73
"27642","E01028480",2001,593,67,526,63
"27643","E01028508",2001,421,18,403,34
"27644","E01028509",2001,621,37,584,52
"27645","E01028441",2001,645,225,420,45
"27646","E01028442",2001,607,36,571,84
"27647","E01028443",2001,595,32,563,55
"27648","E01028444",2001,606,24,582,40
"27649","E01028445",2001,523,168,355,28
"27650","E01028446",2001,620,96,524,31
"27651","E01028447",2001,508,104,404,95
"27652","E01028448",2001,626,268,358,42
"27653","E01028435",2001,800,240,560,294
"27654","E01028436",2001,772,300,472,113
"27655","E01028437",2001,626,23,603,98
"27656","E01028438",2001,716,16,700,194
"27657","E01028439",2001,595,25,570,65
"27658","E01028440",2001,732,90,642,222
"27659","E01028449",2001,516,239,277,15
"27660","E01028450",2001,520,292,228,22
"27661","E01028451",2001,500,110,390,19
"27662","E01028452",2001,502,190,312,33
"27663","E01028453",2001,497,192,305,18
"27664","E01028454",2001,616,339,277,7
"27665","E01028430",2001,627,79,548,168
"27666","E01028431",2001,650,35,615,52
"27667","E01028432",2001,647,92,555,31
"27668","E01028433",2001,752,33,719,22
"27669","E01028434",2001,497,6,491,26
"27670","E01028426",2001,569,40,529,45
"27671","E01028427",2001,639,50,589,216
"27672","E01028428",2001,511,19,492,22
"27673","E01028429",2001,470,69,401,23
"27674","E01028475",2001,848,63,785,46
"27675","E01028476",2001,772,20,752,45
"27676","E01028422",2001,508,60,448,32
"27677","E01028423",2001,599,16,583,68
"27678","E01028485",2001,501,60,441,14
"27679","E01028486",2001,519,23,496,59
"27680","E01028503",2001,436,29,407,39
"27681","E01028504",2001,541,45,496,57
"27682","E01028474",2001,638,115,523,39
"27683","E01028505",2001,693,92,601,276
"27684","E01028506",2001,677,96,581,69
"27685","E01028507",2001,564,10,554,74
"27686","E01028481",2001,618,77,541,85
"27687","E01028482",2001,479,10,469,31
"27688","E01028483",2001,475,27,448,57
"27689","E01028484",2001,434,66,368,45
"27690","E01028477",2001,552,43,509,44
"27691","E01028478",2001,475,27,448,47
"27692","E01028425",2001,478,45,433,219
"27693","E01028499",2001,571,39,532,42
"27694","E01028459",2001,648,13,635,73
"27695","E01028460",2001,472,0,472,18
"27696","E01028461",2001,611,8,603,53
"27697","E01028462",2001,547,52,495,24
"27698","E01028467",2001,730,92,638,94
"27699","E01028455",2001,538,16,522,20
"27700","E01028456",2001,624,160,464,41
"27701","E01028457",2001,511,7,504,18
"27702","E01028458",2001,633,202,431,33
"27703","E01028466",2001,716,268,448,26
"27704","E01028469",2001,615,17,598,19
"27705","E01028470",2001,649,104,545,32
"27706","E01028471",2001,492,183,309,25
"27707","E01028472",2001,482,8,474,40
"27708","E01028473",2001,616,7,609,48
"27709","E01028463",2001,709,8,701,69
"27710","E01028464",2001,587,21,566,57
"27711","E01028465",2001,558,3,555,49
"27712","E01028468",2001,879,180,699,154
"27713","E01028424",2001,618,47,571,60
"27714","E01028500",2001,460,76,384,31
"27715","E01028501",2001,455,19,436,36
"27716","E01028502",2001,482,21,461,57
"27717","E01028497",2001,591,23,568,90
"27718","E01028498",2001,569,132,437,43
"27719","E01028494",2001,469,164,305,28
"27720","E01028489",2001,612,15,597,31
"27721","E01028490",2001,468,96,372,16
"27722","E01028491",2001,628,60,568,47
"27723","E01028487",2001,521,14,507,56
"27724","E01028492",2001,627,23,604,51
"27725","E01028493",2001,532,101,431,14
"27726","E01028495",2001,505,29,476,30
"27727","E01028496",2001,519,98,421,26
"27728","E01028488",2001,635,31,604,62
"27729","E01028510",2001,570,6,564,34
"27730","E01028511",2001,676,32,644,53
"27731","E01028512",2001,615,47,568,29
"27732","E01028594",2001,616,43,573,50
"27733","E01028595",2001,627,92,535,73
"27734","E01028596",2001,650,71,579,122
"27735","E01028597",2001,650,135,515,110
"27736","E01028589",2001,609,132,477,136
"27737","E01028590",2001,633,21,612,130
"27738","E01028591",2001,497,30,467,134
"27739","E01028592",2001,478,11,467,169
"27740","E01028593",2001,604,185,419,173
"27741","E01028583",2001,484,21,463,188
"27742","E01028584",2001,629,22,607,183
"27743","E01028585",2001,535,70,465,224
"27744","E01028565",2001,506,14,492,157
"27745","E01028560",2001,663,94,569,93
"27746","E01028561",2001,631,18,613,53
"27747","E01028562",2001,631,124,507,102
"27748","E01028563",2001,636,27,609,148
"27749","E01028538",2001,601,256,345,32
"27750","E01028513",2001,596,335,261,41
"27751","E01028514",2001,506,287,219,26
"27752","E01028516",2001,637,198,439,59
"27753","E01028539",2001,633,81,552,144
"27754","E01028540",2001,467,75,392,44
"27755","E01028534",2001,483,17,466,68
"27756","E01028535",2001,642,38,604,162
"27757","E01028536",2001,644,127,517,115
"27758","E01028537",2001,586,70,516,189
"27759","E01028515",2001,608,81,527,70
"27760","E01028571",2001,613,103,510,66
"27761","E01028572",2001,643,26,617,59
"27762","E01028573",2001,638,13,625,117
"27763","E01028574",2001,616,161,455,84
"27764","E01028521",2001,835,58,777,528
"27765","E01028522",2001,503,229,274,139
"27766","E01028564",2001,757,71,686,365
"27767","E01028566",2001,525,25,500,261
"27768","E01028548",2001,733,56,677,212
"27769","E01028549",2001,760,122,638,240
"27770","E01028550",2001,741,175,566,373
"27771","E01028551",2001,542,69,473,247
"27772","E01028523",2001,459,145,314,91
"27773","E01028524",2001,640,309,331,64
"27774","E01028525",2001,616,278,338,44
"27775","E01028526",2001,524,104,420,158
"27776","E01028579",2001,512,73,439,224
"27777","E01028580",2001,547,90,457,222
"27778","E01028581",2001,492,52,440,140
"27779","E01028582",2001,636,168,468,228
"27780","E01028586",2001,636,106,530,269
"27781","E01028587",2001,639,107,532,275
"27782","E01028588",2001,524,49,475,275
"27783","E01028541",2001,616,80,536,170
"27784","E01028542",2001,591,111,480,106
"27785","E01028543",2001,656,245,411,155
"27786","E01028544",2001,634,30,604,237
"27787","E01028556",2001,608,93,515,115
"27788","E01028557",2001,607,156,451,54
"27789","E01028558",2001,519,23,496,59
"27790","E01028559",2001,636,71,565,132
"27791","E01028531",2001,724,71,653,219
"27792","E01028532",2001,727,203,524,197
"27793","E01028533",2001,619,106,513,121
"27794","E01028545",2001,573,54,519,165
"27795","E01028546",2001,712,301,411,67
"27796","E01028547",2001,784,42,742,256
"27797","E01028527",2001,637,46,591,60
"27798","E01028528",2001,494,38,456,69
"27799","E01028529",2001,600,250,350,31
"27800","E01028530",2001,605,90,515,54
"27801","E01028575",2001,602,120,482,99
"27802","E01028578",2001,620,83,537,83
"27803","E01028576",2001,519,270,249,24
"27804","E01028577",2001,646,359,287,21
"27805","E01028552",2001,616,291,325,34
"27806","E01028553",2001,653,113,540,55
"27807","E01028554",2001,547,94,453,46
"27808","E01028555",2001,638,64,574,43
"27809","E01028567",2001,640,295,345,34
"27810","E01028517",2001,515,218,297,24
"27811","E01028518",2001,656,418,238,27
"27812","E01028519",2001,533,213,320,25
"27813","E01028520",2001,607,352,255,18
"27814","E01028568",2001,595,391,204,19
"27815","E01028569",2001,632,347,285,39
"27816","E01028570",2001,743,87,656,46
"27817","E01028666",2001,679,86,593,103
"27818","E01028667",2001,531,5,526,38
"27819","E01028668",2001,550,43,507,17
"27820","E01028669",2001,538,37,501,28
"27821","E01028683",2001,559,18,541,29
"27822","E01028638",2001,536,40,496,61
"27823","E01028639",2001,522,65,457,69
"27824","E01028640",2001,570,91,479,76
"27825","E01028670",2001,508,26,482,24
"27826","E01028671",2001,607,137,470,61
"27827","E01028672",2001,574,18,556,13
"27828","E01028673",2001,471,85,386,26
"27829","E01028684",2001,641,60,581,93
"27830","E01028681",2001,529,14,515,39
"27831","E01028682",2001,514,90,424,33
"27832","E01028646",2001,468,89,379,47
"27833","E01028647",2001,606,38,568,87
"27834","E01028613",2001,513,23,490,20
"27835","E01028614",2001,557,59,498,35
"27836","E01028615",2001,617,6,611,36
"27837","E01028616",2001,514,12,502,25
"27838","E01028598",2001,955,118,837,68
"27839","E01028604",2001,514,190,324,14
"27840","E01028605",2001,610,170,440,32
"27841","E01028607",2001,497,38,459,54
"27842","E01028641",2001,495,12,483,67
"27843","E01028657",2001,597,25,572,90
"27844","E01028658",2001,472,26,446,82
"27845","E01028603",2001,443,36,407,49
"27846","E01028606",2001,742,69,673,80
"27847","E01028609",2001,496,46,450,19
"27848","E01028610",2001,596,80,516,38
"27849","E01028600",2001,605,14,591,30
"27850","E01028678",2001,651,60,591,105
"27851","E01028679",2001,825,131,694,139
"27852","E01028680",2001,670,23,647,74
"27853","E01028625",2001,651,9,642,55
"27854","E01028626",2001,609,0,609,42
"27855","E01028627",2001,612,56,556,48
"27856","E01028628",2001,501,3,498,42
"27857","E01028629",2001,638,34,604,49
"27858","E01028621",2001,503,192,311,56
"27859","E01028622",2001,524,43,481,16
"27860","E01028623",2001,641,86,555,76
"27861","E01028624",2001,522,35,487,22
"27862","E01028620",2001,889,86,803,138
"27863","E01028601",2001,470,47,423,140
"27864","E01028602",2001,508,60,448,351
"27865","E01028599",2001,594,59,535,60
"27866","E01028608",2001,449,53,396,17
"27867","E01028617",2001,638,22,616,55
"27868","E01028674",2001,511,36,475,17
"27869","E01028675",2001,505,129,376,27
"27870","E01028676",2001,607,135,472,34
"27871","E01028677",2001,738,182,556,120
"27872","E01028630",2001,691,37,654,135
"27873","E01028631",2001,473,57,416,51
"27874","E01028632",2001,507,164,343,7
"27875","E01028633",2001,623,134,489,84
"27876","E01028634",2001,495,11,484,14
"27877","E01028635",2001,627,161,466,22
"27878","E01028636",2001,544,209,335,28
"27879","E01028637",2001,600,21,579,25
"27880","E01028618",2001,669,33,636,96
"27881","E01028619",2001,715,154,561,45
"27882","E01028644",2001,693,90,603,73
"27883","E01028648",2001,465,68,397,19
"27884","E01028649",2001,592,63,529,59
"27885","E01028650",2001,806,104,702,63
"27886","E01028651",2001,751,222,529,56
"27887","E01028652",2001,989,54,935,211
"27888","E01028653",2001,614,152,462,86
"27889","E01028654",2001,620,116,504,34
"27890","E01028655",2001,755,40,715,182
"27891","E01028656",2001,504,3,501,38
"27892","E01028645",2001,623,8,615,52
"27893","E01028642",2001,491,49,442,31
"27894","E01028643",2001,549,49,500,67
"27895","E01028611",2001,443,40,403,45
"27896","E01028685",2001,489,67,422,10
"27897","E01028686",2001,464,63,401,24
"27898","E01028660",2001,657,52,605,110
"27899","E01028661",2001,561,44,517,29
"27900","E01028662",2001,455,19,436,29
"27901","E01028612",2001,495,54,441,58
"27902","E01028663",2001,591,147,444,26
"27903","E01028664",2001,542,45,497,17
"27904","E01028665",2001,520,9,511,22
"27905","E01028659",2001,614,39,575,76
"27906","E01028708",2001,722,92,630,61
"27907","E01028709",2001,619,6,613,27
"27908","E01028710",2001,617,8,609,38
"27909","E01028711",2001,652,75,577,59
"27910","E01028733",2001,526,48,478,39
"27911","E01028734",2001,610,7,603,42
"27912","E01028735",2001,595,87,508,21
"27913","E01028740",2001,647,12,635,55
"27914","E01028741",2001,468,14,454,51
"27915","E01028742",2001,665,115,550,120
"27916","E01028743",2001,444,25,419,21
"27917","E01028744",2001,487,42,445,49
"27918","E01028750",2001,574,166,408,55
"27919","E01028751",2001,579,31,548,52
"27920","E01028752",2001,550,19,531,39
"27921","E01028738",2001,472,47,425,270
"27922","E01028739",2001,647,89,558,41
"27923","E01028701",2001,621,92,529,39
"27924","E01028705",2001,490,6,484,20
"27925","E01028706",2001,599,3,596,44
"27926","E01028707",2001,606,12,594,29
"27927","E01028693",2001,605,9,596,30
"27928","E01028694",2001,613,6,607,75
"27929","E01028695",2001,638,5,633,51
"27930","E01028699",2001,644,15,629,57
"27931","E01028688",2001,508,65,443,38
"27932","E01028689",2001,642,94,548,88
"27933","E01028687",2001,909,145,764,253
"27934","E01028700",2001,646,276,370,25
"27935","E01028696",2001,510,0,510,20
"27936","E01028697",2001,641,175,466,51
"27937","E01028698",2001,597,57,540,91
"27938","E01028703",2001,660,188,472,84
"27939","E01028736",2001,873,37,836,72
"27940","E01028737",2001,900,65,835,106
"27941","E01028726",2001,881,66,815,83
"27942","E01028704",2001,616,99,517,33
"27943","E01028702",2001,522,29,493,13
"27944","E01028690",2001,599,144,455,40
"27945","E01028691",2001,602,177,425,25
"27946","E01028692",2001,510,281,229,14
"27947","E01028716",2001,517,66,451,50
"27948","E01028717",2001,733,210,523,134
"27949","E01028718",2001,624,181,443,55
"27950","E01028719",2001,628,47,581,48
"27951","E01028749",2001,857,102,755,75
"27952","E01028753",2001,565,139,426,38
"27953","E01028754",2001,508,22,486,56
"27954","E01028714",2001,897,114,783,61
"27955","E01028731",2001,517,148,369,21
"27956","E01028732",2001,481,75,406,41
"27957","E01028721",2001,521,19,502,33
"27958","E01028722",2001,589,22,567,110
"27959","E01028723",2001,604,120,484,15
"27960","E01028724",2001,504,12,492,22
"27961","E01028725",2001,624,130,494,30
"27962","E01028745",2001,492,43,449,116
"27963","E01028746",2001,506,56,450,34
"27964","E01028747",2001,480,49,431,245
"27965","E01028748",2001,522,100,422,231
"27966","E01028713",2001,902,107,795,124
"27967","E01028715",2001,478,69,409,99
"27968","E01028720",2001,868,142,726,82
"27969","E01028758",2001,618,12,606,32
"27970","E01028759",2001,613,150,463,45
"27971","E01028760",2001,473,74,399,41
"27972","E01028761",2001,505,80,425,27
"27973","E01028755",2001,640,115,525,16
"27974","E01028756",2001,598,57,541,122
"27975","E01028757",2001,615,182,433,60
"27976","E01028712",2001,860,82,778,62
"27977","E01028727",2001,626,17,609,58
"27978","E01028728",2001,479,125,354,33
"27979","E01028729",2001,409,37,372,32
"27980","E01028730",2001,624,55,569,153
"27981","E01028780",2001,663,22,641,68
"27982","E01028781",2001,524,268,256,9
"27983","E01028782",2001,611,47,564,38
"27984","E01028783",2001,736,177,559,77
"27985","E01028795",2001,653,63,590,113
"27986","E01028796",2001,514,59,455,59
"27987","E01028797",2001,459,63,396,39
"27988","E01028806",2001,785,70,715,75
"27989","E01028798",2001,865,94,771,103
"27990","E01028776",2001,779,68,711,118
"27991","E01028763",2001,839,120,719,83
"27992","E01028803",2001,717,114,603,97
"27993","E01028804",2001,523,18,505,52
"27994","E01028805",2001,412,45,367,47
"27995","E01028823",2001,616,60,556,148
"27996","E01028824",2001,625,82,543,49
"27997","E01028825",2001,469,30,439,41
"27998","E01028777",2001,514,23,491,78
"27999","E01028778",2001,649,133,516,38
"28000","E01028779",2001,432,33,399,18
"28001","E01028799",2001,756,78,678,43
"28002","E01028788",2001,664,39,625,92
"28003","E01028789",2001,589,17,572,61
"28004","E01028790",2001,448,81,367,29
"28005","E01028791",2001,552,13,539,26
"28006","E01028792",2001,439,12,427,45
"28007","E01028793",2001,577,86,491,41
"28008","E01028794",2001,559,36,523,27
"28009","E01028784",2001,812,70,742,63
"28010","E01028810",2001,592,6,586,67
"28011","E01028811",2001,596,221,375,32
"28012","E01028812",2001,624,17,607,55
"28013","E01028813",2001,490,160,330,19
"28014","E01028814",2001,613,14,599,57
"28015","E01028815",2001,491,4,487,10
"28016","E01028820",2001,516,6,510,32
"28017","E01028821",2001,592,92,500,66
"28018","E01028822",2001,573,3,570,36
"28019","E01028809",2001,520,406,114,12
"28020","E01028807",2001,495,62,433,51
"28021","E01028808",2001,512,120,392,23
"28022","E01028816",2001,493,35,458,38
"28023","E01028817",2001,587,74,513,34
"28024","E01028818",2001,754,65,689,109
"28025","E01028819",2001,664,256,408,21
"28026","E01028800",2001,506,76,430,76
"28027","E01028785",2001,631,70,561,55
"28028","E01028786",2001,509,3,506,25
"28029","E01028787",2001,501,159,342,52
"28030","E01028762",2001,711,90,621,103
"28031","E01028766",2001,795,51,744,101
"28032","E01028767",2001,865,167,698,109
"28033","E01028768",2001,520,67,453,290
"28034","E01028769",2001,501,100,401,197
"28035","E01028770",2001,497,90,407,196
"28036","E01028772",2001,707,18,689,50
"28037","E01028773",2001,614,37,577,123
"28038","E01028774",2001,475,86,389,127
"28039","E01028775",2001,492,0,492,39
"28040","E01028771",2001,625,154,471,60
"28041","E01028764",2001,710,23,687,62
"28042","E01028765",2001,791,203,588,49
"28043","E01028801",2001,510,61,449,42
"28044","E01028802",2001,539,24,515,43
"28045","E01030330",2001,635,6,629,47
"28046","E01030331",2001,665,30,635,38
"28047","E01030332",2001,608,123,485,35
"28048","E01030333",2001,606,36,570,55
"28049","E01030326",2001,737,54,683,180
"28050","E01030327",2001,635,15,620,100
"28051","E01030328",2001,609,0,609,29
"28052","E01030329",2001,637,8,629,64
"28053","E01030334",2001,523,9,514,43
"28054","E01030335",2001,694,110,584,57
"28055","E01030336",2001,768,144,624,49
"28056","E01030337",2001,749,245,504,47
"28057","E01030361",2001,850,51,799,51
"28058","E01030362",2001,538,168,370,29
"28059","E01030363",2001,762,202,560,59
"28060","E01030364",2001,741,244,497,63
"28061","E01030350",2001,653,29,624,94
"28062","E01030351",2001,626,29,597,48
"28063","E01030352",2001,594,99,495,42
"28064","E01030353",2001,541,9,532,59
"28065","E01030322",2001,655,107,548,86
"28066","E01030323",2001,532,47,485,38
"28067","E01030324",2001,627,61,566,50
"28068","E01030325",2001,594,79,515,29
"28069","E01030357",2001,640,7,633,53
"28070","E01030358",2001,621,0,621,49
"28071","E01030359",2001,624,95,529,92
"28072","E01030360",2001,666,6,660,116
"28073","E01030354",2001,515,235,280,34
"28074","E01030355",2001,526,26,500,25
"28075","E01030356",2001,513,47,466,19
"28076","E01030365",2001,606,4,602,43
"28077","E01030368",2001,598,38,560,50
"28078","E01030369",2001,769,13,756,52
"28079","E01030370",2001,623,41,582,56
"28080","E01030319",2001,527,7,520,22
"28081","E01030320",2001,509,27,482,47
"28082","E01030321",2001,513,0,513,16
"28083","E01030366",2001,784,53,731,174
"28084","E01030367",2001,618,3,615,65
"28085","E01030313",2001,637,96,541,50
"28086","E01030314",2001,624,58,566,61
"28087","E01030338",2001,628,10,618,60
"28088","E01030339",2001,725,112,613,104
"28089","E01030340",2001,608,57,551,75
"28090","E01030341",2001,620,3,617,71
"28091","E01030371",2001,728,164,564,82
"28092","E01030372",2001,495,66,429,65
"28093","E01030373",2001,609,80,529,82
"28094","E01030374",2001,630,25,605,110
"28095","E01030375",2001,728,40,688,158
"28096","E01030376",2001,487,3,484,98
"28097","E01030307",2001,597,8,589,57
"28098","E01030308",2001,641,70,571,73
"28099","E01030309",2001,648,35,613,45
"28100","E01030310",2001,609,199,410,57
"28101","E01030311",2001,653,182,471,37
"28102","E01030312",2001,519,117,402,33
"28103","E01030315",2001,626,54,572,62
"28104","E01030316",2001,614,0,614,74
"28105","E01030317",2001,735,125,610,46
"28106","E01030318",2001,646,238,408,81
"28107","E01030296",2001,612,0,612,38
"28108","E01030297",2001,746,15,731,47
"28109","E01030298",2001,611,154,457,23
"28110","E01030299",2001,608,72,536,40
"28111","E01030346",2001,525,3,522,66
"28112","E01030347",2001,649,72,577,86
"28113","E01030348",2001,627,0,627,119
"28114","E01030349",2001,620,8,612,88
"28115","E01030300",2001,746,188,558,108
"28116","E01030301",2001,606,55,551,73
"28117","E01030302",2001,607,24,583,95
"28118","E01030304",2001,683,236,447,59
"28119","E01030305",2001,514,0,514,111
"28120","E01030306",2001,488,13,475,76
"28121","E01030342",2001,620,11,609,77
"28122","E01030343",2001,615,37,578,47
"28123","E01030344",2001,492,0,492,52
"28124","E01030345",2001,604,75,529,39
"28125","E01030303",2001,610,3,607,54
"28126","E01030386",2001,517,0,517,19
"28127","E01030387",2001,607,0,607,41
"28128","E01030388",2001,512,16,496,20
"28129","E01030389",2001,666,107,559,68
"28130","E01030393",2001,768,46,722,62
"28131","E01030394",2001,617,3,614,12
"28132","E01030399",2001,875,115,760,54
"28133","E01030400",2001,603,280,323,23
"28134","E01030414",2001,499,61,438,22
"28135","E01030406",2001,603,33,570,67
"28136","E01030407",2001,539,3,536,8
"28137","E01030408",2001,633,0,633,11
"28138","E01030377",2001,882,3,879,10
"28139","E01030378",2001,584,6,578,48
"28140","E01030415",2001,607,10,597,38
"28141","E01030416",2001,499,3,496,28
"28142","E01030395",2001,737,6,731,22
"28143","E01030413",2001,538,50,488,19
"28144","E01030401",2001,761,23,738,25
"28145","E01030402",2001,460,69,391,28
"28146","E01030383",2001,618,211,407,57
"28147","E01030384",2001,637,66,571,96
"28148","E01030382",2001,529,27,502,95
"28149","E01030392",2001,729,7,722,81
"28150","E01030390",2001,753,123,630,92
"28151","E01030396",2001,618,6,612,21
"28152","E01030397",2001,659,0,659,12
"28153","E01030398",2001,630,6,624,17
"28154","E01030403",2001,611,47,564,43
"28155","E01030404",2001,629,0,629,45
"28156","E01030391",2001,751,34,717,93
"28157","E01030385",2001,639,293,346,38
"28158","E01030409",2001,490,5,485,79
"28159","E01030410",2001,595,37,558,145
"28160","E01030411",2001,781,166,615,142
"28161","E01030412",2001,745,24,721,111
"28162","E01030381",2001,618,62,556,93
"28163","E01030419",2001,651,26,625,124
"28164","E01030420",2001,489,99,390,54
"28165","E01030379",2001,503,23,480,69
"28166","E01030380",2001,516,0,516,37
"28167","E01030417",2001,516,0,516,53
"28168","E01030418",2001,513,5,508,14
"28169","E01030405",2001,642,42,600,53
"28170","E01030440",2001,606,83,523,39
"28171","E01030458",2001,518,19,499,92
"28172","E01030459",2001,523,149,374,43
"28173","E01030475",2001,494,6,488,22
"28174","E01030476",2001,461,4,457,9
"28175","E01030477",2001,668,127,541,49
"28176","E01030465",2001,579,82,497,34
"28177","E01030466",2001,697,24,673,30
"28178","E01030473",2001,636,32,604,131
"28179","E01030474",2001,451,45,406,346
"28180","E01030441",2001,490,33,457,31
"28181","E01030442",2001,566,7,559,18
"28182","E01030443",2001,508,5,503,23
"28183","E01030444",2001,590,32,558,26
"28184","E01030445",2001,579,90,489,63
"28185","E01030446",2001,480,5,475,37
"28186","E01030447",2001,509,42,467,17
"28187","E01030426",2001,597,127,470,41
"28188","E01030427",2001,612,4,608,32
"28189","E01030428",2001,490,15,475,37
"28190","E01030429",2001,750,22,728,130
"28191","E01030430",2001,625,3,622,46
"28192","E01030499",2001,630,15,615,30
"28193","E01030500",2001,618,17,601,48
"28194","E01030501",2001,599,48,551,36
"28195","E01030502",2001,518,62,456,29
"28196","E01030503",2001,509,200,309,40
"28197","E01030504",2001,498,4,494,22
"28198","E01030487",2001,649,22,627,118
"28199","E01030488",2001,627,97,530,64
"28200","E01030489",2001,608,26,582,50
"28201","E01030485",2001,751,95,656,124
"28202","E01030481",2001,599,174,425,44
"28203","E01030482",2001,502,120,382,47
"28204","E01030483",2001,601,334,267,25
"28205","E01030484",2001,633,195,438,80
"28206","E01030434",2001,738,9,729,146
"28207","E01030435",2001,618,42,576,22
"28208","E01030462",2001,730,141,589,99
"28209","E01030463",2001,644,27,617,70
"28210","E01030464",2001,639,257,382,32
"28211","E01030486",2001,636,16,620,49
"28212","E01030493",2001,521,220,301,42
"28213","E01030495",2001,635,55,580,100
"28214","E01030498",2001,510,7,503,45
"28215","E01030424",2001,672,199,473,41
"28216","E01030431",2001,615,31,584,24
"28217","E01030432",2001,627,175,452,34
"28218","E01030433",2001,644,191,453,40
"28219","E01030439",2001,639,6,633,40
"28220","E01030460",2001,630,39,591,51
"28221","E01030461",2001,627,6,621,51
"28222","E01030436",2001,911,13,898,125
"28223","E01030437",2001,627,7,620,58
"28224","E01030496",2001,621,299,322,43
"28225","E01030497",2001,614,346,268,39
"28226","E01030494",2001,641,251,390,31
"28227","E01030470",2001,490,19,471,75
"28228","E01030457",2001,748,88,660,238
"28229","E01030438",2001,744,104,640,127
"28230","E01030455",2001,748,79,669,218
"28231","E01030450",2001,867,75,792,202
"28232","E01030451",2001,761,204,557,167
"28233","E01030453",2001,764,24,740,263
"28234","E01030425",2001,683,8,675,33
"28235","E01030421",2001,629,14,615,26
"28236","E01030422",2001,655,89,566,45
"28237","E01030423",2001,699,148,551,37
"28238","E01030452",2001,775,92,683,182
"28239","E01030467",2001,644,3,641,41
"28240","E01030468",2001,507,42,465,120
"28241","E01030469",2001,511,106,405,41
"28242","E01030454",2001,662,79,583,81
"28243","E01030456",2001,533,9,524,27
"28244","E01030448",2001,633,6,627,107
"28245","E01030449",2001,613,110,503,123
"28246","E01030471",2001,460,7,453,52
"28247","E01030472",2001,508,61,447,66
"28248","E01030478",2001,666,74,592,81
"28249","E01030479",2001,731,184,547,53
"28250","E01030480",2001,765,35,730,45
"28251","E01030490",2001,674,55,619,84
"28252","E01030491",2001,775,158,617,143
"28253","E01030492",2001,802,32,770,63
"28254","E01030506",2001,489,4,485,10
"28255","E01030508",2001,517,25,492,18
"28256","E01030509",2001,508,100,408,38
"28257","E01030513",2001,494,82,412,7
"28258","E01030514",2001,640,70,570,50
"28259","E01030511",2001,524,7,517,18
"28260","E01030512",2001,628,50,578,40
"28261","E01030507",2001,498,3,495,39
"28262","E01030505",2001,615,117,498,31
"28263","E01030548",2001,521,99,422,43
"28264","E01030549",2001,615,91,524,81
"28265","E01030550",2001,811,272,539,91
"28266","E01030551",2001,646,288,358,34
"28267","E01030552",2001,583,15,568,122
"28268","E01030553",2001,670,82,588,46
"28269","E01030554",2001,438,6,432,19
"28270","E01030510",2001,535,39,496,18
"28271","E01030539",2001,674,99,575,54
"28272","E01030540",2001,744,6,738,20
"28273","E01030541",2001,495,0,495,18
"28274","E01030542",2001,482,13,469,10
"28275","E01030543",2001,596,15,581,35
"28276","E01030516",2001,623,210,413,55
"28277","E01030517",2001,609,3,606,37
"28278","E01030518",2001,525,6,519,3
"28279","E01030519",2001,605,121,484,26
"28280","E01030520",2001,625,177,448,19
"28281","E01030521",2001,612,31,581,47
"28282","E01030522",2001,503,3,500,21
"28283","E01030523",2001,515,36,479,27
"28284","E01030524",2001,1015,34,981,153
"28285","E01030525",2001,625,22,603,24
"28286","E01030526",2001,531,92,439,22
"28287","E01030527",2001,605,58,547,102
"28288","E01030556",2001,791,41,750,93
"28289","E01030532",2001,631,26,605,69
"28290","E01030533",2001,512,28,484,23
"28291","E01030534",2001,644,123,521,89
"28292","E01030535",2001,755,91,664,94
"28293","E01030536",2001,758,107,651,65
"28294","E01030537",2001,633,129,504,31
"28295","E01030538",2001,658,108,550,131
"28296","E01030544",2001,601,45,556,46
"28297","E01030545",2001,666,54,612,70
"28298","E01030546",2001,597,190,407,23
"28299","E01030547",2001,677,424,253,14
"28300","E01030555",2001,683,54,629,152
"28301","E01030557",2001,726,52,674,109
"28302","E01030558",2001,885,121,764,66
"28303","E01030529",2001,633,112,521,49
"28304","E01030530",2001,475,45,430,54
"28305","E01030531",2001,825,89,736,70
"28306","E01030528",2001,491,52,439,38
"28307","E01030515",2001,857,155,702,48
"28308","E01030607",2001,623,20,603,11
"28309","E01030603",2001,529,7,522,3
"28310","E01030604",2001,614,97,517,32
"28311","E01030605",2001,511,37,474,20
"28312","E01030559",2001,470,17,453,12
"28313","E01030560",2001,674,20,654,93
"28314","E01030561",2001,594,45,549,25
"28315","E01030562",2001,516,96,420,29
"28316","E01030563",2001,408,3,405,5
"28317","E01030564",2001,522,57,465,11
"28318","E01030606",2001,505,3,502,14
"28319","E01030641",2001,618,54,564,27
"28320","E01030642",2001,640,59,581,12
"28321","E01030644",2001,495,13,482,13
"28322","E01030565",2001,557,66,491,23
"28323","E01030566",2001,530,19,511,17
"28324","E01030567",2001,596,15,581,29
"28325","E01030568",2001,493,0,493,11
"28326","E01030569",2001,479,41,438,39
"28327","E01030640",2001,728,295,433,22
"28328","E01030643",2001,654,93,561,17
"28329","E01030608",2001,601,256,345,12
"28330","E01030609",2001,603,221,382,10
"28331","E01030635",2001,635,40,595,46
"28332","E01030636",2001,457,36,421,6
"28333","E01030637",2001,455,3,452,7
"28334","E01030638",2001,598,0,598,33
"28335","E01030639",2001,632,29,603,47
"28336","E01030589",2001,598,3,595,19
"28337","E01030590",2001,666,23,643,34
"28338","E01030591",2001,629,48,581,22
"28339","E01030592",2001,584,70,514,32
"28340","E01030599",2001,667,408,259,10
"28341","E01030600",2001,608,115,493,32
"28342","E01030601",2001,595,186,409,10
"28343","E01030602",2001,633,13,620,64
"28344","E01030623",2001,877,16,861,84
"28345","E01030624",2001,492,18,474,45
"28346","E01030625",2001,457,8,449,22
"28347","E01030626",2001,448,3,445,36
"28348","E01030627",2001,777,13,764,112
"28349","E01030598",2001,604,91,513,57
"28350","E01030622",2001,760,48,712,133
"28351","E01030615",2001,628,278,350,95
"28352","E01030616",2001,623,11,612,53
"28353","E01030617",2001,655,60,595,50
"28354","E01030618",2001,639,132,507,53
"28355","E01030619",2001,626,298,328,23
"28356","E01030610",2001,497,86,411,58
"28357","E01030611",2001,568,10,558,89
"28358","E01030612",2001,781,23,758,205
"28359","E01030613",2001,641,15,626,179
"28360","E01030614",2001,561,27,534,20
"28361","E01030596",2001,509,25,484,26
"28362","E01030597",2001,658,6,652,81
"28363","E01030620",2001,745,41,704,123
"28364","E01030621",2001,632,198,434,57
"28365","E01030593",2001,629,78,551,73
"28366","E01030594",2001,639,189,450,27
"28367","E01030595",2001,623,87,536,41
"28368","E01030630",2001,571,104,467,25
"28369","E01030631",2001,637,203,434,26
"28370","E01030570",2001,636,86,550,27
"28371","E01030571",2001,599,22,577,17
"28372","E01030572",2001,647,179,468,62
"28373","E01030573",2001,696,51,645,52
"28374","E01030574",2001,769,50,719,128
"28375","E01030632",2001,534,4,530,31
"28376","E01030633",2001,569,162,407,43
"28377","E01030634",2001,583,286,297,14
"28378","E01030628",2001,546,31,515,16
"28379","E01030629",2001,513,10,503,61
"28380","E01030584",2001,634,19,615,23
"28381","E01030585",2001,652,29,623,33
"28382","E01030586",2001,627,141,486,29
"28383","E01030587",2001,610,119,491,41
"28384","E01030588",2001,617,235,382,36
"28385","E01030580",2001,588,7,581,99
"28386","E01030581",2001,518,0,518,28
"28387","E01030582",2001,531,15,516,124
"28388","E01030583",2001,564,3,561,19
"28389","E01030575",2001,766,39,727,132
"28390","E01030576",2001,623,37,586,76
"28391","E01030577",2001,765,33,732,100
"28392","E01030578",2001,602,248,354,20
"28393","E01030579",2001,521,52,469,51
"28394","E01030667",2001,744,156,588,146
"28395","E01030668",2001,728,32,696,120
"28396","E01030669",2001,599,88,511,62
"28397","E01030670",2001,492,21,471,32
"28398","E01030671",2001,458,26,432,139
"28399","E01030672",2001,761,8,753,120
"28400","E01030673",2001,469,13,456,105
"28401","E01030674",2001,641,251,390,88
"28402","E01030675",2001,512,103,409,95
"28403","E01030676",2001,468,181,287,93
"28404","E01030663",2001,617,228,389,20
"28405","E01030664",2001,727,266,461,30
"28406","E01030665",2001,658,101,557,103
"28407","E01030666",2001,727,40,687,90
"28408","E01030687",2001,527,14,513,34
"28409","E01030688",2001,611,41,570,40
"28410","E01030685",2001,493,17,476,37
"28411","E01030686",2001,634,5,629,42
"28412","E01030656",2001,558,144,414,23
"28413","E01030658",2001,579,3,576,38
"28414","E01030689",2001,607,23,584,77
"28415","E01030690",2001,617,35,582,144
"28416","E01030691",2001,590,12,578,48
"28417","E01030692",2001,540,4,536,69
"28418","E01030659",2001,744,71,673,69
"28419","E01030657",2001,519,265,254,19
"28420","E01030652",2001,612,13,599,54
"28421","E01030653",2001,601,145,456,67
"28422","E01030654",2001,618,0,618,88
"28423","E01030655",2001,513,0,513,22
"28424","E01030647",2001,739,13,726,60
"28425","E01030648",2001,611,51,560,36
"28426","E01030649",2001,745,71,674,112
"28427","E01030650",2001,528,146,382,30
"28428","E01030651",2001,515,64,451,38
"28429","E01030662",2001,615,79,536,24
"28430","E01030677",2001,667,108,559,98
"28431","E01030678",2001,579,144,435,57
"28432","E01030679",2001,464,6,458,63
"28433","E01030680",2001,611,5,606,38
"28434","E01030645",2001,852,309,543,61
"28435","E01030646",2001,878,12,866,136
"28436","E01030660",2001,792,44,748,37
"28437","E01030661",2001,667,9,658,29
"28438","E01030684",2001,608,103,505,52
"28439","E01030693",2001,502,22,480,11
"28440","E01030694",2001,510,106,404,18
"28441","E01030695",2001,488,0,488,11
"28442","E01030696",2001,637,44,593,47
"28443","E01030681",2001,651,85,566,35
"28444","E01030682",2001,501,18,483,30
"28445","E01030683",2001,533,22,511,41
"28446","E01030743",2001,668,96,572,39
"28447","E01030744",2001,821,313,508,72
"28448","E01030745",2001,594,213,381,32
"28449","E01030747",2001,560,25,535,53
"28450","E01030746",2001,604,140,464,22
"28451","E01030709",2001,581,88,493,45
"28452","E01030710",2001,651,175,476,37
"28453","E01030711",2001,499,112,387,35
"28454","E01030712",2001,518,5,513,79
"28455","E01030713",2001,512,10,502,34
"28456","E01030714",2001,464,14,450,20
"28457","E01030715",2001,608,8,600,43
"28458","E01030716",2001,593,32,561,27
"28459","E01030707",2001,618,31,587,62
"28460","E01030708",2001,606,46,560,43
"28461","E01030734",2001,525,33,492,30
"28462","E01030735",2001,621,32,589,84
"28463","E01030736",2001,874,60,814,284
"28464","E01030737",2001,703,118,585,108
"28465","E01030738",2001,735,147,588,131
"28466","E01030701",2001,623,47,576,30
"28467","E01030702",2001,522,184,338,38
"28468","E01030703",2001,610,11,599,31
"28469","E01030704",2001,605,49,556,81
"28470","E01030705",2001,640,10,630,36
"28471","E01030706",2001,531,3,528,41
"28472","E01030725",2001,492,45,447,32
"28473","E01030697",2001,656,11,645,17
"28474","E01030698",2001,656,21,635,37
"28475","E01030699",2001,619,86,533,19
"28476","E01030700",2001,740,72,668,68
"28477","E01030739",2001,699,232,467,27
"28478","E01030740",2001,757,240,517,22
"28479","E01030741",2001,626,80,546,49
"28480","E01030729",2001,614,100,514,15
"28481","E01030748",2001,624,76,548,35
"28482","E01030749",2001,618,187,431,22
"28483","E01030750",2001,586,126,460,40
"28484","E01030751",2001,632,73,559,83
"28485","E01030752",2001,626,250,376,41
"28486","E01030742",2001,751,38,713,63
"28487","E01030726",2001,656,20,636,24
"28488","E01030727",2001,859,44,815,111
"28489","E01030728",2001,718,0,718,42
"28490","E01030753",2001,767,63,704,88
"28491","E01030754",2001,610,6,604,42
"28492","E01030755",2001,642,93,549,26
"28493","E01030756",2001,638,11,627,45
"28494","E01030717",2001,762,53,709,54
"28495","E01030718",2001,514,63,451,11
"28496","E01030719",2001,598,126,472,19
"28497","E01030720",2001,628,80,548,16
"28498","E01030721",2001,614,75,539,32
"28499","E01030722",2001,625,9,616,32
"28500","E01030723",2001,625,34,591,24
"28501","E01030724",2001,640,163,477,21
"28502","E01030730",2001,767,8,759,44
"28503","E01030731",2001,648,0,648,41
"28504","E01030732",2001,724,15,709,72
"28505","E01030733",2001,761,35,726,113
"28506","E01030763",2001,501,18,483,40
"28507","E01030764",2001,486,3,483,34
"28508","E01030765",2001,609,163,446,25
"28509","E01030809",2001,618,60,558,71
"28510","E01030810",2001,510,3,507,28
"28511","E01030811",2001,597,3,594,43
"28512","E01030757",2001,660,11,649,107
"28513","E01030758",2001,432,15,417,35
"28514","E01030759",2001,726,218,508,66
"28515","E01030760",2001,488,17,471,26
"28516","E01030778",2001,738,4,734,43
"28517","E01030779",2001,725,9,716,53
"28518","E01030780",2001,644,5,639,47
"28519","E01030781",2001,620,97,523,37
"28520","E01030801",2001,500,83,417,164
"28521","E01030802",2001,638,5,633,88
"28522","E01030786",2001,647,296,351,38
"28523","E01030787",2001,510,136,374,23
"28524","E01030788",2001,489,231,258,16
"28525","E01030796",2001,504,3,501,23
"28526","E01030797",2001,498,0,498,31
"28527","E01030798",2001,515,0,515,21
"28528","E01030799",2001,492,0,492,45
"28529","E01030800",2001,534,9,525,118
"28530","E01030761",2001,580,24,556,25
"28531","E01030762",2001,745,14,731,46
"28532","E01030806",2001,533,15,518,19
"28533","E01030807",2001,477,30,447,25
"28534","E01030808",2001,629,3,626,42
"28535","E01030774",2001,521,0,521,46
"28536","E01030775",2001,535,6,529,22
"28537","E01030776",2001,620,6,614,34
"28538","E01030777",2001,621,40,581,60
"28539","E01030793",2001,619,249,370,109
"28540","E01030794",2001,598,47,551,65
"28541","E01030795",2001,625,43,582,79
"28542","E01030803",2001,610,99,511,84
"28543","E01030804",2001,610,10,600,46
"28544","E01030805",2001,613,236,377,24
"28545","E01030789",2001,503,6,497,16
"28546","E01030790",2001,626,59,567,28
"28547","E01030791",2001,641,0,641,31
"28548","E01030792",2001,467,3,464,18
"28549","E01030766",2001,662,73,589,69
"28550","E01030767",2001,596,180,416,23
"28551","E01030768",2001,501,70,431,42
"28552","E01030769",2001,566,3,563,17
"28553","E01030770",2001,597,5,592,56
"28554","E01030771",2001,475,0,475,25
"28555","E01030772",2001,616,108,508,46
"28556","E01030773",2001,510,15,495,35
"28557","E01030782",2001,618,89,529,27
"28558","E01030783",2001,636,17,619,70
"28559","E01030784",2001,461,25,436,232
"28560","E01030785",2001,654,3,651,61
"28561","E01030849",2001,693,50,643,26
"28562","E01030852",2001,620,169,451,57
"28563","E01030853",2001,679,64,615,37
"28564","E01030854",2001,764,44,720,17
"28565","E01030855",2001,735,7,728,19
"28566","E01030856",2001,621,34,587,31
"28567","E01030859",2001,638,33,605,62
"28568","E01030860",2001,866,79,787,106
"28569","E01030857",2001,615,177,438,25
"28570","E01030858",2001,840,81,759,53
"28571","E01030844",2001,526,14,512,61
"28572","E01030845",2001,509,60,449,16
"28573","E01030846",2001,524,43,481,22
"28574","E01030850",2001,891,107,784,92
"28575","E01030851",2001,750,111,639,41
"28576","E01030828",2001,491,3,488,32
"28577","E01030829",2001,599,49,550,64
"28578","E01030830",2001,498,10,488,28
"28579","E01030861",2001,734,14,720,45
"28580","E01030847",2001,674,100,574,28
"28581","E01030848",2001,855,82,773,72
"28582","E01030820",2001,635,10,625,12
"28583","E01030831",2001,873,22,851,79
"28584","E01030832",2001,605,67,538,53
"28585","E01030836",2001,717,127,590,100
"28586","E01030837",2001,563,39,524,22
"28587","E01030838",2001,501,44,457,49
"28588","E01030839",2001,552,19,533,31
"28589","E01030840",2001,584,127,457,31
"28590","E01030841",2001,503,18,485,14
"28591","E01030842",2001,556,183,373,20
"28592","E01030843",2001,623,172,451,50
"28593","E01030812",2001,627,157,470,56
"28594","E01030813",2001,617,46,571,59
"28595","E01030814",2001,459,55,404,23
"28596","E01030815",2001,603,101,502,48
"28597","E01030824",2001,618,192,426,24
"28598","E01030825",2001,586,59,527,43
"28599","E01030826",2001,585,100,485,30
"28600","E01030827",2001,600,86,514,31
"28601","E01030833",2001,615,110,505,57
"28602","E01030834",2001,545,140,405,27
"28603","E01030835",2001,504,25,479,15
"28604","E01030821",2001,786,114,672,84
"28605","E01030822",2001,642,6,636,44
"28606","E01030823",2001,779,23,756,38
"28607","E01030816",2001,582,42,540,74
"28608","E01030817",2001,593,21,572,40
"28609","E01030818",2001,500,92,408,35
"28610","E01030819",2001,555,13,542,58
"28611","E01030890",2001,627,110,517,29
"28612","E01030902",2001,530,10,520,34
"28613","E01030903",2001,624,47,577,51
"28614","E01030904",2001,641,130,511,29
"28615","E01030899",2001,641,0,641,44
"28616","E01030900",2001,505,50,455,15
"28617","E01030901",2001,503,219,284,44
"28618","E01030891",2001,627,4,623,29
"28619","E01030892",2001,500,8,492,46
"28620","E01030893",2001,610,132,478,49
"28621","E01030884",2001,696,178,518,81
"28622","E01030885",2001,631,104,527,130
"28623","E01030886",2001,467,38,429,28
"28624","E01030895",2001,629,151,478,103
"28625","E01030881",2001,530,3,527,23
"28626","E01030894",2001,567,4,563,32
"28627","E01030883",2001,520,56,464,20
"28628","E01030888",2001,616,55,561,66
"28629","E01030911",2001,620,109,511,35
"28630","E01030912",2001,550,198,352,24
"28631","E01030913",2001,509,236,273,30
"28632","E01030920",2001,612,54,558,76
"28633","E01030921",2001,769,223,546,83
"28634","E01030896",2001,493,169,324,18
"28635","E01030897",2001,479,47,432,19
"28636","E01030889",2001,627,172,455,47
"28637","E01030882",2001,510,6,504,26
"28638","E01030887",2001,518,56,462,32
"28639","E01030922",2001,629,19,610,91
"28640","E01030916",2001,708,31,677,155
"28641","E01030917",2001,495,19,476,125
"28642","E01030918",2001,532,78,454,86
"28643","E01030919",2001,523,6,517,42
"28644","E01030940",2001,739,93,646,65
"28645","E01030863",2001,740,39,701,45
"28646","E01030865",2001,613,187,426,57
"28647","E01030866",2001,600,8,592,61
"28648","E01030898",2001,603,5,598,40
"28649","E01030905",2001,528,117,411,35
"28650","E01030906",2001,645,24,621,52
"28651","E01030907",2001,471,4,467,30
"28652","E01030914",2001,525,210,315,50
"28653","E01030915",2001,629,155,474,31
"28654","E01030923",2001,542,8,534,30
"28655","E01030924",2001,495,0,495,42
"28656","E01030925",2001,502,3,499,12
"28657","E01030937",2001,593,62,531,50
"28658","E01030938",2001,604,177,427,49
"28659","E01030939",2001,463,36,427,15
"28660","E01030877",2001,518,149,369,45
"28661","E01030878",2001,606,12,594,38
"28662","E01030879",2001,453,17,436,35
"28663","E01030864",2001,533,24,509,71
"28664","E01030941",2001,415,3,412,14
"28665","E01030942",2001,549,33,516,51
"28666","E01030943",2001,521,177,344,22
"28667","E01030870",2001,625,3,622,25
"28668","E01030871",2001,650,69,581,51
"28669","E01030872",2001,728,268,460,35
"28670","E01030873",2001,608,83,525,41
"28671","E01030874",2001,460,21,439,50
"28672","E01030875",2001,588,80,508,87
"28673","E01030876",2001,518,0,518,12
"28674","E01030934",2001,501,86,415,42
"28675","E01030935",2001,475,8,467,33
"28676","E01030936",2001,501,38,463,49
"28677","E01030908",2001,563,14,549,32
"28678","E01030909",2001,489,61,428,36
"28679","E01030910",2001,461,78,383,24
"28680","E01030880",2001,798,72,726,41
"28681","E01030867",2001,556,49,507,42
"28682","E01030868",2001,474,29,445,16
"28683","E01030869",2001,450,98,352,35
"28684","E01030862",2001,841,82,759,71
"28685","E01030930",2001,632,18,614,66
"28686","E01030931",2001,686,35,651,61
"28687","E01030932",2001,578,132,446,28
"28688","E01030933",2001,672,201,471,46
"28689","E01030926",2001,596,70,526,40
"28690","E01030927",2001,534,124,410,24
"28691","E01030928",2001,731,139,592,117
"28692","E01030929",2001,510,6,504,53
"28693","E01030946",2001,599,243,356,29
"28694","E01030947",2001,499,24,475,18
"28695","E01030948",2001,610,39,571,50
"28696","E01030949",2001,613,48,565,30
"28697","E01030950",2001,650,52,598,40
"28698","E01030996",2001,574,6,568,22
"28699","E01030998",2001,716,3,713,63
"28700","E01031002",2001,640,5,635,41
"28701","E01031003",2001,617,12,605,100
"28702","E01031004",2001,856,102,754,156
"28703","E01030963",2001,496,3,493,20
"28704","E01030964",2001,630,34,596,98
"28705","E01030965",2001,528,12,516,19
"28706","E01030966",2001,498,35,463,29
"28707","E01030967",2001,580,18,562,30
"28708","E01030968",2001,531,137,394,38
"28709","E01030980",2001,466,83,383,100
"28710","E01030981",2001,463,125,338,26
"28711","E01030982",2001,608,117,491,86
"28712","E01030983",2001,499,113,386,88
"28713","E01030984",2001,683,216,467,30
"28714","E01030985",2001,622,366,256,17
"28715","E01030956",2001,524,88,436,41
"28716","E01030957",2001,508,133,375,22
"28717","E01030958",2001,634,9,625,47
"28718","E01030959",2001,479,48,431,27
"28719","E01030951",2001,659,46,613,62
"28720","E01030952",2001,619,438,181,20
"28721","E01030953",2001,672,17,655,63
"28722","E01030988",2001,685,0,685,198
"28723","E01030989",2001,582,40,542,67
"28724","E01030990",2001,574,37,537,64
"28725","E01030997",2001,677,33,644,34
"28726","E01030979",2001,527,65,462,33
"28727","E01030974",2001,629,126,503,48
"28728","E01030975",2001,549,30,519,30
"28729","E01030976",2001,627,15,612,43
"28730","E01030977",2001,612,38,574,58
"28731","E01030969",2001,530,10,520,56
"28732","E01030970",2001,638,129,509,75
"28733","E01030954",2001,693,68,625,173
"28734","E01030991",2001,902,32,870,220
"28735","E01030993",2001,903,54,849,299
"28736","E01031000",2001,620,12,608,46
"28737","E01030960",2001,753,59,694,56
"28738","E01030961",2001,729,25,704,28
"28739","E01030962",2001,751,323,428,40
"28740","E01030955",2001,582,6,576,51
"28741","E01031001",2001,724,125,599,59
"28742","E01030999",2001,494,3,491,28
"28743","E01030992",2001,615,6,609,83
"28744","E01030994",2001,531,61,470,37
"28745","E01030995",2001,520,142,378,37
"28746","E01030971",2001,744,207,537,26
"28747","E01030972",2001,677,94,583,56
"28748","E01030973",2001,673,138,535,21
"28749","E01030978",2001,488,64,424,19
"28750","E01030944",2001,475,3,472,43
"28751","E01030945",2001,459,5,454,45
"28752","E01030986",2001,416,0,416,14
"28753","E01030987",2001,509,10,499,29
"28754","E01031349",2001,552,27,525,18
"28755","E01031350",2001,488,162,326,10
"28756","E01031351",2001,641,32,609,13
"28757","E01031352",2001,642,84,558,15
"28758","E01031370",2001,551,131,420,11
"28759","E01031374",2001,637,16,621,72
"28760","E01031365",2001,628,70,558,23
"28761","E01031367",2001,548,0,548,11
"28762","E01031338",2001,502,7,495,14
"28763","E01031339",2001,509,10,499,20
"28764","E01031340",2001,629,6,623,8
"28765","E01031359",2001,524,15,509,30
"28766","E01031353",2001,479,6,473,31
"28767","E01031354",2001,542,9,533,16
"28768","E01031355",2001,662,70,592,20
"28769","E01031345",2001,641,33,608,20
"28770","E01031347",2001,633,211,422,38
"28771","E01031348",2001,607,250,357,19
"28772","E01031366",2001,475,176,299,20
"28773","E01031371",2001,610,245,365,23
"28774","E01031372",2001,523,168,355,10
"28775","E01031373",2001,629,103,526,45
"28776","E01031375",2001,697,80,617,64
"28777","E01031368",2001,523,77,446,20
"28778","E01031369",2001,613,33,580,63
"28779","E01031364",2001,536,116,420,92
"28780","E01031356",2001,718,6,712,40
"28781","E01031357",2001,979,31,948,130
"28782","E01031346",2001,642,11,631,39
"28783","E01031344",2001,596,173,423,26
"28784","E01031361",2001,613,219,394,24
"28785","E01031362",2001,495,24,471,16
"28786","E01031363",2001,750,96,654,39
"28787","E01031360",2001,620,136,484,36
"28788","E01031358",2001,643,272,371,21
"28789","E01031376",2001,628,38,590,38
"28790","E01031378",2001,652,33,619,47
"28791","E01031379",2001,721,20,701,27
"28792","E01031377",2001,734,118,616,83
"28793","E01031341",2001,635,199,436,72
"28794","E01031342",2001,792,37,755,64
"28795","E01031343",2001,619,15,604,57
"28796","E01031390",2001,545,113,432,31
"28797","E01031391",2001,743,46,697,80
"28798","E01031392",2001,707,48,659,133
"28799","E01031465",2001,507,37,470,82
"28800","E01031386",2001,587,83,504,35
"28801","E01031387",2001,682,72,610,24
"28802","E01031425",2001,546,7,539,26
"28803","E01031426",2001,522,88,434,38
"28804","E01031393",2001,671,13,658,34
"28805","E01031394",2001,631,118,513,41
"28806","E01031395",2001,597,16,581,38
"28807","E01031396",2001,719,108,611,43
"28808","E01031397",2001,614,22,592,46
"28809","E01031466",2001,596,50,546,32
"28810","E01031467",2001,672,47,625,51
"28811","E01031468",2001,628,28,600,52
"28812","E01031427",2001,624,237,387,40
"28813","E01031429",2001,526,262,264,19
"28814","E01031430",2001,612,64,548,40
"28815","E01031414",2001,638,86,552,28
"28816","E01031415",2001,729,161,568,35
"28817","E01031388",2001,607,37,570,35
"28818","E01031389",2001,688,3,685,36
"28819","E01031459",2001,745,225,520,55
"28820","E01031470",2001,518,26,492,38
"28821","E01031471",2001,526,7,519,22
"28822","E01031472",2001,598,42,556,36
"28823","E01031473",2001,483,144,339,20
"28824","E01031462",2001,636,60,576,51
"28825","E01031463",2001,597,11,586,24
"28826","E01031464",2001,757,34,723,71
"28827","E01031407",2001,545,72,473,23
"28828","E01031408",2001,674,15,659,51
"28829","E01031410",2001,590,52,538,32
"28830","E01031412",2001,650,8,642,17
"28831","E01031422",2001,749,7,742,61
"28832","E01031423",2001,761,29,732,38
"28833","E01031424",2001,668,3,665,25
"28834","E01031409",2001,491,106,385,24
"28835","E01031398",2001,577,29,548,13
"28836","E01031399",2001,739,46,693,15
"28837","E01031469",2001,754,55,699,46
"28838","E01031461",2001,792,12,780,29
"28839","E01031455",2001,605,80,525,58
"28840","E01031457",2001,852,67,785,61
"28841","E01031458",2001,893,6,887,30
"28842","E01031460",2001,889,17,872,55
"28843","E01031413",2001,610,6,604,81
"28844","E01031411",2001,652,97,555,14
"28845","E01031400",2001,781,36,745,220
"28846","E01031428",2001,622,26,596,125
"28847","E01031454",2001,754,76,678,205
"28848","E01031456",2001,886,70,816,299
"28849","E01031401",2001,622,13,609,55
"28850","E01031402",2001,614,21,593,45
"28851","E01031403",2001,636,85,551,53
"28852","E01031405",2001,653,12,641,41
"28853","E01031406",2001,503,22,481,29
"28854","E01031417",2001,686,23,663,56
"28855","E01031438",2001,734,108,626,56
"28856","E01031439",2001,866,55,811,40
"28857","E01031440",2001,763,10,753,59
"28858","E01031441",2001,718,208,510,30
"28859","E01031442",2001,609,15,594,102
"28860","E01031433",2001,616,133,483,41
"28861","E01031434",2001,631,80,551,111
"28862","E01031404",2001,502,254,248,20
"28863","E01031418",2001,752,35,717,16
"28864","E01031419",2001,764,19,745,140
"28865","E01031420",2001,736,3,733,45
"28866","E01031421",2001,719,3,716,18
"28867","E01031416",2001,615,0,615,7
"28868","E01031450",2001,488,233,255,37
"28869","E01031451",2001,592,234,358,26
"28870","E01031452",2001,489,36,453,50
"28871","E01031443",2001,511,116,395,36
"28872","E01031444",2001,630,90,540,126
"28873","E01031453",2001,746,115,631,160
"28874","E01031435",2001,689,3,686,142
"28875","E01031436",2001,1027,121,906,464
"28876","E01031437",2001,854,23,831,307
"28877","E01031431",2001,504,55,449,118
"28878","E01031432",2001,806,46,760,324
"28879","E01031380",2001,741,7,734,37
"28880","E01031381",2001,739,13,726,80
"28881","E01031382",2001,770,0,770,34
"28882","E01031383",2001,742,12,730,22
"28883","E01031384",2001,739,5,734,39
"28884","E01031385",2001,764,184,580,27
"28885","E01031445",2001,652,29,623,42
"28886","E01031446",2001,628,6,622,29
"28887","E01031447",2001,738,3,735,21
"28888","E01031448",2001,750,10,740,50
"28889","E01031449",2001,615,55,560,38
"28890","E01031502",2001,560,11,549,26
"28891","E01031503",2001,549,62,487,49
"28892","E01031504",2001,885,155,730,71
"28893","E01031519",2001,534,110,424,62
"28894","E01031517",2001,644,49,595,33
"28895","E01031518",2001,591,27,564,40
"28896","E01031544",2001,455,59,396,47
"28897","E01031545",2001,487,57,430,30
"28898","E01031536",2001,525,80,445,68
"28899","E01031520",2001,537,110,427,56
"28900","E01031521",2001,444,18,426,39
"28901","E01031508",2001,857,119,738,98
"28902","E01031497",2001,487,86,401,48
"28903","E01031510",2001,729,125,604,122
"28904","E01031511",2001,744,41,703,79
"28905","E01031512",2001,851,337,514,51
"28906","E01031537",2001,433,58,375,68
"28907","E01031514",2001,675,50,625,163
"28908","E01031515",2001,642,253,389,43
"28909","E01031516",2001,654,85,569,96
"28910","E01031498",2001,506,30,476,115
"28911","E01031478",2001,468,30,438,80
"28912","E01031479",2001,429,45,384,55
"28913","E01031485",2001,622,8,614,9
"28914","E01031487",2001,634,35,599,25
"28915","E01031477",2001,955,148,807,220
"28916","E01031509",2001,818,185,633,65
"28917","E01031506",2001,489,38,451,32
"28918","E01031507",2001,558,22,536,124
"28919","E01031531",2001,510,16,494,15
"28920","E01031533",2001,521,153,368,26
"28921","E01031543",2001,893,148,745,77
"28922","E01031494",2001,718,380,338,30
"28923","E01031495",2001,751,58,693,124
"28924","E01031488",2001,610,217,393,98
"28925","E01031486",2001,657,50,607,139
"28926","E01031482",2001,632,274,358,83
"28927","E01031483",2001,638,354,284,39
"28928","E01031475",2001,482,19,463,42
"28929","E01031476",2001,726,32,694,122
"28930","E01031534",2001,713,69,644,96
"28931","E01031535",2001,614,68,546,44
"28932","E01031532",2001,464,34,430,203
"28933","E01031480",2001,597,121,476,99
"28934","E01031481",2001,633,105,528,130
"28935","E01031484",2001,748,166,582,139
"28936","E01031490",2001,746,59,687,134
"28937","E01031491",2001,874,141,733,154
"28938","E01031474",2001,591,82,509,55
"28939","E01031496",2001,877,19,858,88
"28940","E01031493",2001,724,85,639,64
"28941","E01031505",2001,840,39,801,80
"28942","E01031513",2001,882,144,738,79
"28943","E01031492",2001,599,335,264,30
"28944","E01031489",2001,622,43,579,52
"28945","E01031530",2001,471,133,338,31
"28946","E01031538",2001,477,151,326,27
"28947","E01031539",2001,483,68,415,54
"28948","E01031540",2001,677,54,623,69
"28949","E01031541",2001,662,12,650,38
"28950","E01031542",2001,779,62,717,61
"28951","E01031529",2001,452,38,414,30
"28952","E01031499",2001,646,132,514,70
"28953","E01031500",2001,660,22,638,46
"28954","E01031501",2001,669,64,605,104
"28955","E01031522",2001,679,194,485,50
"28956","E01031523",2001,626,5,621,45
"28957","E01031524",2001,702,11,691,49
"28958","E01031525",2001,610,41,569,40
"28959","E01031526",2001,501,70,431,13
"28960","E01031527",2001,641,21,620,37
"28961","E01031528",2001,642,15,627,94
"28962","E01031573",2001,644,223,421,20
"28963","E01031574",2001,507,69,438,13
"28964","E01031575",2001,641,221,420,33
"28965","E01031576",2001,599,196,403,25
"28966","E01031577",2001,492,72,420,33
"28967","E01031593",2001,627,18,609,62
"28968","E01031586",2001,737,146,591,68
"28969","E01031587",2001,636,8,628,22
"28970","E01031588",2001,619,19,600,34
"28971","E01031590",2001,658,3,655,31
"28972","E01031570",2001,510,116,394,11
"28973","E01031571",2001,586,192,394,19
"28974","E01031572",2001,601,207,394,17
"28975","E01031609",2001,649,284,365,22
"28976","E01031610",2001,733,252,481,65
"28977","E01031601",2001,529,116,413,34
"28978","E01031602",2001,635,133,502,27
"28979","E01031583",2001,723,174,549,169
"28980","E01031584",2001,616,141,475,35
"28981","E01031585",2001,621,170,451,51
"28982","E01031591",2001,653,166,487,71
"28983","E01031589",2001,716,17,699,32
"28984","E01031603",2001,505,62,443,17
"28985","E01031594",2001,620,203,417,25
"28986","E01031600",2001,638,153,485,53
"28987","E01031564",2001,619,77,542,28
"28988","E01031565",2001,849,273,576,20
"28989","E01031566",2001,624,92,532,17
"28990","E01031567",2001,502,81,421,27
"28991","E01031568",2001,629,81,548,72
"28992","E01031596",2001,749,238,511,52
"28993","E01031597",2001,602,19,583,24
"28994","E01031598",2001,643,198,445,77
"28995","E01031599",2001,756,89,667,88
"28996","E01031608",2001,622,132,490,55
"28997","E01031592",2001,627,8,619,32
"28998","E01031580",2001,622,5,617,48
"28999","E01031581",2001,620,0,620,29
"29000","E01031578",2001,743,13,730,75
"29001","E01031579",2001,643,152,491,74
"29002","E01031560",2001,661,82,579,16
"29003","E01031561",2001,616,70,546,20
"29004","E01031562",2001,615,273,342,34
"29005","E01031563",2001,510,20,490,27
"29006","E01031582",2001,723,19,704,89
"29007","E01031569",2001,626,262,364,23
"29008","E01031547",2001,520,214,306,32
"29009","E01031548",2001,668,301,367,30
"29010","E01031549",2001,501,190,311,18
"29011","E01031550",2001,505,213,292,27
"29012","E01031595",2001,666,208,458,32
"29013","E01031604",2001,729,235,494,32
"29014","E01031605",2001,625,206,419,10
"29015","E01031606",2001,640,176,464,13
"29016","E01031607",2001,608,160,448,17
"29017","E01031551",2001,493,125,368,19
"29018","E01031546",2001,488,101,387,19
"29019","E01031553",2001,487,269,218,17
"29020","E01031554",2001,661,120,541,54
"29021","E01031555",2001,497,180,317,31
"29022","E01031556",2001,619,330,289,16
"29023","E01031557",2001,779,34,745,114
"29024","E01031558",2001,638,491,147,18
"29025","E01031559",2001,504,148,356,22
"29026","E01031552",2001,639,220,419,41
"29027","E01031670",2001,654,22,632,89
"29028","E01031671",2001,757,264,493,38
"29029","E01031673",2001,635,39,596,18
"29030","E01031676",2001,920,50,870,155
"29031","E01031666",2001,641,28,613,14
"29032","E01031668",2001,641,47,594,27
"29033","E01031644",2001,550,6,544,24
"29034","E01031645",2001,549,19,530,46
"29035","E01031646",2001,589,37,552,31
"29036","E01031647",2001,476,125,351,23
"29037","E01031649",2001,465,3,462,21
"29038","E01031650",2001,467,3,464,28
"29039","E01031651",2001,568,127,441,49
"29040","E01031648",2001,742,71,671,81
"29041","E01031620",2001,626,134,492,30
"29042","E01031658",2001,781,109,672,87
"29043","E01031689",2001,616,17,599,74
"29044","E01031654",2001,616,57,559,39
"29045","E01031655",2001,596,21,575,63
"29046","E01031669",2001,641,148,493,54
"29047","E01031667",2001,637,176,461,28
"29048","E01031672",2001,673,10,663,122
"29049","E01031674",2001,496,23,473,47
"29050","E01031675",2001,520,37,483,32
"29051","E01031659",2001,535,29,506,29
"29052","E01031657",2001,628,113,515,38
"29053","E01031691",2001,628,57,571,50
"29054","E01031656",2001,763,262,501,93
"29055","E01031652",2001,598,275,323,15
"29056","E01031653",2001,652,38,614,92
"29057","E01031636",2001,876,146,730,177
"29058","E01031688",2001,601,179,422,25
"29059","E01031637",2001,656,223,433,18
"29060","E01031638",2001,768,34,734,56
"29061","E01031619",2001,620,6,614,54
"29062","E01031690",2001,638,3,635,14
"29063","E01031679",2001,417,7,410,89
"29064","E01031660",2001,494,6,488,29
"29065","E01031661",2001,583,60,523,66
"29066","E01031639",2001,645,52,593,34
"29067","E01031640",2001,700,3,697,22
"29068","E01031680",2001,477,0,477,14
"29069","E01031681",2001,580,43,537,43
"29070","E01031682",2001,463,9,454,32
"29071","E01031683",2001,518,38,480,20
"29072","E01031677",2001,590,117,473,24
"29073","E01031678",2001,497,20,477,10
"29074","E01031611",2001,582,30,552,93
"29075","E01031612",2001,628,79,549,20
"29076","E01031613",2001,640,42,598,61
"29077","E01031614",2001,627,209,418,62
"29078","E01031615",2001,659,74,585,52
"29079","E01031632",2001,521,20,501,77
"29080","E01031633",2001,474,33,441,24
"29081","E01031634",2001,493,68,425,46
"29082","E01031635",2001,516,36,480,21
"29083","E01031627",2001,641,7,634,14
"29084","E01031623",2001,718,58,660,41
"29085","E01031621",2001,751,3,748,8
"29086","E01031664",2001,628,20,608,40
"29087","E01031665",2001,477,53,424,45
"29088","E01031662",2001,611,64,547,65
"29089","E01031663",2001,611,210,401,21
"29090","E01031626",2001,603,47,556,52
"29091","E01031630",2001,737,71,666,28
"29092","E01031631",2001,746,303,443,47
"29093","E01031618",2001,497,20,477,33
"29094","E01031641",2001,723,40,683,72
"29095","E01031642",2001,721,29,692,41
"29096","E01031643",2001,632,233,399,17
"29097","E01031687",2001,611,190,421,40
"29098","E01031622",2001,599,10,589,98
"29099","E01031624",2001,536,56,480,35
"29100","E01031625",2001,534,19,515,32
"29101","E01031628",2001,475,96,379,54
"29102","E01031629",2001,601,38,563,18
"29103","E01031684",2001,628,9,619,31
"29104","E01031685",2001,764,51,713,78
"29105","E01031686",2001,620,14,606,31
"29106","E01031616",2001,676,72,604,56
"29107","E01031617",2001,953,35,918,54
"29108","E01031731",2001,758,319,439,25
"29109","E01031732",2001,621,184,437,45
"29110","E01031733",2001,727,85,642,85
"29111","E01031734",2001,600,21,579,24
"29112","E01031741",2001,512,33,479,50
"29113","E01031742",2001,736,76,660,95
"29114","E01031743",2001,661,157,504,100
"29115","E01031718",2001,623,9,614,26
"29116","E01031719",2001,598,59,539,30
"29117","E01031720",2001,515,9,506,22
"29118","E01031722",2001,444,64,380,70
"29119","E01031695",2001,525,4,521,30
"29120","E01031696",2001,534,64,470,28
"29121","E01031735",2001,668,8,660,34
"29122","E01031729",2001,625,15,610,19
"29123","E01031730",2001,760,14,746,85
"29124","E01031736",2001,596,7,589,39
"29125","E01031737",2001,551,62,489,24
"29126","E01031738",2001,507,0,507,14
"29127","E01031739",2001,634,11,623,49
"29128","E01031740",2001,498,10,488,32
"29129","E01031723",2001,527,13,514,27
"29130","E01031724",2001,495,3,492,7
"29131","E01031725",2001,559,31,528,30
"29132","E01031721",2001,671,73,598,20
"29133","E01031694",2001,620,93,527,71
"29134","E01031764",2001,552,71,481,47
"29135","E01031765",2001,588,59,529,46
"29136","E01031766",2001,806,37,769,90
"29137","E01031697",2001,444,44,400,35
"29138","E01031727",2001,608,15,593,70
"29139","E01031692",2001,738,109,629,99
"29140","E01031693",2001,686,83,603,116
"29141","E01031760",2001,602,5,597,44
"29142","E01031758",2001,502,4,498,16
"29143","E01031772",2001,693,139,554,56
"29144","E01031773",2001,779,12,767,34
"29145","E01031774",2001,618,4,614,15
"29146","E01031775",2001,748,29,719,64
"29147","E01031759",2001,669,53,616,71
"29148","E01031761",2001,920,58,862,213
"29149","E01031762",2001,730,56,674,121
"29150","E01031751",2001,1002,80,922,204
"29151","E01031752",2001,647,376,271,14
"29152","E01031753",2001,502,64,438,32
"29153","E01031754",2001,616,63,553,46
"29154","E01031755",2001,519,48,471,51
"29155","E01031757",2001,653,229,424,40
"29156","E01031756",2001,591,101,490,29
"29157","E01031749",2001,600,13,587,29
"29158","E01031750",2001,611,192,419,28
"29159","E01031763",2001,608,0,608,11
"29160","E01031728",2001,724,39,685,104
"29161","E01031726",2001,598,127,471,43
"29162","E01031714",2001,500,71,429,6
"29163","E01031699",2001,682,5,677,48
"29164","E01031700",2001,602,3,599,25
"29165","E01031701",2001,748,102,646,58
"29166","E01031704",2001,630,3,627,31
"29167","E01031706",2001,649,23,626,24
"29168","E01031711",2001,635,41,594,24
"29169","E01031712",2001,621,145,476,29
"29170","E01031713",2001,540,6,534,22
"29171","E01031716",2001,451,161,290,19
"29172","E01031717",2001,511,9,502,52
"29173","E01031707",2001,624,55,569,17
"29174","E01031708",2001,669,80,589,149
"29175","E01031709",2001,731,153,578,50
"29176","E01031705",2001,627,199,428,30
"29177","E01031710",2001,599,6,593,11
"29178","E01031702",2001,480,6,474,12
"29179","E01031703",2001,640,9,631,19
"29180","E01031715",2001,605,3,602,73
"29181","E01031698",2001,561,45,516,52
"29182","E01031767",2001,514,16,498,38
"29183","E01031769",2001,585,102,483,39
"29184","E01031770",2001,601,41,560,89
"29185","E01031771",2001,556,202,354,30
"29186","E01031768",2001,634,38,596,23
"29187","E01031744",2001,566,7,559,16
"29188","E01031745",2001,620,5,615,28
"29189","E01031746",2001,681,192,489,67
"29190","E01031747",2001,649,18,631,39
"29191","E01031748",2001,538,7,531,26
"29192","E01031793",2001,597,3,594,11
"29193","E01031820",2001,782,6,776,11
"29194","E01031821",2001,735,55,680,48
"29195","E01031828",2001,510,0,510,13
"29196","E01031829",2001,596,0,596,20
"29197","E01031825",2001,748,82,666,34
"29198","E01031826",2001,606,70,536,31
"29199","E01031827",2001,615,80,535,57
"29200","E01031839",2001,735,102,633,50
"29201","E01031822",2001,636,13,623,34
"29202","E01031818",2001,727,106,621,39
"29203","E01031830",2001,617,158,459,33
"29204","E01031794",2001,651,106,545,26
"29205","E01031795",2001,634,127,507,39
"29206","E01031792",2001,621,70,551,34
"29207","E01031797",2001,491,6,485,19
"29208","E01031800",2001,610,0,610,41
"29209","E01031778",2001,605,12,593,73
"29210","E01031823",2001,521,4,517,6
"29211","E01031824",2001,497,4,493,14
"29212","E01031780",2001,520,7,513,29
"29213","E01031781",2001,584,22,562,21
"29214","E01031776",2001,628,13,615,68
"29215","E01031777",2001,633,33,600,80
"29216","E01031798",2001,650,55,595,111
"29217","E01031783",2001,615,272,343,19
"29218","E01031785",2001,636,49,587,41
"29219","E01031786",2001,613,117,496,30
"29220","E01031819",2001,468,318,150,18
"29221","E01031817",2001,638,111,527,46
"29222","E01031838",2001,609,25,584,47
"29223","E01031840",2001,751,27,724,49
"29224","E01031836",2001,734,211,523,37
"29225","E01031782",2001,787,68,719,20
"29226","E01031784",2001,772,83,689,64
"29227","E01031796",2001,626,56,570,92
"29228","E01031799",2001,619,114,505,73
"29229","E01031791",2001,743,156,587,146
"29230","E01031801",2001,732,25,707,156
"29231","E01031837",2001,750,19,731,112
"29232","E01031831",2001,625,26,599,83
"29233","E01031832",2001,862,145,717,89
"29234","E01031833",2001,583,70,513,135
"29235","E01031834",2001,624,104,520,32
"29236","E01031779",2001,484,188,296,30
"29237","E01031790",2001,853,194,659,219
"29238","E01031807",2001,769,82,687,118
"29239","E01031809",2001,882,29,853,268
"29240","E01031810",2001,720,57,663,176
"29241","E01031811",2001,623,49,574,178
"29242","E01031808",2001,764,88,676,363
"29243","E01031835",2001,787,16,771,259
"29244","E01031787",2001,930,86,844,368
"29245","E01031788",2001,743,51,692,195
"29246","E01031789",2001,783,29,754,314
"29247","E01031812",2001,786,14,772,110
"29248","E01031813",2001,742,63,679,106
"29249","E01031814",2001,739,17,722,73
"29250","E01031815",2001,777,24,753,97
"29251","E01031816",2001,626,3,623,41
"29252","E01031802",2001,839,12,827,39
"29253","E01031803",2001,655,3,652,6
"29254","E01031804",2001,747,11,736,21
"29255","E01031805",2001,807,3,804,38
"29256","E01031806",2001,718,149,569,73
"29257","E01014399",2001,634,64,570,24
"29258","E01014400",2001,756,59,697,60
"29259","E01014401",2001,630,221,409,15
"29260","E01014402",2001,732,89,643,19
"29261","E01014403",2001,754,189,565,26
"29262","E01014404",2001,732,267,465,24
"29263","E01014395",2001,516,0,516,5
"29264","E01014396",2001,636,34,602,57
"29265","E01014397",2001,516,3,513,17
"29266","E01014398",2001,643,81,562,30
"29267","E01014409",2001,749,224,525,55
"29268","E01014410",2001,729,32,697,38
"29269","E01014411",2001,850,31,819,144
"29270","E01014477",2001,604,9,595,30
"29271","E01014478",2001,468,183,285,15
"29272","E01014479",2001,639,33,606,70
"29273","E01014480",2001,612,140,472,69
"29274","E01014465",2001,664,44,620,77
"29275","E01014466",2001,605,219,386,96
"29276","E01014467",2001,776,45,731,231
"29277","E01014468",2001,721,35,686,241
"29278","E01014412",2001,704,23,681,160
"29279","E01014413",2001,644,5,639,86
"29280","E01014414",2001,869,237,632,283
"29281","E01014370",2001,977,414,563,255
"29282","E01014371",2001,1026,159,867,396
"29283","E01014372",2001,1088,206,882,450
"29284","E01014427",2001,480,79,401,119
"29285","E01014428",2001,485,14,471,95
"29286","E01014429",2001,627,56,571,55
"29287","E01014430",2001,725,158,567,48
"29288","E01014405",2001,831,31,800,144
"29289","E01014406",2001,671,151,520,248
"29290","E01014407",2001,604,263,341,174
"29291","E01014408",2001,545,93,452,204
"29292","E01014373",2001,644,105,539,48
"29293","E01014374",2001,607,132,475,30
"29294","E01014375",2001,551,15,536,93
"29295","E01014376",2001,626,8,618,46
"29296","E01014377",2001,648,4,644,39
"29297","E01014378",2001,1154,68,1086,150
"29298","E01014461",2001,480,151,329,30
"29299","E01014462",2001,599,298,301,22
"29300","E01014463",2001,628,326,302,32
"29301","E01014464",2001,627,283,344,63
"29302","E01014481",2001,513,12,501,157
"29303","E01014482",2001,514,6,508,79
"29304","E01014483",2001,647,91,556,142
"29305","E01014484",2001,611,30,581,203
"29306","E01014380",2001,518,5,513,48
"29307","E01014381",2001,658,23,635,106
"29308","E01014473",2001,585,12,573,106
"29309","E01014474",2001,493,109,384,58
"29310","E01014475",2001,611,71,540,130
"29311","E01014476",2001,511,4,507,72
"29312","E01014435",2001,507,4,503,177
"29313","E01014436",2001,633,117,516,94
"29314","E01014437",2001,615,223,392,28
"29315","E01014438",2001,505,142,363,34
"29316","E01014455",2001,576,164,412,24
"29317","E01014456",2001,621,67,554,41
"29318","E01014457",2001,624,22,602,39
"29319","E01014458",2001,514,270,244,23
"29320","E01014459",2001,564,138,426,28
"29321","E01014460",2001,498,17,481,19
"29322","E01014452",2001,656,144,512,23
"29323","E01014453",2001,512,12,500,13
"29324","E01014454",2001,513,0,513,10
"29325","E01014391",2001,597,69,528,25
"29326","E01014392",2001,429,38,391,32
"29327","E01014415",2001,720,23,697,112
"29328","E01014416",2001,602,96,506,21
"29329","E01014417",2001,752,29,723,54
"29330","E01014387",2001,522,87,435,43
"29331","E01014388",2001,552,13,539,56
"29332","E01014389",2001,617,110,507,61
"29333","E01014390",2001,653,380,273,23
"29334","E01014431",2001,511,114,397,38
"29335","E01014432",2001,516,84,432,53
"29336","E01014433",2001,539,160,379,57
"29337","E01014434",2001,612,23,589,27
"29338","E01014419",2001,472,67,405,26
"29339","E01014385",2001,482,41,441,36
"29340","E01014386",2001,446,46,400,9
"29341","E01014446",2001,429,37,392,33
"29342","E01014447",2001,483,44,439,16
"29343","E01014418",2001,548,37,511,44
"29344","E01014382",2001,911,67,844,65
"29345","E01014383",2001,412,31,381,31
"29346","E01014384",2001,473,40,433,23
"29347","E01014379",2001,827,69,758,127
"29348","E01014442",2001,709,37,672,46
"29349","E01014443",2001,590,4,586,32
"29350","E01014444",2001,626,16,610,39
"29351","E01014445",2001,641,207,434,34
"29352","E01014439",2001,683,186,497,33
"29353","E01014440",2001,609,6,603,45
"29354","E01014441",2001,678,7,671,40
"29355","E01014393",2001,489,7,482,29
"29356","E01014394",2001,631,84,547,33
"29357","E01014448",2001,650,169,481,40
"29358","E01014449",2001,533,30,503,35
"29359","E01014450",2001,493,155,338,17
"29360","E01014451",2001,471,40,431,41
"29361","E01014420",2001,661,56,605,64
"29362","E01014421",2001,506,15,491,16
"29363","E01014422",2001,513,3,510,11
"29364","E01014423",2001,514,10,504,42
"29365","E01014469",2001,486,122,364,17
"29366","E01014470",2001,509,3,506,17
"29367","E01014471",2001,636,56,580,47
"29368","E01014472",2001,525,32,493,27
"29369","E01014424",2001,592,9,583,23
"29370","E01014425",2001,809,66,743,54
"29371","E01014426",2001,643,187,456,23
"29372","E01015301",2001,641,53,588,40
"29373","E01015303",2001,709,43,666,65
"29374","E01015305",2001,610,194,416,16
"29375","E01015306",2001,622,226,396,18
"29376","E01015304",2001,773,332,441,17
"29377","E01015302",2001,786,97,689,34
"29378","E01015311",2001,684,10,674,22
"29379","E01015308",2001,599,155,444,34
"29380","E01015332",2001,687,7,680,85
"29381","E01015333",2001,640,26,614,20
"29382","E01015334",2001,653,87,566,36
"29383","E01015335",2001,632,3,629,35
"29384","E01015337",2001,686,21,665,80
"29385","E01015343",2001,617,147,470,27
"29386","E01015349",2001,599,63,536,42
"29387","E01015351",2001,607,6,601,48
"29388","E01015352",2001,641,20,621,58
"29389","E01015353",2001,504,53,451,34
"29390","E01015354",2001,647,23,624,61
"29391","E01015359",2001,752,210,542,79
"29392","E01015309",2001,582,302,280,19
"29393","E01015312",2001,529,212,317,13
"29394","E01015313",2001,514,325,189,9
"29395","E01015307",2001,601,313,288,20
"29396","E01015320",2001,656,11,645,50
"29397","E01015323",2001,601,3,598,60
"29398","E01015324",2001,624,44,580,114
"29399","E01015325",2001,623,6,617,41
"29400","E01015350",2001,625,8,617,22
"29401","E01015336",2001,621,17,604,43
"29402","E01015310",2001,610,181,429,44
"29403","E01015355",2001,621,38,583,57
"29404","E01015357",2001,648,197,451,41
"29405","E01015358",2001,647,19,628,73
"29406","E01015338",2001,733,391,342,22
"29407","E01015339",2001,607,120,487,45
"29408","E01015340",2001,726,48,678,20
"29409","E01015341",2001,523,244,279,24
"29410","E01015321",2001,711,154,557,110
"29411","E01015356",2001,587,16,571,73
"29412","E01015377",2001,589,58,531,93
"29413","E01015374",2001,658,20,638,223
"29414","E01015375",2001,603,28,575,182
"29415","E01015378",2001,611,7,604,95
"29416","E01015373",2001,638,18,620,156
"29417","E01015322",2001,652,21,631,56
"29418","E01015342",2001,595,8,587,27
"29419","E01015330",2001,732,60,672,122
"29420","E01015318",2001,639,25,614,148
"29421","E01015319",2001,509,6,503,54
"29422","E01015314",2001,610,33,577,33
"29423","E01015315",2001,719,6,713,27
"29424","E01015344",2001,652,3,649,40
"29425","E01015346",2001,604,80,524,156
"29426","E01015348",2001,657,8,649,73
"29427","E01015360",2001,593,13,580,111
"29428","E01015345",2001,664,15,649,239
"29429","E01015331",2001,771,47,724,214
"29430","E01015326",2001,748,14,734,191
"29431","E01015376",2001,612,9,603,186
"29432","E01015316",2001,653,7,646,54
"29433","E01015317",2001,672,87,585,68
"29434","E01015361",2001,504,30,474,64
"29435","E01015362",2001,472,192,280,29
"29436","E01015363",2001,600,9,591,98
"29437","E01015327",2001,623,72,551,129
"29438","E01015329",2001,614,7,607,163
"29439","E01015292",2001,583,63,520,132
"29440","E01015293",2001,557,69,488,118
"29441","E01015294",2001,636,71,565,160
"29442","E01015275",2001,640,46,594,146
"29443","E01015276",2001,603,36,567,108
"29444","E01015277",2001,712,68,644,182
"29445","E01015272",2001,772,14,758,132
"29446","E01015273",2001,683,38,645,213
"29447","E01015286",2001,1014,139,875,233
"29448","E01015287",2001,688,86,602,156
"29449","E01015283",2001,796,61,735,428
"29450","E01015284",2001,866,91,775,373
"29451","E01015328",2001,802,135,667,232
"29452","E01015364",2001,640,11,629,49
"29453","E01015365",2001,607,43,564,209
"29454","E01015366",2001,678,78,600,116
"29455","E01015297",2001,637,10,627,96
"29456","E01015274",2001,729,44,685,174
"29457","E01015278",2001,927,44,883,415
"29458","E01015279",2001,781,55,726,369
"29459","E01015280",2001,645,17,628,324
"29460","E01015281",2001,770,160,610,306
"29461","E01015282",2001,881,63,818,524
"29462","E01015298",2001,779,40,739,28
"29463","E01015299",2001,687,9,678,76
"29464","E01015300",2001,623,6,617,39
"29465","E01015295",2001,612,0,612,34
"29466","E01015296",2001,764,94,670,167
"29467","E01015285",2001,822,21,801,317
"29468","E01015288",2001,668,137,531,227
"29469","E01015289",2001,774,55,719,291
"29470","E01015290",2001,624,86,538,235
"29471","E01015291",2001,859,48,811,173
"29472","E01015367",2001,756,29,727,352
"29473","E01015368",2001,951,18,933,201
"29474","E01015369",2001,866,26,840,173
"29475","E01015370",2001,583,0,583,136
"29476","E01015371",2001,787,70,717,366
"29477","E01015372",2001,882,143,739,216
"29478","E01015347",2001,1081,76,1005,240
"29479","E01014601",2001,618,166,452,15
"29480","E01014602",2001,738,317,421,18
"29481","E01014603",2001,762,187,575,47
"29482","E01014604",2001,596,92,504,48
"29483","E01014605",2001,735,447,288,29
"29484","E01014606",2001,799,244,555,44
"29485","E01014688",2001,618,254,364,45
"29486","E01014689",2001,633,410,223,25
"29487","E01014690",2001,637,256,381,18
"29488","E01014691",2001,739,263,476,33
"29489","E01014692",2001,533,196,337,30
"29490","E01014693",2001,639,11,628,56
"29491","E01014694",2001,628,196,432,35
"29492","E01014638",2001,761,428,333,30
"29493","E01014639",2001,631,436,195,6
"29494","E01014640",2001,626,250,376,18
"29495","E01014497",2001,652,292,360,14
"29496","E01014498",2001,647,266,381,15
"29497","E01014631",2001,468,73,395,27
"29498","E01014632",2001,633,137,496,63
"29499","E01014633",2001,649,86,563,44
"29500","E01014636",2001,634,282,352,34
"29501","E01014634",2001,598,24,574,146
"29502","E01014661",2001,610,211,399,39
"29503","E01014630",2001,506,288,218,36
"29504","E01014659",2001,622,366,256,33
"29505","E01014719",2001,625,52,573,79
"29506","E01014720",2001,754,190,564,53
"29507","E01014721",2001,648,86,562,27
"29508","E01014616",2001,649,61,588,92
"29509","E01014641",2001,628,125,503,19
"29510","E01014642",2001,632,150,482,31
"29511","E01014643",2001,602,307,295,23
"29512","E01014644",2001,619,214,405,15
"29513","E01014499",2001,601,178,423,17
"29514","E01014492",2001,748,319,429,22
"29515","E01014493",2001,588,189,399,40
"29516","E01014494",2001,635,50,585,35
"29517","E01014495",2001,658,115,543,37
"29518","E01014496",2001,635,117,518,54
"29519","E01014715",2001,588,17,571,14
"29520","E01014716",2001,613,9,604,21
"29521","E01014717",2001,590,132,458,18
"29522","E01014718",2001,634,18,616,56
"29523","E01014510",2001,656,19,637,95
"29524","E01014635",2001,597,37,560,95
"29525","E01014637",2001,511,15,496,121
"29526","E01014662",2001,611,111,500,78
"29527","E01014617",2001,530,0,530,22
"29528","E01014618",2001,635,8,627,31
"29529","E01014620",2001,647,12,635,34
"29530","E01014615",2001,617,10,607,27
"29531","E01014571",2001,625,174,451,46
"29532","E01014577",2001,632,11,621,60
"29533","E01014586",2001,713,128,585,43
"29534","E01014587",2001,598,172,426,21
"29535","E01014588",2001,659,116,543,51
"29536","E01014589",2001,637,378,259,26
"29537","E01014590",2001,597,87,510,133
"29538","E01014591",2001,719,32,687,48
"29539","E01014592",2001,638,68,570,74
"29540","E01014663",2001,621,275,346,42
"29541","E01014664",2001,619,167,452,35
"29542","E01014665",2001,685,29,656,57
"29543","E01014660",2001,648,323,325,31
"29544","E01014709",2001,612,32,580,71
"29545","E01014710",2001,516,23,493,79
"29546","E01014711",2001,516,15,501,19
"29547","E01014712",2001,498,85,413,23
"29548","E01014713",2001,598,43,555,34
"29549","E01014714",2001,519,10,509,18
"29550","E01014511",2001,514,5,509,95
"29551","E01014512",2001,600,58,542,114
"29552","E01014513",2001,619,14,605,44
"29553","E01014514",2001,667,13,654,154
"29554","E01014507",2001,624,26,598,139
"29555","E01014508",2001,500,22,478,148
"29556","E01014509",2001,546,30,516,156
"29557","E01014666",2001,619,36,583,58
"29558","E01014667",2001,625,10,615,151
"29559","E01014621",2001,613,78,535,110
"29560","E01014619",2001,602,20,582,117
"29561","E01014672",2001,757,17,740,293
"29562","E01014628",2001,622,120,502,53
"29563","E01014629",2001,550,178,372,25
"29564","E01014624",2001,643,153,490,26
"29565","E01014625",2001,635,266,369,23
"29566","E01014572",2001,647,24,623,162
"29567","E01014573",2001,728,30,698,121
"29568","E01014575",2001,636,115,521,93
"29569","E01014576",2001,772,97,675,63
"29570","E01014668",2001,613,13,600,156
"29571","E01014669",2001,649,33,616,266
"29572","E01014670",2001,594,24,570,220
"29573","E01014671",2001,635,65,570,242
"29574","E01014491",2001,639,29,610,148
"29575","E01014487",2001,646,37,609,233
"29576","E01014626",2001,733,163,570,67
"29577","E01014627",2001,623,36,587,44
"29578","E01014622",2001,627,52,575,72
"29579","E01014623",2001,630,95,535,52
"29580","E01014562",2001,602,22,580,289
"29581","E01014557",2001,631,33,598,211
"29582","E01014558",2001,761,53,708,468
"29583","E01014559",2001,700,48,652,246
"29584","E01014560",2001,748,38,710,332
"29585","E01014488",2001,621,123,498,122
"29586","E01014489",2001,791,240,551,215
"29587","E01014490",2001,870,513,357,181
"29588","E01014485",2001,720,66,654,112
"29589","E01014486",2001,729,213,516,140
"29590","E01014564",2001,632,97,535,83
"29591","E01014568",2001,728,151,577,153
"29592","E01014569",2001,647,71,576,83
"29593","E01014570",2001,656,59,597,67
"29594","E01014574",2001,735,168,567,125
"29595","E01014653",2001,692,385,307,69
"29596","E01014655",2001,675,172,503,121
"29597","E01014563",2001,712,67,645,311
"29598","E01014541",2001,884,368,516,310
"29599","E01014561",2001,769,38,731,331
"29600","E01014539",2001,752,78,674,280
"29601","E01014551",2001,766,38,728,469
"29602","E01014552",2001,743,36,707,349
"29603","E01014553",2001,742,13,729,401
"29604","E01014554",2001,770,58,712,338
"29605","E01014556",2001,814,19,795,280
"29606","E01014673",2001,645,44,601,110
"29607","E01014674",2001,598,107,491,30
"29608","E01014675",2001,624,51,573,63
"29609","E01014676",2001,600,127,473,37
"29610","E01014682",2001,604,11,593,78
"29611","E01014683",2001,757,245,512,81
"29612","E01014685",2001,589,176,413,35
"29613","E01014686",2001,640,129,511,40
"29614","E01014687",2001,640,95,545,55
"29615","E01014681",2001,872,136,736,115
"29616","E01014684",2001,732,45,687,173
"29617","E01014565",2001,706,157,549,85
"29618","E01014566",2001,731,63,668,165
"29619","E01014567",2001,728,56,672,128
"29620","E01014544",2001,510,7,503,157
"29621","E01014545",2001,741,96,645,268
"29622","E01014546",2001,645,23,622,352
"29623","E01014547",2001,785,25,760,310
"29624","E01014656",2001,867,599,268,104
"29625","E01014657",2001,863,592,271,30
"29626","E01014658",2001,786,544,242,69
"29627","E01014654",2001,664,283,381,104
"29628","E01014652",2001,898,414,484,264
"29629","E01014540",2001,533,221,312,149
"29630","E01014538",2001,606,67,539,329
"29631","E01014542",2001,594,104,490,328
"29632","E01014543",2001,750,151,599,229
"29633","E01014677",2001,617,52,565,63
"29634","E01014678",2001,620,43,577,47
"29635","E01014679",2001,630,44,586,49
"29636","E01014680",2001,507,10,497,15
"29637","E01014548",2001,746,137,609,271
"29638","E01014549",2001,517,138,379,155
"29639","E01014550",2001,725,41,684,186
"29640","E01014555",2001,645,123,522,300
"29641","E01014537",2001,620,133,487,34
"29642","E01014528",2001,669,14,655,56
"29643","E01014529",2001,588,227,361,22
"29644","E01014530",2001,659,63,596,74
"29645","E01014531",2001,709,17,692,122
"29646","E01014532",2001,597,75,522,43
"29647","E01014695",2001,719,313,406,85
"29648","E01014696",2001,603,23,580,116
"29649","E01014698",2001,701,64,637,106
"29650","E01014699",2001,651,189,462,137
"29651","E01014700",2001,622,12,610,92
"29652","E01014701",2001,642,79,563,141
"29653","E01014735",2001,610,30,580,68
"29654","E01014730",2001,781,147,634,206
"29655","E01014731",2001,636,109,527,143
"29656","E01014732",2001,651,52,599,185
"29657","E01014523",2001,591,82,509,23
"29658","E01014524",2001,594,52,542,17
"29659","E01014525",2001,608,36,572,32
"29660","E01014526",2001,643,269,374,23
"29661","E01014527",2001,607,143,464,52
"29662","E01014500",2001,635,50,585,70
"29663","E01014502",2001,701,174,527,39
"29664","E01014503",2001,783,128,655,140
"29665","E01014697",2001,794,393,401,127
"29666","E01014733",2001,628,91,537,79
"29667","E01014734",2001,614,83,531,74
"29668","E01014736",2001,651,175,476,47
"29669","E01014729",2001,584,292,292,27
"29670","E01014504",2001,651,36,615,83
"29671","E01014505",2001,775,49,726,119
"29672","E01014506",2001,594,16,578,14
"29673","E01014501",2001,713,179,534,28
"29674","E01014651",2001,626,20,606,59
"29675","E01014648",2001,611,39,572,62
"29676","E01014649",2001,641,19,622,77
"29677","E01014645",2001,640,138,502,28
"29678","E01014646",2001,627,119,508,27
"29679","E01014533",2001,593,12,581,70
"29680","E01014534",2001,601,25,576,65
"29681","E01014535",2001,653,28,625,19
"29682","E01014536",2001,686,246,440,19
"29683","E01014585",2001,599,363,236,21
"29684","E01014583",2001,506,254,252,13
"29685","E01014578",2001,610,153,457,30
"29686","E01014647",2001,631,264,367,23
"29687","E01014650",2001,617,120,497,15
"29688","E01014579",2001,518,102,416,31
"29689","E01014580",2001,647,361,286,20
"29690","E01014581",2001,614,319,295,16
"29691","E01014582",2001,493,198,295,21
"29692","E01014584",2001,489,246,243,18
"29693","E01014518",2001,629,78,551,33
"29694","E01014519",2001,535,113,422,28
"29695","E01014520",2001,627,37,590,22
"29696","E01014521",2001,495,70,425,9
"29697","E01014607",2001,540,8,532,22
"29698","E01014608",2001,617,181,436,39
"29699","E01014609",2001,625,151,474,14
"29700","E01014610",2001,631,277,354,63
"29701","E01014613",2001,624,49,575,29
"29702","E01014614",2001,497,22,475,13
"29703","E01014598",2001,610,8,602,8
"29704","E01014599",2001,499,15,484,13
"29705","E01014600",2001,510,81,429,23
"29706","E01014594",2001,639,374,265,5
"29707","E01014702",2001,609,47,562,12
"29708","E01014703",2001,675,283,392,25
"29709","E01014704",2001,604,116,488,15
"29710","E01014705",2001,615,95,520,7
"29711","E01014706",2001,651,291,360,20
"29712","E01014707",2001,638,51,587,14
"29713","E01014708",2001,617,74,543,12
"29714","E01014522",2001,661,241,420,20
"29715","E01014515",2001,619,189,430,29
"29716","E01014516",2001,612,366,246,17
"29717","E01014517",2001,495,249,246,17
"29718","E01014593",2001,500,282,218,15
"29719","E01014595",2001,608,257,351,9
"29720","E01014596",2001,605,273,332,15
"29721","E01014597",2001,639,278,361,21
"29722","E01014611",2001,580,13,567,10
"29723","E01014612",2001,614,66,548,17
"29724","E01014725",2001,617,9,608,17
"29725","E01014722",2001,624,9,615,23
"29726","E01014723",2001,520,17,503,20
"29727","E01014724",2001,755,551,204,18
"29728","E01014726",2001,614,411,203,15
"29729","E01014727",2001,629,327,302,20
"29730","E01014728",2001,749,301,448,25
"29731","E01014788",2001,692,71,621,58
"29732","E01014790",2001,600,60,540,19
"29733","E01014797",2001,712,153,559,22
"29734","E01014795",2001,609,156,453,30
"29735","E01014798",2001,600,10,590,12
"29736","E01014793",2001,654,0,654,32
"29737","E01014794",2001,655,51,604,17
"29738","E01014789",2001,591,0,591,35
"29739","E01014791",2001,629,7,622,34
"29740","E01014792",2001,768,75,693,33
"29741","E01014796",2001,712,34,678,35
"29742","E01014786",2001,738,240,498,32
"29743","E01014787",2001,721,82,639,39
"29744","E01014766",2001,636,16,620,91
"29745","E01014767",2001,557,6,551,17
"29746","E01014752",2001,650,14,636,50
"29747","E01014754",2001,614,25,589,146
"29748","E01014758",2001,517,14,503,43
"29749","E01014759",2001,616,3,613,10
"29750","E01014768",2001,1078,45,1033,65
"29751","E01014849",2001,680,26,654,48
"29752","E01014850",2001,726,76,650,31
"29753","E01014851",2001,734,80,654,57
"29754","E01014852",2001,604,54,550,52
"29755","E01014753",2001,788,145,643,76
"29756","E01014760",2001,649,72,577,29
"29757","E01014755",2001,605,72,533,90
"29758","E01014750",2001,650,94,556,96
"29759","E01014751",2001,656,161,495,32
"29760","E01014780",2001,711,110,601,57
"29761","E01014781",2001,738,142,596,23
"29762","E01014782",2001,617,9,608,12
"29763","E01014783",2001,734,106,628,47
"29764","E01014784",2001,711,21,690,24
"29765","E01014785",2001,583,11,572,12
"29766","E01014775",2001,500,0,500,12
"29767","E01014776",2001,504,3,501,17
"29768","E01014777",2001,632,16,616,41
"29769","E01014778",2001,517,3,514,10
"29770","E01014779",2001,514,62,452,29
"29771","E01014756",2001,782,39,743,108
"29772","E01014757",2001,638,25,613,35
"29773","E01014761",2001,751,11,740,55
"29774","E01014762",2001,616,3,613,39
"29775","E01014763",2001,739,85,654,67
"29776","E01014737",2001,604,5,599,26
"29777","E01014738",2001,492,68,424,36
"29778","E01014739",2001,594,39,555,31
"29779","E01014740",2001,511,23,488,46
"29780","E01014855",2001,560,5,555,17
"29781","E01014856",2001,559,75,484,22
"29782","E01014857",2001,616,67,549,32
"29783","E01014858",2001,629,7,622,70
"29784","E01014859",2001,640,42,598,39
"29785","E01014860",2001,625,113,512,11
"29786","E01014853",2001,717,51,666,77
"29787","E01014854",2001,563,7,556,44
"29788","E01014847",2001,590,6,584,31
"29789","E01014848",2001,525,35,490,33
"29790","E01014764",2001,650,113,537,32
"29791","E01014765",2001,715,28,687,31
"29792","E01014773",2001,602,9,593,43
"29793","E01014774",2001,647,35,612,53
"29794","E01014821",2001,513,5,508,70
"29795","E01014822",2001,515,3,512,14
"29796","E01014823",2001,515,0,515,22
"29797","E01014824",2001,634,58,576,29
"29798","E01014825",2001,498,0,498,20
"29799","E01014826",2001,631,5,626,84
"29800","E01014827",2001,610,116,494,65
"29801","E01014817",2001,721,16,705,44
"29802","E01014820",2001,733,114,619,42
"29803","E01014835",2001,660,171,489,29
"29804","E01014836",2001,622,26,596,58
"29805","E01014838",2001,592,17,575,37
"29806","E01014840",2001,615,42,573,37
"29807","E01014818",2001,754,0,754,23
"29808","E01014819",2001,742,14,728,32
"29809","E01014812",2001,748,30,718,34
"29810","E01014813",2001,746,31,715,64
"29811","E01014815",2001,598,141,457,37
"29812","E01014816",2001,646,10,636,29
"29813","E01014841",2001,807,10,797,284
"29814","E01014842",2001,767,11,756,245
"29815","E01014843",2001,629,17,612,122
"29816","E01014844",2001,717,79,638,298
"29817","E01014845",2001,593,17,576,32
"29818","E01014846",2001,629,19,610,79
"29819","E01014839",2001,596,28,568,51
"29820","E01014837",2001,753,50,703,86
"29821","E01014814",2001,611,4,607,64
"29822","E01014810",2001,733,162,571,90
"29823","E01014743",2001,641,63,578,46
"29824","E01014811",2001,735,173,562,50
"29825","E01014799",2001,739,33,706,242
"29826","E01014800",2001,748,72,676,305
"29827","E01014801",2001,750,58,692,249
"29828","E01014802",2001,745,50,695,290
"29829","E01014809",2001,693,17,676,134
"29830","E01014829",2001,649,331,318,35
"29831","E01014830",2001,597,9,588,104
"29832","E01014831",2001,617,435,182,10
"29833","E01014832",2001,648,380,268,14
"29834","E01014833",2001,648,388,260,19
"29835","E01014804",2001,618,78,540,59
"29836","E01014806",2001,622,35,587,186
"29837","E01014807",2001,764,11,753,233
"29838","E01014808",2001,604,11,593,45
"29839","E01014744",2001,588,7,581,44
"29840","E01014769",2001,600,64,536,96
"29841","E01014770",2001,674,10,664,34
"29842","E01014771",2001,646,28,618,24
"29843","E01014772",2001,594,19,575,36
"29844","E01014746",2001,612,101,511,26
"29845","E01014747",2001,594,45,549,87
"29846","E01014748",2001,441,53,388,53
"29847","E01014749",2001,486,11,475,28
"29848","E01014741",2001,647,68,579,61
"29849","E01014742",2001,603,13,590,48
"29850","E01014745",2001,578,34,544,24
"29851","E01014828",2001,627,197,430,37
"29852","E01014805",2001,750,0,750,15
"29853","E01014803",2001,607,9,598,61
"29854","E01014834",2001,635,238,397,27
"29855","E01015025",2001,620,12,608,19
"29856","E01015097",2001,805,10,795,44
"29857","E01015160",2001,622,6,616,18
"29858","E01015164",2001,622,137,485,126
"29859","E01015161",2001,632,203,429,41
"29860","E01015162",2001,637,286,351,23
"29861","E01015166",2001,644,301,343,33
"29862","E01015027",2001,648,92,556,39
"29863","E01015159",2001,759,227,532,24
"29864","E01015028",2001,631,371,260,26
"29865","E01015026",2001,772,316,456,51
"29866","E01015023",2001,679,263,416,26
"29867","E01015163",2001,587,143,444,29
"29868","E01015165",2001,599,35,564,112
"29869","E01015024",2001,655,65,590,60
"29870","E01015082",2001,649,356,293,10
"29871","E01015083",2001,674,340,334,21
"29872","E01015084",2001,619,170,449,24
"29873","E01015090",2001,578,20,558,32
"29874","E01015091",2001,609,124,485,9
"29875","E01015092",2001,403,78,325,45
"29876","E01015093",2001,637,227,410,21
"29877","E01015094",2001,542,175,367,14
"29878","E01015087",2001,562,295,267,16
"29879","E01015088",2001,618,385,233,20
"29880","E01015085",2001,726,113,613,32
"29881","E01015147",2001,491,72,419,30
"29882","E01015148",2001,645,201,444,36
"29883","E01015086",2001,629,322,307,19
"29884","E01015070",2001,712,212,500,19
"29885","E01015089",2001,725,129,596,66
"29886","E01015081",2001,646,295,351,19
"29887","E01015030",2001,719,424,295,21
"29888","E01015029",2001,608,83,525,136
"29889","E01015064",2001,701,8,693,23
"29890","E01015065",2001,629,170,459,102
"29891","E01015071",2001,672,156,516,60
"29892","E01015076",2001,618,11,607,37
"29893","E01015149",2001,620,430,190,27
"29894","E01015150",2001,615,88,527,30
"29895","E01015142",2001,612,26,586,81
"29896","E01015143",2001,623,124,499,22
"29897","E01015144",2001,612,192,420,66
"29898","E01015146",2001,599,324,275,32
"29899","E01015068",2001,615,12,603,35
"29900","E01015069",2001,680,209,471,43
"29901","E01015095",2001,634,155,479,26
"29902","E01015096",2001,622,316,306,17
"29903","E01015063",2001,625,205,420,45
"29904","E01015102",2001,665,51,614,62
"29905","E01015104",2001,591,6,585,17
"29906","E01015074",2001,666,310,356,23
"29907","E01015077",2001,660,199,461,19
"29908","E01015079",2001,608,69,539,17
"29909","E01015066",2001,602,9,593,20
"29910","E01015067",2001,618,8,610,18
"29911","E01015037",2001,599,119,480,33
"29912","E01015058",2001,555,305,250,37
"29913","E01015035",2001,629,13,616,39
"29914","E01015080",2001,481,361,120,21
"29915","E01015078",2001,610,387,223,20
"29916","E01015072",2001,602,232,370,24
"29917","E01015073",2001,624,258,366,32
"29918","E01015106",2001,480,69,411,14
"29919","E01015075",2001,639,236,403,35
"29920","E01015039",2001,432,40,392,71
"29921","E01015040",2001,592,241,351,32
"29922","E01015041",2001,630,43,587,113
"29923","E01015145",2001,619,496,123,57
"29924","E01015120",2001,525,58,467,14
"29925","E01015121",2001,639,6,633,18
"29926","E01015123",2001,603,22,581,61
"29927","E01015124",2001,627,22,605,28
"29928","E01015125",2001,607,50,557,26
"29929","E01015101",2001,624,5,619,29
"29930","E01015036",2001,618,106,512,68
"29931","E01015033",2001,593,17,576,28
"29932","E01015034",2001,514,14,500,71
"29933","E01015038",2001,633,13,620,39
"29934","E01015105",2001,637,7,630,57
"29935","E01015103",2001,626,8,618,92
"29936","E01015098",2001,620,7,613,98
"29937","E01015099",2001,618,6,612,106
"29938","E01015100",2001,581,22,559,135
"29939","E01015119",2001,608,10,598,14
"29940","E01015107",2001,612,58,554,26
"29941","E01015110",2001,604,6,598,26
"29942","E01015111",2001,699,29,670,68
"29943","E01015112",2001,528,10,518,37
"29944","E01015113",2001,625,7,618,27
"29945","E01015114",2001,607,36,571,50
"29946","E01015118",2001,624,11,613,20
"29947","E01015122",2001,616,18,598,26
"29948","E01015042",2001,641,49,592,141
"29949","E01015044",2001,682,67,615,257
"29950","E01015167",2001,672,69,603,113
"29951","E01015168",2001,759,77,682,144
"29952","E01015171",2001,720,57,663,249
"29953","E01015176",2001,594,191,403,51
"29954","E01015059",2001,645,89,556,82
"29955","E01015060",2001,595,90,505,53
"29956","E01015055",2001,605,255,350,23
"29957","E01015056",2001,759,133,626,70
"29958","E01015057",2001,619,265,354,35
"29959","E01015108",2001,633,45,588,136
"29960","E01015109",2001,641,9,632,54
"29961","E01015115",2001,622,270,352,16
"29962","E01015116",2001,610,61,549,30
"29963","E01015117",2001,596,92,504,22
"29964","E01015049",2001,558,15,543,210
"29965","E01015050",2001,579,24,555,385
"29966","E01015051",2001,473,21,452,189
"29967","E01015031",2001,646,13,633,254
"29968","E01015032",2001,640,14,626,388
"29969","E01015169",2001,585,29,556,146
"29970","E01015170",2001,716,257,459,129
"29971","E01015173",2001,616,30,586,129
"29972","E01015174",2001,659,5,654,53
"29973","E01015175",2001,687,39,648,212
"29974","E01015177",2001,727,15,712,183
"29975","E01015178",2001,718,31,687,288
"29976","E01015061",2001,622,83,539,174
"29977","E01015062",2001,654,31,623,269
"29978","E01015045",2001,579,296,283,94
"29979","E01015046",2001,734,612,122,18
"29980","E01015047",2001,691,356,335,190
"29981","E01015048",2001,726,491,235,85
"29982","E01015043",2001,637,260,377,147
"29983","E01015053",2001,516,147,369,228
"29984","E01015054",2001,413,146,267,184
"29985","E01015152",2001,850,585,265,77
"29986","E01015154",2001,941,338,603,195
"29987","E01015156",2001,763,287,476,237
"29988","E01015179",2001,674,16,658,284
"29989","E01015180",2001,815,264,551,162
"29990","E01015181",2001,805,27,778,358
"29991","E01015182",2001,729,155,574,162
"29992","E01015052",2001,704,155,549,297
"29993","E01015157",2001,704,215,489,223
"29994","E01015158",2001,990,223,767,403
"29995","E01015155",2001,868,599,269,94
"29996","E01015153",2001,769,374,395,234
"29997","E01015151",2001,839,314,525,296
"29998","E01015172",2001,741,32,709,233
"29999","E01015126",2001,629,7,622,11
"30000","E01015127",2001,606,58,548,35
"30001","E01015131",2001,618,5,613,20
"30002","E01015132",2001,652,120,532,65
"30003","E01015133",2001,640,3,637,9
"30004","E01015135",2001,624,57,567,50
"30005","E01015136",2001,615,4,611,67
"30006","E01015137",2001,599,50,549,48
"30007","E01015138",2001,652,11,641,73
"30008","E01015139",2001,625,88,537,51
"30009","E01015141",2001,625,30,595,25
"30010","E01015140",2001,646,28,618,105
"30011","E01015134",2001,529,9,520,74
"30012","E01015128",2001,753,32,721,56
"30013","E01015129",2001,676,55,621,74
"30014","E01015130",2001,601,30,571,102
"30015","E01015431",2001,431,6,425,36
"30016","E01015432",2001,742,65,677,34
"30017","E01015433",2001,576,4,572,21
"30018","E01015434",2001,647,3,644,5
"30019","E01015435",2001,649,94,555,50
"30020","E01015436",2001,535,35,500,16
"30021","E01015437",2001,500,12,488,12
"30022","E01015379",2001,476,153,323,35
"30023","E01015395",2001,598,63,535,46
"30024","E01015396",2001,634,3,631,12
"30025","E01015397",2001,530,3,527,12
"30026","E01015398",2001,497,3,494,7
"30027","E01015399",2001,598,9,589,20
"30028","E01015400",2001,622,4,618,8
"30029","E01015401",2001,637,3,634,12
"30030","E01015412",2001,488,3,485,9
"30031","E01015413",2001,631,117,514,28
"30032","E01015414",2001,623,68,555,25
"30033","E01015415",2001,531,227,304,24
"30034","E01015416",2001,513,44,469,25
"30035","E01015407",2001,619,6,613,40
"30036","E01015408",2001,513,42,471,23
"30037","E01015409",2001,583,166,417,53
"30038","E01015410",2001,655,37,618,57
"30039","E01015411",2001,526,11,515,21
"30040","E01015417",2001,623,147,476,25
"30041","E01015418",2001,702,39,663,46
"30042","E01015419",2001,775,7,768,36
"30043","E01015420",2001,638,236,402,14
"30044","E01015421",2001,632,75,557,23
"30045","E01015422",2001,621,15,606,49
"30046","E01015380",2001,741,51,690,24
"30047","E01015381",2001,636,203,433,17
"30048","E01015382",2001,775,95,680,98
"30049","E01015383",2001,669,16,653,48
"30050","E01015384",2001,485,240,245,19
"30051","E01015385",2001,736,196,540,42
"30052","E01015438",2001,611,7,604,41
"30053","E01015439",2001,715,172,543,61
"30054","E01015441",2001,730,99,631,106
"30055","E01015442",2001,674,274,400,20
"30056","E01015443",2001,625,53,572,43
"30057","E01015444",2001,651,39,612,62
"30058","E01015386",2001,776,230,546,165
"30059","E01015387",2001,598,66,532,28
"30060","E01015388",2001,476,49,427,26
"30061","E01015389",2001,617,13,604,54
"30062","E01015390",2001,650,59,591,118
"30063","E01015391",2001,610,12,598,45
"30064","E01015392",2001,628,21,607,84
"30065","E01015393",2001,509,48,461,52
"30066","E01015394",2001,608,12,596,41
"30067","E01015447",2001,615,13,602,33
"30068","E01015449",2001,622,174,448,49
"30069","E01015456",2001,691,237,454,77
"30070","E01015457",2001,747,77,670,85
"30071","E01015440",2001,766,11,755,75
"30072","E01015450",2001,637,43,594,28
"30073","E01015451",2001,629,7,622,18
"30074","E01015448",2001,608,53,555,26
"30075","E01015445",2001,746,5,741,38
"30076","E01015446",2001,631,129,502,39
"30077","E01015458",2001,612,0,612,22
"30078","E01015460",2001,643,14,629,117
"30079","E01015461",2001,616,54,562,129
"30080","E01015462",2001,643,68,575,122
"30081","E01015463",2001,655,36,619,91
"30082","E01015464",2001,602,3,599,34
"30083","E01015427",2001,628,93,535,153
"30084","E01015428",2001,872,98,774,88
"30085","E01015429",2001,634,178,456,40
"30086","E01015430",2001,549,279,270,33
"30087","E01015465",2001,712,124,588,105
"30088","E01015466",2001,670,72,598,65
"30089","E01015467",2001,898,24,874,251
"30090","E01015468",2001,728,52,676,148
"30091","E01015469",2001,910,478,432,110
"30092","E01015423",2001,633,153,480,48
"30093","E01015424",2001,592,10,582,51
"30094","E01015425",2001,528,32,496,26
"30095","E01015426",2001,527,170,357,24
"30096","E01015459",2001,758,6,752,52
"30097","E01015452",2001,797,20,777,59
"30098","E01015453",2001,845,38,807,169
"30099","E01015454",2001,765,25,740,180
"30100","E01015455",2001,850,32,818,54
"30101","E01015402",2001,740,19,721,93
"30102","E01015403",2001,963,12,951,83
"30103","E01015404",2001,757,3,754,31
"30104","E01015405",2001,646,7,639,54
"30105","E01015406",2001,729,8,721,118
"30106","E01014985",2001,647,6,641,54
"30107","E01014986",2001,632,162,470,32
"30108","E01014987",2001,516,0,516,33
"30109","E01014988",2001,501,6,495,19
"30110","E01014989",2001,425,10,415,39
"30111","E01014990",2001,638,6,632,21
"30112","E01014991",2001,891,313,578,57
"30113","E01014992",2001,582,16,566,27
"30114","E01014993",2001,549,29,520,32
"30115","E01014929",2001,712,68,644,50
"30116","E01014930",2001,679,84,595,31
"30117","E01014884",2001,572,90,482,76
"30118","E01014885",2001,714,10,704,23
"30119","E01014863",2001,631,80,551,8
"30120","E01014864",2001,605,16,589,34
"30121","E01014962",2001,630,14,616,93
"30122","E01014963",2001,729,36,693,47
"30123","E01014953",2001,767,30,737,60
"30124","E01014954",2001,633,49,584,57
"30125","E01014861",2001,606,52,554,49
"30126","E01014862",2001,820,41,779,32
"30127","E01015014",2001,507,0,507,25
"30128","E01015015",2001,526,5,521,52
"30129","E01015016",2001,446,3,443,7
"30130","E01015017",2001,572,65,507,45
"30131","E01015018",2001,568,85,483,23
"30132","E01015019",2001,746,129,617,56
"30133","E01015020",2001,622,116,506,44
"30134","E01015021",2001,627,3,624,21
"30135","E01015022",2001,661,14,647,55
"30136","E01014886",2001,822,202,620,80
"30137","E01014887",2001,609,4,605,42
"30138","E01014888",2001,631,19,612,32
"30139","E01014889",2001,598,6,592,11
"30140","E01014872",2001,690,27,663,162
"30141","E01014874",2001,613,10,603,113
"30142","E01014876",2001,744,23,721,164
"30143","E01014877",2001,596,0,596,75
"30144","E01014879",2001,655,8,647,62
"30145","E01014881",2001,483,3,480,43
"30146","E01015009",2001,611,52,559,20
"30147","E01015010",2001,499,3,496,34
"30148","E01015011",2001,606,153,453,42
"30149","E01015012",2001,525,13,512,12
"30150","E01015013",2001,504,6,498,33
"30151","E01014946",2001,628,149,479,19
"30152","E01014947",2001,630,25,605,17
"30153","E01014948",2001,753,367,386,41
"30154","E01014949",2001,505,11,494,20
"30155","E01014950",2001,605,27,578,70
"30156","E01014951",2001,603,147,456,36
"30157","E01014952",2001,658,43,615,29
"30158","E01014882",2001,544,204,340,32
"30159","E01014883",2001,535,21,514,67
"30160","E01014880",2001,601,48,553,70
"30161","E01014878",2001,865,6,859,152
"30162","E01014875",2001,795,25,770,192
"30163","E01014873",2001,545,0,545,42
"30164","E01014911",2001,521,15,506,12
"30165","E01014912",2001,642,3,639,21
"30166","E01014913",2001,627,13,614,15
"30167","E01014914",2001,616,188,428,18
"30168","E01014892",2001,664,52,612,73
"30169","E01014893",2001,610,3,607,28
"30170","E01014894",2001,478,0,478,25
"30171","E01014895",2001,524,6,518,47
"30172","E01014896",2001,475,3,472,27
"30173","E01014979",2001,658,3,655,57
"30174","E01014980",2001,629,4,625,27
"30175","E01014982",2001,640,53,587,49
"30176","E01014983",2001,613,157,456,32
"30177","E01014984",2001,586,97,489,25
"30178","E01014998",2001,614,101,513,21
"30179","E01014999",2001,607,13,594,11
"30180","E01015000",2001,606,114,492,31
"30181","E01015001",2001,621,41,580,16
"30182","E01014996",2001,679,3,676,68
"30183","E01014997",2001,547,36,511,42
"30184","E01014978",2001,596,58,538,31
"30185","E01014981",2001,730,25,705,150
"30186","E01014904",2001,602,109,493,44
"30187","E01014905",2001,647,6,641,55
"30188","E01014906",2001,708,299,409,50
"30189","E01014907",2001,658,53,605,59
"30190","E01014908",2001,494,5,489,15
"30191","E01014909",2001,531,15,516,79
"30192","E01014910",2001,525,78,447,23
"30193","E01014971",2001,599,92,507,18
"30194","E01014994",2001,678,55,623,33
"30195","E01014995",2001,642,3,639,15
"30196","E01014867",2001,500,77,423,22
"30197","E01014868",2001,591,18,573,28
"30198","E01014965",2001,600,22,578,16
"30199","E01014901",2001,625,3,622,19
"30200","E01014902",2001,498,0,498,3
"30201","E01014903",2001,627,31,596,17
"30202","E01014966",2001,645,9,636,22
"30203","E01014967",2001,711,0,711,26
"30204","E01014964",2001,585,0,585,23
"30205","E01014969",2001,574,8,566,20
"30206","E01014970",2001,692,24,668,61
"30207","E01014897",2001,610,7,603,27
"30208","E01014898",2001,665,49,616,32
"30209","E01014899",2001,668,53,615,48
"30210","E01014900",2001,589,63,526,44
"30211","E01014968",2001,693,257,436,13
"30212","E01014959",2001,520,75,445,14
"30213","E01014960",2001,634,127,507,31
"30214","E01014961",2001,635,194,441,17
"30215","E01014890",2001,760,58,702,86
"30216","E01014891",2001,626,44,582,129
"30217","E01014869",2001,639,66,573,46
"30218","E01014870",2001,591,48,543,62
"30219","E01014871",2001,513,67,446,22
"30220","E01014865",2001,733,147,586,49
"30221","E01014955",2001,516,3,513,10
"30222","E01014956",2001,628,20,608,9
"30223","E01014957",2001,512,3,509,17
"30224","E01014974",2001,605,44,561,34
"30225","E01014977",2001,635,282,353,92
"30226","E01014973",2001,602,132,470,23
"30227","E01014975",2001,600,27,573,59
"30228","E01014976",2001,634,154,480,38
"30229","E01014922",2001,516,8,508,21
"30230","E01014923",2001,611,112,499,17
"30231","E01014924",2001,618,50,568,71
"30232","E01014925",2001,589,65,524,16
"30233","E01014926",2001,650,261,389,8
"30234","E01014927",2001,751,156,595,54
"30235","E01014928",2001,619,173,446,18
"30236","E01014958",2001,491,149,342,17
"30237","E01014915",2001,612,103,509,25
"30238","E01015003",2001,618,7,611,21
"30239","E01015005",2001,613,26,587,76
"30240","E01015007",2001,611,127,484,41
"30241","E01015008",2001,628,92,536,18
"30242","E01015006",2001,626,108,518,23
"30243","E01015004",2001,604,53,551,34
"30244","E01015002",2001,532,47,485,18
"30245","E01014943",2001,787,42,745,61
"30246","E01014944",2001,657,13,644,21
"30247","E01014972",2001,561,49,512,23
"30248","E01014945",2001,610,87,523,17
"30249","E01014936",2001,515,82,433,26
"30250","E01014938",2001,606,94,512,18
"30251","E01014939",2001,496,51,445,36
"30252","E01014940",2001,502,24,478,17
"30253","E01014941",2001,608,259,349,7
"30254","E01014942",2001,640,201,439,18
"30255","E01014916",2001,614,76,538,46
"30256","E01014917",2001,587,68,519,22
"30257","E01014918",2001,633,22,611,23
"30258","E01014919",2001,502,3,499,5
"30259","E01014920",2001,513,42,471,9
"30260","E01014921",2001,521,33,488,10
"30261","E01014937",2001,524,8,516,18
"30262","E01014931",2001,603,19,584,50
"30263","E01014932",2001,644,14,630,23
"30264","E01014933",2001,613,9,604,42
"30265","E01014934",2001,497,3,494,9
"30266","E01014935",2001,652,7,645,26
"30267","E01014866",2001,635,32,603,17
"30268","E01015519",2001,680,321,359,41
"30269","E01015520",2001,468,50,418,49
"30270","E01015521",2001,609,8,601,24
"30271","E01015522",2001,642,59,583,49
"30272","E01015523",2001,611,44,567,56
"30273","E01015524",2001,474,69,405,17
"30274","E01015525",2001,663,5,658,40
"30275","E01015512",2001,596,6,590,57
"30276","E01015518",2001,537,0,537,26
"30277","E01015470",2001,580,4,576,27
"30278","E01015471",2001,478,5,473,38
"30279","E01015472",2001,610,3,607,37
"30280","E01015543",2001,602,155,447,8
"30281","E01015544",2001,724,420,304,22
"30282","E01015545",2001,658,443,215,18
"30283","E01015546",2001,635,432,203,5
"30284","E01015513",2001,666,11,655,69
"30285","E01015514",2001,511,13,498,3
"30286","E01015515",2001,578,0,578,27
"30287","E01015516",2001,623,194,429,21
"30288","E01015517",2001,675,9,666,19
"30289","E01015555",2001,655,135,520,35
"30290","E01015556",2001,659,23,636,31
"30291","E01015557",2001,640,16,624,35
"30292","E01015558",2001,632,432,200,7
"30293","E01015559",2001,625,81,544,32
"30294","E01015560",2001,608,10,598,24
"30295","E01015528",2001,708,370,338,25
"30296","E01015529",2001,639,76,563,19
"30297","E01015530",2001,658,282,376,12
"30298","E01015526",2001,604,39,565,43
"30299","E01015527",2001,650,185,465,18
"30300","E01015506",2001,594,198,396,30
"30301","E01015507",2001,595,370,225,8
"30302","E01015580",2001,627,151,476,12
"30303","E01015547",2001,551,62,489,53
"30304","E01015548",2001,558,24,534,43
"30305","E01015473",2001,645,56,589,44
"30306","E01015474",2001,635,99,536,58
"30307","E01015549",2001,637,3,634,31
"30308","E01015550",2001,736,9,727,25
"30309","E01015551",2001,605,26,579,23
"30310","E01015552",2001,580,37,543,33
"30311","E01015553",2001,633,11,622,52
"30312","E01015554",2001,640,168,472,20
"30313","E01015508",2001,611,263,348,20
"30314","E01015509",2001,671,49,622,59
"30315","E01015510",2001,757,149,608,103
"30316","E01015511",2001,689,45,644,80
"30317","E01015562",2001,594,70,524,47
"30318","E01015563",2001,603,6,597,52
"30319","E01015565",2001,634,117,517,45
"30320","E01015566",2001,673,4,669,98
"30321","E01015581",2001,603,10,593,27
"30322","E01015582",2001,680,31,649,44
"30323","E01015577",2001,761,43,718,91
"30324","E01015578",2001,745,123,622,81
"30325","E01015579",2001,675,36,639,57
"30326","E01015481",2001,497,45,452,24
"30327","E01015482",2001,521,6,515,12
"30328","E01015483",2001,647,7,640,6
"30329","E01015484",2001,611,5,606,21
"30330","E01015485",2001,651,12,639,40
"30331","E01015486",2001,613,58,555,21
"30332","E01015564",2001,594,10,584,26
"30333","E01015561",2001,652,13,639,106
"30334","E01015567",2001,655,8,647,65
"30335","E01015568",2001,618,34,584,67
"30336","E01015480",2001,732,17,715,212
"30337","E01015475",2001,629,46,583,146
"30338","E01015476",2001,880,335,545,185
"30339","E01015477",2001,686,100,586,138
"30340","E01015538",2001,752,398,354,12
"30341","E01015572",2001,486,290,196,13
"30342","E01015573",2001,625,371,254,19
"30343","E01015575",2001,477,287,190,14
"30344","E01015576",2001,659,51,608,11
"30345","E01015574",2001,634,65,569,25
"30346","E01015479",2001,607,21,586,86
"30347","E01015493",2001,675,14,661,103
"30348","E01015499",2001,462,0,462,23
"30349","E01015500",2001,634,27,607,71
"30350","E01015504",2001,512,39,473,18
"30351","E01015505",2001,656,111,545,89
"30352","E01015494",2001,767,27,740,230
"30353","E01015495",2001,868,85,783,357
"30354","E01015496",2001,753,16,737,192
"30355","E01015497",2001,668,31,637,134
"30356","E01015539",2001,600,168,432,11
"30357","E01015540",2001,625,298,327,15
"30358","E01015541",2001,649,356,293,18
"30359","E01015542",2001,623,327,296,28
"30360","E01015537",2001,653,276,377,9
"30361","E01015531",2001,574,8,566,37
"30362","E01015532",2001,583,17,566,113
"30363","E01015498",2001,737,17,720,72
"30364","E01015478",2001,591,61,530,56
"30365","E01015501",2001,500,6,494,17
"30366","E01015502",2001,604,232,372,33
"30367","E01015503",2001,591,259,332,29
"30368","E01015569",2001,617,219,398,20
"30369","E01015570",2001,746,372,374,34
"30370","E01015571",2001,650,50,600,44
"30371","E01015487",2001,595,11,584,15
"30372","E01015488",2001,660,265,395,15
"30373","E01015489",2001,550,20,530,18
"30374","E01015490",2001,535,54,481,23
"30375","E01015491",2001,712,330,382,9
"30376","E01015492",2001,542,135,407,22
"30377","E01015533",2001,639,12,627,20
"30378","E01015534",2001,771,114,657,68
"30379","E01015535",2001,605,6,599,19
"30380","E01015536",2001,647,6,641,20
"30381","E01015583",2001,599,78,521,114
"30382","E01015584",2001,648,68,580,16
"30383","E01015585",2001,601,52,549,42
"30384","E01015586",2001,624,15,609,17
"30385","E01015587",2001,713,254,459,26
"30386","E01015588",2001,713,152,561,31
"30387","E01015262",2001,522,84,438,26
"30388","E01015263",2001,623,223,400,51
"30389","E01015264",2001,619,9,610,18
"30390","E01015265",2001,655,74,581,37
"30391","E01015266",2001,627,285,342,26
"30392","E01015236",2001,626,14,612,93
"30393","E01015237",2001,523,10,513,60
"30394","E01015238",2001,615,8,607,140
"30395","E01015239",2001,663,32,631,219
"30396","E01015249",2001,615,175,440,29
"30397","E01015250",2001,627,9,618,97
"30398","E01015251",2001,511,39,472,65
"30399","E01015252",2001,631,60,571,72
"30400","E01015253",2001,489,39,450,66
"30401","E01015254",2001,613,35,578,34
"30402","E01015257",2001,600,196,404,89
"30403","E01015258",2001,710,124,586,103
"30404","E01015259",2001,589,24,565,116
"30405","E01015260",2001,800,41,759,321
"30406","E01015240",2001,740,33,707,183
"30407","E01015241",2001,636,34,602,99
"30408","E01015242",2001,528,91,437,66
"30409","E01015243",2001,601,15,586,77
"30410","E01015214",2001,666,3,663,232
"30411","E01015215",2001,606,7,599,87
"30412","E01015216",2001,611,12,599,150
"30413","E01015218",2001,590,50,540,99
"30414","E01015209",2001,603,8,595,200
"30415","E01015210",2001,674,144,530,113
"30416","E01015212",2001,636,9,627,155
"30417","E01015213",2001,597,50,547,42
"30418","E01015217",2001,755,82,673,277
"30419","E01015255",2001,770,99,671,415
"30420","E01015256",2001,852,55,797,400
"30421","E01015261",2001,768,32,736,237
"30422","E01015211",2001,591,7,584,27
"30423","E01015207",2001,679,12,667,122
"30424","E01015208",2001,832,6,826,46
"30425","E01015267",2001,780,17,763,297
"30426","E01015268",2001,784,57,727,201
"30427","E01015269",2001,711,27,684,178
"30428","E01015270",2001,880,51,829,243
"30429","E01015271",2001,711,0,711,69
"30430","E01015224",2001,649,7,642,84
"30431","E01015225",2001,600,67,533,48
"30432","E01015226",2001,610,3,607,19
"30433","E01015227",2001,615,4,611,21
"30434","E01015228",2001,727,5,722,164
"30435","E01015230",2001,649,3,646,29
"30436","E01015202",2001,595,30,565,45
"30437","E01015203",2001,512,8,504,12
"30438","E01015204",2001,614,20,594,137
"30439","E01015205",2001,657,15,642,45
"30440","E01015206",2001,646,27,619,96
"30441","E01015190",2001,543,46,497,87
"30442","E01015191",2001,622,34,588,49
"30443","E01015192",2001,611,163,448,39
"30444","E01015193",2001,581,84,497,41
"30445","E01015194",2001,609,126,483,22
"30446","E01015195",2001,620,118,502,41
"30447","E01015196",2001,632,305,327,26
"30448","E01015231",2001,728,151,577,307
"30449","E01015232",2001,752,11,741,255
"30450","E01015233",2001,620,13,607,229
"30451","E01015234",2001,603,76,527,110
"30452","E01015235",2001,744,17,727,212
"30453","E01015229",2001,645,92,553,123
"30454","E01015219",2001,617,119,498,88
"30455","E01015220",2001,625,26,599,31
"30456","E01015221",2001,659,56,603,51
"30457","E01015222",2001,580,12,568,60
"30458","E01015223",2001,524,6,518,27
"30459","E01015197",2001,652,3,649,11
"30460","E01015198",2001,734,8,726,28
"30461","E01015199",2001,641,6,635,23
"30462","E01015200",2001,455,63,392,16
"30463","E01015201",2001,597,54,543,65
"30464","E01015183",2001,595,70,525,52
"30465","E01015184",2001,628,5,623,25
"30466","E01015185",2001,727,89,638,125
"30467","E01015186",2001,726,43,683,261
"30468","E01015187",2001,766,18,748,130
"30469","E01015188",2001,651,30,621,76
"30470","E01015189",2001,646,19,627,165
"30471","E01015244",2001,638,21,617,46
"30472","E01015245",2001,597,107,490,35
"30473","E01015246",2001,630,17,613,65
"30474","E01015247",2001,615,50,565,74
"30475","E01015248",2001,653,87,566,118
"30476","E01018753",2001,619,13,606,37
"30477","E01018754",2001,638,142,496,63
"30478","E01018755",2001,638,8,630,64
"30479","E01018756",2001,722,55,667,106
"30480","E01018777",2001,800,63,737,66
"30481","E01018782",2001,616,72,544,46
"30482","E01018783",2001,616,23,593,55
"30483","E01018784",2001,608,55,553,84
"30484","E01018779",2001,916,68,848,77
"30485","E01018750",2001,734,5,729,69
"30486","E01018751",2001,692,179,513,140
"30487","E01018752",2001,611,8,603,43
"30488","E01018758",2001,942,124,818,83
"30489","E01018778",2001,665,78,587,98
"30490","E01018768",2001,652,27,625,68
"30491","E01018769",2001,681,66,615,101
"30492","E01018770",2001,512,210,302,38
"30493","E01018771",2001,645,61,584,209
"30494","E01018772",2001,656,3,653,46
"30495","E01018767",2001,641,311,330,44
"30496","E01018764",2001,580,30,550,58
"30497","E01018787",2001,468,6,462,38
"30498","E01018795",2001,509,4,505,33
"30499","E01018796",2001,500,9,491,44
"30500","E01018785",2001,771,86,685,150
"30501","E01018765",2001,643,85,558,60
"30502","E01018763",2001,410,41,369,56
"30503","E01018757",2001,867,40,827,112
"30504","E01018786",2001,474,17,457,15
"30505","E01018788",2001,648,243,405,27
"30506","E01018790",2001,489,135,354,26
"30507","E01018794",2001,610,89,521,28
"30508","E01018791",2001,501,153,348,30
"30509","E01018792",2001,619,9,610,26
"30510","E01018793",2001,728,115,613,143
"30511","E01018789",2001,601,16,585,39
"30512","E01018774",2001,615,167,448,66
"30513","E01018766",2001,852,144,708,131
"30514","E01018759",2001,580,51,529,94
"30515","E01018760",2001,471,49,422,57
"30516","E01018761",2001,686,120,566,57
"30517","E01018797",2001,497,154,343,50
"30518","E01018798",2001,649,56,593,56
"30519","E01018799",2001,525,186,339,41
"30520","E01018800",2001,635,15,620,124
"30521","E01018801",2001,401,33,368,43
"30522","E01018802",2001,611,33,578,38
"30523","E01018780",2001,887,176,711,98
"30524","E01018781",2001,892,114,778,168
"30525","E01018775",2001,610,8,602,73
"30526","E01018776",2001,608,19,589,154
"30527","E01018773",2001,740,131,609,98
"30528","E01018762",2001,536,19,517,88
"30529","E01018815",2001,787,62,725,121
"30530","E01018831",2001,507,44,463,63
"30531","E01018832",2001,491,11,480,39
"30532","E01018847",2001,592,30,562,83
"30533","E01018842",2001,631,83,548,53
"30534","E01018843",2001,521,9,512,43
"30535","E01018844",2001,622,66,556,178
"30536","E01018833",2001,546,35,511,48
"30537","E01018851",2001,669,124,545,70
"30538","E01018852",2001,1013,14,999,120
"30539","E01018825",2001,679,11,668,128
"30540","E01018826",2001,967,72,895,77
"30541","E01018853",2001,840,161,679,92
"30542","E01018854",2001,597,248,349,42
"30543","E01018823",2001,757,54,703,85
"30544","E01018824",2001,764,136,628,36
"30545","E01018855",2001,653,57,596,90
"30546","E01018856",2001,629,160,469,60
"30547","E01018857",2001,593,195,398,70
"30548","E01018858",2001,607,90,517,31
"30549","E01018822",2001,515,8,507,43
"30550","E01018819",2001,642,75,567,80
"30551","E01018807",2001,626,53,573,124
"30552","E01018808",2001,589,7,582,109
"30553","E01018809",2001,864,262,602,201
"30554","E01018810",2001,612,7,605,122
"30555","E01018820",2001,691,67,624,120
"30556","E01018821",2001,453,15,438,39
"30557","E01018816",2001,726,19,707,48
"30558","E01018817",2001,884,17,867,216
"30559","E01018818",2001,700,67,633,47
"30560","E01018845",2001,579,71,508,76
"30561","E01018846",2001,614,48,566,135
"30562","E01018848",2001,669,12,657,91
"30563","E01018849",2001,1045,125,920,142
"30564","E01018850",2001,603,79,524,77
"30565","E01018827",2001,637,21,616,57
"30566","E01018828",2001,695,85,610,90
"30567","E01018829",2001,515,24,491,78
"30568","E01018830",2001,638,53,585,48
"30569","E01018834",2001,603,76,527,46
"30570","E01018835",2001,632,95,537,60
"30571","E01018836",2001,750,274,476,129
"30572","E01018837",2001,751,91,660,98
"30573","E01018838",2001,611,194,417,47
"30574","E01018839",2001,631,54,577,177
"30575","E01018840",2001,606,45,561,171
"30576","E01018841",2001,610,294,316,30
"30577","E01018860",2001,841,415,426,28
"30578","E01018803",2001,745,39,706,212
"30579","E01018804",2001,748,49,699,277
"30580","E01018805",2001,647,26,621,94
"30581","E01018806",2001,657,56,601,146
"30582","E01018811",2001,645,12,633,53
"30583","E01018812",2001,479,141,338,28
"30584","E01018813",2001,511,0,511,46
"30585","E01018814",2001,621,20,601,50
"30586","E01018859",2001,734,15,719,46
"30587","E01018889",2001,538,3,535,45
"30588","E01018890",2001,618,82,536,39
"30589","E01018891",2001,607,12,595,83
"30590","E01018892",2001,601,11,590,110
"30591","E01018893",2001,635,190,445,62
"30592","E01018908",2001,617,56,561,71
"30593","E01018909",2001,735,7,728,117
"30594","E01018910",2001,745,463,282,46
"30595","E01018911",2001,765,192,573,149
"30596","E01018912",2001,611,4,607,85
"30597","E01018913",2001,643,31,612,151
"30598","E01018914",2001,656,33,623,78
"30599","E01018915",2001,650,5,645,83
"30600","E01018916",2001,507,93,414,49
"30601","E01018917",2001,554,3,551,45
"30602","E01018918",2001,721,68,653,90
"30603","E01018919",2001,587,23,564,39
"30604","E01018894",2001,658,14,644,56
"30605","E01018895",2001,646,13,633,95
"30606","E01018896",2001,619,63,556,56
"30607","E01018897",2001,588,54,534,118
"30608","E01018898",2001,508,257,251,46
"30609","E01018865",2001,733,34,699,129
"30610","E01018866",2001,735,16,719,98
"30611","E01018867",2001,663,111,552,119
"30612","E01018868",2001,729,18,711,195
"30613","E01018874",2001,582,82,500,28
"30614","E01018875",2001,623,337,286,57
"30615","E01018876",2001,528,10,518,57
"30616","E01018877",2001,628,71,557,62
"30617","E01018878",2001,639,37,602,226
"30618","E01018869",2001,635,70,565,54
"30619","E01018870",2001,493,293,200,44
"30620","E01018871",2001,634,7,627,74
"30621","E01018872",2001,524,33,491,53
"30622","E01018873",2001,506,83,423,45
"30623","E01018863",2001,601,41,560,59
"30624","E01018864",2001,592,14,578,53
"30625","E01018921",2001,825,81,744,90
"30626","E01018922",2001,855,16,839,91
"30627","E01018879",2001,808,49,759,74
"30628","E01018880",2001,872,83,789,120
"30629","E01018899",2001,568,59,509,34
"30630","E01018900",2001,596,40,556,49
"30631","E01018901",2001,566,39,527,48
"30632","E01018882",2001,593,7,586,46
"30633","E01018883",2001,597,16,581,61
"30634","E01018884",2001,641,7,634,57
"30635","E01018885",2001,591,79,512,96
"30636","E01018886",2001,495,61,434,214
"30637","E01018887",2001,599,107,492,127
"30638","E01018888",2001,737,279,458,53
"30639","E01018861",2001,580,37,543,55
"30640","E01018862",2001,599,33,566,51
"30641","E01018905",2001,489,38,451,58
"30642","E01018906",2001,626,19,607,119
"30643","E01018907",2001,616,162,454,61
"30644","E01018920",2001,908,87,821,146
"30645","E01018881",2001,863,73,790,111
"30646","E01018902",2001,528,63,465,80
"30647","E01018903",2001,409,31,378,64
"30648","E01018904",2001,885,88,797,100
"30649","E01018936",2001,708,53,655,192
"30650","E01018937",2001,609,223,386,43
"30651","E01018938",2001,757,147,610,66
"30652","E01018959",2001,691,5,686,58
"30653","E01018960",2001,703,72,631,100
"30654","E01018961",2001,709,28,681,182
"30655","E01018943",2001,822,57,765,91
"30656","E01018951",2001,878,68,810,77
"30657","E01018974",2001,883,64,819,106
"30658","E01018969",2001,964,56,908,117
"30659","E01018940",2001,608,36,572,71
"30660","E01018941",2001,626,71,555,68
"30661","E01018942",2001,692,42,650,126
"30662","E01018939",2001,920,161,759,108
"30663","E01018953",2001,484,26,458,97
"30664","E01018968",2001,892,34,858,112
"30665","E01018946",2001,623,122,501,41
"30666","E01018947",2001,514,101,413,60
"30667","E01018948",2001,630,56,574,130
"30668","E01018949",2001,504,230,274,28
"30669","E01018950",2001,763,80,683,247
"30670","E01018925",2001,861,50,811,140
"30671","E01018965",2001,905,42,863,108
"30672","E01018966",2001,438,11,427,37
"30673","E01018967",2001,513,38,475,52
"30674","E01018952",2001,482,20,462,62
"30675","E01018924",2001,427,24,403,88
"30676","E01018962",2001,991,143,848,138
"30677","E01018963",2001,647,101,546,124
"30678","E01018964",2001,499,19,480,123
"30679","E01018954",2001,511,64,447,217
"30680","E01018955",2001,771,87,684,115
"30681","E01018956",2001,491,41,450,73
"30682","E01018957",2001,575,38,537,77
"30683","E01018958",2001,751,202,549,103
"30684","E01018970",2001,626,30,596,64
"30685","E01018971",2001,715,75,640,53
"30686","E01018972",2001,780,197,583,144
"30687","E01018973",2001,632,88,544,71
"30688","E01018944",2001,435,76,359,43
"30689","E01018945",2001,510,15,495,46
"30690","E01018926",2001,944,71,873,107
"30691","E01018923",2001,510,52,458,54
"30692","E01018932",2001,654,144,510,76
"30693","E01018933",2001,596,153,443,157
"30694","E01018934",2001,609,7,602,42
"30695","E01018935",2001,601,54,547,55
"30696","E01018927",2001,575,106,469,45
"30697","E01018928",2001,725,213,512,104
"30698","E01018929",2001,428,50,378,30
"30699","E01018930",2001,648,392,256,34
"30700","E01018931",2001,514,48,466,39
"30701","E01019008",2001,624,243,381,38
"30702","E01019009",2001,527,152,375,46
"30703","E01019010",2001,522,20,502,36
"30704","E01019011",2001,592,3,589,99
"30705","E01019012",2001,1100,96,1004,254
"30706","E01018978",2001,548,97,451,66
"30707","E01018981",2001,762,23,739,74
"30708","E01018982",2001,914,88,826,146
"30709","E01018983",2001,649,10,639,78
"30710","E01018984",2001,857,357,500,85
"30711","E01018985",2001,872,7,865,109
"30712","E01018986",2001,676,41,635,68
"30713","E01018987",2001,885,6,879,158
"30714","E01018975",2001,816,86,730,81
"30715","E01018979",2001,519,60,459,69
"30716","E01018980",2001,509,13,496,63
"30717","E01018990",2001,897,140,757,185
"30718","E01019007",2001,894,68,826,136
"30719","E01019006",2001,624,16,608,99
"30720","E01018991",2001,662,77,585,67
"30721","E01018988",2001,651,46,605,79
"30722","E01018989",2001,687,94,593,119
"30723","E01018976",2001,976,31,945,147
"30724","E01018977",2001,597,208,389,38
"30725","E01018994",2001,762,137,625,61
"30726","E01018996",2001,763,81,682,244
"30727","E01018997",2001,588,357,231,30
"30728","E01018998",2001,645,3,642,146
"30729","E01018999",2001,761,193,568,168
"30730","E01019001",2001,861,91,770,266
"30731","E01018995",2001,1045,361,684,180
"30732","E01018992",2001,703,10,693,95
"30733","E01018993",2001,746,119,627,123
"30734","E01019005",2001,852,126,726,138
"30735","E01019002",2001,743,37,706,106
"30736","E01019003",2001,759,6,753,92
"30737","E01019004",2001,769,186,583,141
"30738","E01019000",2001,717,91,626,82
"30739","E01019048",2001,797,11,786,125
"30740","E01019049",2001,705,66,639,197
"30741","E01019050",2001,556,12,544,84
"30742","E01019051",2001,706,200,506,59
"30743","E01019060",2001,611,33,578,95
"30744","E01019061",2001,646,31,615,90
"30745","E01019062",2001,614,173,441,73
"30746","E01019063",2001,646,27,619,102
"30747","E01019064",2001,648,11,637,95
"30748","E01019065",2001,487,59,428,50
"30749","E01019028",2001,646,128,518,125
"30750","E01019029",2001,746,77,669,218
"30751","E01019030",2001,625,27,598,87
"30752","E01019031",2001,622,46,576,112
"30753","E01019018",2001,600,15,585,31
"30754","E01019019",2001,598,32,566,66
"30755","E01019020",2001,621,86,535,197
"30756","E01019021",2001,653,15,638,82
"30757","E01019022",2001,767,181,586,75
"30758","E01019023",2001,636,41,595,132
"30759","E01019052",2001,653,99,554,89
"30760","E01019053",2001,666,0,666,148
"30761","E01019054",2001,657,15,642,87
"30762","E01019055",2001,544,178,366,64
"30763","E01019035",2001,703,37,666,136
"30764","E01019036",2001,658,31,627,81
"30765","E01019037",2001,588,109,479,53
"30766","E01019074",2001,609,95,514,77
"30767","E01019075",2001,629,20,609,92
"30768","E01019076",2001,604,57,547,65
"30769","E01019069",2001,520,45,475,100
"30770","E01019070",2001,701,42,659,103
"30771","E01019071",2001,601,15,586,101
"30772","E01019072",2001,605,116,489,47
"30773","E01019073",2001,547,20,527,68
"30774","E01019056",2001,605,270,335,42
"30775","E01019057",2001,738,23,715,93
"30776","E01019058",2001,706,18,688,68
"30777","E01019059",2001,696,114,582,72
"30778","E01019024",2001,606,39,567,67
"30779","E01019025",2001,601,16,585,96
"30780","E01019026",2001,658,6,652,84
"30781","E01019027",2001,741,99,642,124
"30782","E01019013",2001,661,130,531,59
"30783","E01019014",2001,560,40,520,27
"30784","E01019015",2001,538,0,538,17
"30785","E01019016",2001,538,36,502,44
"30786","E01019017",2001,861,8,853,69
"30787","E01019032",2001,609,6,603,73
"30788","E01019034",2001,606,37,569,153
"30789","E01019045",2001,611,14,597,62
"30790","E01019047",2001,603,100,503,148
"30791","E01019046",2001,611,219,392,34
"30792","E01019033",2001,657,199,458,116
"30793","E01019041",2001,625,167,458,89
"30794","E01019042",2001,626,82,544,134
"30795","E01019043",2001,631,20,611,55
"30796","E01019044",2001,730,29,701,66
"30797","E01019038",2001,635,17,618,153
"30798","E01019039",2001,634,24,610,111
"30799","E01019040",2001,509,36,473,59
"30800","E01019066",2001,490,23,467,87
"30801","E01019067",2001,491,16,475,113
"30802","E01019068",2001,698,14,684,36
"30803","E01019077",2001,881,162,719,284
"30804","E01019902",2001,859,25,834,68
"30805","E01019938",2001,861,43,818,74
"30806","E01019967",2001,529,23,506,81
"30807","E01019927",2001,605,166,439,80
"30808","E01019932",2001,733,221,512,87
"30809","E01019933",2001,611,54,557,80
"30810","E01019934",2001,643,31,612,21
"30811","E01019928",2001,592,120,472,25
"30812","E01019929",2001,631,39,592,68
"30813","E01019930",2001,664,16,648,53
"30814","E01019931",2001,517,6,511,39
"30815","E01019925",2001,521,14,507,21
"30816","E01019926",2001,406,12,394,61
"30817","E01019941",2001,404,32,372,45
"30818","E01019962",2001,861,87,774,86
"30819","E01019959",2001,462,54,408,68
"30820","E01019960",2001,480,17,463,60
"30821","E01019966",2001,443,30,413,24
"30822","E01019886",2001,965,266,699,44
"30823","E01019887",2001,580,150,430,41
"30824","E01019888",2001,656,4,652,119
"30825","E01019889",2001,600,29,571,26
"30826","E01019891",2001,582,85,497,126
"30827","E01019892",2001,584,74,510,54
"30828","E01019893",2001,696,71,625,72
"30829","E01019903",2001,844,66,778,109
"30830","E01019935",2001,526,37,489,26
"30831","E01019936",2001,485,64,421,42
"30832","E01019899",2001,597,129,468,30
"30833","E01019900",2001,735,14,721,36
"30834","E01019961",2001,940,48,892,77
"30835","E01019939",2001,576,29,547,30
"30836","E01019940",2001,649,19,630,31
"30837","E01019942",2001,653,153,500,54
"30838","E01019943",2001,631,36,595,14
"30839","E01019944",2001,648,26,622,121
"30840","E01019901",2001,548,35,513,53
"30841","E01019890",2001,830,86,744,116
"30842","E01019951",2001,909,58,851,61
"30843","E01019946",2001,641,35,606,22
"30844","E01019947",2001,787,7,780,251
"30845","E01019948",2001,626,45,581,18
"30846","E01019949",2001,654,3,651,44
"30847","E01019950",2001,594,176,418,29
"30848","E01019952",2001,761,59,702,61
"30849","E01019953",2001,680,110,570,10
"30850","E01019954",2001,629,157,472,22
"30851","E01019955",2001,732,143,589,44
"30852","E01019956",2001,887,38,849,135
"30853","E01019957",2001,897,16,881,37
"30854","E01019958",2001,769,43,726,35
"30855","E01019963",2001,651,67,584,60
"30856","E01019945",2001,806,56,750,152
"30857","E01019937",2001,890,88,802,67
"30858","E01019964",2001,407,3,404,47
"30859","E01019965",2001,662,63,599,110
"30860","E01019898",2001,944,12,932,88
"30861","E01019904",2001,616,152,464,24
"30862","E01019905",2001,625,4,621,10
"30863","E01019906",2001,654,14,640,33
"30864","E01019907",2001,662,26,636,40
"30865","E01019908",2001,623,92,531,48
"30866","E01019909",2001,754,15,739,28
"30867","E01019910",2001,643,36,607,45
"30868","E01019911",2001,757,47,710,49
"30869","E01019894",2001,744,26,718,75
"30870","E01019895",2001,639,22,617,65
"30871","E01019896",2001,729,32,697,76
"30872","E01019897",2001,630,146,484,61
"30873","E01019920",2001,600,90,510,62
"30874","E01019921",2001,619,30,589,37
"30875","E01019922",2001,635,265,370,13
"30876","E01019923",2001,527,103,424,21
"30877","E01019924",2001,600,135,465,47
"30878","E01019916",2001,868,36,832,318
"30879","E01019917",2001,626,6,620,112
"30880","E01019918",2001,762,7,755,289
"30881","E01019919",2001,715,48,667,174
"30882","E01019912",2001,765,64,701,104
"30883","E01019913",2001,666,4,662,61
"30884","E01019914",2001,875,388,487,47
"30885","E01019915",2001,617,20,597,41
"30886","E01019978",2001,495,125,370,73
"30887","E01019979",2001,636,16,620,26
"30888","E01020001",2001,619,4,615,70
"30889","E01019998",2001,613,82,531,67
"30890","E01019999",2001,502,22,480,47
"30891","E01020000",2001,616,259,357,33
"30892","E01020007",2001,513,15,498,240
"30893","E01019993",2001,505,6,499,30
"30894","E01019990",2001,610,288,322,20
"30895","E01019991",2001,610,220,390,44
"30896","E01019992",2001,621,106,515,25
"30897","E01020002",2001,621,157,464,16
"30898","E01020003",2001,643,13,630,20
"30899","E01020004",2001,650,6,644,49
"30900","E01020005",2001,628,191,437,26
"30901","E01020019",2001,593,19,574,276
"30902","E01020020",2001,628,9,619,306
"30903","E01020021",2001,498,12,486,138
"30904","E01020022",2001,609,141,468,281
"30905","E01019997",2001,613,13,600,246
"30906","E01019982",2001,645,102,543,103
"30907","E01019983",2001,635,69,566,37
"30908","E01019984",2001,560,11,549,39
"30909","E01019985",2001,610,293,317,27
"30910","E01019980",2001,657,181,476,65
"30911","E01019987",2001,645,83,562,136
"30912","E01019989",2001,515,10,505,63
"30913","E01020006",2001,660,192,468,79
"30914","E01020008",2001,633,18,615,263
"30915","E01020009",2001,625,24,601,166
"30916","E01019986",2001,635,12,623,47
"30917","E01020036",2001,672,159,513,30
"30918","E01020037",2001,610,269,341,16
"30919","E01020039",2001,840,516,324,16
"30920","E01020040",2001,630,144,486,21
"30921","E01020016",2001,880,439,441,178
"30922","E01020017",2001,703,68,635,315
"30923","E01020018",2001,900,286,614,239
"30924","E01019994",2001,654,117,537,182
"30925","E01019995",2001,740,368,372,130
"30926","E01019996",2001,513,71,442,198
"30927","E01020023",2001,734,97,637,54
"30928","E01020024",2001,680,46,634,101
"30929","E01020025",2001,763,76,687,195
"30930","E01019975",2001,496,142,354,29
"30931","E01020029",2001,628,41,587,52
"30932","E01020030",2001,768,103,665,152
"30933","E01020031",2001,635,24,611,68
"30934","E01020032",2001,615,9,606,136
"30935","E01020038",2001,624,37,587,38
"30936","E01020035",2001,511,48,463,26
"30937","E01020026",2001,642,3,639,26
"30938","E01020027",2001,718,72,646,46
"30939","E01020028",2001,615,3,612,47
"30940","E01019976",2001,540,0,540,22
"30941","E01019977",2001,626,63,563,24
"30942","E01019981",2001,598,150,448,39
"30943","E01019973",2001,626,86,540,29
"30944","E01019974",2001,642,92,550,26
"30945","E01019988",2001,517,34,483,43
"30946","E01020010",2001,607,239,368,60
"30947","E01020013",2001,518,94,424,59
"30948","E01020014",2001,656,348,308,32
"30949","E01020015",2001,734,470,264,14
"30950","E01019968",2001,650,81,569,55
"30951","E01019969",2001,612,57,555,66
"30952","E01019970",2001,531,15,516,50
"30953","E01019971",2001,738,99,639,202
"30954","E01019972",2001,572,98,474,60
"30955","E01020011",2001,516,59,457,34
"30956","E01020012",2001,590,224,366,22
"30957","E01020033",2001,749,52,697,63
"30958","E01020034",2001,1332,91,1241,244
"30959","E01020046",2001,588,45,543,73
"30960","E01020049",2001,514,17,497,63
"30961","E01020050",2001,837,109,728,118
"30962","E01020077",2001,590,36,554,74
"30963","E01020066",2001,726,11,715,98
"30964","E01020080",2001,508,9,499,46
"30965","E01020051",2001,778,31,747,45
"30966","E01020047",2001,723,13,710,101
"30967","E01020063",2001,940,203,737,56
"30968","E01020074",2001,784,28,756,75
"30969","E01020075",2001,682,78,604,59
"30970","E01020065",2001,650,163,487,81
"30971","E01020067",2001,652,377,275,25
"30972","E01020052",2001,740,196,544,134
"30973","E01020053",2001,599,169,430,24
"30974","E01020048",2001,808,42,766,274
"30975","E01020078",2001,661,224,437,175
"30976","E01020079",2001,604,228,376,18
"30977","E01020081",2001,503,152,351,26
"30978","E01020062",2001,637,7,630,39
"30979","E01020064",2001,511,134,377,61
"30980","E01020059",2001,713,79,634,72
"30981","E01020045",2001,613,56,557,29
"30982","E01020057",2001,720,213,507,73
"30983","E01020058",2001,781,32,749,58
"30984","E01020054",2001,625,34,591,35
"30985","E01020055",2001,716,167,549,118
"30986","E01020056",2001,716,30,686,103
"30987","E01020043",2001,739,137,602,95
"30988","E01020044",2001,587,59,528,63
"30989","E01020071",2001,797,97,700,55
"30990","E01020072",2001,611,41,570,67
"30991","E01020073",2001,668,75,593,45
"30992","E01020076",2001,630,50,580,102
"30993","E01020082",2001,443,42,401,37
"30994","E01020083",2001,726,66,660,89
"30995","E01020068",2001,630,80,550,80
"30996","E01020069",2001,575,60,515,77
"30997","E01020070",2001,674,47,627,58
"30998","E01020060",2001,770,131,639,200
"30999","E01020061",2001,764,69,695,59
"31000","E01020041",2001,771,243,528,75
"31001","E01020042",2001,648,14,634,48
"31002","E01020114",2001,494,15,479,134
"31003","E01020115",2001,496,3,493,68
"31004","E01020111",2001,650,195,455,145
"31005","E01020112",2001,648,53,595,296
"31006","E01020126",2001,722,54,668,94
"31007","E01020099",2001,562,6,556,84
"31008","E01020100",2001,432,30,402,43
"31009","E01020101",2001,629,35,594,105
"31010","E01020116",2001,630,44,586,94
"31011","E01020117",2001,652,33,619,45
"31012","E01020118",2001,515,147,368,47
"31013","E01020113",2001,478,10,468,151
"31014","E01020108",2001,891,25,866,132
"31015","E01020109",2001,633,10,623,53
"31016","E01020090",2001,628,3,625,32
"31017","E01020091",2001,550,4,546,62
"31018","E01020092",2001,638,17,621,26
"31019","E01020093",2001,594,101,493,94
"31020","E01020110",2001,747,140,607,186
"31021","E01020089",2001,925,66,859,101
"31022","E01020088",2001,739,63,676,70
"31023","E01020120",2001,603,3,600,50
"31024","E01020127",2001,691,26,665,78
"31025","E01020132",2001,644,46,598,51
"31026","E01020133",2001,515,6,509,28
"31027","E01020134",2001,515,172,343,84
"31028","E01020139",2001,601,145,456,65
"31029","E01020140",2001,507,42,465,63
"31030","E01020141",2001,625,231,394,69
"31031","E01020094",2001,898,360,538,243
"31032","E01020095",2001,628,118,510,105
"31033","E01020096",2001,774,117,657,179
"31034","E01020123",2001,581,132,449,21
"31035","E01020124",2001,526,4,522,63
"31036","E01020125",2001,602,3,599,44
"31037","E01020128",2001,504,4,500,35
"31038","E01020129",2001,505,147,358,40
"31039","E01020130",2001,634,47,587,134
"31040","E01020102",2001,605,9,596,84
"31041","E01020103",2001,518,259,259,14
"31042","E01020104",2001,573,146,427,97
"31043","E01020105",2001,518,55,463,22
"31044","E01020106",2001,507,3,504,14
"31045","E01020107",2001,647,3,644,25
"31046","E01020119",2001,661,22,639,131
"31047","E01020121",2001,752,67,685,59
"31048","E01020122",2001,649,33,616,91
"31049","E01020084",2001,654,103,551,80
"31050","E01020085",2001,526,17,509,64
"31051","E01020086",2001,613,3,610,42
"31052","E01020097",2001,867,40,827,129
"31053","E01020131",2001,811,75,736,134
"31054","E01020135",2001,613,164,449,50
"31055","E01020136",2001,524,21,503,42
"31056","E01020137",2001,641,40,601,136
"31057","E01020138",2001,852,81,771,73
"31058","E01020098",2001,873,85,788,94
"31059","E01020087",2001,791,65,726,85
"31060","E01020144",2001,609,4,605,47
"31061","E01020145",2001,700,54,646,80
"31062","E01020146",2001,530,6,524,81
"31063","E01020149",2001,531,73,458,74
"31064","E01020148",2001,462,39,423,76
"31065","E01020157",2001,856,51,805,130
"31066","E01020160",2001,711,55,656,81
"31067","E01020176",2001,495,20,475,60
"31068","E01020177",2001,585,152,433,39
"31069","E01020180",2001,837,259,578,102
"31070","E01020181",2001,758,163,595,35
"31071","E01020182",2001,615,111,504,69
"31072","E01020183",2001,748,32,716,228
"31073","E01020184",2001,751,156,595,108
"31074","E01020188",2001,777,50,727,70
"31075","E01020170",2001,873,34,839,52
"31076","E01020156",2001,801,20,781,115
"31077","E01020153",2001,619,21,598,88
"31078","E01020161",2001,926,143,783,86
"31079","E01020162",2001,631,21,610,34
"31080","E01020163",2001,659,35,624,19
"31081","E01020164",2001,615,98,517,52
"31082","E01020165",2001,617,12,605,60
"31083","E01020166",2001,584,3,581,23
"31084","E01020167",2001,501,4,497,17
"31085","E01020150",2001,728,132,596,77
"31086","E01020142",2001,842,63,779,104
"31087","E01020143",2001,865,60,805,164
"31088","E01020151",2001,789,25,764,64
"31089","E01020152",2001,869,137,732,193
"31090","E01020154",2001,477,123,354,68
"31091","E01020155",2001,457,244,213,17
"31092","E01020158",2001,630,80,550,54
"31093","E01020159",2001,560,39,521,103
"31094","E01020147",2001,825,88,737,83
"31095","E01020190",2001,835,97,738,74
"31096","E01020185",2001,584,17,567,28
"31097","E01020186",2001,640,0,640,32
"31098","E01020187",2001,521,87,434,51
"31099","E01020171",2001,777,37,740,78
"31100","E01020168",2001,860,94,766,76
"31101","E01020169",2001,919,63,856,162
"31102","E01020189",2001,935,303,632,83
"31103","E01020174",2001,680,58,622,79
"31104","E01020175",2001,902,69,833,87
"31105","E01020178",2001,895,49,846,68
"31106","E01020179",2001,801,77,724,80
"31107","E01020172",2001,807,52,755,40
"31108","E01020173",2001,802,117,685,57
"31109","E01020243",2001,527,38,489,72
"31110","E01020262",2001,517,28,489,73
"31111","E01020263",2001,692,27,665,64
"31112","E01020274",2001,460,6,454,74
"31113","E01020244",2001,646,113,533,61
"31114","E01020245",2001,663,35,628,89
"31115","E01020240",2001,659,112,547,64
"31116","E01020241",2001,647,24,623,89
"31117","E01020242",2001,534,3,531,21
"31118","E01020205",2001,623,18,605,55
"31119","E01020273",2001,594,73,521,42
"31120","E01020258",2001,655,68,587,83
"31121","E01020259",2001,537,18,519,113
"31122","E01020206",2001,672,84,588,116
"31123","E01020220",2001,529,135,394,45
"31124","E01020221",2001,523,45,478,90
"31125","E01020222",2001,508,3,505,55
"31126","E01020223",2001,685,52,633,88
"31127","E01020203",2001,734,3,731,64
"31128","E01020229",2001,652,12,640,76
"31129","E01020230",2001,731,22,709,99
"31130","E01020231",2001,651,18,633,52
"31131","E01020232",2001,625,49,576,55
"31132","E01020233",2001,802,14,788,87
"31133","E01020234",2001,612,166,446,29
"31134","E01020235",2001,755,84,671,138
"31135","E01020228",2001,853,135,718,234
"31136","E01020202",2001,671,62,609,43
"31137","E01020236",2001,545,6,539,29
"31138","E01020237",2001,595,26,569,73
"31139","E01020204",2001,627,96,531,114
"31140","E01020270",2001,709,6,703,38
"31141","E01020265",2001,715,7,708,27
"31142","E01020266",2001,631,20,611,87
"31143","E01020267",2001,620,6,614,117
"31144","E01020268",2001,614,35,579,43
"31145","E01020252",2001,625,138,487,70
"31146","E01020253",2001,600,31,569,72
"31147","E01020254",2001,567,150,417,53
"31148","E01020255",2001,587,52,535,58
"31149","E01020257",2001,508,6,502,26
"31150","E01020250",2001,644,23,621,34
"31151","E01020269",2001,1063,107,956,429
"31152","E01020271",2001,646,107,539,107
"31153","E01020272",2001,736,268,468,45
"31154","E01020264",2001,638,80,558,136
"31155","E01020260",2001,588,9,579,100
"31156","E01020261",2001,503,20,483,44
"31157","E01020251",2001,567,5,562,44
"31158","E01020200",2001,485,9,476,52
"31159","E01020201",2001,630,31,599,25
"31160","E01020208",2001,523,179,344,18
"31161","E01020209",2001,627,20,607,76
"31162","E01020210",2001,494,10,484,21
"31163","E01020219",2001,530,9,521,50
"31164","E01020207",2001,445,3,442,79
"31165","E01020194",2001,568,4,564,35
"31166","E01020191",2001,420,15,405,51
"31167","E01020256",2001,599,14,585,77
"31168","E01020211",2001,632,269,363,23
"31169","E01020217",2001,729,31,698,180
"31170","E01020218",2001,667,114,553,152
"31171","E01020224",2001,544,11,533,145
"31172","E01020225",2001,506,67,439,115
"31173","E01020226",2001,494,35,459,66
"31174","E01020227",2001,646,49,597,74
"31175","E01020216",2001,622,165,457,59
"31176","E01020212",2001,510,178,332,18
"31177","E01020213",2001,641,75,566,30
"31178","E01020214",2001,632,40,592,23
"31179","E01020215",2001,582,3,579,16
"31180","E01020195",2001,636,79,557,60
"31181","E01020196",2001,774,169,605,122
"31182","E01020197",2001,549,33,516,49
"31183","E01020198",2001,637,180,457,137
"31184","E01020199",2001,631,89,542,99
"31185","E01020246",2001,426,9,417,29
"31186","E01020247",2001,650,95,555,60
"31187","E01020248",2001,689,3,686,59
"31188","E01020249",2001,628,6,622,47
"31189","E01020238",2001,517,56,461,31
"31190","E01020239",2001,533,7,526,28
"31191","E01020192",2001,626,30,596,46
"31192","E01020193",2001,534,35,499,49
"31193","E01020275",2001,750,74,676,146
"31194","E01020276",2001,621,39,582,36
"31195","E01020297",2001,742,201,541,107
"31196","E01020299",2001,860,9,851,113
"31197","E01020300",2001,706,3,703,72
"31198","E01020298",2001,737,19,718,49
"31199","E01020310",2001,927,14,913,239
"31200","E01020280",2001,1014,85,929,374
"31201","E01020281",2001,644,5,639,38
"31202","E01020282",2001,737,193,544,88
"31203","E01020283",2001,615,17,598,41
"31204","E01020284",2001,656,108,548,90
"31205","E01020285",2001,748,251,497,41
"31206","E01020277",2001,743,325,418,61
"31207","E01020278",2001,554,21,533,58
"31208","E01020279",2001,625,71,554,54
"31209","E01020288",2001,666,31,635,165
"31210","E01020292",2001,598,59,539,111
"31211","E01020295",2001,613,29,584,59
"31212","E01020296",2001,548,25,523,70
"31213","E01020304",2001,613,94,519,65
"31214","E01020305",2001,495,36,459,130
"31215","E01020306",2001,500,16,484,37
"31216","E01020307",2001,602,148,454,58
"31217","E01020308",2001,647,25,622,60
"31218","E01020311",2001,827,65,762,100
"31219","E01020303",2001,650,36,614,64
"31220","E01020287",2001,611,14,597,110
"31221","E01020291",2001,649,40,609,95
"31222","E01020293",2001,826,17,809,175
"31223","E01020294",2001,640,141,499,73
"31224","E01020302",2001,550,34,516,56
"31225","E01020309",2001,612,24,588,52
"31226","E01020301",2001,618,44,574,70
"31227","E01020289",2001,635,24,611,66
"31228","E01020290",2001,640,26,614,63
"31229","E01020286",2001,657,26,631,98
"31230","E01020320",2001,634,21,613,78
"31231","E01020321",2001,697,71,626,87
"31232","E01020322",2001,622,28,594,65
"31233","E01020326",2001,696,63,633,92
"31234","E01020327",2001,642,59,583,56
"31235","E01020328",2001,638,85,553,113
"31236","E01020329",2001,684,89,595,79
"31237","E01020330",2001,740,119,621,169
"31238","E01020323",2001,583,78,505,147
"31239","E01020318",2001,685,70,615,127
"31240","E01020319",2001,637,49,588,84
"31241","E01020339",2001,656,54,602,91
"31242","E01020340",2001,591,48,543,62
"31243","E01020325",2001,569,18,551,119
"31244","E01020314",2001,627,19,608,89
"31245","E01020331",2001,594,30,564,90
"31246","E01020332",2001,724,43,681,198
"31247","E01020333",2001,628,6,622,26
"31248","E01020334",2001,754,114,640,81
"31249","E01020335",2001,614,74,540,23
"31250","E01020336",2001,614,3,611,26
"31251","E01020337",2001,594,145,449,21
"31252","E01020338",2001,764,83,681,45
"31253","E01020324",2001,648,39,609,49
"31254","E01020317",2001,637,14,623,56
"31255","E01020341",2001,661,11,650,49
"31256","E01020342",2001,630,140,490,78
"31257","E01020315",2001,604,62,542,96
"31258","E01020316",2001,736,8,728,87
"31259","E01020312",2001,676,18,658,51
"31260","E01020313",2001,613,117,496,60
"31261","E01020343",2001,624,74,550,18
"31262","E01020344",2001,574,26,548,35
"31263","E01020345",2001,513,79,434,42
"31264","E01020365",2001,687,46,641,47
"31265","E01020366",2001,893,4,889,25
"31266","E01020351",2001,471,19,452,31
"31267","E01020352",2001,524,47,477,20
"31268","E01020353",2001,618,159,459,24
"31269","E01020359",2001,463,83,380,22
"31270","E01020357",2001,851,127,724,37
"31271","E01020358",2001,655,4,651,25
"31272","E01020349",2001,893,148,745,108
"31273","E01020350",2001,888,7,881,35
"31274","E01020369",2001,627,0,627,31
"31275","E01020370",2001,633,11,622,37
"31276","E01020371",2001,742,4,738,10
"31277","E01020372",2001,505,3,502,20
"31278","E01020363",2001,492,136,356,29
"31279","E01020346",2001,715,209,506,40
"31280","E01020347",2001,720,363,357,32
"31281","E01020348",2001,636,315,321,13
"31282","E01020364",2001,742,132,610,78
"31283","E01020360",2001,610,62,548,50
"31284","E01020361",2001,621,28,593,88
"31285","E01020367",2001,740,30,710,94
"31286","E01020368",2001,1113,277,836,138
"31287","E01020362",2001,650,19,631,41
"31288","E01020354",2001,712,106,606,51
"31289","E01020355",2001,921,12,909,48
"31290","E01020356",2001,769,26,743,51
"31291","E01020373",2001,475,47,428,24
"31292","E01020374",2001,630,6,624,12
"31293","E01020389",2001,841,113,728,193
"31294","E01020397",2001,589,105,484,73
"31295","E01020416",2001,678,10,668,55
"31296","E01020417",2001,452,6,446,16
"31297","E01020418",2001,678,3,675,21
"31298","E01020419",2001,618,7,611,12
"31299","E01020420",2001,511,26,485,21
"31300","E01020411",2001,442,93,349,24
"31301","E01020412",2001,480,131,349,24
"31302","E01020413",2001,525,8,517,28
"31303","E01020414",2001,651,86,565,27
"31304","E01020415",2001,563,9,554,10
"31305","E01020403",2001,617,3,614,22
"31306","E01020404",2001,687,47,640,19
"31307","E01020405",2001,617,6,611,46
"31308","E01020406",2001,1025,6,1019,16
"31309","E01020398",2001,872,44,828,66
"31310","E01020409",2001,436,12,424,29
"31311","E01020410",2001,519,144,375,101
"31312","E01020396",2001,441,30,411,152
"31313","E01020421",2001,501,37,464,60
"31314","E01020422",2001,747,135,612,40
"31315","E01020423",2001,624,27,597,11
"31316","E01020424",2001,647,48,599,18
"31317","E01020425",2001,743,42,701,49
"31318","E01020377",2001,628,3,625,17
"31319","E01020379",2001,663,162,501,21
"31320","E01020380",2001,436,11,425,24
"31321","E01020381",2001,496,0,496,13
"31322","E01020390",2001,618,55,563,15
"31323","E01020391",2001,633,3,630,15
"31324","E01020392",2001,705,29,676,55
"31325","E01020393",2001,553,158,395,35
"31326","E01020394",2001,716,155,561,27
"31327","E01020378",2001,621,11,610,34
"31328","E01020407",2001,494,4,490,16
"31329","E01020408",2001,458,35,423,29
"31330","E01020375",2001,639,58,581,16
"31331","E01020376",2001,497,12,485,20
"31332","E01020426",2001,802,41,761,56
"31333","E01020427",2001,719,301,418,36
"31334","E01020428",2001,1004,183,821,156
"31335","E01020429",2001,744,139,605,75
"31336","E01020399",2001,794,17,777,42
"31337","E01020400",2001,631,4,627,22
"31338","E01020401",2001,708,6,702,19
"31339","E01020402",2001,633,6,627,15
"31340","E01020395",2001,816,3,813,32
"31341","E01020382",2001,612,10,602,31
"31342","E01020383",2001,769,18,751,27
"31343","E01020384",2001,636,33,603,33
"31344","E01020385",2001,477,52,425,26
"31345","E01020386",2001,470,15,455,10
"31346","E01020387",2001,481,0,481,3
"31347","E01020388",2001,614,120,494,28
"31348","E01020443",2001,842,179,663,113
"31349","E01020447",2001,812,145,667,33
"31350","E01020463",2001,745,19,726,49
"31351","E01020464",2001,673,47,626,29
"31352","E01020462",2001,723,61,662,63
"31353","E01020450",2001,702,29,673,63
"31354","E01020451",2001,712,52,660,57
"31355","E01020440",2001,761,74,687,68
"31356","E01020454",2001,913,223,690,110
"31357","E01020455",2001,674,47,627,48
"31358","E01020456",2001,695,105,590,51
"31359","E01020457",2001,716,47,669,56
"31360","E01020458",2001,705,17,688,74
"31361","E01020459",2001,881,274,607,64
"31362","E01020449",2001,883,98,785,48
"31363","E01020433",2001,704,50,654,86
"31364","E01020434",2001,724,140,584,50
"31365","E01020444",2001,672,170,502,55
"31366","E01020445",2001,479,32,447,61
"31367","E01020446",2001,622,55,567,34
"31368","E01020460",2001,784,84,700,51
"31369","E01020461",2001,772,87,685,399
"31370","E01020452",2001,668,202,466,77
"31371","E01020453",2001,702,62,640,62
"31372","E01020442",2001,825,48,777,110
"31373","E01020435",2001,781,33,748,64
"31374","E01020436",2001,482,67,415,26
"31375","E01020437",2001,745,123,622,21
"31376","E01020438",2001,929,243,686,149
"31377","E01020439",2001,937,254,683,86
"31378","E01020441",2001,788,121,667,72
"31379","E01020430",2001,574,66,508,45
"31380","E01020431",2001,431,54,377,73
"31381","E01020432",2001,490,87,403,62
"31382","E01020448",2001,688,87,601,52
"31383","E01020465",2001,850,171,679,110
"31384","E01020469",2001,774,160,614,66
"31385","E01020470",2001,701,3,698,38
"31386","E01020471",2001,499,88,411,31
"31387","E01020472",2001,571,91,480,43
"31388","E01020473",2001,580,8,572,30
"31389","E01020474",2001,720,15,705,65
"31390","E01020475",2001,800,48,752,40
"31391","E01020476",2001,531,19,512,50
"31392","E01020477",2001,579,121,458,25
"31393","E01020485",2001,742,169,573,170
"31394","E01020486",2001,644,77,567,65
"31395","E01020487",2001,517,14,503,25
"31396","E01020488",2001,646,107,539,46
"31397","E01020489",2001,590,47,543,162
"31398","E01020490",2001,688,55,633,125
"31399","E01020491",2001,489,28,461,29
"31400","E01020492",2001,490,78,412,29
"31401","E01020493",2001,645,190,455,270
"31402","E01020466",2001,842,140,702,170
"31403","E01020467",2001,784,48,736,139
"31404","E01020468",2001,684,38,646,62
"31405","E01020478",2001,482,8,474,39
"31406","E01020479",2001,636,64,572,85
"31407","E01020480",2001,742,50,692,70
"31408","E01020481",2001,723,39,684,93
"31409","E01020482",2001,745,73,672,126
"31410","E01020483",2001,489,139,350,29
"31411","E01020484",2001,628,138,490,33
"31412","E01020542",2001,565,103,462,68
"31413","E01020543",2001,612,196,416,32
"31414","E01020544",2001,761,69,692,129
"31415","E01020545",2001,515,44,471,34
"31416","E01020546",2001,494,96,398,173
"31417","E01020547",2001,511,159,352,18
"31418","E01020548",2001,485,77,408,72
"31419","E01020550",2001,702,71,631,47
"31420","E01020541",2001,856,100,756,156
"31421","E01020497",2001,810,52,758,87
"31422","E01020508",2001,819,54,765,104
"31423","E01020494",2001,478,30,448,57
"31424","E01020495",2001,599,51,548,62
"31425","E01020496",2001,738,206,532,52
"31426","E01020534",2001,802,79,723,107
"31427","E01020506",2001,705,82,623,74
"31428","E01020530",2001,739,38,701,157
"31429","E01020529",2001,836,77,759,99
"31430","E01020539",2001,829,92,737,94
"31431","E01020540",2001,925,102,823,136
"31432","E01020509",2001,907,47,860,108
"31433","E01020510",2001,699,189,510,50
"31434","E01020511",2001,775,130,645,50
"31435","E01020535",2001,747,56,691,89
"31436","E01020532",2001,782,13,769,101
"31437","E01020533",2001,882,241,641,41
"31438","E01020498",2001,924,93,831,56
"31439","E01020499",2001,621,288,333,33
"31440","E01020500",2001,742,124,618,103
"31441","E01020501",2001,563,30,533,38
"31442","E01020517",2001,793,22,771,94
"31443","E01020531",2001,768,55,713,89
"31444","E01020507",2001,884,81,803,66
"31445","E01020536",2001,790,104,686,92
"31446","E01020502",2001,760,299,461,70
"31447","E01020503",2001,767,113,654,124
"31448","E01020504",2001,959,25,934,71
"31449","E01020521",2001,730,79,651,91
"31450","E01020522",2001,1017,340,677,152
"31451","E01020526",2001,508,71,437,15
"31452","E01020527",2001,505,91,414,50
"31453","E01020528",2001,639,214,425,25
"31454","E01020523",2001,517,5,512,43
"31455","E01020524",2001,620,45,575,11
"31456","E01020525",2001,520,14,506,10
"31457","E01020518",2001,735,280,455,52
"31458","E01020519",2001,638,104,534,46
"31459","E01020520",2001,661,83,578,53
"31460","E01020505",2001,790,75,715,49
"31461","E01020537",2001,752,40,712,91
"31462","E01020538",2001,705,144,561,37
"31463","E01020549",2001,857,61,796,110
"31464","E01020512",2001,915,82,833,188
"31465","E01020513",2001,626,133,493,29
"31466","E01020514",2001,492,6,486,40
"31467","E01020515",2001,504,37,467,42
"31468","E01020516",2001,636,66,570,27
"31469","E01020551",2001,764,94,670,72
"31470","E01020552",2001,740,439,301,20
"31471","E01020570",2001,675,7,668,64
"31472","E01020571",2001,877,181,696,76
"31473","E01020557",2001,713,6,707,31
"31474","E01020558",2001,752,11,741,42
"31475","E01020559",2001,736,6,730,14
"31476","E01020560",2001,800,12,788,41
"31477","E01020561",2001,757,96,661,105
"31478","E01020579",2001,794,6,788,66
"31479","E01020580",2001,605,14,591,18
"31480","E01020574",2001,632,118,514,27
"31481","E01020575",2001,713,351,362,31
"31482","E01020576",2001,772,51,721,30
"31483","E01020581",2001,1014,34,980,213
"31484","E01020582",2001,749,210,539,109
"31485","E01020553",2001,579,107,472,157
"31486","E01020554",2001,800,60,740,426
"31487","E01020555",2001,723,44,679,225
"31488","E01020556",2001,618,22,596,191
"31489","E01020572",2001,842,8,834,170
"31490","E01020573",2001,744,170,574,77
"31491","E01020577",2001,604,71,533,47
"31492","E01020578",2001,861,221,640,36
"31493","E01020583",2001,732,23,709,84
"31494","E01020584",2001,732,105,627,65
"31495","E01020585",2001,608,180,428,10
"31496","E01020586",2001,520,51,469,14
"31497","E01020587",2001,636,99,537,58
"31498","E01020588",2001,535,10,525,50
"31499","E01020589",2001,625,115,510,47
"31500","E01020563",2001,483,39,444,55
"31501","E01020567",2001,473,20,453,97
"31502","E01020568",2001,484,43,441,67
"31503","E01020569",2001,607,314,293,56
"31504","E01020564",2001,612,134,478,49
"31505","E01020565",2001,648,34,614,74
"31506","E01020566",2001,757,19,738,41
"31507","E01020562",2001,854,8,846,104
"31508","E01022163",2001,630,29,601,36
"31509","E01022164",2001,627,247,380,63
"31510","E01022165",2001,678,15,663,64
"31511","E01022166",2001,561,6,555,26
"31512","E01022143",2001,660,10,650,41
"31513","E01022144",2001,521,72,449,10
"31514","E01022145",2001,504,9,495,18
"31515","E01022146",2001,603,10,593,21
"31516","E01022122",2001,609,356,253,25
"31517","E01022160",2001,604,377,227,41
"31518","E01022161",2001,630,85,545,57
"31519","E01022162",2001,637,43,594,26
"31520","E01022151",2001,635,113,522,155
"31521","E01022152",2001,509,286,223,66
"31522","E01022153",2001,519,100,419,238
"31523","E01022154",2001,620,42,578,213
"31524","E01022139",2001,523,29,494,29
"31525","E01022147",2001,713,413,300,34
"31526","E01022120",2001,648,320,328,10
"31527","E01022121",2001,640,319,321,29
"31528","E01022157",2001,611,238,373,29
"31529","E01022159",2001,608,182,426,12
"31530","E01022131",2001,594,229,365,28
"31531","E01022132",2001,603,211,392,21
"31532","E01022133",2001,500,261,239,17
"31533","E01022134",2001,770,203,567,77
"31534","E01022148",2001,624,105,519,29
"31535","E01022149",2001,493,130,363,18
"31536","E01022150",2001,628,115,513,51
"31537","E01022158",2001,756,51,705,236
"31538","E01022155",2001,635,44,591,69
"31539","E01022156",2001,577,93,484,124
"31540","E01022140",2001,566,17,549,48
"31541","E01022141",2001,773,21,752,300
"31542","E01022142",2001,748,145,603,210
"31543","E01022100",2001,798,27,771,137
"31544","E01022101",2001,816,72,744,167
"31545","E01022102",2001,957,76,881,449
"31546","E01022124",2001,605,148,457,153
"31547","E01022125",2001,558,12,546,127
"31548","E01022126",2001,947,96,851,437
"31549","E01022127",2001,520,48,472,218
"31550","E01022116",2001,508,15,493,164
"31551","E01022117",2001,802,51,751,400
"31552","E01022119",2001,599,15,584,102
"31553","E01022123",2001,612,33,579,38
"31554","E01022106",2001,733,10,723,37
"31555","E01022107",2001,624,3,621,37
"31556","E01022108",2001,749,58,691,34
"31557","E01022135",2001,490,38,452,49
"31558","E01022136",2001,733,71,662,108
"31559","E01022137",2001,762,32,730,227
"31560","E01022138",2001,618,22,596,92
"31561","E01022174",2001,621,10,611,31
"31562","E01022109",2001,605,9,596,20
"31563","E01022110",2001,628,108,520,45
"31564","E01022111",2001,623,40,583,54
"31565","E01022112",2001,463,10,453,24
"31566","E01022103",2001,609,15,594,24
"31567","E01022104",2001,737,53,684,67
"31568","E01022105",2001,604,8,596,37
"31569","E01022167",2001,518,3,515,26
"31570","E01022168",2001,523,20,503,21
"31571","E01022169",2001,682,84,598,20
"31572","E01022170",2001,639,6,633,43
"31573","E01022171",2001,556,0,556,38
"31574","E01022172",2001,751,7,744,33
"31575","E01022173",2001,591,121,470,31
"31576","E01022113",2001,748,53,695,22
"31577","E01022114",2001,675,7,668,24
"31578","E01022115",2001,749,32,717,124
"31579","E01022118",2001,595,16,579,47
"31580","E01022128",2001,634,0,634,26
"31581","E01022129",2001,877,57,820,43
"31582","E01022130",2001,742,9,733,95
"31583","E01022182",2001,682,77,605,61
"31584","E01022183",2001,669,96,573,59
"31585","E01022184",2001,681,71,610,107
"31586","E01022185",2001,576,91,485,40
"31587","E01022179",2001,883,144,739,90
"31588","E01022205",2001,835,109,726,141
"31589","E01022211",2001,747,198,549,77
"31590","E01022212",2001,720,72,648,63
"31591","E01022177",2001,955,190,765,75
"31592","E01022178",2001,615,59,556,77
"31593","E01022214",2001,794,59,735,75
"31594","E01022222",2001,857,87,770,152
"31595","E01022180",2001,819,215,604,44
"31596","E01022181",2001,767,17,750,88
"31597","E01022201",2001,712,37,675,116
"31598","E01022216",2001,747,46,701,129
"31599","E01022186",2001,686,45,641,94
"31600","E01022187",2001,711,70,641,133
"31601","E01022175",2001,791,77,714,147
"31602","E01022213",2001,785,122,663,107
"31603","E01022215",2001,828,82,746,222
"31604","E01022207",2001,682,58,624,67
"31605","E01022196",2001,656,65,591,50
"31606","E01022197",2001,756,16,740,33
"31607","E01022188",2001,520,226,294,14
"31608","E01022189",2001,506,43,463,16
"31609","E01022190",2001,524,65,459,23
"31610","E01022199",2001,763,133,630,120
"31611","E01022200",2001,529,290,239,38
"31612","E01022194",2001,908,191,717,190
"31613","E01022195",2001,630,88,542,118
"31614","E01022198",2001,505,87,418,47
"31615","E01022225",2001,602,121,481,111
"31616","E01022191",2001,663,108,555,99
"31617","E01022192",2001,483,189,294,14
"31618","E01022193",2001,421,17,404,25
"31619","E01022208",2001,612,6,606,49
"31620","E01022209",2001,488,63,425,44
"31621","E01022210",2001,608,166,442,55
"31622","E01022202",2001,426,30,396,61
"31623","E01022203",2001,629,39,590,61
"31624","E01022204",2001,600,122,478,38
"31625","E01022223",2001,884,150,734,68
"31626","E01022224",2001,609,26,583,72
"31627","E01022221",2001,747,106,641,141
"31628","E01022206",2001,795,52,743,158
"31629","E01022217",2001,516,107,409,14
"31630","E01022218",2001,501,232,269,17
"31631","E01022219",2001,486,42,444,20
"31632","E01022220",2001,756,42,714,122
"31633","E01022176",2001,767,84,683,166
"31634","E01022235",2001,697,38,659,62
"31635","E01022233",2001,765,73,692,72
"31636","E01022247",2001,651,29,622,58
"31637","E01022270",2001,704,61,643,50
"31638","E01022271",2001,662,30,632,61
"31639","E01022261",2001,754,136,618,37
"31640","E01022262",2001,761,170,591,119
"31641","E01022267",2001,646,24,622,44
"31642","E01022258",2001,415,108,307,24
"31643","E01022259",2001,591,11,580,21
"31644","E01022260",2001,649,112,537,22
"31645","E01022251",2001,598,184,414,16
"31646","E01022252",2001,697,30,667,21
"31647","E01022249",2001,778,41,737,45
"31648","E01022250",2001,721,196,525,36
"31649","E01022236",2001,864,80,784,76
"31650","E01022237",2001,626,198,428,38
"31651","E01022238",2001,630,311,319,26
"31652","E01022239",2001,614,23,591,25
"31653","E01022240",2001,719,51,668,89
"31654","E01022230",2001,674,22,652,55
"31655","E01022265",2001,664,54,610,61
"31656","E01022266",2001,509,41,468,38
"31657","E01022228",2001,651,63,588,57
"31658","E01022234",2001,605,32,573,25
"31659","E01022253",2001,708,71,637,36
"31660","E01022263",2001,761,64,697,51
"31661","E01022241",2001,768,112,656,99
"31662","E01022242",2001,611,161,450,22
"31663","E01022243",2001,506,149,357,16
"31664","E01022244",2001,609,156,453,17
"31665","E01022245",2001,603,131,472,70
"31666","E01022246",2001,509,6,503,25
"31667","E01022229",2001,657,146,511,30
"31668","E01022231",2001,654,179,475,15
"31669","E01022232",2001,606,29,577,33
"31670","E01022264",2001,616,72,544,33
"31671","E01022268",2001,637,126,511,11
"31672","E01022269",2001,748,64,684,37
"31673","E01022254",2001,748,262,486,30
"31674","E01022255",2001,615,32,583,32
"31675","E01022256",2001,717,249,468,67
"31676","E01022257",2001,754,8,746,34
"31677","E01022226",2001,659,111,548,76
"31678","E01022227",2001,653,62,591,70
"31679","E01022272",2001,571,186,385,29
"31680","E01022273",2001,464,35,429,183
"31681","E01022274",2001,462,5,457,35
"31682","E01022275",2001,576,23,553,27
"31683","E01022248",2001,674,54,620,22
"31684","E01022315",2001,609,0,609,22
"31685","E01022316",2001,619,19,600,46
"31686","E01022317",2001,600,16,584,9
"31687","E01022318",2001,641,3,638,10
"31688","E01022313",2001,649,7,642,48
"31689","E01022314",2001,650,4,646,8
"31690","E01022309",2001,624,45,579,77
"31691","E01022310",2001,736,99,637,114
"31692","E01022311",2001,869,334,535,233
"31693","E01022312",2001,617,60,557,116
"31694","E01022295",2001,597,19,578,4
"31695","E01022296",2001,606,124,482,30
"31696","E01022297",2001,509,6,503,11
"31697","E01022298",2001,512,7,505,38
"31698","E01022332",2001,643,107,536,139
"31699","E01022347",2001,865,142,723,473
"31700","E01022348",2001,496,34,462,69
"31701","E01022349",2001,887,419,468,153
"31702","E01022288",2001,636,77,559,149
"31703","E01022289",2001,651,148,503,122
"31704","E01022290",2001,580,118,462,89
"31705","E01022291",2001,618,43,575,189
"31706","E01022292",2001,491,21,470,127
"31707","E01022303",2001,636,106,530,46
"31708","E01022304",2001,789,9,780,47
"31709","E01022305",2001,603,30,573,20
"31710","E01022283",2001,656,66,590,23
"31711","E01022308",2001,652,11,641,24
"31712","E01022284",2001,515,131,384,34
"31713","E01022285",2001,502,184,318,23
"31714","E01022286",2001,501,172,329,30
"31715","E01022287",2001,647,52,595,43
"31716","E01022282",2001,614,9,605,15
"31717","E01022278",2001,551,5,546,24
"31718","E01022279",2001,578,8,570,30
"31719","E01022293",2001,616,42,574,192
"31720","E01022294",2001,634,24,610,130
"31721","E01022328",2001,520,184,336,30
"31722","E01022329",2001,616,188,428,78
"31723","E01022323",2001,557,296,261,20
"31724","E01022330",2001,603,36,567,84
"31725","E01022331",2001,504,89,415,20
"31726","E01022333",2001,659,439,220,18
"31727","E01022334",2001,645,115,530,23
"31728","E01022326",2001,540,18,522,72
"31729","E01022327",2001,614,41,573,63
"31730","E01022306",2001,581,6,575,39
"31731","E01022307",2001,635,0,635,34
"31732","E01022280",2001,686,26,660,73
"31733","E01022281",2001,692,37,655,28
"31734","E01022276",2001,684,6,678,24
"31735","E01022277",2001,610,36,574,23
"31736","E01022324",2001,656,267,389,15
"31737","E01022325",2001,592,90,502,26
"31738","E01022319",2001,762,506,256,24
"31739","E01022320",2001,632,167,465,15
"31740","E01022321",2001,582,87,495,31
"31741","E01022322",2001,642,270,372,21
"31742","E01022343",2001,493,54,439,20
"31743","E01022344",2001,627,93,534,22
"31744","E01022345",2001,634,76,558,24
"31745","E01022346",2001,637,345,292,15
"31746","E01022299",2001,604,6,598,29
"31747","E01022300",2001,643,4,639,23
"31748","E01022301",2001,592,104,488,51
"31749","E01022302",2001,622,22,600,38
"31750","E01022339",2001,641,9,632,18
"31751","E01022340",2001,628,15,613,117
"31752","E01022341",2001,570,51,519,28
"31753","E01022342",2001,618,0,618,55
"31754","E01022335",2001,565,44,521,35
"31755","E01022336",2001,480,7,473,35
"31756","E01022337",2001,566,10,556,52
"31757","E01022338",2001,651,17,634,118
"31758","E01022378",2001,614,16,598,54
"31759","E01022379",2001,685,100,585,110
"31760","E01022380",2001,569,29,540,67
"31761","E01022412",2001,857,39,818,59
"31762","E01022390",2001,581,76,505,61
"31763","E01022391",2001,622,7,615,67
"31764","E01022392",2001,645,19,626,90
"31765","E01022354",2001,885,52,833,55
"31766","E01022376",2001,686,79,607,57
"31767","E01022396",2001,596,31,565,88
"31768","E01022397",2001,678,90,588,38
"31769","E01022398",2001,423,38,385,40
"31770","E01022389",2001,715,56,659,33
"31771","E01022377",2001,970,272,698,37
"31772","E01022355",2001,650,106,544,18
"31773","E01022356",2001,623,80,543,38
"31774","E01022357",2001,767,71,696,38
"31775","E01022358",2001,648,258,390,11
"31776","E01022400",2001,650,75,575,46
"31777","E01022401",2001,601,176,425,30
"31778","E01022402",2001,639,70,569,39
"31779","E01022403",2001,623,277,346,20
"31780","E01022404",2001,492,34,458,40
"31781","E01022399",2001,938,250,688,96
"31782","E01022410",2001,925,170,755,108
"31783","E01022411",2001,928,170,758,59
"31784","E01022414",2001,929,208,721,92
"31785","E01022365",2001,776,70,706,126
"31786","E01022408",2001,422,23,399,20
"31787","E01022409",2001,472,42,430,26
"31788","E01022393",2001,616,24,592,16
"31789","E01022394",2001,610,62,548,62
"31790","E01022395",2001,623,22,601,25
"31791","E01022366",2001,624,14,610,13
"31792","E01022367",2001,651,38,613,27
"31793","E01022368",2001,592,31,561,18
"31794","E01022369",2001,746,58,688,91
"31795","E01022370",2001,509,73,436,48
"31796","E01022371",2001,403,35,368,13
"31797","E01022405",2001,629,190,439,27
"31798","E01022406",2001,537,22,515,40
"31799","E01022407",2001,558,46,512,47
"31800","E01022350",2001,877,60,817,75
"31801","E01022382",2001,611,11,600,23
"31802","E01022383",2001,606,250,356,21
"31803","E01022384",2001,496,27,469,40
"31804","E01022359",2001,646,32,614,18
"31805","E01022360",2001,520,22,498,23
"31806","E01022361",2001,608,200,408,15
"31807","E01022362",2001,494,43,451,5
"31808","E01022363",2001,746,71,675,37
"31809","E01022364",2001,498,265,233,14
"31810","E01022351",2001,590,125,465,70
"31811","E01022352",2001,557,35,522,37
"31812","E01022353",2001,593,101,492,64
"31813","E01022413",2001,675,46,629,82
"31814","E01022385",2001,646,72,574,45
"31815","E01022386",2001,629,69,560,79
"31816","E01022387",2001,631,195,436,40
"31817","E01022388",2001,601,83,518,38
"31818","E01022372",2001,653,14,639,72
"31819","E01022373",2001,628,158,470,23
"31820","E01022374",2001,748,162,586,57
"31821","E01022375",2001,494,252,242,20
"31822","E01022381",2001,742,56,686,45
"31823","E01022415",2001,579,28,551,40
"31824","E01022416",2001,594,185,409,16
"31825","E01022417",2001,707,46,661,31
"31826","E01022418",2001,739,162,577,88
"31827","E01022419",2001,899,44,855,111
"31828","E01022455",2001,797,24,773,23
"31829","E01022450",2001,754,234,520,42
"31830","E01022451",2001,645,49,596,28
"31831","E01022452",2001,533,12,521,12
"31832","E01022456",2001,530,36,494,30
"31833","E01022457",2001,591,203,388,22
"31834","E01022458",2001,645,388,257,25
"31835","E01022459",2001,755,89,666,181
"31836","E01022460",2001,598,120,478,33
"31837","E01022461",2001,604,11,593,26
"31838","E01022462",2001,707,38,669,35
"31839","E01022463",2001,719,84,635,104
"31840","E01022464",2001,724,220,504,30
"31841","E01022465",2001,620,25,595,40
"31842","E01022466",2001,666,14,652,82
"31843","E01022449",2001,872,35,837,116
"31844","E01022453",2001,594,15,579,39
"31845","E01022434",2001,749,3,746,24
"31846","E01022441",2001,564,43,521,44
"31847","E01022445",2001,559,55,504,78
"31848","E01022432",2001,908,79,829,51
"31849","E01022433",2001,701,13,688,25
"31850","E01022435",2001,960,343,617,15
"31851","E01022436",2001,734,45,689,24
"31852","E01022437",2001,533,86,447,20
"31853","E01022438",2001,607,8,599,49
"31854","E01022439",2001,714,14,700,68
"31855","E01022440",2001,780,88,692,149
"31856","E01022442",2001,598,52,546,53
"31857","E01022443",2001,537,24,513,18
"31858","E01022444",2001,559,7,552,42
"31859","E01022425",2001,495,32,463,12
"31860","E01022426",2001,645,4,641,14
"31861","E01022427",2001,633,38,595,74
"31862","E01022428",2001,743,274,469,32
"31863","E01022429",2001,625,12,613,49
"31864","E01022430",2001,638,27,611,16
"31865","E01022431",2001,833,14,819,81
"31866","E01022447",2001,401,97,304,231
"31867","E01022448",2001,575,102,473,49
"31868","E01022454",2001,840,210,630,29
"31869","E01022420",2001,928,62,866,85
"31870","E01022421",2001,698,210,488,34
"31871","E01022422",2001,545,12,533,22
"31872","E01022423",2001,743,54,689,22
"31873","E01022424",2001,614,249,365,26
"31874","E01022446",2001,639,5,634,30
"31875","E01029022",2001,511,29,482,48
"31876","E01029023",2001,472,76,396,47
"31877","E01029044",2001,490,70,420,31
"31878","E01029053",2001,922,57,865,156
"31879","E01029057",2001,832,64,768,92
"31880","E01029068",2001,468,104,364,87
"31881","E01029069",2001,427,44,383,34
"31882","E01029024",2001,756,80,676,53
"31883","E01029025",2001,505,149,356,30
"31884","E01029026",2001,421,9,412,25
"31885","E01029030",2001,786,3,783,43
"31886","E01029031",2001,615,0,615,17
"31887","E01029032",2001,502,3,499,15
"31888","E01029033",2001,624,12,612,61
"31889","E01029034",2001,591,4,587,57
"31890","E01029036",2001,637,151,486,89
"31891","E01029045",2001,539,101,438,28
"31892","E01029041",2001,749,210,539,113
"31893","E01029042",2001,637,286,351,55
"31894","E01029043",2001,501,94,407,29
"31895","E01029052",2001,829,119,710,60
"31896","E01029060",2001,737,35,702,55
"31897","E01029061",2001,881,67,814,86
"31898","E01029083",2001,518,15,503,37
"31899","E01029084",2001,660,99,561,42
"31900","E01029064",2001,561,19,542,88
"31901","E01029056",2001,894,12,882,156
"31902","E01029018",2001,878,58,820,53
"31903","E01029029",2001,621,216,405,40
"31904","E01029037",2001,575,91,484,70
"31905","E01029038",2001,485,149,336,20
"31906","E01029039",2001,617,80,537,23
"31907","E01029040",2001,709,62,647,68
"31908","E01029035",2001,518,3,515,54
"31909","E01029078",2001,899,95,804,143
"31910","E01029079",2001,762,223,539,76
"31911","E01029080",2001,627,64,563,32
"31912","E01029081",2001,655,59,596,91
"31913","E01029082",2001,636,18,618,60
"31914","E01029065",2001,620,7,613,30
"31915","E01029066",2001,641,66,575,73
"31916","E01029067",2001,652,195,457,24
"31917","E01029062",2001,650,209,441,208
"31918","E01029063",2001,587,82,505,33
"31919","E01029020",2001,549,62,487,44
"31920","E01029021",2001,463,20,443,39
"31921","E01029027",2001,459,21,438,62
"31922","E01029028",2001,520,70,450,50
"31923","E01029058",2001,913,110,803,101
"31924","E01029048",2001,454,144,310,37
"31925","E01029049",2001,502,17,485,62
"31926","E01029050",2001,861,149,712,65
"31927","E01029051",2001,700,43,657,60
"31928","E01029046",2001,649,114,535,217
"31929","E01029047",2001,529,48,481,48
"31930","E01029054",2001,574,49,525,52
"31931","E01029055",2001,478,25,453,38
"31932","E01029074",2001,503,15,488,43
"31933","E01029076",2001,825,26,799,33
"31934","E01029077",2001,811,50,761,90
"31935","E01029059",2001,823,52,771,97
"31936","E01029019",2001,934,36,898,101
"31937","E01029075",2001,615,90,525,63
"31938","E01029070",2001,605,21,584,147
"31939","E01029071",2001,643,139,504,44
"31940","E01029072",2001,776,271,505,66
"31941","E01029073",2001,487,86,401,71
"31942","E01029085",2001,822,116,706,92
"31943","E01029126",2001,635,56,579,51
"31944","E01029127",2001,756,114,642,76
"31945","E01029128",2001,674,13,661,33
"31946","E01029129",2001,583,37,546,22
"31947","E01029140",2001,822,19,803,40
"31948","E01029113",2001,648,5,643,22
"31949","E01029115",2001,724,6,718,32
"31950","E01029087",2001,535,11,524,92
"31951","E01029088",2001,434,31,403,22
"31952","E01029089",2001,788,57,731,46
"31953","E01029086",2001,778,19,759,46
"31954","E01029147",2001,617,20,597,21
"31955","E01029148",2001,623,51,572,56
"31956","E01029149",2001,522,30,492,30
"31957","E01029116",2001,762,79,683,179
"31958","E01029117",2001,772,13,759,170
"31959","E01029119",2001,728,132,596,52
"31960","E01029120",2001,665,0,665,68
"31961","E01029114",2001,663,24,639,58
"31962","E01029118",2001,619,13,606,39
"31963","E01029131",2001,627,126,501,88
"31964","E01029132",2001,631,334,297,21
"31965","E01029133",2001,590,42,548,23
"31966","E01029134",2001,740,104,636,28
"31967","E01029135",2001,692,30,662,33
"31968","E01029136",2001,797,99,698,42
"31969","E01029145",2001,826,41,785,33
"31970","E01029152",2001,933,164,769,36
"31971","E01029121",2001,496,16,480,46
"31972","E01029122",2001,582,14,568,53
"31973","E01029123",2001,498,101,397,33
"31974","E01029124",2001,745,87,658,44
"31975","E01029125",2001,548,38,510,57
"31976","E01029106",2001,624,377,247,18
"31977","E01029107",2001,635,256,379,7
"31978","E01029109",2001,509,171,338,32
"31979","E01029093",2001,730,129,601,144
"31980","E01029096",2001,617,55,562,87
"31981","E01029094",2001,634,6,628,117
"31982","E01029095",2001,649,108,541,162
"31983","E01029110",2001,765,247,518,69
"31984","E01029111",2001,639,241,398,20
"31985","E01029112",2001,762,49,713,143
"31986","E01029108",2001,906,97,809,59
"31987","E01029090",2001,638,27,611,44
"31988","E01029091",2001,736,10,726,113
"31989","E01029092",2001,620,6,614,44
"31990","E01029102",2001,621,91,530,43
"31991","E01029103",2001,623,4,619,25
"31992","E01029104",2001,623,42,581,11
"31993","E01029146",2001,818,23,795,46
"31994","E01029150",2001,469,14,455,32
"31995","E01029151",2001,523,36,487,24
"31996","E01029137",2001,578,40,538,33
"31997","E01029138",2001,580,43,537,36
"31998","E01029139",2001,562,33,529,28
"31999","E01029130",2001,809,63,746,62
"32000","E01029105",2001,761,363,398,58
"32001","E01029097",2001,619,171,448,74
"32002","E01029098",2001,634,127,507,89
"32003","E01029099",2001,503,192,311,9
"32004","E01029100",2001,532,204,328,26
"32005","E01029101",2001,476,66,410,30
"32006","E01029141",2001,608,10,598,68
"32007","E01029142",2001,632,9,623,48
"32008","E01029143",2001,619,175,444,38
"32009","E01029144",2001,489,21,468,40
"32010","E01029157",2001,581,149,432,58
"32011","E01029158",2001,466,20,446,53
"32012","E01029221",2001,971,42,929,108
"32013","E01029166",2001,885,48,837,120
"32014","E01029167",2001,708,210,498,92
"32015","E01029168",2001,690,15,675,51
"32016","E01029210",2001,593,19,574,62
"32017","E01029211",2001,539,61,478,37
"32018","E01029224",2001,657,25,632,52
"32019","E01029225",2001,862,38,824,38
"32020","E01029226",2001,749,191,558,79
"32021","E01029222",2001,525,25,500,29
"32022","E01029223",2001,485,33,452,32
"32023","E01029200",2001,581,109,472,101
"32024","E01029201",2001,604,33,571,38
"32025","E01029155",2001,744,51,693,75
"32026","E01029227",2001,635,67,568,34
"32027","E01029228",2001,656,64,592,43
"32028","E01029229",2001,750,175,575,117
"32029","E01029164",2001,561,78,483,50
"32030","E01029165",2001,510,58,452,41
"32031","E01029198",2001,464,98,366,222
"32032","E01029199",2001,824,89,735,105
"32033","E01029196",2001,605,87,518,37
"32034","E01029197",2001,525,40,485,54
"32035","E01029187",2001,415,110,305,36
"32036","E01029188",2001,611,14,597,48
"32037","E01029206",2001,608,127,481,45
"32038","E01029207",2001,513,19,494,45
"32039","E01029156",2001,744,94,650,69
"32040","E01029154",2001,652,115,537,80
"32041","E01029202",2001,533,179,354,18
"32042","E01029203",2001,604,41,563,52
"32043","E01029204",2001,531,26,505,43
"32044","E01029205",2001,641,62,579,42
"32045","E01029216",2001,654,42,612,33
"32046","E01029217",2001,646,65,581,57
"32047","E01029218",2001,763,164,599,39
"32048","E01029163",2001,885,80,805,79
"32049","E01029238",2001,624,176,448,23
"32050","E01029252",2001,566,14,552,75
"32051","E01029253",2001,676,115,561,37
"32052","E01029254",2001,592,4,588,9
"32053","E01029248",2001,630,167,463,36
"32054","E01029250",2001,529,12,517,30
"32055","E01029251",2001,552,32,520,31
"32056","E01029160",2001,429,18,411,51
"32057","E01029161",2001,463,71,392,22
"32058","E01029162",2001,758,58,700,119
"32059","E01029247",2001,575,327,248,27
"32060","E01029255",2001,606,108,498,100
"32061","E01029233",2001,601,215,386,34
"32062","E01029235",2001,614,124,490,58
"32063","E01029236",2001,601,271,330,27
"32064","E01029237",2001,629,274,355,21
"32065","E01029231",2001,606,62,544,42
"32066","E01029232",2001,617,31,586,107
"32067","E01029234",2001,808,173,635,198
"32068","E01029239",2001,626,195,431,109
"32069","E01029240",2001,594,13,581,64
"32070","E01029241",2001,729,96,633,103
"32071","E01029249",2001,630,167,463,42
"32072","E01029245",2001,654,28,626,50
"32073","E01029246",2001,609,32,577,60
"32074","E01029212",2001,473,23,450,35
"32075","E01029213",2001,522,78,444,35
"32076","E01029214",2001,479,52,427,43
"32077","E01029215",2001,493,142,351,46
"32078","E01029189",2001,476,114,362,19
"32079","E01029190",2001,597,17,580,68
"32080","E01029191",2001,530,103,427,40
"32081","E01029192",2001,607,85,522,75
"32082","E01029159",2001,499,10,489,25
"32083","E01029242",2001,631,53,578,33
"32084","E01029243",2001,747,36,711,45
"32085","E01029244",2001,591,3,588,13
"32086","E01029193",2001,788,128,660,134
"32087","E01029194",2001,637,29,608,39
"32088","E01029195",2001,682,143,539,26
"32089","E01029208",2001,469,85,384,34
"32090","E01029209",2001,488,10,478,35
"32091","E01029178",2001,650,51,599,48
"32092","E01029179",2001,485,138,347,31
"32093","E01029180",2001,568,91,477,42
"32094","E01029181",2001,607,64,543,47
"32095","E01029182",2001,612,41,571,21
"32096","E01029183",2001,603,135,468,12
"32097","E01029184",2001,637,9,628,41
"32098","E01029185",2001,746,39,707,117
"32099","E01029186",2001,714,189,525,62
"32100","E01029169",2001,488,30,458,19
"32101","E01029172",2001,618,20,598,24
"32102","E01029173",2001,503,79,424,34
"32103","E01029176",2001,536,28,508,40
"32104","E01029177",2001,511,237,274,24
"32105","E01029174",2001,499,52,447,19
"32106","E01029175",2001,633,168,465,85
"32107","E01029170",2001,469,196,273,25
"32108","E01029171",2001,936,185,751,56
"32109","E01029153",2001,960,75,885,80
"32110","E01029219",2001,546,12,534,45
"32111","E01029220",2001,514,82,432,11
"32112","E01029230",2001,928,74,854,90
"32113","E01029258",2001,559,11,548,65
"32114","E01029259",2001,603,153,450,50
"32115","E01029260",2001,478,3,475,41
"32116","E01029268",2001,630,57,573,80
"32117","E01029276",2001,576,43,533,40
"32118","E01029278",2001,539,78,461,75
"32119","E01029290",2001,626,80,546,45
"32120","E01029306",2001,615,119,496,42
"32121","E01029319",2001,472,18,454,43
"32122","E01029320",2001,655,145,510,73
"32123","E01029321",2001,891,31,860,90
"32124","E01029267",2001,653,104,549,58
"32125","E01029297",2001,615,312,303,14
"32126","E01029298",2001,618,211,407,15
"32127","E01029304",2001,624,321,303,23
"32128","E01029305",2001,621,142,479,18
"32129","E01029307",2001,617,327,290,20
"32130","E01029271",2001,751,52,699,87
"32131","E01029279",2001,585,61,524,46
"32132","E01029273",2001,496,24,472,30
"32133","E01029274",2001,623,27,596,25
"32134","E01029275",2001,559,57,502,52
"32135","E01029294",2001,621,8,613,62
"32136","E01029291",2001,755,210,545,63
"32137","E01029282",2001,661,25,636,96
"32138","E01029317",2001,488,110,378,25
"32139","E01029318",2001,613,7,606,49
"32140","E01029285",2001,741,14,727,213
"32141","E01029287",2001,643,12,631,153
"32142","E01029288",2001,623,32,591,89
"32143","E01029289",2001,779,49,730,186
"32144","E01029299",2001,739,135,604,135
"32145","E01029300",2001,477,22,455,40
"32146","E01029277",2001,477,75,402,35
"32147","E01029272",2001,793,191,602,77
"32148","E01029256",2001,630,114,516,24
"32149","E01029257",2001,870,268,602,53
"32150","E01029280",2001,722,304,418,28
"32151","E01029281",2001,718,248,470,39
"32152","E01029283",2001,721,257,464,24
"32153","E01029292",2001,605,349,256,26
"32154","E01029293",2001,606,444,162,23
"32155","E01029284",2001,625,201,424,121
"32156","E01029286",2001,619,114,505,109
"32157","E01029301",2001,1011,166,845,195
"32158","E01029266",2001,618,62,556,88
"32159","E01029303",2001,749,11,738,81
"32160","E01029308",2001,774,26,748,41
"32161","E01029263",2001,620,16,604,65
"32162","E01029264",2001,609,11,598,30
"32163","E01029265",2001,601,3,598,23
"32164","E01029302",2001,752,31,721,75
"32165","E01029309",2001,746,315,431,66
"32166","E01029311",2001,583,311,272,35
"32167","E01029312",2001,600,84,516,47
"32168","E01029313",2001,511,62,449,49
"32169","E01029316",2001,740,100,640,96
"32170","E01029314",2001,941,155,786,71
"32171","E01029315",2001,632,4,628,19
"32172","E01029310",2001,785,4,781,81
"32173","E01029269",2001,774,50,724,66
"32174","E01029262",2001,890,64,826,68
"32175","E01029261",2001,835,68,767,84
"32176","E01029270",2001,856,59,797,122
"32177","E01029295",2001,679,9,670,63
"32178","E01029296",2001,637,46,591,31
"32179","E01029323",2001,503,43,460,76
"32180","E01029324",2001,664,143,521,46
"32181","E01029329",2001,719,34,685,142
"32182","E01029330",2001,749,16,733,116
"32183","E01029332",2001,500,30,470,71
"32184","E01029333",2001,592,179,413,46
"32185","E01029331",2001,763,35,728,31
"32186","E01029322",2001,621,151,470,60
"32187","E01029336",2001,1072,212,860,173
"32188","E01029326",2001,582,102,480,75
"32189","E01029334",2001,547,80,467,46
"32190","E01029339",2001,646,206,440,35
"32191","E01029340",2001,443,55,388,11
"32192","E01029341",2001,619,61,558,93
"32193","E01029344",2001,482,226,256,16
"32194","E01029342",2001,533,12,521,84
"32195","E01029343",2001,616,31,585,103
"32196","E01029335",2001,492,35,457,51
"32197","E01029327",2001,840,76,764,87
"32198","E01029337",2001,907,112,795,114
"32199","E01029338",2001,798,70,728,132
"32200","E01029328",2001,998,177,821,103
"32201","E01029325",2001,924,138,786,115
"32202","E01031841",2001,740,101,639,66
"32203","E01031868",2001,637,58,579,83
"32204","E01031873",2001,662,96,566,86
"32205","E01031874",2001,643,112,531,40
"32206","E01031884",2001,647,75,572,93
"32207","E01031861",2001,874,165,709,35
"32208","E01031862",2001,697,345,352,42
"32209","E01031863",2001,471,53,418,110
"32210","E01031864",2001,512,19,493,43
"32211","E01031865",2001,512,69,443,60
"32212","E01031866",2001,634,65,569,98
"32213","E01031869",2001,734,297,437,28
"32214","E01031870",2001,713,8,705,90
"32215","E01031871",2001,665,69,596,93
"32216","E01031875",2001,963,72,891,94
"32217","E01031850",2001,723,149,574,53
"32218","E01031851",2001,622,266,356,32
"32219","E01031852",2001,754,66,688,120
"32220","E01031853",2001,628,201,427,25
"32221","E01031854",2001,846,322,524,131
"32222","E01031855",2001,615,43,572,26
"32223","E01031856",2001,754,306,448,46
"32224","E01031845",2001,575,44,531,36
"32225","E01031846",2001,609,148,461,45
"32226","E01031848",2001,665,88,577,44
"32227","E01031876",2001,595,73,522,45
"32228","E01031872",2001,626,159,467,40
"32229","E01031877",2001,737,69,668,114
"32230","E01031849",2001,594,82,512,77
"32231","E01031847",2001,689,87,602,60
"32232","E01031843",2001,761,129,632,108
"32233","E01031844",2001,711,92,619,89
"32234","E01031857",2001,617,162,455,64
"32235","E01031858",2001,632,22,610,49
"32236","E01031883",2001,723,88,635,35
"32237","E01031882",2001,801,102,699,189
"32238","E01031867",2001,743,151,592,88
"32239","E01031842",2001,739,89,650,82
"32240","E01031878",2001,590,37,553,180
"32241","E01031879",2001,506,95,411,386
"32242","E01031880",2001,494,51,443,274
"32243","E01031881",2001,888,366,522,186
"32244","E01031859",2001,631,262,369,53
"32245","E01031860",2001,612,147,465,44
"32246","E01031887",2001,715,55,660,70
"32247","E01031934",2001,645,6,639,32
"32248","E01031935",2001,605,23,582,73
"32249","E01031936",2001,628,200,428,25
"32250","E01031947",2001,644,251,393,17
"32251","E01031948",2001,589,11,578,59
"32252","E01031949",2001,772,42,730,138
"32253","E01031885",2001,595,66,529,69
"32254","E01031954",2001,489,12,477,24
"32255","E01031955",2001,618,30,588,31
"32256","E01031956",2001,482,141,341,33
"32257","E01031962",2001,536,16,520,13
"32258","E01031886",2001,498,17,481,23
"32259","E01031892",2001,541,55,486,48
"32260","E01031893",2001,571,25,546,29
"32261","E01031894",2001,587,29,558,69
"32262","E01031957",2001,529,59,470,63
"32263","E01031958",2001,551,12,539,69
"32264","E01031959",2001,567,44,523,43
"32265","E01031960",2001,497,60,437,143
"32266","E01031963",2001,650,309,341,30
"32267","E01031964",2001,781,13,768,91
"32268","E01031967",2001,724,136,588,105
"32269","E01031969",2001,576,6,570,45
"32270","E01031968",2001,667,18,649,46
"32271","E01031965",2001,616,51,565,22
"32272","E01031966",2001,609,4,605,29
"32273","E01031961",2001,492,26,466,34
"32274","E01031943",2001,511,93,418,195
"32275","E01031944",2001,449,21,428,85
"32276","E01031945",2001,480,15,465,55
"32277","E01031946",2001,479,83,396,329
"32278","E01031950",2001,504,15,489,64
"32279","E01031951",2001,425,65,360,75
"32280","E01031939",2001,807,66,741,72
"32281","E01031940",2001,850,68,782,84
"32282","E01031910",2001,520,55,465,26
"32283","E01031907",2001,848,0,848,42
"32284","E01031914",2001,478,237,241,33
"32285","E01031915",2001,592,40,552,46
"32286","E01031919",2001,542,42,500,12
"32287","E01031920",2001,518,41,477,66
"32288","E01031908",2001,526,135,391,22
"32289","E01031909",2001,521,43,478,15
"32290","E01031905",2001,476,0,476,21
"32291","E01031906",2001,640,5,635,52
"32292","E01031925",2001,487,172,315,9
"32293","E01031926",2001,600,85,515,21
"32294","E01031927",2001,500,6,494,20
"32295","E01031928",2001,611,313,298,25
"32296","E01031917",2001,517,166,351,55
"32297","E01031918",2001,879,25,854,21
"32298","E01031911",2001,506,221,285,13
"32299","E01031912",2001,536,178,358,85
"32300","E01031913",2001,516,7,509,32
"32301","E01031891",2001,837,52,785,111
"32302","E01031904",2001,700,41,659,100
"32303","E01031937",2001,448,61,387,40
"32304","E01031938",2001,494,35,459,90
"32305","E01031916",2001,528,119,409,15
"32306","E01031921",2001,521,11,510,49
"32307","E01031922",2001,599,15,584,81
"32308","E01031923",2001,526,12,514,38
"32309","E01031924",2001,505,17,488,48
"32310","E01031895",2001,523,96,427,17
"32311","E01031896",2001,522,266,256,18
"32312","E01031897",2001,546,70,476,23
"32313","E01031898",2001,530,77,453,50
"32314","E01031899",2001,525,178,347,27
"32315","E01031900",2001,1007,94,913,60
"32316","E01031901",2001,595,143,452,52
"32317","E01031902",2001,479,53,426,25
"32318","E01031903",2001,896,22,874,34
"32319","E01031888",2001,565,24,541,55
"32320","E01031889",2001,557,129,428,120
"32321","E01031890",2001,601,45,556,43
"32322","E01031929",2001,537,33,504,33
"32323","E01031930",2001,492,43,449,191
"32324","E01031931",2001,645,13,632,53
"32325","E01031932",2001,692,97,595,29
"32326","E01031933",2001,581,169,412,16
"32327","E01031941",2001,560,43,517,62
"32328","E01031942",2001,522,86,436,80
"32329","E01031952",2001,1013,314,699,148
"32330","E01031953",2001,645,78,567,36
"32331","E01031987",2001,433,50,383,191
"32332","E01031988",2001,601,74,527,484
"32333","E01031998",2001,642,105,537,484
"32334","E01032026",2001,637,58,579,77
"32335","E01032028",2001,475,120,355,75
"32336","E01031999",2001,627,37,590,37
"32337","E01031989",2001,596,178,418,124
"32338","E01031996",2001,581,212,369,25
"32339","E01031997",2001,603,14,589,53
"32340","E01031974",2001,646,64,582,32
"32341","E01031975",2001,515,308,207,11
"32342","E01031976",2001,430,88,342,105
"32343","E01031977",2001,577,15,562,72
"32344","E01031978",2001,597,114,483,59
"32345","E01031979",2001,861,144,717,127
"32346","E01032013",2001,811,158,653,149
"32347","E01032032",2001,617,30,587,46
"32348","E01032033",2001,619,47,572,87
"32349","E01032034",2001,594,69,525,90
"32350","E01032035",2001,624,28,596,72
"32351","E01032036",2001,621,112,509,117
"32352","E01032037",2001,619,215,404,69
"32353","E01032010",2001,948,106,842,110
"32354","E01032017",2001,618,6,612,27
"32355","E01031984",2001,523,14,509,35
"32356","E01031985",2001,531,150,381,38
"32357","E01031986",2001,628,238,390,23
"32358","E01031980",2001,643,199,444,45
"32359","E01031981",2001,634,345,289,28
"32360","E01031982",2001,570,149,421,26
"32361","E01031983",2001,607,357,250,17
"32362","E01032018",2001,642,34,608,47
"32363","E01032019",2001,642,269,373,25
"32364","E01032020",2001,659,76,583,68
"32365","E01032025",2001,655,100,555,56
"32366","E01032027",2001,607,64,543,108
"32367","E01032004",2001,955,130,825,179
"32368","E01032038",2001,608,85,523,118
"32369","E01032039",2001,623,110,513,137
"32370","E01032040",2001,613,187,426,57
"32371","E01031990",2001,800,101,699,150
"32372","E01032001",2001,592,17,575,56
"32373","E01032002",2001,614,69,545,84
"32374","E01032003",2001,746,93,653,161
"32375","E01032024",2001,950,72,878,169
"32376","E01032021",2001,722,37,685,159
"32377","E01032014",2001,889,114,775,232
"32378","E01032015",2001,624,124,500,129
"32379","E01032016",2001,661,30,631,131
"32380","E01032011",2001,671,124,547,55
"32381","E01032012",2001,761,11,750,32
"32382","E01032000",2001,746,84,662,124
"32383","E01032008",2001,726,264,462,35
"32384","E01032009",2001,856,67,789,60
"32385","E01032022",2001,903,160,743,190
"32386","E01032023",2001,770,348,422,83
"32387","E01032005",2001,513,14,499,47
"32388","E01032006",2001,521,11,510,87
"32389","E01032007",2001,528,94,434,63
"32390","E01032041",2001,763,16,747,33
"32391","E01032042",2001,666,47,619,66
"32392","E01031970",2001,625,4,621,48
"32393","E01031971",2001,482,70,412,38
"32394","E01031972",2001,555,54,501,44
"32395","E01031991",2001,847,105,742,117
"32396","E01032029",2001,587,44,543,79
"32397","E01032030",2001,627,196,431,52
"32398","E01032031",2001,507,67,440,50
"32399","E01031992",2001,618,3,615,91
"32400","E01031993",2001,633,114,519,29
"32401","E01031994",2001,505,98,407,40
"32402","E01031995",2001,653,28,625,111
"32403","E01031973",2001,684,8,676,59
"32404","E01032063",2001,636,41,595,27
"32405","E01032064",2001,471,209,262,21
"32406","E01032065",2001,605,85,520,41
"32407","E01032073",2001,580,7,573,45
"32408","E01032074",2001,512,3,509,12
"32409","E01032070",2001,711,210,501,27
"32410","E01032071",2001,660,8,652,34
"32411","E01032072",2001,578,18,560,32
"32412","E01032057",2001,472,17,455,28
"32413","E01032043",2001,492,57,435,61
"32414","E01032044",2001,544,37,507,33
"32415","E01032066",2001,628,137,491,24
"32416","E01032067",2001,602,22,580,43
"32417","E01032068",2001,700,111,589,74
"32418","E01032069",2001,511,22,489,16
"32419","E01032062",2001,657,206,451,111
"32420","E01032058",2001,517,83,434,45
"32421","E01032059",2001,726,42,684,85
"32422","E01032060",2001,712,68,644,53
"32423","E01032061",2001,501,66,435,18
"32424","E01032045",2001,612,15,597,33
"32425","E01032046",2001,671,118,553,46
"32426","E01032047",2001,631,78,553,22
"32427","E01032048",2001,748,235,513,44
"32428","E01032049",2001,624,48,576,34
"32429","E01032050",2001,875,56,819,156
"32430","E01032077",2001,566,40,526,34
"32431","E01032078",2001,573,125,448,49
"32432","E01032079",2001,623,59,564,38
"32433","E01032080",2001,497,0,497,26
"32434","E01032085",2001,648,7,641,72
"32435","E01032086",2001,738,277,461,123
"32436","E01032087",2001,898,83,815,75
"32437","E01032099",2001,617,7,610,27
"32438","E01032100",2001,613,36,577,53
"32439","E01032101",2001,741,155,586,126
"32440","E01032102",2001,617,6,611,32
"32441","E01032096",2001,646,349,297,38
"32442","E01032097",2001,760,10,750,19
"32443","E01032098",2001,618,32,586,26
"32444","E01032092",2001,628,5,623,44
"32445","E01032093",2001,594,277,317,26
"32446","E01032094",2001,771,193,578,95
"32447","E01032095",2001,608,5,603,32
"32448","E01032088",2001,614,7,607,11
"32449","E01032089",2001,627,10,617,114
"32450","E01032090",2001,607,114,493,22
"32451","E01032091",2001,468,40,428,44
"32452","E01032083",2001,857,27,830,64
"32453","E01032084",2001,933,45,888,70
"32454","E01032053",2001,608,19,589,25
"32455","E01032054",2001,502,104,398,44
"32456","E01032055",2001,543,11,532,36
"32457","E01032056",2001,524,89,435,40
"32458","E01032052",2001,544,18,526,21
"32459","E01032121",2001,699,11,688,32
"32460","E01032115",2001,753,165,588,98
"32461","E01032116",2001,793,8,785,41
"32462","E01032117",2001,624,78,546,30
"32463","E01032118",2001,518,234,284,24
"32464","E01032119",2001,769,34,735,185
"32465","E01032120",2001,742,12,730,58
"32466","E01032104",2001,466,234,232,28
"32467","E01032105",2001,660,6,654,25
"32468","E01032107",2001,476,69,407,359
"32469","E01032108",2001,629,35,594,93
"32470","E01032110",2001,622,10,612,40
"32471","E01032111",2001,530,129,401,42
"32472","E01032112",2001,620,25,595,80
"32473","E01032113",2001,609,157,452,27
"32474","E01032114",2001,633,96,537,107
"32475","E01032109",2001,613,141,472,41
"32476","E01032106",2001,608,17,591,33
"32477","E01032103",2001,829,95,734,192
"32478","E01032081",2001,566,30,536,168
"32479","E01032082",2001,504,32,472,60
"32480","E01032075",2001,553,64,489,62
"32481","E01032076",2001,495,67,428,97
"32482","E01032051",2001,579,30,549,70
"32483","W01001440",2001,596,176,420,19
"32484","W01001441",2001,482,282,200,16
"32485","W01001442",2001,496,7,489,23
"32486","W01001470",2001,627,97,530,14
"32487","W01001471",2001,732,406,326,21
"32488","W01001446",2001,483,98,385,12
"32489","W01001447",2001,634,290,344,28
"32490","W01001448",2001,612,98,514,92
"32491","W01001449",2001,710,238,472,42
"32492","W01001472",2001,588,48,540,25
"32493","W01001473",2001,611,407,204,7
"32494","W01001474",2001,662,269,393,14
"32495","W01001475",2001,447,41,406,23
"32496","W01001480",2001,623,312,311,7
"32497","W01001438",2001,636,254,382,15
"32498","W01001439",2001,650,129,521,12
"32499","W01001456",2001,612,195,417,43
"32500","W01001457",2001,756,475,281,18
"32501","W01001458",2001,637,69,568,29
"32502","W01001443",2001,656,176,480,79
"32503","W01001444",2001,726,305,421,22
"32504","W01001445",2001,619,103,516,51
"32505","W01001467",2001,656,379,277,20
"32506","W01001468",2001,588,185,403,45
"32507","W01001469",2001,513,248,265,18
"32508","W01001481",2001,674,200,474,88
"32509","W01001478",2001,637,38,599,50
"32510","W01001479",2001,701,438,263,24
"32511","W01001462",2001,636,210,426,24
"32512","W01001463",2001,842,29,813,72
"32513","W01001459",2001,520,284,236,30
"32514","W01001460",2001,622,63,559,108
"32515","W01001461",2001,609,127,482,36
"32516","W01001450",2001,563,127,436,35
"32517","W01001451",2001,648,76,572,83
"32518","W01001452",2001,592,44,548,46
"32519","W01001453",2001,642,295,347,32
"32520","W01001454",2001,606,219,387,35
"32521","W01001455",2001,768,199,569,59
"32522","W01001435",2001,623,42,581,98
"32523","W01001436",2001,638,77,561,101
"32524","W01001437",2001,633,39,594,43
"32525","W01001464",2001,657,267,390,47
"32526","W01001465",2001,730,284,446,43
"32527","W01001466",2001,753,72,681,138
"32528","W01001476",2001,495,105,390,64
"32529","W01001477",2001,638,22,616,68
"32530","W01000991",2001,487,220,267,25
"32531","W01000992",2001,623,45,578,79
"32532","W01000993",2001,600,56,544,63
"32533","W01000994",2001,515,53,462,43
"32534","W01000995",2001,639,17,622,36
"32535","W01001014",2001,774,104,670,66
"32536","W01001015",2001,614,146,468,23
"32537","W01001017",2001,614,42,572,19
"32538","W01001018",2001,643,38,605,85
"32539","W01001020",2001,600,143,457,21
"32540","W01000976",2001,430,80,350,28
"32541","W01000977",2001,485,132,353,21
"32542","W01001024",2001,472,43,429,55
"32543","W01001025",2001,496,17,479,43
"32544","W01001033",2001,714,48,666,64
"32545","W01001034",2001,615,109,506,51
"32546","W01001042",2001,529,27,502,82
"32547","W01001043",2001,504,31,473,38
"32548","W01000978",2001,782,108,674,70
"32549","W01001009",2001,488,92,396,41
"32550","W01000975",2001,801,371,430,26
"32551","W01001012",2001,514,0,514,26
"32552","W01001013",2001,619,141,478,14
"32553","W01001019",2001,600,143,457,21
"32554","W01001016",2001,744,40,704,37
"32555","W01000974",2001,852,62,790,49
"32556","W01001057",2001,621,218,403,36
"32557","W01001058",2001,645,43,602,46
"32558","W01001055",2001,490,171,319,15
"32559","W01001056",2001,499,74,425,8
"32560","W01000986",2001,554,34,520,37
"32561","W01000987",2001,743,199,544,36
"32562","W01000996",2001,616,107,509,18
"32563","W01001048",2001,605,7,598,48
"32564","W01001049",2001,519,165,354,17
"32565","W01001050",2001,654,139,515,43
"32566","W01001051",2001,584,86,498,36
"32567","W01001052",2001,606,194,412,30
"32568","W01001039",2001,614,92,522,24
"32569","W01001040",2001,589,33,556,27
"32570","W01001004",2001,485,117,368,45
"32571","W01001005",2001,627,6,621,36
"32572","W01001006",2001,872,7,865,17
"32573","W01001007",2001,587,148,439,24
"32574","W01000999",2001,595,176,419,25
"32575","W01001000",2001,625,64,561,30
"32576","W01001001",2001,604,105,499,11
"32577","W01001002",2001,634,326,308,23
"32578","W01001008",2001,894,10,884,14
"32579","W01000998",2001,418,12,406,22
"32580","W01001038",2001,872,123,749,47
"32581","W01001026",2001,743,278,465,24
"32582","W01001010",2001,498,162,336,10
"32583","W01001011",2001,580,63,517,18
"32584","W01000997",2001,762,91,671,22
"32585","W01000989",2001,550,29,521,38
"32586","W01001037",2001,636,0,636,19
"32587","W01001041",2001,832,10,822,19
"32588","W01001035",2001,726,158,568,92
"32589","W01001028",2001,765,43,722,46
"32590","W01001021",2001,631,87,544,64
"32591","W01001022",2001,615,231,384,17
"32592","W01001023",2001,728,233,495,42
"32593","W01000985",2001,497,0,497,26
"32594","W01000983",2001,627,9,618,71
"32595","W01001003",2001,517,5,512,29
"32596","W01000979",2001,600,65,535,54
"32597","W01000980",2001,556,97,459,32
"32598","W01000981",2001,480,304,176,22
"32599","W01000982",2001,588,70,518,30
"32600","W01000984",2001,622,10,612,58
"32601","W01000990",2001,621,215,406,20
"32602","W01000988",2001,535,3,532,16
"32603","W01001027",2001,726,80,646,15
"32604","W01001036",2001,635,40,595,30
"32605","W01001031",2001,616,9,607,16
"32606","W01001032",2001,827,11,816,53
"32607","W01001053",2001,470,25,445,21
"32608","W01001054",2001,499,8,491,27
"32609","W01001046",2001,784,40,744,203
"32610","W01001047",2001,768,75,693,66
"32611","W01001044",2001,753,220,533,51
"32612","W01001045",2001,740,40,700,130
"32613","W01001029",2001,774,6,768,75
"32614","W01001030",2001,748,12,736,53
"32615","W01001374",2001,577,131,446,22
"32616","W01001375",2001,711,233,478,47
"32617","W01001376",2001,655,372,283,12
"32618","W01001406",2001,776,249,527,26
"32619","W01001428",2001,525,345,180,7
"32620","W01001429",2001,489,65,424,22
"32621","W01001384",2001,651,33,618,72
"32622","W01001385",2001,657,147,510,55
"32623","W01001386",2001,733,336,397,48
"32624","W01001360",2001,515,46,469,35
"32625","W01001361",2001,503,231,272,19
"32626","W01001362",2001,899,148,751,90
"32627","W01001325",2001,623,252,371,18
"32628","W01001326",2001,835,269,566,54
"32629","W01001336",2001,605,153,452,20
"32630","W01001337",2001,630,18,612,45
"32631","W01001338",2001,758,47,711,113
"32632","W01001339",2001,605,381,224,10
"32633","W01001334",2001,576,244,332,20
"32634","W01001335",2001,447,45,402,29
"32635","W01001347",2001,609,81,528,28
"32636","W01001351",2001,651,51,600,18
"32637","W01001356",2001,480,19,461,21
"32638","W01001357",2001,565,104,461,19
"32639","W01001358",2001,622,274,348,14
"32640","W01001359",2001,596,40,556,53
"32641","W01001390",2001,500,28,472,8
"32642","W01001391",2001,652,138,514,29
"32643","W01001387",2001,503,147,356,56
"32644","W01001388",2001,648,197,451,22
"32645","W01001389",2001,407,43,364,12
"32646","W01001352",2001,748,272,476,29
"32647","W01001353",2001,741,244,497,20
"32648","W01001414",2001,615,211,404,18
"32649","W01001415",2001,632,106,526,44
"32650","W01001416",2001,624,64,560,38
"32651","W01001417",2001,521,16,505,19
"32652","W01001418",2001,581,159,422,28
"32653","W01001392",2001,643,29,614,16
"32654","W01001348",2001,631,290,341,23
"32655","W01001349",2001,623,51,572,19
"32656","W01001350",2001,743,56,687,52
"32657","W01001380",2001,663,84,579,32
"32658","W01001381",2001,599,297,302,19
"32659","W01001382",2001,633,70,563,49
"32660","W01001383",2001,626,93,533,35
"32661","W01001401",2001,750,259,491,26
"32662","W01001402",2001,637,251,386,18
"32663","W01001403",2001,614,73,541,38
"32664","W01001404",2001,571,7,564,8
"32665","W01001405",2001,676,227,449,23
"32666","W01001363",2001,522,85,437,28
"32667","W01001364",2001,607,233,374,38
"32668","W01001365",2001,714,159,555,31
"32669","W01001369",2001,873,132,741,23
"32670","W01001377",2001,632,39,593,22
"32671","W01001378",2001,658,202,456,24
"32672","W01001379",2001,619,73,546,15
"32673","W01001432",2001,610,113,497,14
"32674","W01001433",2001,609,27,582,59
"32675","W01001434",2001,500,9,491,12
"32676","W01001354",2001,675,44,631,46
"32677","W01001327",2001,736,73,663,67
"32678","W01001328",2001,644,157,487,59
"32679","W01001329",2001,631,94,537,42
"32680","W01001355",2001,733,218,515,44
"32681","W01001430",2001,879,148,731,96
"32682","W01001431",2001,603,43,560,31
"32683","W01001407",2001,603,56,547,30
"32684","W01001408",2001,595,230,365,19
"32685","W01001409",2001,604,70,534,18
"32686","W01001410",2001,762,236,526,17
"32687","W01001411",2001,755,203,552,32
"32688","W01001412",2001,761,68,693,98
"32689","W01001413",2001,742,186,556,29
"32690","W01001330",2001,607,132,475,21
"32691","W01001331",2001,634,40,594,54
"32692","W01001332",2001,771,182,589,75
"32693","W01001333",2001,624,124,500,51
"32694","W01001393",2001,514,151,363,7
"32695","W01001397",2001,607,63,544,28
"32696","W01001400",2001,546,289,257,20
"32697","W01001366",2001,612,29,583,21
"32698","W01001367",2001,620,29,591,60
"32699","W01001368",2001,606,188,418,34
"32700","W01001346",2001,647,86,561,30
"32701","W01001344",2001,659,109,550,36
"32702","W01001340",2001,613,54,559,16
"32703","W01001341",2001,783,300,483,26
"32704","W01001342",2001,481,52,429,23
"32705","W01001343",2001,472,36,436,16
"32706","W01001345",2001,585,357,228,10
"32707","W01001419",2001,561,101,460,19
"32708","W01001420",2001,573,24,549,32
"32709","W01001421",2001,710,498,212,34
"32710","W01001422",2001,675,249,426,16
"32711","W01001371",2001,621,244,377,23
"32712","W01001372",2001,720,54,666,21
"32713","W01001373",2001,626,32,594,42
"32714","W01001370",2001,748,123,625,35
"32715","W01001399",2001,562,39,523,21
"32716","W01001394",2001,506,10,496,10
"32717","W01001395",2001,601,172,429,13
"32718","W01001396",2001,574,265,309,17
"32719","W01001398",2001,547,18,529,9
"32720","W01001423",2001,625,7,618,15
"32721","W01001424",2001,636,119,517,41
"32722","W01001425",2001,655,12,643,20
"32723","W01001426",2001,494,8,486,12
"32724","W01001427",2001,578,0,578,11
"32725","W01001777",2001,611,8,603,21
"32726","W01001778",2001,640,4,636,8
"32727","W01001794",2001,614,3,611,38
"32728","W01001799",2001,502,7,495,14
"32729","W01001795",2001,601,15,586,39
"32730","W01001796",2001,600,62,538,32
"32731","W01001793",2001,509,17,492,33
"32732","W01001798",2001,633,15,618,35
"32733","W01001841",2001,630,3,627,13
"32734","W01001842",2001,661,6,655,52
"32735","W01001843",2001,641,18,623,27
"32736","W01001844",2001,579,103,476,31
"32737","W01001852",2001,648,5,643,17
"32738","W01001853",2001,764,8,756,13
"32739","W01001854",2001,789,9,780,34
"32740","W01001849",2001,647,6,641,17
"32741","W01001797",2001,600,31,569,13
"32742","W01001791",2001,635,38,597,40
"32743","W01001792",2001,671,200,471,11
"32744","W01001800",2001,657,199,458,29
"32745","W01001801",2001,529,115,414,10
"32746","W01001845",2001,632,12,620,32
"32747","W01001846",2001,531,31,500,15
"32748","W01001847",2001,638,3,635,7
"32749","W01001820",2001,457,80,377,7
"32750","W01001840",2001,707,154,553,23
"32751","W01001802",2001,662,132,530,24
"32752","W01001807",2001,578,283,295,14
"32753","W01001808",2001,640,317,323,26
"32754","W01001815",2001,513,45,468,21
"32755","W01001730",2001,630,3,627,16
"32756","W01001731",2001,526,3,523,18
"32757","W01001736",2001,605,6,599,14
"32758","W01001816",2001,601,214,387,35
"32759","W01001817",2001,532,85,447,18
"32760","W01001818",2001,605,67,538,60
"32761","W01001811",2001,502,229,273,13
"32762","W01001888",2001,603,84,519,14
"32763","W01001893",2001,785,170,615,33
"32764","W01001894",2001,655,7,648,29
"32765","W01001895",2001,729,345,384,17
"32766","W01001885",2001,562,111,451,29
"32767","W01001882",2001,630,22,608,36
"32768","W01001877",2001,652,34,618,37
"32769","W01001878",2001,610,84,526,34
"32770","W01001850",2001,790,6,784,22
"32771","W01001851",2001,697,55,642,27
"32772","W01001848",2001,604,0,604,17
"32773","W01001773",2001,604,28,576,38
"32774","W01001879",2001,642,337,305,24
"32775","W01001880",2001,547,308,239,40
"32776","W01001881",2001,633,229,404,36
"32777","W01001884",2001,517,410,107,21
"32778","W01001819",2001,895,75,820,24
"32779","W01001727",2001,449,11,438,18
"32780","W01001728",2001,591,3,588,18
"32781","W01001729",2001,555,10,545,42
"32782","W01001803",2001,712,237,475,16
"32783","W01001804",2001,612,179,433,19
"32784","W01001805",2001,640,223,417,29
"32785","W01001806",2001,824,66,758,54
"32786","W01001883",2001,610,220,390,17
"32787","W01001886",2001,515,225,290,16
"32788","W01001866",2001,602,157,445,20
"32789","W01001867",2001,500,228,272,7
"32790","W01001812",2001,469,64,405,23
"32791","W01001813",2001,645,266,379,20
"32792","W01001814",2001,606,45,561,48
"32793","W01001809",2001,510,66,444,15
"32794","W01001810",2001,580,205,375,24
"32795","W01001774",2001,533,0,533,19
"32796","W01001769",2001,612,5,607,12
"32797","W01001770",2001,475,54,421,25
"32798","W01001771",2001,596,12,584,30
"32799","W01001732",2001,646,6,640,41
"32800","W01001733",2001,567,60,507,37
"32801","W01001734",2001,602,7,595,24
"32802","W01001735",2001,626,8,618,71
"32803","W01001887",2001,638,3,635,31
"32804","W01001889",2001,751,76,675,51
"32805","W01001891",2001,738,114,624,58
"32806","W01001892",2001,607,3,604,7
"32807","W01001896",2001,626,5,621,34
"32808","W01001890",2001,602,9,593,42
"32809","W01001772",2001,604,8,596,23
"32810","W01001775",2001,629,27,602,58
"32811","W01001776",2001,519,6,513,39
"32812","W01001868",2001,610,194,416,12
"32813","W01001863",2001,611,51,560,38
"32814","W01001864",2001,612,12,600,26
"32815","W01001865",2001,510,35,475,7
"32816","W01001785",2001,481,247,234,6
"32817","W01001786",2001,600,78,522,34
"32818","W01001787",2001,540,168,372,14
"32819","W01001788",2001,584,240,344,22
"32820","W01001789",2001,677,29,648,79
"32821","W01001790",2001,493,127,366,20
"32822","W01001821",2001,483,74,409,47
"32823","W01001826",2001,515,10,505,28
"32824","W01001827",2001,591,7,584,20
"32825","W01001828",2001,628,7,621,14
"32826","W01001755",2001,501,16,485,140
"32827","W01001756",2001,518,154,364,24
"32828","W01001757",2001,509,19,490,133
"32829","W01001758",2001,611,15,596,187
"32830","W01001779",2001,640,24,616,38
"32831","W01001780",2001,599,39,560,37
"32832","W01001781",2001,748,81,667,124
"32833","W01001782",2001,578,10,568,13
"32834","W01001783",2001,511,12,499,28
"32835","W01001784",2001,588,12,576,34
"32836","W01001747",2001,760,27,733,59
"32837","W01001748",2001,625,170,455,14
"32838","W01001749",2001,609,106,503,25
"32839","W01001751",2001,691,276,415,27
"32840","W01001726",2001,460,26,434,196
"32841","W01001718",2001,505,13,492,210
"32842","W01001719",2001,515,9,506,139
"32843","W01001720",2001,542,9,533,300
"32844","W01001722",2001,479,18,461,222
"32845","W01001822",2001,662,111,551,30
"32846","W01001823",2001,489,3,486,62
"32847","W01001824",2001,608,44,564,253
"32848","W01001825",2001,615,48,567,102
"32849","W01001831",2001,593,15,578,190
"32850","W01001836",2001,493,34,459,216
"32851","W01001837",2001,479,72,407,192
"32852","W01001838",2001,586,8,578,225
"32853","W01001839",2001,587,27,560,190
"32854","W01001752",2001,648,39,609,9
"32855","W01001753",2001,584,233,351,34
"32856","W01001754",2001,770,65,705,39
"32857","W01001750",2001,758,329,429,15
"32858","W01001723",2001,494,25,469,278
"32859","W01001724",2001,515,8,507,280
"32860","W01001725",2001,514,15,499,380
"32861","W01001721",2001,495,100,395,247
"32862","W01001832",2001,516,36,480,360
"32863","W01001833",2001,615,52,563,194
"32864","W01001834",2001,651,70,581,161
"32865","W01001835",2001,827,281,546,221
"32866","W01001829",2001,607,53,554,271
"32867","W01001830",2001,754,77,677,460
"32868","W01001858",2001,745,96,649,223
"32869","W01001859",2001,658,65,593,167
"32870","W01001860",2001,776,47,729,212
"32871","W01001861",2001,572,27,545,176
"32872","W01001714",2001,597,7,590,28
"32873","W01001715",2001,702,82,620,106
"32874","W01001716",2001,519,4,515,42
"32875","W01001717",2001,725,151,574,57
"32876","W01001694",2001,650,168,482,127
"32877","W01001695",2001,495,198,297,103
"32878","W01001696",2001,633,265,368,73
"32879","W01001697",2001,625,86,539,104
"32880","W01001698",2001,490,38,452,209
"32881","W01001875",2001,626,206,420,27
"32882","W01001876",2001,641,265,376,32
"32883","W01001870",2001,582,77,505,53
"32884","W01001871",2001,685,327,358,25
"32885","W01001872",2001,647,134,513,66
"32886","W01001873",2001,649,159,490,77
"32887","W01001874",2001,660,300,360,67
"32888","W01001869",2001,611,107,504,49
"32889","W01001737",2001,629,304,325,28
"32890","W01001738",2001,513,275,238,22
"32891","W01001739",2001,492,258,234,26
"32892","W01001740",2001,649,308,341,25
"32893","W01001741",2001,594,341,253,30
"32894","W01001709",2001,500,12,488,58
"32895","W01001710",2001,633,18,615,58
"32896","W01001711",2001,669,159,510,29
"32897","W01001712",2001,633,35,598,123
"32898","W01001713",2001,646,24,622,88
"32899","W01001706",2001,518,58,460,26
"32900","W01001707",2001,640,205,435,32
"32901","W01001704",2001,622,311,311,25
"32902","W01001746",2001,617,235,382,37
"32903","W01001862",2001,627,82,545,227
"32904","W01001855",2001,630,183,447,101
"32905","W01001856",2001,625,176,449,166
"32906","W01001857",2001,716,287,429,78
"32907","W01001742",2001,614,312,302,22
"32908","W01001743",2001,593,19,574,14
"32909","W01001744",2001,702,334,368,23
"32910","W01001745",2001,536,11,525,23
"32911","W01001764",2001,505,89,416,81
"32912","W01001765",2001,473,51,422,83
"32913","W01001766",2001,638,92,546,89
"32914","W01001767",2001,630,88,542,90
"32915","W01001768",2001,515,73,442,96
"32916","W01001708",2001,718,294,424,59
"32917","W01001705",2001,605,141,464,31
"32918","W01001702",2001,605,134,471,29
"32919","W01001703",2001,489,213,276,14
"32920","W01001759",2001,649,39,610,44
"32921","W01001760",2001,572,83,489,42
"32922","W01001761",2001,646,145,501,84
"32923","W01001762",2001,624,201,423,87
"32924","W01001763",2001,795,252,543,158
"32925","W01001699",2001,651,414,237,39
"32926","W01001700",2001,600,231,369,83
"32927","W01001701",2001,910,120,790,298
"32928","W01000685",2001,633,132,501,49
"32929","W01000686",2001,497,30,467,41
"32930","W01000701",2001,602,51,551,64
"32931","W01000702",2001,468,128,340,49
"32932","W01000678",2001,594,121,473,32
"32933","W01000679",2001,575,57,518,110
"32934","W01000650",2001,652,33,619,75
"32935","W01000647",2001,596,39,557,75
"32936","W01000646",2001,875,111,764,116
"32937","W01000688",2001,712,222,490,69
"32938","W01000689",2001,660,20,640,67
"32939","W01000728",2001,808,48,760,82
"32940","W01000709",2001,834,33,801,62
"32941","W01000687",2001,793,67,726,68
"32942","W01000676",2001,605,27,578,66
"32943","W01000677",2001,706,136,570,127
"32944","W01000682",2001,514,44,470,33
"32945","W01000683",2001,454,25,429,54
"32946","W01000684",2001,700,51,649,39
"32947","W01000624",2001,909,57,852,91
"32948","W01000648",2001,486,24,462,36
"32949","W01000649",2001,611,44,567,47
"32950","W01000643",2001,635,180,455,58
"32951","W01000644",2001,452,61,391,72
"32952","W01000645",2001,678,119,559,76
"32953","W01000637",2001,629,218,411,41
"32954","W01000638",2001,505,215,290,46
"32955","W01000639",2001,648,146,502,81
"32956","W01000640",2001,495,10,485,30
"32957","W01000641",2001,1069,287,782,275
"32958","W01000642",2001,684,10,674,41
"32959","W01000693",2001,502,169,333,15
"32960","W01000694",2001,462,33,429,41
"32961","W01000720",2001,624,68,556,91
"32962","W01000721",2001,527,124,403,44
"32963","W01000735",2001,906,124,782,110
"32964","W01000674",2001,792,28,764,77
"32965","W01000656",2001,802,170,632,54
"32966","W01000657",2001,498,147,351,30
"32967","W01000658",2001,504,83,421,42
"32968","W01000718",2001,619,183,436,41
"32969","W01000719",2001,609,96,513,26
"32970","W01000724",2001,623,157,466,31
"32971","W01000725",2001,792,157,635,39
"32972","W01000680",2001,761,20,741,23
"32973","W01000681",2001,848,261,587,71
"32974","W01000675",2001,752,93,659,60
"32975","W01000722",2001,504,19,485,45
"32976","W01000723",2001,568,35,533,61
"32977","W01000695",2001,616,124,492,37
"32978","W01000696",2001,604,115,489,43
"32979","W01000714",2001,560,172,388,51
"32980","W01000715",2001,541,23,518,38
"32981","W01000625",2001,506,169,337,30
"32982","W01000626",2001,737,109,628,101
"32983","W01000627",2001,740,151,589,54
"32984","W01000700",2001,890,75,815,106
"32985","W01000672",2001,620,91,529,72
"32986","W01000673",2001,566,99,467,61
"32987","W01000697",2001,761,130,631,62
"32988","W01000698",2001,712,180,532,23
"32989","W01000699",2001,535,13,522,45
"32990","W01000712",2001,479,35,444,44
"32991","W01000713",2001,503,83,420,34
"32992","W01000716",2001,540,37,503,18
"32993","W01000717",2001,635,182,453,24
"32994","W01000662",2001,839,129,710,40
"32995","W01000663",2001,881,214,667,28
"32996","W01000664",2001,663,72,591,32
"32997","W01000665",2001,641,34,607,27
"32998","W01000666",2001,624,106,518,37
"32999","W01000731",2001,893,100,793,56
"33000","W01000729",2001,526,135,391,21
"33001","W01000730",2001,511,87,424,32
"33002","W01000670",2001,756,195,561,62
"33003","W01000671",2001,621,87,534,29
"33004","W01000690",2001,649,108,541,34
"33005","W01000691",2001,620,98,522,14
"33006","W01000692",2001,623,85,538,36
"33007","W01000726",2001,554,4,550,13
"33008","W01000727",2001,476,27,449,17
"33009","W01000655",2001,814,256,558,45
"33010","W01000651",2001,678,80,598,63
"33011","W01000652",2001,740,233,507,46
"33012","W01000632",2001,612,106,506,37
"33013","W01000633",2001,640,138,502,57
"33014","W01000634",2001,633,16,617,27
"33015","W01000710",2001,702,13,689,30
"33016","W01000711",2001,902,254,648,41
"33017","W01000703",2001,765,71,694,103
"33018","W01000704",2001,722,83,639,14
"33019","W01000705",2001,752,223,529,25
"33020","W01000653",2001,644,80,564,47
"33021","W01000654",2001,765,48,717,88
"33022","W01000667",2001,613,67,546,29
"33023","W01000668",2001,401,153,248,16
"33024","W01000669",2001,587,11,576,43
"33025","W01000628",2001,603,25,578,23
"33026","W01000629",2001,732,111,621,44
"33027","W01000630",2001,608,76,532,47
"33028","W01000631",2001,766,338,428,36
"33029","W01000635",2001,649,82,567,27
"33030","W01000636",2001,630,276,354,16
"33031","W01000706",2001,626,135,491,25
"33032","W01000707",2001,604,262,342,18
"33033","W01000708",2001,597,264,333,33
"33034","W01000659",2001,639,161,478,73
"33035","W01000660",2001,762,223,539,67
"33036","W01000661",2001,873,372,501,62
"33037","W01000732",2001,625,47,578,89
"33038","W01000733",2001,624,273,351,53
"33039","W01000734",2001,598,72,526,86
"33040","W01000520",2001,441,26,415,51
"33041","W01000521",2001,530,23,507,135
"33042","W01000523",2001,815,53,762,107
"33043","W01000548",2001,738,90,648,73
"33044","W01000549",2001,667,25,642,56
"33045","W01000526",2001,399,84,315,151
"33046","W01000517",2001,508,82,426,219
"33047","W01000512",2001,539,78,461,141
"33048","W01000513",2001,991,121,870,617
"33049","W01000514",2001,803,82,721,330
"33050","W01000515",2001,606,255,351,29
"33051","W01000516",2001,614,217,397,36
"33052","W01000518",2001,661,152,509,134
"33053","W01000530",2001,795,108,687,164
"33054","W01000525",2001,509,11,498,45
"33055","W01000534",2001,602,30,572,68
"33056","W01000543",2001,903,54,849,114
"33057","W01000552",2001,803,47,756,107
"33058","W01000538",2001,592,21,571,75
"33059","W01000539",2001,499,6,493,60
"33060","W01000540",2001,537,47,490,62
"33061","W01000524",2001,818,48,770,85
"33062","W01000506",2001,750,116,634,112
"33063","W01000536",2001,657,30,627,100
"33064","W01000550",2001,546,48,498,84
"33065","W01000542",2001,918,63,855,126
"33066","W01000544",2001,532,69,463,82
"33067","W01000545",2001,871,58,813,66
"33068","W01000532",2001,820,35,785,76
"33069","W01000529",2001,633,57,576,94
"33070","W01000535",2001,866,89,777,91
"33071","W01000541",2001,766,51,715,89
"33072","W01000527",2001,488,59,429,140
"33073","W01000528",2001,614,189,425,71
"33074","W01000537",2001,769,44,725,98
"33075","W01000546",2001,522,66,456,44
"33076","W01000547",2001,509,46,463,29
"33077","W01000507",2001,545,38,507,32
"33078","W01000508",2001,586,129,457,68
"33079","W01000509",2001,749,114,635,39
"33080","W01000510",2001,629,214,415,101
"33081","W01000511",2001,537,103,434,142
"33082","W01000533",2001,663,180,483,72
"33083","W01000531",2001,794,101,693,77
"33084","W01000519",2001,693,45,648,57
"33085","W01000522",2001,575,49,526,55
"33086","W01000551",2001,575,58,517,55
"33087","W01000132",2001,760,17,743,309
"33088","W01000146",2001,1042,17,1025,442
"33089","W01000147",2001,737,46,691,114
"33090","W01000169",2001,893,210,683,226
"33091","W01000186",2001,740,341,399,81
"33092","W01000187",2001,612,380,232,31
"33093","W01000188",2001,756,79,677,22
"33094","W01000168",2001,764,138,626,59
"33095","W01000133",2001,840,17,823,60
"33096","W01000154",2001,612,0,612,40
"33097","W01000173",2001,642,7,635,76
"33098","W01000174",2001,759,8,751,59
"33099","W01000175",2001,780,3,777,37
"33100","W01000155",2001,670,19,651,138
"33101","W01000156",2001,750,53,697,138
"33102","W01000157",2001,617,224,393,36
"33103","W01000158",2001,753,83,670,24
"33104","W01000149",2001,649,10,639,73
"33105","W01000150",2001,614,10,604,45
"33106","W01000151",2001,507,120,387,37
"33107","W01000152",2001,630,31,599,74
"33108","W01000184",2001,989,75,914,106
"33109","W01000135",2001,1006,6,1000,52
"33110","W01000136",2001,741,99,642,76
"33111","W01000165",2001,862,6,856,52
"33112","W01000166",2001,730,107,623,42
"33113","W01000143",2001,603,22,581,124
"33114","W01000144",2001,605,60,545,283
"33115","W01000139",2001,611,47,564,44
"33116","W01000182",2001,758,80,678,358
"33117","W01000183",2001,508,34,474,80
"33118","W01000180",2001,492,6,486,41
"33119","W01000181",2001,573,7,566,48
"33120","W01000138",2001,835,236,599,42
"33121","W01000145",2001,492,169,323,41
"33122","W01000153",2001,690,57,633,66
"33123","W01000163",2001,491,231,260,46
"33124","W01000164",2001,501,30,471,47
"33125","W01000126",2001,632,29,603,76
"33126","W01000127",2001,505,185,320,22
"33127","W01000128",2001,624,90,534,80
"33128","W01000120",2001,1079,98,981,207
"33129","W01000140",2001,637,114,523,87
"33130","W01000141",2001,803,8,795,34
"33131","W01000142",2001,689,6,683,22
"33132","W01000178",2001,760,231,529,86
"33133","W01000179",2001,787,8,779,47
"33134","W01000176",2001,654,88,566,102
"33135","W01000177",2001,499,33,466,21
"33136","W01000167",2001,804,150,654,67
"33137","W01000160",2001,452,36,416,48
"33138","W01000161",2001,518,9,509,59
"33139","W01000124",2001,835,72,763,77
"33140","W01000129",2001,494,130,364,58
"33141","W01000130",2001,728,36,692,128
"33142","W01000131",2001,592,105,487,26
"33143","W01000123",2001,795,131,664,99
"33144","W01000125",2001,660,50,610,52
"33145","W01000170",2001,739,63,676,75
"33146","W01000171",2001,528,94,434,82
"33147","W01000172",2001,527,99,428,71
"33148","W01000162",2001,702,96,606,72
"33149","W01000159",2001,521,36,485,100
"33150","W01000122",2001,769,84,685,102
"33151","W01000190",2001,541,68,473,105
"33152","W01000185",2001,562,63,499,48
"33153","W01000189",2001,624,81,543,104
"33154","W01000121",2001,540,54,486,76
"33155","W01000148",2001,455,104,351,36
"33156","W01000134",2001,847,165,682,91
"33157","W01000137",2001,593,24,569,82
"33158","W01000218",2001,750,84,666,87
"33159","W01000219",2001,752,11,741,76
"33160","W01000220",2001,892,8,884,53
"33161","W01000213",2001,613,220,393,83
"33162","W01000214",2001,512,11,501,102
"33163","W01000215",2001,607,6,601,17
"33164","W01000216",2001,608,104,504,74
"33165","W01000221",2001,718,11,707,103
"33166","W01000222",2001,847,0,847,66
"33167","W01000212",2001,916,20,896,48
"33168","W01000226",2001,747,91,656,68
"33169","W01000227",2001,750,61,689,77
"33170","W01000228",2001,515,34,481,144
"33171","W01000239",2001,787,88,699,348
"33172","W01000240",2001,762,180,582,343
"33173","W01000241",2001,513,55,458,148
"33174","W01000235",2001,549,5,544,46
"33175","W01000231",2001,637,54,583,74
"33176","W01000232",2001,625,9,616,62
"33177","W01000233",2001,595,32,563,59
"33178","W01000236",2001,755,316,439,86
"33179","W01000237",2001,640,356,284,35
"33180","W01000238",2001,653,41,612,105
"33181","W01000234",2001,602,199,403,56
"33182","W01000229",2001,761,108,653,38
"33183","W01000230",2001,900,19,881,56
"33184","W01000217",2001,907,174,733,69
"33185","W01000200",2001,522,18,504,26
"33186","W01000201",2001,530,117,413,52
"33187","W01000248",2001,638,55,583,98
"33188","W01000191",2001,864,159,705,123
"33189","W01000223",2001,561,7,554,73
"33190","W01000224",2001,639,88,551,38
"33191","W01000225",2001,693,91,602,98
"33192","W01000245",2001,797,115,682,82
"33193","W01000246",2001,701,173,528,36
"33194","W01000247",2001,789,76,713,94
"33195","W01000194",2001,888,66,822,183
"33196","W01000198",2001,629,411,218,31
"33197","W01000199",2001,709,155,554,88
"33198","W01000195",2001,631,17,614,37
"33199","W01000196",2001,526,18,508,44
"33200","W01000197",2001,623,88,535,55
"33201","W01000211",2001,757,64,693,100
"33202","W01000203",2001,952,66,886,69
"33203","W01000204",2001,632,41,591,83
"33204","W01000206",2001,817,100,717,111
"33205","W01000242",2001,859,246,613,55
"33206","W01000243",2001,749,108,641,109
"33207","W01000244",2001,742,15,727,26
"33208","W01000193",2001,568,152,416,88
"33209","W01000207",2001,907,87,820,138
"33210","W01000202",2001,638,49,589,31
"33211","W01000208",2001,558,44,514,150
"33212","W01000209",2001,581,175,406,32
"33213","W01000210",2001,552,31,521,73
"33214","W01000192",2001,442,77,365,58
"33215","W01000205",2001,476,68,408,44
"33216","W01000287",2001,954,111,843,145
"33217","W01000298",2001,695,146,549,57
"33218","W01000338",2001,795,107,688,79
"33219","W01000320",2001,846,252,594,79
"33220","W01000340",2001,888,22,866,83
"33221","W01000306",2001,884,129,755,73
"33222","W01000304",2001,826,347,479,77
"33223","W01000305",2001,770,141,629,36
"33224","W01000296",2001,624,249,375,42
"33225","W01000297",2001,484,55,429,40
"33226","W01000253",2001,742,104,638,52
"33227","W01000254",2001,864,208,656,72
"33228","W01000292",2001,538,140,398,19
"33229","W01000293",2001,620,112,508,36
"33230","W01000288",2001,1000,489,511,53
"33231","W01000290",2001,645,321,324,44
"33232","W01000291",2001,565,91,474,66
"33233","W01000289",2001,484,14,470,11
"33234","W01000294",2001,688,8,680,31
"33235","W01000295",2001,623,40,583,20
"33236","W01000301",2001,693,77,616,63
"33237","W01000258",2001,905,111,794,48
"33238","W01000270",2001,469,22,447,37
"33239","W01000271",2001,559,55,504,74
"33240","W01000272",2001,727,80,647,39
"33241","W01000273",2001,639,156,483,40
"33242","W01000274",2001,847,354,493,80
"33243","W01000275",2001,495,19,476,39
"33244","W01000278",2001,626,310,316,27
"33245","W01000279",2001,516,19,497,12
"33246","W01000281",2001,511,25,486,12
"33247","W01000276",2001,505,40,465,38
"33248","W01000277",2001,509,11,498,21
"33249","W01000283",2001,863,53,810,55
"33250","W01000332",2001,515,115,400,57
"33251","W01000333",2001,600,320,280,34
"33252","W01000334",2001,787,103,684,79
"33253","W01000335",2001,512,234,278,20
"33254","W01000336",2001,475,256,219,18
"33255","W01000337",2001,854,90,764,64
"33256","W01000325",2001,652,83,569,16
"33257","W01000252",2001,746,23,723,40
"33258","W01000282",2001,489,6,483,8
"33259","W01000280",2001,560,70,490,15
"33260","W01000311",2001,722,193,529,52
"33261","W01000312",2001,749,128,621,62
"33262","W01000328",2001,843,129,714,131
"33263","W01000323",2001,606,65,541,47
"33264","W01000324",2001,587,18,569,12
"33265","W01000264",2001,480,90,390,36
"33266","W01000265",2001,542,15,527,25
"33267","W01000251",2001,587,193,394,13
"33268","W01000268",2001,601,32,569,13
"33269","W01000302",2001,824,29,795,98
"33270","W01000284",2001,598,8,590,24
"33271","W01000285",2001,564,0,564,15
"33272","W01000286",2001,656,3,653,23
"33273","W01000261",2001,612,14,598,29
"33274","W01000249",2001,499,3,496,8
"33275","W01000250",2001,638,13,625,37
"33276","W01000321",2001,618,14,604,17
"33277","W01000322",2001,571,65,506,28
"33278","W01000329",2001,586,180,406,69
"33279","W01000330",2001,747,333,414,32
"33280","W01000331",2001,619,60,559,24
"33281","W01000255",2001,857,157,700,92
"33282","W01000256",2001,623,137,486,34
"33283","W01000257",2001,889,22,867,29
"33284","W01000313",2001,602,147,455,41
"33285","W01000314",2001,496,80,416,57
"33286","W01000315",2001,850,128,722,50
"33287","W01000316",2001,491,9,482,9
"33288","W01000317",2001,490,4,486,4
"33289","W01000318",2001,465,284,181,9
"33290","W01000319",2001,610,152,458,31
"33291","W01000259",2001,728,177,551,55
"33292","W01000260",2001,739,12,727,19
"33293","W01000266",2001,528,52,476,54
"33294","W01000267",2001,600,62,538,30
"33295","W01000262",2001,621,169,452,38
"33296","W01000263",2001,585,311,274,20
"33297","W01000303",2001,618,27,591,36
"33298","W01000326",2001,625,63,562,17
"33299","W01000327",2001,834,46,788,59
"33300","W01000339",2001,615,116,499,22
"33301","W01000309",2001,864,129,735,87
"33302","W01000299",2001,796,53,743,44
"33303","W01000300",2001,740,57,683,61
"33304","W01000310",2001,695,57,638,34
"33305","W01000307",2001,507,8,499,40
"33306","W01000308",2001,498,87,411,29
"33307","W01000269",2001,712,149,563,68
"33308","W01000062",2001,591,152,439,254
"33309","W01000076",2001,440,69,371,101
"33310","W01000077",2001,527,144,383,108
"33311","W01000091",2001,508,306,202,30
"33312","W01000092",2001,666,70,596,287
"33313","W01000102",2001,426,24,402,49
"33314","W01000090",2001,527,343,184,27
"33315","W01000072",2001,686,147,539,42
"33316","W01000075",2001,610,222,388,101
"33317","W01000064",2001,603,170,433,45
"33318","W01000071",2001,926,160,766,115
"33319","W01000050",2001,554,59,495,98
"33320","W01000115",2001,884,145,739,54
"33321","W01000096",2001,486,147,339,38
"33322","W01000097",2001,471,67,404,86
"33323","W01000119",2001,918,92,826,125
"33324","W01000087",2001,707,123,584,31
"33325","W01000052",2001,448,43,405,29
"33326","W01000053",2001,454,30,424,47
"33327","W01000063",2001,746,154,592,67
"33328","W01000081",2001,889,187,702,90
"33329","W01000099",2001,686,73,613,36
"33330","W01000103",2001,506,79,427,60
"33331","W01000098",2001,925,533,392,36
"33332","W01000093",2001,940,91,849,84
"33333","W01000110",2001,550,127,423,15
"33334","W01000059",2001,943,377,566,61
"33335","W01000054",2001,437,59,378,22
"33336","W01000088",2001,735,112,623,35
"33337","W01000111",2001,737,194,543,95
"33338","W01000118",2001,668,100,568,31
"33339","W01000112",2001,771,123,648,59
"33340","W01000104",2001,766,166,600,72
"33341","W01000086",2001,849,163,686,61
"33342","W01000073",2001,689,83,606,47
"33343","W01000056",2001,808,169,639,99
"33344","W01000065",2001,525,84,441,65
"33345","W01000113",2001,778,110,668,68
"33346","W01000114",2001,648,106,542,48
"33347","W01000105",2001,721,129,592,79
"33348","W01000106",2001,870,98,772,80
"33349","W01000107",2001,626,145,481,72
"33350","W01000100",2001,432,51,381,58
"33351","W01000066",2001,475,59,416,62
"33352","W01000061",2001,803,91,712,122
"33353","W01000078",2001,653,115,538,69
"33354","W01000089",2001,774,77,697,79
"33355","W01000047",2001,578,88,490,74
"33356","W01000070",2001,523,59,464,68
"33357","W01000094",2001,550,46,504,63
"33358","W01000095",2001,573,106,467,44
"33359","W01000108",2001,926,190,736,138
"33360","W01000109",2001,845,238,607,162
"33361","W01000101",2001,624,90,534,67
"33362","W01000074",2001,865,95,770,119
"33363","W01000079",2001,483,42,441,37
"33364","W01000069",2001,760,84,676,77
"33365","W01000055",2001,747,80,667,158
"33366","W01000080",2001,814,94,720,71
"33367","W01000084",2001,488,54,434,77
"33368","W01000045",2001,421,40,381,65
"33369","W01000051",2001,881,243,638,95
"33370","W01000082",2001,414,57,357,76
"33371","W01000083",2001,508,45,463,44
"33372","W01000060",2001,550,66,484,69
"33373","W01000057",2001,582,60,522,52
"33374","W01000067",2001,571,68,503,99
"33375","W01000068",2001,634,194,440,58
"33376","W01000048",2001,587,169,418,47
"33377","W01000049",2001,513,37,476,194
"33378","W01000046",2001,553,65,488,61
"33379","W01000058",2001,447,58,389,30
"33380","W01000085",2001,935,81,854,122
"33381","W01000116",2001,777,11,766,112
"33382","W01000117",2001,691,194,497,117
"33383","W01000003",2001,595,106,489,69
"33384","W01000004",2001,520,67,453,29
"33385","W01000018",2001,620,87,533,79
"33386","W01000031",2001,623,71,552,70
"33387","W01000028",2001,693,157,536,83
"33388","W01000032",2001,505,70,435,66
"33389","W01000020",2001,528,36,492,65
"33390","W01000021",2001,885,91,794,103
"33391","W01000010",2001,802,30,772,76
"33392","W01000016",2001,528,82,446,148
"33393","W01000017",2001,600,131,469,71
"33394","W01000033",2001,669,315,354,32
"33395","W01000029",2001,676,178,498,94
"33396","W01000030",2001,988,320,668,138
"33397","W01000036",2001,501,165,336,68
"33398","W01000037",2001,491,112,379,28
"33399","W01000039",2001,457,17,440,41
"33400","W01000040",2001,581,45,536,87
"33401","W01000043",2001,514,131,383,47
"33402","W01000044",2001,484,7,477,26
"33403","W01000034",2001,493,110,383,20
"33404","W01000022",2001,631,81,550,85
"33405","W01000013",2001,910,66,844,56
"33406","W01000035",2001,728,83,645,89
"33407","W01000019",2001,718,33,685,82
"33408","W01000026",2001,565,85,480,53
"33409","W01000005",2001,979,190,789,152
"33410","W01000006",2001,614,92,522,53
"33411","W01000012",2001,621,76,545,42
"33412","W01000014",2001,737,198,539,53
"33413","W01000041",2001,623,367,256,24
"33414","W01000023",2001,563,116,447,75
"33415","W01000024",2001,507,56,451,219
"33416","W01000009",2001,670,135,535,55
"33417","W01000001",2001,510,88,422,86
"33418","W01000002",2001,525,63,462,79
"33419","W01000011",2001,537,57,480,117
"33420","W01000008",2001,590,54,536,45
"33421","W01000015",2001,623,53,570,48
"33422","W01000042",2001,882,139,743,70
"33423","W01000038",2001,935,171,764,107
"33424","W01000025",2001,835,98,737,74
"33425","W01000027",2001,670,104,566,99
"33426","W01000007",2001,635,82,553,86
"33427","W01001299",2001,719,364,355,55
"33428","W01001300",2001,598,303,295,11
"33429","W01001301",2001,754,357,397,12
"33430","W01001323",2001,595,177,418,25
"33431","W01001308",2001,475,242,233,18
"33432","W01001309",2001,503,195,308,19
"33433","W01001310",2001,623,63,560,20
"33434","W01001311",2001,503,75,428,42
"33435","W01001295",2001,706,278,428,40
"33436","W01001296",2001,610,76,534,27
"33437","W01001297",2001,747,130,617,83
"33438","W01001298",2001,751,301,450,42
"33439","W01001294",2001,540,6,534,14
"33440","W01001291",2001,616,103,513,46
"33441","W01001305",2001,496,37,459,42
"33442","W01001306",2001,641,32,609,37
"33443","W01001324",2001,885,134,751,63
"33444","W01001315",2001,736,175,561,111
"33445","W01001307",2001,750,267,483,59
"33446","W01001292",2001,709,351,358,30
"33447","W01001293",2001,612,209,403,17
"33448","W01001316",2001,758,46,712,38
"33449","W01001317",2001,648,185,463,27
"33450","W01001318",2001,638,15,623,34
"33451","W01001314",2001,822,101,721,45
"33452","W01001312",2001,646,215,431,29
"33453","W01001313",2001,644,30,614,63
"33454","W01001289",2001,585,47,538,57
"33455","W01001302",2001,498,56,442,72
"33456","W01001303",2001,497,204,293,36
"33457","W01001304",2001,584,60,524,29
"33458","W01001290",2001,794,154,640,51
"33459","W01001319",2001,621,19,602,22
"33460","W01001320",2001,589,92,497,29
"33461","W01001321",2001,626,116,510,42
"33462","W01001322",2001,635,69,566,75
"33463","W01001548",2001,791,50,741,81
"33464","W01001545",2001,643,17,626,58
"33465","W01001557",2001,850,159,691,120
"33466","W01001571",2001,478,16,462,46
"33467","W01001579",2001,663,40,623,73
"33468","W01001580",2001,642,143,499,30
"33469","W01001570",2001,427,216,211,18
"33470","W01001558",2001,692,235,457,21
"33471","W01001546",2001,645,281,364,57
"33472","W01001547",2001,725,234,491,21
"33473","W01001561",2001,599,3,596,24
"33474","W01001562",2001,545,91,454,37
"33475","W01001563",2001,461,118,343,22
"33476","W01001564",2001,876,125,751,64
"33477","W01001569",2001,573,81,492,30
"33478","W01001552",2001,612,15,597,29
"33479","W01001553",2001,635,104,531,40
"33480","W01001554",2001,628,64,564,150
"33481","W01001576",2001,474,66,408,43
"33482","W01001577",2001,629,324,305,14
"33483","W01001599",2001,922,195,727,51
"33484","W01001575",2001,462,29,433,62
"33485","W01001581",2001,747,105,642,60
"33486","W01001566",2001,457,16,441,125
"33487","W01001567",2001,408,45,363,108
"33488","W01001568",2001,637,21,616,73
"33489","W01001560",2001,490,7,483,68
"33490","W01001565",2001,635,45,590,62
"33491","W01001555",2001,470,3,467,50
"33492","W01001556",2001,486,80,406,10
"33493","W01001596",2001,506,87,419,71
"33494","W01001597",2001,518,28,490,60
"33495","W01001583",2001,612,37,575,50
"33496","W01001594",2001,473,52,421,18
"33497","W01001595",2001,476,4,472,31
"33498","W01001585",2001,496,3,493,14
"33499","W01001586",2001,517,10,507,28
"33500","W01001549",2001,545,30,515,34
"33501","W01001587",2001,905,183,722,188
"33502","W01001559",2001,555,65,490,23
"33503","W01001592",2001,613,314,299,42
"33504","W01001593",2001,748,119,629,52
"33505","W01001584",2001,768,87,681,68
"33506","W01001590",2001,778,38,740,29
"33507","W01001578",2001,804,80,724,18
"33508","W01001542",2001,678,86,592,25
"33509","W01001543",2001,503,6,497,12
"33510","W01001544",2001,469,144,325,11
"33511","W01001550",2001,485,146,339,3
"33512","W01001551",2001,476,137,339,9
"33513","W01001588",2001,749,8,741,32
"33514","W01001589",2001,632,175,457,25
"33515","W01001598",2001,658,169,489,30
"33516","W01001591",2001,549,6,543,27
"33517","W01001582",2001,626,102,524,20
"33518","W01001572",2001,610,107,503,19
"33519","W01001573",2001,543,24,519,21
"33520","W01001574",2001,606,13,593,50
"33521","W01000919",2001,483,87,396,36
"33522","W01000927",2001,624,137,487,44
"33523","W01000928",2001,672,140,532,42
"33524","W01000929",2001,543,155,388,36
"33525","W01000931",2001,528,89,439,32
"33526","W01000972",2001,750,124,626,85
"33527","W01000973",2001,667,222,445,38
"33528","W01000965",2001,833,201,632,36
"33529","W01000918",2001,782,152,630,39
"33530","W01000944",2001,514,142,372,30
"33531","W01000925",2001,652,266,386,15
"33532","W01000926",2001,840,78,762,52
"33533","W01000893",2001,816,147,669,89
"33534","W01000888",2001,915,127,788,45
"33535","W01000946",2001,611,73,538,43
"33536","W01000947",2001,755,295,460,29
"33537","W01000948",2001,788,160,628,72
"33538","W01000955",2001,525,83,442,6
"33539","W01000956",2001,506,8,498,5
"33540","W01000971",2001,597,109,488,32
"33541","W01000970",2001,518,117,401,17
"33542","W01000953",2001,706,184,522,42
"33543","W01000954",2001,618,44,574,34
"33544","W01000887",2001,794,213,581,35
"33545","W01000902",2001,434,27,407,20
"33546","W01000903",2001,500,3,497,15
"33547","W01000904",2001,482,6,476,11
"33548","W01000905",2001,620,82,538,19
"33549","W01000908",2001,711,77,634,23
"33550","W01000906",2001,493,55,438,10
"33551","W01000907",2001,610,264,346,17
"33552","W01000922",2001,719,193,526,45
"33553","W01000923",2001,636,44,592,30
"33554","W01000934",2001,639,72,567,90
"33555","W01000935",2001,749,158,591,75
"33556","W01000938",2001,631,29,602,26
"33557","W01000939",2001,607,155,452,112
"33558","W01000940",2001,601,211,390,39
"33559","W01000909",2001,496,87,409,11
"33560","W01000910",2001,635,17,618,20
"33561","W01000911",2001,486,10,476,9
"33562","W01000969",2001,498,12,486,12
"33563","W01000912",2001,517,97,420,35
"33564","W01000913",2001,523,45,478,57
"33565","W01000914",2001,648,261,387,23
"33566","W01000915",2001,488,70,418,24
"33567","W01000916",2001,474,6,468,32
"33568","W01000917",2001,887,83,804,65
"33569","W01000920",2001,538,71,467,42
"33570","W01000921",2001,691,369,322,12
"33571","W01000924",2001,474,154,320,25
"33572","W01000930",2001,642,147,495,59
"33573","W01000941",2001,625,197,428,40
"33574","W01000942",2001,746,355,391,20
"33575","W01000943",2001,597,14,583,15
"33576","W01000936",2001,616,253,363,21
"33577","W01000937",2001,744,229,515,67
"33578","W01000894",2001,613,83,530,23
"33579","W01000895",2001,749,160,589,81
"33580","W01000896",2001,594,265,329,33
"33581","W01000897",2001,606,107,499,37
"33582","W01000898",2001,626,94,532,16
"33583","W01000899",2001,630,65,565,16
"33584","W01000900",2001,778,322,456,44
"33585","W01000901",2001,742,207,535,18
"33586","W01000945",2001,495,88,407,25
"33587","W01000889",2001,751,43,708,59
"33588","W01000890",2001,643,8,635,12
"33589","W01000891",2001,625,120,505,29
"33590","W01000892",2001,777,72,705,27
"33591","W01000883",2001,574,7,567,12
"33592","W01000961",2001,742,202,540,28
"33593","W01000962",2001,600,265,335,26
"33594","W01000963",2001,738,227,511,32
"33595","W01000964",2001,780,325,455,22
"33596","W01000958",2001,644,337,307,17
"33597","W01000959",2001,635,87,548,23
"33598","W01000960",2001,710,185,525,43
"33599","W01000957",2001,838,360,478,39
"33600","W01000884",2001,549,34,515,87
"33601","W01000885",2001,509,208,301,40
"33602","W01000886",2001,670,85,585,135
"33603","W01000949",2001,490,57,433,19
"33604","W01000950",2001,640,22,618,73
"33605","W01000951",2001,625,17,608,99
"33606","W01000952",2001,500,20,480,41
"33607","W01000966",2001,638,46,592,48
"33608","W01000967",2001,629,87,542,53
"33609","W01000968",2001,686,86,600,39
"33610","W01000932",2001,503,138,365,22
"33611","W01000933",2001,490,35,455,18
"33612","W01001623",2001,649,24,625,47
"33613","W01001624",2001,527,3,524,11
"33614","W01001625",2001,553,43,510,28
"33615","W01001626",2001,591,74,517,9
"33616","W01001627",2001,600,10,590,23
"33617","W01001628",2001,485,208,277,7
"33618","W01001651",2001,637,20,617,7
"33619","W01001652",2001,764,455,309,23
"33620","W01001653",2001,614,13,601,10
"33621","W01001654",2001,641,34,607,24
"33622","W01001655",2001,648,22,626,21
"33623","W01001617",2001,637,365,272,12
"33624","W01001618",2001,514,208,306,13
"33625","W01001619",2001,614,315,299,10
"33626","W01001620",2001,489,191,298,8
"33627","W01001621",2001,599,253,346,16
"33628","W01001622",2001,547,117,430,11
"33629","W01001639",2001,554,19,535,16
"33630","W01001640",2001,471,31,440,12
"33631","W01001641",2001,513,3,510,17
"33632","W01001649",2001,600,97,503,21
"33633","W01001650",2001,612,148,464,15
"33634","W01001614",2001,752,346,406,15
"33635","W01001615",2001,623,120,503,15
"33636","W01001616",2001,627,63,564,23
"33637","W01001678",2001,672,170,502,21
"33638","W01001681",2001,669,244,425,53
"33639","W01001682",2001,614,230,384,14
"33640","W01001683",2001,503,52,451,32
"33641","W01001684",2001,629,20,609,60
"33642","W01001601",2001,624,297,327,38
"33643","W01001679",2001,468,51,417,9
"33644","W01001680",2001,507,8,499,32
"33645","W01001675",2001,591,16,575,62
"33646","W01001676",2001,702,55,647,116
"33647","W01001677",2001,648,25,623,31
"33648","W01001665",2001,649,185,464,15
"33649","W01001606",2001,524,19,505,7
"33650","W01001608",2001,619,61,558,20
"33651","W01001663",2001,627,218,409,15
"33652","W01001669",2001,536,8,528,8
"33653","W01001670",2001,490,3,487,13
"33654","W01001672",2001,628,114,514,18
"33655","W01001673",2001,631,40,591,12
"33656","W01001674",2001,604,115,489,12
"33657","W01001666",2001,637,286,351,14
"33658","W01001667",2001,499,227,272,8
"33659","W01001668",2001,481,186,295,9
"33660","W01001664",2001,634,296,338,11
"33661","W01001611",2001,499,57,442,29
"33662","W01001612",2001,631,65,566,53
"33663","W01001613",2001,605,25,580,27
"33664","W01001691",2001,610,86,524,86
"33665","W01001692",2001,762,45,717,132
"33666","W01001602",2001,640,78,562,16
"33667","W01001603",2001,517,49,468,74
"33668","W01001604",2001,628,22,606,13
"33669","W01001600",2001,642,11,631,19
"33670","W01001642",2001,762,115,647,66
"33671","W01001643",2001,553,183,370,30
"33672","W01001644",2001,608,43,565,52
"33673","W01001693",2001,538,43,495,121
"33674","W01001690",2001,765,64,701,109
"33675","W01001685",2001,767,193,574,133
"33676","W01001686",2001,513,70,443,61
"33677","W01001687",2001,765,153,612,237
"33678","W01001605",2001,591,91,500,103
"33679","W01001609",2001,642,380,262,24
"33680","W01001610",2001,493,145,348,8
"33681","W01001607",2001,505,302,203,10
"33682","W01001645",2001,498,90,408,14
"33683","W01001646",2001,638,278,360,7
"33684","W01001647",2001,623,10,613,28
"33685","W01001648",2001,621,62,559,21
"33686","W01001635",2001,600,63,537,25
"33687","W01001637",2001,646,82,564,22
"33688","W01001638",2001,487,6,481,14
"33689","W01001671",2001,731,251,480,18
"33690","W01001629",2001,619,79,540,16
"33691","W01001630",2001,749,373,376,8
"33692","W01001631",2001,619,50,569,29
"33693","W01001632",2001,584,143,441,13
"33694","W01001659",2001,649,275,374,96
"33695","W01001660",2001,526,94,432,35
"33696","W01001661",2001,504,203,301,65
"33697","W01001662",2001,612,370,242,48
"33698","W01001633",2001,613,325,288,15
"33699","W01001634",2001,625,154,471,24
"33700","W01001688",2001,616,228,388,34
"33701","W01001689",2001,802,663,139,3
"33702","W01001656",2001,537,27,510,28
"33703","W01001657",2001,516,10,506,19
"33704","W01001658",2001,540,76,464,15
"33705","W01001636",2001,491,4,487,26
"33706","W01000558",2001,847,63,784,111
"33707","W01000559",2001,557,21,536,73
"33708","W01000560",2001,475,71,404,47
"33709","W01000561",2001,437,14,423,51
"33710","W01000613",2001,945,67,878,122
"33711","W01000597",2001,555,67,488,56
"33712","W01000562",2001,650,50,600,73
"33713","W01000565",2001,796,120,676,56
"33714","W01000566",2001,670,116,554,63
"33715","W01000567",2001,803,100,703,109
"33716","W01000617",2001,516,80,436,43
"33717","W01000618",2001,569,124,445,54
"33718","W01000612",2001,809,111,698,75
"33719","W01000579",2001,844,119,725,54
"33720","W01000581",2001,611,85,526,58
"33721","W01000582",2001,632,22,610,70
"33722","W01000583",2001,512,60,452,68
"33723","W01000611",2001,692,19,673,59
"33724","W01000623",2001,648,54,594,62
"33725","W01000568",2001,1018,294,724,228
"33726","W01000569",2001,505,107,398,135
"33727","W01000570",2001,588,332,256,94
"33728","W01000572",2001,748,110,638,83
"33729","W01000573",2001,941,99,842,133
"33730","W01000571",2001,973,185,788,81
"33731","W01000586",2001,837,243,594,54
"33732","W01000595",2001,893,167,726,154
"33733","W01000596",2001,519,28,491,50
"33734","W01000585",2001,501,27,474,94
"33735","W01000577",2001,564,30,534,44
"33736","W01000575",2001,854,183,671,67
"33737","W01000555",2001,482,24,458,43
"33738","W01000556",2001,465,46,419,49
"33739","W01000614",2001,579,101,478,66
"33740","W01000622",2001,544,45,499,63
"33741","W01000598",2001,929,208,721,88
"33742","W01000599",2001,833,191,642,69
"33743","W01000554",2001,597,57,540,32
"33744","W01000580",2001,803,90,713,46
"33745","W01000593",2001,910,221,689,58
"33746","W01000587",2001,860,147,713,123
"33747","W01000588",2001,889,353,536,46
"33748","W01000615",2001,652,40,612,41
"33749","W01000616",2001,584,72,512,153
"33750","W01000576",2001,877,95,782,60
"33751","W01000563",2001,415,13,402,76
"33752","W01000564",2001,519,39,480,49
"33753","W01000553",2001,512,33,479,48
"33754","W01000589",2001,513,135,378,67
"33755","W01000590",2001,534,159,375,22
"33756","W01000591",2001,420,83,337,35
"33757","W01000592",2001,501,258,243,19
"33758","W01000594",2001,945,336,609,119
"33759","W01000600",2001,735,149,586,162
"33760","W01000601",2001,587,332,255,33
"33761","W01000602",2001,479,35,444,82
"33762","W01000603",2001,696,78,618,110
"33763","W01000604",2001,595,176,419,55
"33764","W01000605",2001,605,75,530,48
"33765","W01000609",2001,952,100,852,36
"33766","W01000557",2001,547,41,506,54
"33767","W01000578",2001,663,53,610,58
"33768","W01000584",2001,761,123,638,68
"33769","W01000574",2001,684,93,591,81
"33770","W01000606",2001,662,342,320,42
"33771","W01000607",2001,764,327,437,47
"33772","W01000608",2001,625,102,523,122
"33773","W01000610",2001,655,49,606,65
"33774","W01000619",2001,988,158,830,122
"33775","W01000620",2001,595,97,498,189
"33776","W01000621",2001,723,151,572,117
"33777","W01000461",2001,609,102,507,96
"33778","W01000468",2001,593,36,557,100
"33779","W01000469",2001,731,94,637,121
"33780","W01000470",2001,751,83,668,130
"33781","W01000475",2001,916,44,872,140
"33782","W01000457",2001,702,74,628,56
"33783","W01000458",2001,677,56,621,79
"33784","W01000444",2001,904,45,859,110
"33785","W01000498",2001,699,293,406,133
"33786","W01000499",2001,507,126,381,70
"33787","W01000500",2001,568,69,499,47
"33788","W01000501",2001,990,166,824,132
"33789","W01000473",2001,991,297,694,113
"33790","W01000442",2001,815,61,754,115
"33791","W01000452",2001,779,74,705,86
"33792","W01000441",2001,545,42,503,72
"33793","W01000428",2001,547,38,509,116
"33794","W01000476",2001,564,88,476,92
"33795","W01000497",2001,456,37,419,56
"33796","W01000488",2001,716,35,681,92
"33797","W01000433",2001,928,134,794,81
"33798","W01000460",2001,650,65,585,78
"33799","W01000434",2001,638,88,550,71
"33800","W01000439",2001,645,40,605,83
"33801","W01000447",2001,762,70,692,68
"33802","W01000480",2001,895,361,534,115
"33803","W01000481",2001,921,141,780,55
"33804","W01000482",2001,770,61,709,108
"33805","W01000483",2001,791,426,365,34
"33806","W01000478",2001,700,338,362,40
"33807","W01000479",2001,615,269,346,23
"33808","W01000466",2001,601,177,424,28
"33809","W01000467",2001,728,104,624,133
"33810","W01000453",2001,555,24,531,95
"33811","W01000429",2001,859,18,841,114
"33812","W01000427",2001,564,68,496,58
"33813","W01000464",2001,495,17,478,58
"33814","W01000448",2001,603,125,478,33
"33815","W01000449",2001,724,94,630,142
"33816","W01000484",2001,681,20,661,112
"33817","W01000485",2001,665,31,634,81
"33818","W01000486",2001,480,148,332,63
"33819","W01000487",2001,937,181,756,160
"33820","W01000477",2001,592,12,580,64
"33821","W01000472",2001,465,41,424,80
"33822","W01000438",2001,526,79,447,45
"33823","W01000451",2001,427,36,391,51
"33824","W01000454",2001,619,155,464,212
"33825","W01000455",2001,785,217,568,49
"33826","W01000456",2001,993,83,910,224
"33827","W01000459",2001,475,39,436,50
"33828","W01000471",2001,750,82,668,114
"33829","W01000450",2001,577,17,560,77
"33830","W01000431",2001,497,99,398,92
"33831","W01000432",2001,508,39,469,45
"33832","W01000430",2001,498,39,459,86
"33833","W01000443",2001,861,48,813,107
"33834","W01000445",2001,586,85,501,60
"33835","W01000446",2001,728,168,560,119
"33836","W01000494",2001,683,123,560,63
"33837","W01000495",2001,791,71,720,112
"33838","W01000503",2001,420,11,409,86
"33839","W01000474",2001,781,62,719,113
"33840","W01000440",2001,483,13,470,80
"33841","W01000489",2001,698,176,522,68
"33842","W01000490",2001,790,72,718,55
"33843","W01000491",2001,627,399,228,11
"33844","W01000492",2001,726,91,635,205
"33845","W01000493",2001,557,55,502,106
"33846","W01000435",2001,679,44,635,76
"33847","W01000436",2001,538,105,433,77
"33848","W01000465",2001,409,34,375,41
"33849","W01000462",2001,418,36,382,41
"33850","W01000463",2001,788,58,730,101
"33851","W01000437",2001,772,142,630,59
"33852","W01000426",2001,610,87,523,31
"33853","W01000496",2001,871,129,742,43
"33854","W01000504",2001,516,229,287,15
"33855","W01000505",2001,604,94,510,50
"33856","W01000502",2001,958,134,824,57
"33857","W01001186",2001,549,96,453,26
"33858","W01001187",2001,519,31,488,26
"33859","W01001188",2001,616,222,394,34
"33860","W01001221",2001,624,238,386,31
"33861","W01001222",2001,657,363,294,19
"33862","W01001233",2001,679,117,562,12
"33863","W01001148",2001,747,22,725,116
"33864","W01001155",2001,650,19,631,89
"33865","W01001152",2001,679,100,579,22
"33866","W01001153",2001,654,135,519,57
"33867","W01001154",2001,694,178,516,25
"33868","W01001156",2001,510,3,507,12
"33869","W01001149",2001,622,111,511,19
"33870","W01001150",2001,769,42,727,150
"33871","W01001151",2001,639,32,607,23
"33872","W01001168",2001,629,90,539,36
"33873","W01001169",2001,639,306,333,14
"33874","W01001170",2001,499,7,492,21
"33875","W01001147",2001,724,121,603,37
"33876","W01001137",2001,983,118,865,115
"33877","W01001138",2001,625,176,449,39
"33878","W01001139",2001,597,23,574,55
"33879","W01001140",2001,601,71,530,55
"33880","W01001141",2001,638,146,492,61
"33881","W01001142",2001,668,95,573,60
"33882","W01001204",2001,540,19,521,60
"33883","W01001205",2001,650,125,525,45
"33884","W01001206",2001,612,100,512,41
"33885","W01001207",2001,524,208,316,22
"33886","W01001208",2001,714,52,662,72
"33887","W01001265",2001,655,52,603,65
"33888","W01001266",2001,627,179,448,52
"33889","W01001267",2001,633,112,521,48
"33890","W01001268",2001,631,37,594,67
"33891","W01001209",2001,608,250,358,48
"33892","W01001210",2001,635,73,562,64
"33893","W01001211",2001,620,65,555,59
"33894","W01001212",2001,604,105,499,56
"33895","W01001202",2001,861,157,704,75
"33896","W01001203",2001,591,252,339,32
"33897","W01001175",2001,596,50,546,36
"33898","W01001177",2001,625,26,599,67
"33899","W01001269",2001,626,10,616,48
"33900","W01001270",2001,629,30,599,64
"33901","W01001271",2001,712,52,660,79
"33902","W01001272",2001,632,108,524,28
"33903","W01001273",2001,782,48,734,45
"33904","W01001213",2001,634,60,574,50
"33905","W01001214",2001,532,27,505,21
"33906","W01001215",2001,507,79,428,80
"33907","W01001216",2001,632,29,603,66
"33908","W01001143",2001,604,21,583,67
"33909","W01001144",2001,657,184,473,52
"33910","W01001145",2001,707,137,570,54
"33911","W01001146",2001,620,47,573,52
"33912","W01001176",2001,619,25,594,53
"33913","W01001274",2001,613,259,354,43
"33914","W01001275",2001,740,48,692,104
"33915","W01001276",2001,638,68,570,98
"33916","W01001260",2001,464,88,376,41
"33917","W01001285",2001,617,48,569,54
"33918","W01001286",2001,652,22,630,64
"33919","W01001287",2001,629,78,551,46
"33920","W01001288",2001,623,165,458,48
"33921","W01001200",2001,415,19,396,32
"33922","W01001201",2001,510,125,385,27
"33923","W01001180",2001,636,270,366,23
"33924","W01001181",2001,599,173,426,13
"33925","W01001282",2001,849,124,725,75
"33926","W01001283",2001,630,105,525,23
"33927","W01001284",2001,424,3,421,11
"33928","W01001247",2001,738,71,667,55
"33929","W01001248",2001,713,20,693,71
"33930","W01001166",2001,611,37,574,84
"33931","W01001167",2001,625,17,608,63
"33932","W01001171",2001,610,34,576,53
"33933","W01001229",2001,604,12,592,53
"33934","W01001230",2001,591,11,580,21
"33935","W01001231",2001,659,59,600,69
"33936","W01001280",2001,716,172,544,101
"33937","W01001281",2001,760,11,749,52
"33938","W01001261",2001,491,13,478,59
"33939","W01001259",2001,650,65,585,28
"33940","W01001217",2001,483,126,357,24
"33941","W01001218",2001,657,19,638,58
"33942","W01001219",2001,636,179,457,45
"33943","W01001220",2001,620,47,573,45
"33944","W01001256",2001,530,12,518,40
"33945","W01001257",2001,517,33,484,19
"33946","W01001258",2001,632,52,580,66
"33947","W01001164",2001,639,24,615,63
"33948","W01001165",2001,533,66,467,30
"33949","W01001172",2001,625,47,578,65
"33950","W01001173",2001,623,183,440,28
"33951","W01001174",2001,618,205,413,47
"33952","W01001232",2001,594,123,471,39
"33953","W01001227",2001,533,17,516,20
"33954","W01001228",2001,642,42,600,52
"33955","W01001234",2001,613,15,598,35
"33956","W01001235",2001,723,78,645,71
"33957","W01001236",2001,605,20,585,25
"33958","W01001182",2001,587,33,554,73
"33959","W01001183",2001,480,112,368,115
"33960","W01001185",2001,729,235,494,27
"33961","W01001237",2001,630,240,390,11
"33962","W01001238",2001,653,370,283,28
"33963","W01001262",2001,510,43,467,143
"33964","W01001263",2001,513,13,500,192
"33965","W01001264",2001,504,16,488,197
"33966","W01001253",2001,550,66,484,35
"33967","W01001254",2001,843,68,775,31
"33968","W01001255",2001,590,255,335,17
"33969","W01001178",2001,628,90,538,50
"33970","W01001179",2001,729,268,461,16
"33971","W01001249",2001,634,92,542,43
"33972","W01001250",2001,539,33,506,21
"33973","W01001251",2001,601,273,328,25
"33974","W01001252",2001,532,21,511,17
"33975","W01001244",2001,618,15,603,15
"33976","W01001245",2001,515,3,512,7
"33977","W01001246",2001,622,76,546,20
"33978","W01001162",2001,729,238,491,33
"33979","W01001239",2001,645,327,318,25
"33980","W01001240",2001,829,67,762,31
"33981","W01001241",2001,643,141,502,34
"33982","W01001184",2001,853,58,795,59
"33983","W01001196",2001,619,14,605,38
"33984","W01001197",2001,482,6,476,12
"33985","W01001198",2001,666,6,660,31
"33986","W01001199",2001,609,15,594,14
"33987","W01001163",2001,604,8,596,17
"33988","W01001157",2001,602,13,589,40
"33989","W01001158",2001,612,74,538,50
"33990","W01001159",2001,527,16,511,39
"33991","W01001277",2001,471,28,443,9
"33992","W01001278",2001,466,68,398,37
"33993","W01001279",2001,526,192,334,18
"33994","W01001160",2001,662,6,656,24
"33995","W01001161",2001,755,177,578,34
"33996","W01001189",2001,606,144,462,37
"33997","W01001190",2001,759,82,677,56
"33998","W01001193",2001,484,25,459,12
"33999","W01001194",2001,610,4,606,21
"34000","W01001195",2001,608,128,480,37
"34001","W01001242",2001,498,43,455,3
"34002","W01001243",2001,604,210,394,32
"34003","W01001223",2001,558,3,555,37
"34004","W01001224",2001,572,3,569,15
"34005","W01001225",2001,612,9,603,30
"34006","W01001226",2001,636,161,475,48
"34007","W01001191",2001,659,56,603,32
"34008","W01001192",2001,552,278,274,10
"34009","W01000845",2001,595,43,552,40
"34010","W01000846",2001,628,99,529,80
"34011","W01000847",2001,488,60,428,18
"34012","W01000848",2001,506,221,285,15
"34013","W01000803",2001,732,98,634,38
"34014","W01000750",2001,681,202,479,62
"34015","W01000751",2001,583,21,562,27
"34016","W01000752",2001,626,205,421,32
"34017","W01000753",2001,589,147,442,29
"34018","W01000754",2001,636,52,584,72
"34019","W01000806",2001,620,77,543,20
"34020","W01000807",2001,552,16,536,23
"34021","W01000808",2001,620,56,564,13
"34022","W01000810",2001,646,396,250,13
"34023","W01000815",2001,637,20,617,36
"34024","W01000816",2001,616,23,593,62
"34025","W01000791",2001,602,31,571,25
"34026","W01000792",2001,611,10,601,30
"34027","W01000793",2001,612,6,606,51
"34028","W01000837",2001,472,3,469,16
"34029","W01000838",2001,517,204,313,14
"34030","W01000841",2001,640,141,499,19
"34031","W01000842",2001,571,35,536,19
"34032","W01000843",2001,515,36,479,24
"34033","W01000844",2001,488,203,285,26
"34034","W01000773",2001,773,232,541,56
"34035","W01000774",2001,662,83,579,42
"34036","W01000800",2001,512,7,505,24
"34037","W01000801",2001,620,274,346,43
"34038","W01000795",2001,638,25,613,29
"34039","W01000796",2001,530,60,470,20
"34040","W01000802",2001,910,283,627,33
"34041","W01000784",2001,579,73,506,36
"34042","W01000785",2001,498,3,495,11
"34043","W01000786",2001,568,10,558,23
"34044","W01000877",2001,629,6,623,26
"34045","W01000878",2001,517,73,444,28
"34046","W01000811",2001,634,193,441,51
"34047","W01000812",2001,630,153,477,92
"34048","W01000813",2001,658,5,653,55
"34049","W01000814",2001,625,151,474,47
"34050","W01000809",2001,652,72,580,59
"34051","W01000817",2001,742,455,287,39
"34052","W01000818",2001,651,245,406,20
"34053","W01000819",2001,615,14,601,26
"34054","W01000820",2001,586,75,511,41
"34055","W01000821",2001,648,129,519,33
"34056","W01000822",2001,590,69,521,12
"34057","W01000794",2001,618,48,570,39
"34058","W01000797",2001,633,57,576,26
"34059","W01000798",2001,633,67,566,29
"34060","W01000799",2001,652,288,364,38
"34061","W01000830",2001,624,485,139,24
"34062","W01000832",2001,742,485,257,20
"34063","W01000833",2001,722,440,282,16
"34064","W01000834",2001,602,309,293,21
"34065","W01000836",2001,611,336,275,30
"34066","W01000777",2001,619,30,589,22
"34067","W01000778",2001,766,16,750,77
"34068","W01000779",2001,567,143,424,18
"34069","W01000759",2001,637,13,624,27
"34070","W01000760",2001,661,114,547,61
"34071","W01000761",2001,614,76,538,53
"34072","W01000762",2001,613,289,324,23
"34073","W01000835",2001,616,260,356,16
"34074","W01000831",2001,791,390,401,45
"34075","W01000738",2001,681,349,332,22
"34076","W01000739",2001,621,220,401,44
"34077","W01000740",2001,605,18,587,20
"34078","W01000741",2001,686,244,442,24
"34079","W01000763",2001,628,20,608,56
"34080","W01000764",2001,693,40,653,78
"34081","W01000765",2001,712,53,659,85
"34082","W01000766",2001,629,12,617,39
"34083","W01000767",2001,715,245,470,32
"34084","W01000744",2001,734,165,569,115
"34085","W01000742",2001,746,400,346,68
"34086","W01000787",2001,632,44,588,66
"34087","W01000788",2001,611,51,560,90
"34088","W01000789",2001,638,96,542,74
"34089","W01000790",2001,713,87,626,106
"34090","W01000755",2001,703,122,581,50
"34091","W01000756",2001,741,329,412,27
"34092","W01000757",2001,719,123,596,13
"34093","W01000758",2001,634,77,557,25
"34094","W01000772",2001,568,83,485,16
"34095","W01000828",2001,710,14,696,31
"34096","W01000829",2001,799,105,694,45
"34097","W01000862",2001,630,430,200,27
"34098","W01000863",2001,697,416,281,27
"34099","W01000864",2001,627,387,240,22
"34100","W01000865",2001,622,236,386,33
"34101","W01000866",2001,526,247,279,31
"34102","W01000867",2001,581,375,206,15
"34103","W01000768",2001,619,109,510,32
"34104","W01000769",2001,586,16,570,21
"34105","W01000770",2001,647,11,636,30
"34106","W01000771",2001,513,46,467,18
"34107","W01000849",2001,700,157,543,76
"34108","W01000850",2001,757,120,637,105
"34109","W01000851",2001,624,95,529,57
"34110","W01000852",2001,614,42,572,48
"34111","W01000853",2001,613,28,585,32
"34112","W01000854",2001,535,12,523,27
"34113","W01000855",2001,613,35,578,24
"34114","W01000856",2001,896,510,386,31
"34115","W01000857",2001,885,319,566,49
"34116","W01000780",2001,472,25,447,205
"34117","W01000781",2001,731,6,725,26
"34118","W01000782",2001,534,13,521,16
"34119","W01000783",2001,524,53,471,37
"34120","W01000747",2001,697,95,602,249
"34121","W01000868",2001,492,12,480,24
"34122","W01000869",2001,681,131,550,160
"34123","W01000870",2001,612,62,550,186
"34124","W01000872",2001,625,19,606,45
"34125","W01000874",2001,630,12,618,222
"34126","W01000748",2001,855,177,678,219
"34127","W01000745",2001,721,103,618,243
"34128","W01000746",2001,688,85,603,170
"34129","W01000743",2001,1065,769,296,87
"34130","W01000749",2001,683,103,580,120
"34131","W01000875",2001,655,75,580,272
"34132","W01000876",2001,595,44,551,208
"34133","W01000873",2001,500,62,438,214
"34134","W01000871",2001,632,128,504,194
"34135","W01000858",2001,612,25,587,73
"34136","W01000859",2001,680,51,629,21
"34137","W01000860",2001,639,7,632,21
"34138","W01000861",2001,406,21,385,106
"34139","W01000804",2001,672,32,640,34
"34140","W01000805",2001,476,3,473,12
"34141","W01000736",2001,758,3,755,30
"34142","W01000737",2001,654,20,634,61
"34143","W01000879",2001,718,3,715,24
"34144","W01000880",2001,717,32,685,36
"34145","W01000881",2001,736,295,441,47
"34146","W01000882",2001,846,293,553,29
"34147","W01000839",2001,453,6,447,31
"34148","W01000840",2001,699,5,694,44
"34149","W01000775",2001,718,42,676,60
"34150","W01000776",2001,725,26,699,43
"34151","W01000823",2001,627,3,624,23
"34152","W01000824",2001,783,37,746,75
"34153","W01000825",2001,711,7,704,130
"34154","W01000826",2001,609,5,604,50
"34155","W01000827",2001,625,7,618,94
"34156","W01001487",2001,641,200,441,46
"34157","W01001488",2001,649,319,330,26
"34158","W01001489",2001,659,184,475,33
"34159","W01001490",2001,598,29,569,45
"34160","W01001482",2001,495,190,305,23
"34161","W01001483",2001,523,223,300,26
"34162","W01001484",2001,617,71,546,15
"34163","W01001485",2001,506,215,291,15
"34164","W01001486",2001,620,121,499,37
"34165","W01001525",2001,617,219,398,24
"34166","W01001529",2001,860,253,607,48
"34167","W01001530",2001,721,457,264,21
"34168","W01001531",2001,716,221,495,25
"34169","W01001540",2001,530,42,488,26
"34170","W01001541",2001,431,92,339,27
"34171","W01001523",2001,644,87,557,33
"34172","W01001524",2001,750,151,599,73
"34173","W01001491",2001,829,254,575,43
"34174","W01001496",2001,533,154,379,28
"34175","W01001510",2001,673,154,519,31
"34176","W01001511",2001,730,177,553,19
"34177","W01001512",2001,613,7,606,14
"34178","W01001513",2001,639,16,623,15
"34179","W01001514",2001,503,20,483,21
"34180","W01001515",2001,609,60,549,58
"34181","W01001516",2001,628,253,375,10
"34182","W01001517",2001,623,84,539,33
"34183","W01001518",2001,483,38,445,4
"34184","W01001519",2001,650,361,289,23
"34185","W01001520",2001,632,121,511,10
"34186","W01001521",2001,627,132,495,25
"34187","W01001522",2001,746,322,424,24
"34188","W01001537",2001,511,51,460,21
"34189","W01001507",2001,914,157,757,25
"34190","W01001493",2001,847,249,598,26
"34191","W01001494",2001,681,77,604,8
"34192","W01001495",2001,805,124,681,15
"34193","W01001501",2001,536,256,280,26
"34194","W01001503",2001,514,227,287,19
"34195","W01001538",2001,602,302,300,11
"34196","W01001539",2001,626,224,402,13
"34197","W01001536",2001,502,289,213,22
"34198","W01001506",2001,700,265,435,54
"34199","W01001532",2001,767,345,422,18
"34200","W01001526",2001,602,296,306,17
"34201","W01001527",2001,626,247,379,28
"34202","W01001528",2001,474,129,345,7
"34203","W01001502",2001,480,51,429,15
"34204","W01001497",2001,621,222,399,16
"34205","W01001498",2001,509,194,315,6
"34206","W01001499",2001,524,112,412,17
"34207","W01001500",2001,498,8,490,14
"34208","W01001492",2001,899,218,681,6
"34209","W01001533",2001,571,21,550,17
"34210","W01001534",2001,665,148,517,19
"34211","W01001535",2001,576,124,452,30
"34212","W01001508",2001,503,37,466,9
"34213","W01001509",2001,559,23,536,8
"34214","W01001504",2001,743,228,515,18
"34215","W01001505",2001,617,66,551,21
"34216","W01001105",2001,972,39,933,48
"34217","W01001127",2001,498,0,498,35
"34218","W01001128",2001,564,24,540,32
"34219","W01001082",2001,735,69,666,96
"34220","W01001083",2001,636,13,623,32
"34221","W01001084",2001,702,38,664,41
"34222","W01001085",2001,559,9,550,29
"34223","W01001119",2001,505,12,493,40
"34224","W01001113",2001,843,33,810,62
"34225","W01001135",2001,570,26,544,41
"34226","W01001136",2001,573,6,567,28
"34227","W01001104",2001,831,59,772,49
"34228","W01001129",2001,512,126,386,11
"34229","W01001075",2001,493,28,465,30
"34230","W01001076",2001,606,75,531,64
"34231","W01001077",2001,623,151,472,19
"34232","W01001078",2001,503,48,455,12
"34233","W01001130",2001,503,9,494,94
"34234","W01001123",2001,774,43,731,135
"34235","W01001124",2001,598,21,577,109
"34236","W01001125",2001,600,25,575,65
"34237","W01001126",2001,791,81,710,162
"34238","W01001116",2001,760,6,754,111
"34239","W01001086",2001,610,6,604,44
"34240","W01001087",2001,634,14,620,19
"34241","W01001088",2001,788,308,480,17
"34242","W01001089",2001,601,14,587,23
"34243","W01001090",2001,595,14,581,24
"34244","W01001081",2001,626,236,390,28
"34245","W01001092",2001,613,156,457,22
"34246","W01001094",2001,480,231,249,19
"34247","W01001095",2001,597,367,230,16
"34248","W01001096",2001,625,140,485,28
"34249","W01001097",2001,574,274,300,20
"34250","W01001114",2001,645,3,642,22
"34251","W01001115",2001,639,88,551,12
"34252","W01001131",2001,647,296,351,17
"34253","W01001132",2001,577,16,561,26
"34254","W01001133",2001,729,3,726,21
"34255","W01001134",2001,470,6,464,14
"34256","W01001070",2001,457,93,364,85
"34257","W01001071",2001,623,127,496,44
"34258","W01001072",2001,496,7,489,14
"34259","W01001067",2001,626,297,329,23
"34260","W01001068",2001,648,110,538,52
"34261","W01001098",2001,463,7,456,6
"34262","W01001091",2001,716,12,704,17
"34263","W01001103",2001,521,4,517,23
"34264","W01001100",2001,602,49,553,7
"34265","W01001106",2001,584,21,563,14
"34266","W01001107",2001,712,55,657,38
"34267","W01001109",2001,609,78,531,19
"34268","W01001110",2001,505,12,493,93
"34269","W01001111",2001,591,185,406,22
"34270","W01001112",2001,588,6,582,27
"34271","W01001074",2001,961,60,901,189
"34272","W01001069",2001,637,116,521,92
"34273","W01001065",2001,614,65,549,53
"34274","W01001063",2001,632,9,623,82
"34275","W01001079",2001,647,34,613,102
"34276","W01001080",2001,645,100,545,61
"34277","W01001064",2001,617,293,324,28
"34278","W01001062",2001,507,11,496,59
"34279","W01001093",2001,766,267,499,33
"34280","W01001099",2001,588,228,360,13
"34281","W01001101",2001,670,27,643,146
"34282","W01001102",2001,647,11,636,69
"34283","W01001108",2001,574,53,521,171
"34284","W01001117",2001,597,42,555,25
"34285","W01001118",2001,580,114,466,27
"34286","W01001120",2001,577,6,571,26
"34287","W01001121",2001,626,122,504,35
"34288","W01001122",2001,751,23,728,171
"34289","W01001066",2001,621,109,512,44
"34290","W01001073",2001,663,302,361,56
"34291","W01001059",2001,607,45,562,44
"34292","W01001060",2001,624,9,615,9
"34293","W01001061",2001,644,91,553,100
"34294","W01000383",2001,618,64,554,74
"34295","W01000384",2001,517,49,468,60
"34296","W01000390",2001,664,67,597,44
"34297","W01000417",2001,624,15,609,28
"34298","W01000418",2001,694,156,538,48
"34299","W01000396",2001,512,8,504,15
"34300","W01000397",2001,404,3,401,11
"34301","W01000369",2001,604,96,508,25
"34302","W01000370",2001,642,18,624,60
"34303","W01000391",2001,604,110,494,18
"34304","W01000392",2001,693,454,239,9
"34305","W01000374",2001,596,231,365,18
"34306","W01000375",2001,595,147,448,45
"34307","W01000376",2001,563,43,520,11
"34308","W01000377",2001,547,73,474,33
"34309","W01000378",2001,461,227,234,20
"34310","W01000379",2001,703,353,350,21
"34311","W01000380",2001,489,6,483,20
"34312","W01000351",2001,778,159,619,35
"34313","W01000400",2001,668,183,485,45
"34314","W01000401",2001,747,203,544,45
"34315","W01000373",2001,716,354,362,29
"34316","W01000347",2001,511,58,453,22
"34317","W01000348",2001,561,319,242,10
"34318","W01000362",2001,609,340,269,18
"34319","W01000363",2001,677,141,536,22
"34320","W01000364",2001,614,41,573,60
"34321","W01000343",2001,469,3,466,8
"34322","W01000344",2001,591,5,586,7
"34323","W01000415",2001,689,95,594,25
"34324","W01000416",2001,512,3,509,17
"34325","W01000422",2001,953,158,795,51
"34326","W01000387",2001,500,13,487,16
"34327","W01000388",2001,475,84,391,8
"34328","W01000368",2001,920,14,906,39
"34329","W01000371",2001,479,29,450,101
"34330","W01000372",2001,470,131,339,74
"34331","W01000393",2001,818,215,603,24
"34332","W01000341",2001,623,193,430,15
"34333","W01000342",2001,729,319,410,31
"34334","W01000352",2001,401,137,264,16
"34335","W01000353",2001,500,359,141,11
"34336","W01000413",2001,524,438,86,16
"34337","W01000414",2001,506,354,152,13
"34338","W01000425",2001,874,642,232,30
"34339","W01000402",2001,964,91,873,235
"34340","W01000349",2001,661,212,449,30
"34341","W01000350",2001,801,200,601,272
"34342","W01000365",2001,766,84,682,64
"34343","W01000381",2001,510,156,354,32
"34344","W01000382",2001,595,395,200,48
"34345","W01000421",2001,1058,385,673,172
"34346","W01000423",2001,607,288,319,23
"34347","W01000424",2001,552,97,455,44
"34348","W01000406",2001,883,349,534,33
"34349","W01000408",2001,504,142,362,18
"34350","W01000398",2001,532,85,447,32
"34351","W01000399",2001,441,18,423,16
"34352","W01000385",2001,749,33,716,22
"34353","W01000366",2001,596,244,352,13
"34354","W01000367",2001,521,31,490,23
"34355","W01000410",2001,647,48,599,48
"34356","W01000411",2001,747,352,395,44
"34357","W01000412",2001,634,74,560,62
"34358","W01000405",2001,897,359,538,46
"34359","W01000386",2001,612,255,357,29
"34360","W01000394",2001,502,22,480,92
"34361","W01000395",2001,473,78,395,39
"34362","W01000407",2001,496,19,477,62
"34363","W01000419",2001,490,279,211,13
"34364","W01000420",2001,581,124,457,73
"34365","W01000409",2001,761,626,135,20
"34366","W01000389",2001,842,171,671,59
"34367","W01000354",2001,611,78,533,24
"34368","W01000355",2001,752,317,435,57
"34369","W01000356",2001,637,331,306,27
"34370","W01000345",2001,654,34,620,66
"34371","W01000346",2001,625,47,578,80
"34372","W01000403",2001,539,45,494,96
"34373","W01000404",2001,754,109,645,96
"34374","W01000357",2001,509,35,474,65
"34375","W01000358",2001,443,83,360,65
"34376","W01000359",2001,498,66,432,28
"34377","W01000360",2001,537,212,325,15
"34378","W01000361",2001,795,260,535,57
"34379","E01000001",2011,876,41,835,264
"34380","E01000002",2011,830,48,782,219
"34381","E01000003",2011,817,295,522,177
"34382","E01000005",2011,467,312,155,101
"34383","E01000006",2011,543,18,525,178
"34384","E01000007",2011,612,249,363,222
"34385","E01000008",2011,521,347,174,79
"34386","E01000009",2011,638,131,507,243
"34387","E01000010",2011,1103,288,815,543
"34388","E01000011",2011,457,35,422,173
"34389","E01000012",2011,698,154,544,328
"34390","E01000013",2011,650,254,396,99
"34391","E01000014",2011,638,240,398,96
"34392","E01000015",2011,836,269,567,206
"34393","E01000016",2011,626,226,400,89
"34394","E01000017",2011,609,239,370,73
"34395","E01000018",2011,612,234,378,67
"34396","E01000019",2011,504,126,378,91
"34397","E01000020",2011,650,207,443,94
"34398","E01000021",2011,593,163,430,167
"34399","E01000022",2011,474,123,351,73
"34400","E01000023",2011,500,136,364,129
"34401","E01000024",2011,456,131,325,75
"34402","E01000025",2011,629,227,402,83
"34403","E01000027",2011,641,291,350,51
"34404","E01000028",2011,612,320,292,82
"34405","E01000029",2011,690,55,635,64
"34406","E01000030",2011,770,467,303,72
"34407","E01000031",2011,598,32,566,86
"34408","E01000032",2011,631,97,534,132
"34409","E01000033",2011,533,277,256,31
"34410","E01000034",2011,517,206,311,52
"34411","E01000035",2011,567,109,458,95
"34412","E01000036",2011,469,19,450,82
"34413","E01000037",2011,579,15,564,39
"34414","E01000038",2011,563,76,487,50
"34415","E01000039",2011,659,74,585,87
"34416","E01000040",2011,640,317,323,95
"34417","E01000041",2011,607,220,387,78
"34418","E01000042",2011,679,370,309,116
"34419","E01000043",2011,461,155,306,63
"34420","E01000044",2011,629,72,557,173
"34421","E01000045",2011,602,234,368,122
"34422","E01000046",2011,654,230,424,90
"34423","E01000048",2011,644,525,119,68
"34424","E01000049",2011,643,429,214,62
"34425","E01000050",2011,615,239,376,121
"34426","E01000051",2011,725,552,173,61
"34427","E01000052",2011,769,210,559,166
"34428","E01000053",2011,645,239,406,161
"34429","E01000054",2011,638,236,402,84
"34430","E01000055",2011,560,190,370,73
"34431","E01000056",2011,573,242,331,90
"34432","E01000057",2011,537,215,322,72
"34433","E01000058",2011,690,230,460,115
"34434","E01000059",2011,578,224,354,71
"34435","E01000060",2011,770,355,415,70
"34436","E01000061",2011,668,567,101,25
"34437","E01000062",2011,761,255,506,90
"34438","E01000063",2011,635,212,423,68
"34439","E01000064",2011,709,209,500,117
"34440","E01000065",2011,774,357,417,118
"34441","E01000066",2011,683,191,492,77
"34442","E01000067",2011,679,129,550,85
"34443","E01000068",2011,462,11,451,93
"34444","E01000069",2011,513,6,507,58
"34445","E01000070",2011,598,36,562,87
"34446","E01000071",2011,785,113,672,169
"34447","E01000072",2011,784,351,433,159
"34448","E01000073",2011,627,195,432,102
"34449","E01000074",2011,629,266,363,91
"34450","E01000075",2011,622,201,421,67
"34451","E01000076",2011,710,304,406,103
"34452","E01000077",2011,560,202,358,92
"34453","E01000078",2011,649,256,393,94
"34454","E01000079",2011,609,227,382,82
"34455","E01000080",2011,594,213,381,88
"34456","E01000081",2011,648,199,449,92
"34457","E01000082",2011,672,267,405,85
"34458","E01000083",2011,629,222,407,94
"34459","E01000084",2011,517,214,303,86
"34460","E01000085",2011,640,286,354,115
"34461","E01000086",2011,508,195,313,60
"34462","E01000087",2011,503,164,339,100
"34463","E01000088",2011,640,74,566,173
"34464","E01000089",2011,612,48,564,137
"34465","E01000090",2011,549,40,509,146
"34466","E01000091",2011,633,350,283,93
"34467","E01000092",2011,975,339,636,188
"34468","E01000093",2011,642,370,272,96
"34469","E01000094",2011,517,128,389,140
"34470","E01000095",2011,549,147,402,110
"34471","E01000096",2011,639,423,216,67
"34472","E01000097",2011,708,321,387,97
"34473","E01000098",2011,625,221,404,126
"34474","E01000099",2011,666,221,445,91
"34475","E01000100",2011,615,207,408,75
"34476","E01000101",2011,567,204,363,67
"34477","E01000102",2011,625,248,377,70
"34478","E01000103",2011,600,217,383,109
"34479","E01000104",2011,739,425,314,82
"34480","E01000105",2011,915,531,384,106
"34481","E01000106",2011,916,431,485,208
"34482","E01000107",2011,601,88,513,84
"34483","E01000108",2011,652,73,579,179
"34484","E01000109",2011,608,93,515,102
"34485","E01000110",2011,501,13,488,72
"34486","E01000111",2011,732,220,512,124
"34487","E01000112",2011,739,56,683,227
"34488","E01000113",2011,633,28,605,189
"34489","E01000114",2011,758,77,681,170
"34490","E01000115",2011,485,6,479,33
"34491","E01000116",2011,623,41,582,70
"34492","E01000117",2011,762,7,755,118
"34493","E01000118",2011,709,19,690,84
"34494","E01000119",2011,607,24,583,64
"34495","E01000120",2011,505,2,503,50
"34496","E01000121",2011,501,240,261,35
"34497","E01000122",2011,522,8,514,63
"34498","E01000123",2011,685,27,658,122
"34499","E01000124",2011,660,173,487,161
"34500","E01000125",2011,1015,316,699,301
"34501","E01000126",2011,726,334,392,150
"34502","E01000127",2011,514,222,292,76
"34503","E01000128",2011,624,187,437,101
"34504","E01000129",2011,624,263,361,176
"34505","E01000130",2011,570,202,368,91
"34506","E01000131",2011,634,78,556,199
"34507","E01000132",2011,495,208,287,83
"34508","E01000133",2011,565,270,295,69
"34509","E01000134",2011,625,191,434,165
"34510","E01000135",2011,541,10,531,161
"34511","E01000136",2011,563,3,560,154
"34512","E01000137",2011,669,284,385,140
"34513","E01000138",2011,523,36,487,164
"34514","E01000139",2011,560,26,534,167
"34515","E01000140",2011,683,71,612,312
"34516","E01000141",2011,864,152,712,445
"34517","E01000142",2011,950,52,898,471
"34518","E01000143",2011,538,241,297,124
"34519","E01000144",2011,607,12,595,349
"34520","E01000145",2011,444,3,441,154
"34521","E01000146",2011,744,68,676,409
"34522","E01000147",2011,544,10,534,125
"34523","E01000148",2011,725,257,468,169
"34524","E01000150",2011,744,103,641,175
"34525","E01000151",2011,617,463,154,46
"34526","E01000152",2011,564,392,172,61
"34527","E01000153",2011,620,426,194,57
"34528","E01000154",2011,501,271,230,90
"34529","E01000155",2011,797,99,698,452
"34530","E01000156",2011,751,47,704,256
"34531","E01000157",2011,689,88,601,194
"34532","E01000158",2011,564,91,473,118
"34533","E01000159",2011,645,84,561,97
"34534","E01000160",2011,923,32,891,327
"34535","E01000161",2011,710,74,636,209
"34536","E01000162",2011,552,51,501,113
"34537","E01000163",2011,759,245,514,205
"34538","E01000164",2011,648,190,458,170
"34539","E01000165",2011,707,28,679,163
"34540","E01000166",2011,648,70,578,99
"34541","E01000167",2011,522,172,350,35
"34542","E01000168",2011,576,8,568,59
"34543","E01000169",2011,670,29,641,171
"34544","E01000170",2011,656,118,538,120
"34545","E01000171",2011,856,66,790,371
"34546","E01000172",2011,602,26,576,75
"34547","E01000173",2011,617,40,577,68
"34548","E01000174",2011,766,98,668,240
"34549","E01000175",2011,618,14,604,91
"34550","E01000176",2011,698,388,310,72
"34551","E01000177",2011,690,28,662,209
"34552","E01000178",2011,695,101,594,153
"34553","E01000179",2011,763,29,734,252
"34554","E01000180",2011,689,245,444,150
"34555","E01000181",2011,669,19,650,242
"34556","E01000182",2011,746,25,721,285
"34557","E01000183",2011,584,48,536,146
"34558","E01000184",2011,503,258,245,62
"34559","E01000185",2011,606,336,270,120
"34560","E01000186",2011,501,16,485,43
"34561","E01000187",2011,593,131,462,89
"34562","E01000188",2011,516,7,509,45
"34563","E01000189",2011,711,482,229,106
"34564","E01000190",2011,546,44,502,60
"34565","E01000191",2011,530,6,524,68
"34566","E01000192",2011,683,20,663,246
"34567","E01000193",2011,594,25,569,163
"34568","E01000194",2011,610,20,590,244
"34569","E01000195",2011,697,196,501,189
"34570","E01000196",2011,896,19,877,494
"34571","E01000197",2011,707,12,695,322
"34572","E01000198",2011,685,3,682,147
"34573","E01000199",2011,671,6,665,133
"34574","E01000200",2011,863,39,824,240
"34575","E01000201",2011,517,7,510,75
"34576","E01000202",2011,648,18,630,187
"34577","E01000203",2011,613,135,478,136
"34578","E01000204",2011,687,70,617,179
"34579","E01000205",2011,619,10,609,85
"34580","E01000206",2011,514,16,498,105
"34581","E01000207",2011,608,38,570,149
"34582","E01000208",2011,619,10,609,134
"34583","E01000209",2011,747,95,652,105
"34584","E01000210",2011,600,12,588,158
"34585","E01000211",2011,861,49,812,438
"34586","E01000212",2011,529,14,515,151
"34587","E01000213",2011,465,59,406,51
"34588","E01000214",2011,717,4,713,299
"34589","E01000215",2011,680,59,621,249
"34590","E01000216",2011,684,48,636,255
"34591","E01000217",2011,521,6,515,173
"34592","E01000218",2011,573,12,561,275
"34593","E01000219",2011,581,15,566,299
"34594","E01000220",2011,593,75,518,292
"34595","E01000221",2011,485,287,198,73
"34596","E01000222",2011,506,62,444,146
"34597","E01000223",2011,478,162,316,95
"34598","E01000224",2011,524,8,516,159
"34599","E01000225",2011,529,86,443,121
"34600","E01000226",2011,630,263,367,78
"34601","E01000227",2011,603,15,588,100
"34602","E01000228",2011,475,59,416,51
"34603","E01000229",2011,600,138,462,109
"34604","E01000230",2011,650,16,634,95
"34605","E01000231",2011,654,32,622,134
"34606","E01000232",2011,706,88,618,120
"34607","E01000233",2011,635,28,607,123
"34608","E01000234",2011,650,20,630,182
"34609","E01000235",2011,582,182,400,117
"34610","E01000236",2011,674,55,619,272
"34611","E01000237",2011,740,11,729,365
"34612","E01000238",2011,615,40,575,214
"34613","E01000239",2011,877,83,794,411
"34614","E01000240",2011,582,23,559,163
"34615","E01000241",2011,696,52,644,226
"34616","E01000242",2011,597,102,495,119
"34617","E01000243",2011,791,39,752,358
"34618","E01000244",2011,582,81,501,199
"34619","E01000245",2011,811,356,455,221
"34620","E01000246",2011,654,16,638,93
"34621","E01000247",2011,746,38,708,183
"34622","E01000248",2011,666,48,618,134
"34623","E01000249",2011,572,6,566,53
"34624","E01000250",2011,979,91,888,268
"34625","E01000251",2011,947,140,807,288
"34626","E01000252",2011,753,146,607,164
"34627","E01000253",2011,597,6,591,44
"34628","E01000254",2011,622,14,608,72
"34629","E01000255",2011,527,126,401,71
"34630","E01000256",2011,656,31,625,121
"34631","E01000257",2011,724,300,424,140
"34632","E01000258",2011,696,21,675,159
"34633","E01000259",2011,980,71,909,249
"34634","E01000260",2011,761,50,711,225
"34635","E01000261",2011,646,79,567,70
"34636","E01000262",2011,752,155,597,107
"34637","E01000263",2011,499,5,494,27
"34638","E01000264",2011,634,44,590,235
"34639","E01000265",2011,791,84,707,240
"34640","E01000266",2011,511,5,506,36
"34641","E01000267",2011,567,13,554,92
"34642","E01000268",2011,745,27,718,304
"34643","E01000269",2011,535,24,511,57
"34644","E01000270",2011,626,25,601,121
"34645","E01000271",2011,582,9,573,92
"34646","E01000272",2011,468,6,462,49
"34647","E01000273",2011,648,115,533,154
"34648","E01000274",2011,699,142,557,111
"34649","E01000275",2011,644,49,595,184
"34650","E01000276",2011,506,0,506,85
"34651","E01000277",2011,777,207,570,252
"34652","E01000278",2011,498,6,492,90
"34653","E01000279",2011,513,6,507,56
"34654","E01000280",2011,497,7,490,33
"34655","E01000281",2011,480,84,396,206
"34656","E01000282",2011,639,17,622,132
"34657","E01000283",2011,480,7,473,50
"34658","E01000284",2011,780,125,655,220
"34659","E01000285",2011,610,113,497,63
"34660","E01000286",2011,654,190,464,77
"34661","E01000287",2011,622,220,402,44
"34662","E01000288",2011,568,88,480,55
"34663","E01000289",2011,631,373,258,53
"34664","E01000290",2011,674,117,557,42
"34665","E01000291",2011,602,323,279,37
"34666","E01000292",2011,629,47,582,115
"34667","E01000293",2011,642,8,634,111
"34668","E01000294",2011,672,142,530,117
"34669","E01000295",2011,686,22,664,253
"34670","E01000296",2011,734,41,693,357
"34671","E01000297",2011,554,45,509,158
"34672","E01000298",2011,733,56,677,317
"34673","E01000299",2011,782,44,738,378
"34674","E01000300",2011,667,73,594,158
"34675","E01000301",2011,528,4,524,139
"34676","E01000302",2011,840,142,698,345
"34677","E01000303",2011,540,18,522,131
"34678","E01000304",2011,621,37,584,234
"34679","E01000305",2011,637,158,479,202
"34680","E01000306",2011,558,33,525,177
"34681","E01000307",2011,530,109,421,116
"34682","E01000308",2011,669,435,234,71
"34683","E01000309",2011,619,31,588,227
"34684","E01000310",2011,701,49,652,303
"34685","E01000311",2011,470,5,465,113
"34686","E01000312",2011,710,152,558,231
"34687","E01000313",2011,672,61,611,295
"34688","E01000314",2011,658,12,646,291
"34689","E01000315",2011,614,295,319,49
"34690","E01000316",2011,874,114,760,302
"34691","E01000317",2011,657,50,607,194
"34692","E01000318",2011,610,37,573,98
"34693","E01000319",2011,529,49,480,95
"34694","E01000320",2011,628,31,597,133
"34695","E01000321",2011,700,49,651,285
"34696","E01000322",2011,774,72,702,291
"34697","E01000323",2011,865,38,827,402
"34698","E01000324",2011,655,59,596,125
"34699","E01000325",2011,583,5,578,33
"34700","E01000326",2011,544,8,536,59
"34701","E01000327",2011,604,32,572,31
"34702","E01000328",2011,596,38,558,31
"34703","E01000329",2011,517,83,434,49
"34704","E01000330",2011,772,114,658,110
"34705","E01000331",2011,617,171,446,37
"34706","E01000332",2011,611,46,565,71
"34707","E01000333",2011,793,155,638,157
"34708","E01000334",2011,640,32,608,74
"34709","E01000335",2011,638,145,493,136
"34710","E01000336",2011,793,301,492,165
"34711","E01000337",2011,663,73,590,119
"34712","E01000338",2011,693,25,668,177
"34713","E01000339",2011,602,121,481,35
"34714","E01000340",2011,619,5,614,51
"34715","E01000341",2011,610,9,601,38
"34716","E01000342",2011,644,4,640,60
"34717","E01000343",2011,550,3,547,57
"34718","E01000344",2011,646,13,633,64
"34719","E01000345",2011,487,2,485,32
"34720","E01000346",2011,625,6,619,37
"34721","E01000347",2011,618,37,581,63
"34722","E01000348",2011,523,4,519,14
"34723","E01000349",2011,650,9,641,36
"34724","E01000350",2011,521,7,514,53
"34725","E01000351",2011,616,4,612,43
"34726","E01000352",2011,676,44,632,95
"34727","E01000353",2011,662,6,656,12
"34728","E01000354",2011,623,137,486,40
"34729","E01000355",2011,613,6,607,21
"34730","E01000356",2011,628,6,622,59
"34731","E01000357",2011,488,7,481,23
"34732","E01000358",2011,659,16,643,57
"34733","E01000359",2011,488,4,484,27
"34734","E01000360",2011,662,8,654,194
"34735","E01000361",2011,602,32,570,68
"34736","E01000362",2011,626,30,596,42
"34737","E01000363",2011,565,7,558,55
"34738","E01000364",2011,651,38,613,68
"34739","E01000365",2011,700,36,664,122
"34740","E01000366",2011,655,22,633,86
"34741","E01000367",2011,605,189,416,43
"34742","E01000368",2011,632,261,371,42
"34743","E01000369",2011,626,43,583,49
"34744","E01000370",2011,649,61,588,51
"34745","E01000371",2011,634,11,623,49
"34746","E01000372",2011,593,203,390,35
"34747","E01000373",2011,688,534,154,40
"34748","E01000374",2011,534,219,315,27
"34749","E01000375",2011,565,122,443,44
"34750","E01000376",2011,606,73,533,55
"34751","E01000377",2011,649,39,610,59
"34752","E01000378",2011,968,144,824,177
"34753","E01000379",2011,663,118,545,54
"34754","E01000380",2011,758,317,441,80
"34755","E01000381",2011,660,169,491,58
"34756","E01000382",2011,587,29,558,32
"34757","E01000383",2011,633,82,551,33
"34758","E01000384",2011,780,116,664,122
"34759","E01000385",2011,770,316,454,74
"34760","E01000386",2011,659,322,337,80
"34761","E01000387",2011,618,39,579,41
"34762","E01000388",2011,621,12,609,30
"34763","E01000389",2011,714,82,632,75
"34764","E01000390",2011,515,29,486,29
"34765","E01000391",2011,644,41,603,47
"34766","E01000392",2011,695,186,509,161
"34767","E01000393",2011,640,12,628,76
"34768","E01000394",2011,624,36,588,82
"34769","E01000395",2011,499,1,498,22
"34770","E01000396",2011,507,0,507,28
"34771","E01000398",2011,611,113,498,48
"34772","E01000399",2011,619,45,574,66
"34773","E01000400",2011,590,39,551,72
"34774","E01000401",2011,637,141,496,91
"34775","E01000402",2011,660,168,492,119
"34776","E01000403",2011,990,380,610,112
"34777","E01000404",2011,959,243,716,368
"34778","E01000405",2011,522,71,451,104
"34779","E01000406",2011,594,30,564,128
"34780","E01000407",2011,630,71,559,62
"34781","E01000408",2011,570,34,536,116
"34782","E01000409",2011,649,5,644,30
"34783","E01000410",2011,594,4,590,54
"34784","E01000411",2011,551,5,546,35
"34785","E01000412",2011,632,3,629,68
"34786","E01000413",2011,505,4,501,50
"34787","E01000414",2011,674,16,658,137
"34788","E01000415",2011,512,7,505,17
"34789","E01000416",2011,517,103,414,99
"34790","E01000417",2011,713,136,577,91
"34791","E01000418",2011,754,151,603,135
"34792","E01000419",2011,594,8,586,28
"34793","E01000420",2011,604,20,584,48
"34794","E01000421",2011,603,3,600,16
"34795","E01000422",2011,681,519,162,45
"34796","E01000423",2011,609,6,603,27
"34797","E01000424",2011,765,36,729,69
"34798","E01000425",2011,590,6,584,13
"34799","E01000426",2011,712,60,652,110
"34800","E01000427",2011,922,149,773,84
"34801","E01000428",2011,882,333,549,175
"34802","E01000429",2011,719,211,508,241
"34803","E01000430",2011,678,138,540,90
"34804","E01000431",2011,681,363,318,75
"34805","E01000432",2011,640,180,460,66
"34806","E01000433",2011,720,299,421,81
"34807","E01000434",2011,596,362,234,43
"34808","E01000435",2011,597,179,418,67
"34809","E01000436",2011,615,11,604,41
"34810","E01000437",2011,498,35,463,29
"34811","E01000438",2011,599,13,586,72
"34812","E01000439",2011,496,60,436,85
"34813","E01000440",2011,517,8,509,17
"34814","E01000441",2011,672,200,472,75
"34815","E01000442",2011,626,48,578,40
"34816","E01000443",2011,510,81,429,34
"34817","E01000444",2011,626,4,622,45
"34818","E01000445",2011,687,3,684,54
"34819","E01000446",2011,602,5,597,53
"34820","E01000447",2011,713,64,649,142
"34821","E01000448",2011,504,3,501,11
"34822","E01000449",2011,648,18,630,52
"34823","E01000450",2011,645,124,521,43
"34824","E01000451",2011,621,10,611,34
"34825","E01000452",2011,495,9,486,22
"34826","E01000453",2011,513,5,508,35
"34827","E01000454",2011,628,117,511,41
"34828","E01000455",2011,605,8,597,46
"34829","E01000456",2011,487,5,482,22
"34830","E01000457",2011,825,36,789,253
"34831","E01000458",2011,631,47,584,64
"34832","E01000459",2011,781,130,651,141
"34833","E01000460",2011,498,5,493,45
"34834","E01000461",2011,569,6,563,24
"34835","E01000462",2011,738,75,663,191
"34836","E01000463",2011,452,2,450,29
"34837","E01000464",2011,546,278,268,68
"34838","E01000465",2011,707,452,255,68
"34839","E01000466",2011,602,302,300,73
"34840","E01000467",2011,591,131,460,139
"34841","E01000468",2011,890,97,793,293
"34842","E01000469",2011,645,92,553,161
"34843","E01000470",2011,590,404,186,67
"34844","E01000471",2011,469,49,420,103
"34845","E01000472",2011,512,29,483,268
"34846","E01000473",2011,520,64,456,172
"34847","E01000474",2011,501,111,390,87
"34848","E01000475",2011,596,95,501,170
"34849","E01000476",2011,455,40,415,86
"34850","E01000477",2011,656,71,585,242
"34851","E01000478",2011,447,45,402,102
"34852","E01000479",2011,510,12,498,88
"34853","E01000480",2011,535,11,524,122
"34854","E01000481",2011,610,172,438,221
"34855","E01000482",2011,992,500,492,249
"34856","E01000483",2011,643,274,369,183
"34857","E01000484",2011,423,214,209,56
"34858","E01000485",2011,488,153,335,111
"34859","E01000486",2011,532,16,516,143
"34860","E01000487",2011,674,88,586,242
"34861","E01000488",2011,533,114,419,191
"34862","E01000489",2011,593,143,450,137
"34863","E01000490",2011,787,127,660,395
"34864","E01000491",2011,806,195,611,233
"34865","E01000492",2011,467,45,422,94
"34866","E01000493",2011,578,42,536,111
"34867","E01000494",2011,724,149,575,272
"34868","E01000495",2011,850,332,518,273
"34869","E01000497",2011,586,99,487,146
"34870","E01000498",2011,457,69,388,98
"34871","E01000499",2011,500,98,402,152
"34872","E01000501",2011,734,335,399,129
"34873","E01000502",2011,453,69,384,112
"34874","E01000503",2011,721,171,550,171
"34875","E01000504",2011,676,140,536,253
"34876","E01000505",2011,525,151,374,113
"34877","E01000506",2011,657,163,494,294
"34878","E01000507",2011,508,76,432,128
"34879","E01000508",2011,716,295,421,221
"34880","E01000509",2011,430,29,401,124
"34881","E01000510",2011,533,57,476,225
"34882","E01000511",2011,543,55,488,218
"34883","E01000512",2011,610,69,541,200
"34884","E01000513",2011,471,25,446,106
"34885","E01000514",2011,495,25,470,136
"34886","E01000515",2011,628,198,430,173
"34887","E01000516",2011,517,18,499,154
"34888","E01000517",2011,491,12,479,128
"34889","E01000518",2011,557,133,424,111
"34890","E01000519",2011,629,106,523,206
"34891","E01000520",2011,586,89,497,157
"34892","E01000521",2011,905,333,572,386
"34893","E01000522",2011,710,303,407,155
"34894","E01000523",2011,993,322,671,381
"34895","E01000524",2011,1035,403,632,425
"34896","E01000525",2011,785,348,437,247
"34897","E01000526",2011,813,534,279,112
"34898","E01000527",2011,813,247,566,285
"34899","E01000528",2011,600,441,159,55
"34900","E01000530",2011,700,93,607,174
"34901","E01000531",2011,908,233,675,349
"34902","E01000532",2011,733,272,461,153
"34903","E01000533",2011,952,370,582,346
"34904","E01000534",2011,651,97,554,175
"34905","E01000535",2011,829,130,699,335
"34906","E01000536",2011,522,17,505,116
"34907","E01000538",2011,478,2,476,51
"34908","E01000539",2011,548,41,507,88
"34909","E01000540",2011,471,5,466,62
"34910","E01000541",2011,499,44,455,152
"34911","E01000543",2011,500,59,441,123
"34912","E01000544",2011,742,471,271,128
"34913","E01000545",2011,856,207,649,413
"34914","E01000546",2011,756,150,606,345
"34915","E01000547",2011,768,214,554,254
"34916","E01000548",2011,1014,295,719,438
"34917","E01000549",2011,883,142,741,316
"34918","E01000550",2011,906,540,366,179
"34919","E01000551",2011,940,746,194,82
"34920","E01000552",2011,793,680,113,49
"34921","E01000553",2011,696,101,595,330
"34922","E01000554",2011,683,112,571,251
"34923","E01000555",2011,512,45,467,162
"34924","E01000556",2011,800,153,647,511
"34925","E01000557",2011,751,81,670,434
"34926","E01000558",2011,665,138,527,253
"34927","E01000559",2011,650,157,493,278
"34928","E01000560",2011,727,120,607,334
"34929","E01000561",2011,823,303,520,275
"34930","E01000562",2011,480,35,445,52
"34931","E01000563",2011,474,14,460,48
"34932","E01000564",2011,460,28,432,174
"34933","E01000565",2011,497,125,372,90
"34934","E01000566",2011,475,15,460,68
"34935","E01000567",2011,486,76,410,95
"34936","E01000568",2011,787,366,421,208
"34937","E01000569",2011,480,11,469,58
"34938","E01000570",2011,513,110,403,134
"34939","E01000571",2011,477,12,465,124
"34940","E01000572",2011,462,20,442,98
"34941","E01000573",2011,474,19,455,114
"34942","E01000574",2011,428,24,404,100
"34943","E01000575",2011,625,43,582,251
"34944","E01000576",2011,534,31,503,150
"34945","E01000577",2011,793,271,522,302
"34946","E01000578",2011,689,101,588,188
"34947","E01000579",2011,683,158,525,200
"34948","E01000580",2011,821,161,660,209
"34949","E01000581",2011,603,120,483,200
"34950","E01000582",2011,720,105,615,221
"34951","E01000583",2011,1017,227,790,406
"34952","E01000584",2011,619,77,542,157
"34953","E01000585",2011,718,154,564,205
"34954","E01000586",2011,1093,247,846,531
"34955","E01000587",2011,458,15,443,86
"34956","E01000588",2011,669,239,430,102
"34957","E01000589",2011,592,51,541,125
"34958","E01000590",2011,626,53,573,125
"34959","E01000591",2011,650,80,570,203
"34960","E01000592",2011,525,96,429,99
"34961","E01000593",2011,680,145,535,127
"34962","E01000594",2011,527,42,485,156
"34963","E01000595",2011,582,286,296,125
"34964","E01000596",2011,640,396,244,97
"34965","E01000599",2011,489,367,122,41
"34966","E01000600",2011,783,480,303,168
"34967","E01000601",2011,477,286,191,86
"34968","E01000602",2011,512,292,220,44
"34969","E01000603",2011,576,172,404,194
"34970","E01000604",2011,548,397,151,41
"34971","E01000605",2011,553,413,140,32
"34972","E01000606",2011,567,70,497,162
"34973","E01000607",2011,667,27,640,203
"34974","E01000608",2011,734,138,596,264
"34975","E01000609",2011,640,78,562,198
"34976","E01000610",2011,621,108,513,193
"34977","E01000611",2011,454,113,341,130
"34978","E01000612",2011,521,88,433,142
"34979","E01000613",2011,639,106,533,286
"34980","E01000615",2011,563,41,522,268
"34981","E01000616",2011,586,55,531,250
"34982","E01000617",2011,528,67,461,143
"34983","E01000618",2011,500,57,443,83
"34984","E01000619",2011,473,33,440,81
"34985","E01000620",2011,500,18,482,139
"34986","E01000621",2011,514,24,490,178
"34987","E01000622",2011,636,83,553,278
"34988","E01000623",2011,541,29,512,138
"34989","E01000624",2011,594,21,573,113
"34990","E01000625",2011,557,89,468,141
"34991","E01000626",2011,590,335,255,126
"34992","E01000627",2011,653,212,441,203
"34993","E01000628",2011,633,126,507,206
"34994","E01000629",2011,605,28,577,146
"34995","E01000630",2011,768,311,457,192
"34996","E01000631",2011,522,18,504,155
"34997","E01000632",2011,548,13,535,172
"34998","E01000633",2011,554,54,500,220
"34999","E01000634",2011,696,121,575,261
"35000","E01000635",2011,774,143,631,305
"35001","E01000636",2011,518,24,494,164
"35002","E01000637",2011,636,153,483,251
"35003","E01000638",2011,715,175,540,366
"35004","E01000639",2011,716,95,621,400
"35005","E01000640",2011,802,135,667,448
"35006","E01000641",2011,715,205,510,295
"35007","E01000642",2011,915,169,746,490
"35008","E01000643",2011,840,497,343,117
"35009","E01000644",2011,728,196,532,254
"35010","E01000645",2011,536,3,533,28
"35011","E01000646",2011,728,35,693,187
"35012","E01000647",2011,635,31,604,89
"35013","E01000648",2011,646,21,625,94
"35014","E01000649",2011,774,46,728,88
"35015","E01000650",2011,750,127,623,54
"35016","E01000651",2011,631,71,560,63
"35017","E01000652",2011,659,20,639,36
"35018","E01000653",2011,608,63,545,42
"35019","E01000654",2011,486,5,481,26
"35020","E01000655",2011,494,18,476,29
"35021","E01000656",2011,517,6,511,16
"35022","E01000657",2011,674,93,581,57
"35023","E01000658",2011,550,13,537,22
"35024","E01000659",2011,520,8,512,23
"35025","E01000661",2011,671,381,290,49
"35026","E01000662",2011,680,128,552,39
"35027","E01000663",2011,660,184,476,26
"35028","E01000664",2011,612,128,484,28
"35029","E01000665",2011,757,42,715,93
"35030","E01000666",2011,776,5,771,73
"35031","E01000667",2011,622,7,615,20
"35032","E01000668",2011,691,55,636,141
"35033","E01000669",2011,740,45,695,118
"35034","E01000670",2011,864,84,780,244
"35035","E01000671",2011,784,97,687,159
"35036","E01000672",2011,650,22,628,112
"35037","E01000673",2011,630,51,579,78
"35038","E01000674",2011,802,161,641,160
"35039","E01000675",2011,690,25,665,219
"35040","E01000676",2011,866,207,659,277
"35041","E01000677",2011,800,32,768,229
"35042","E01000678",2011,666,45,621,115
"35043","E01000679",2011,662,19,643,93
"35044","E01000680",2011,646,16,630,55
"35045","E01000681",2011,654,3,651,24
"35046","E01000682",2011,642,2,640,36
"35047","E01000683",2011,705,53,652,80
"35048","E01000684",2011,757,9,748,52
"35049","E01000685",2011,618,83,535,49
"35050","E01000686",2011,648,78,570,34
"35051","E01000687",2011,656,13,643,62
"35052","E01000688",2011,504,13,491,23
"35053","E01000689",2011,612,148,464,91
"35054","E01000690",2011,534,32,502,31
"35055","E01000691",2011,619,121,498,64
"35056","E01000692",2011,659,30,629,119
"35057","E01000693",2011,570,47,523,61
"35058","E01000694",2011,635,6,629,29
"35059","E01000695",2011,614,25,589,61
"35060","E01000696",2011,637,5,632,75
"35061","E01000697",2011,765,13,752,155
"35062","E01000698",2011,439,6,433,8
"35063","E01000699",2011,648,136,512,171
"35064","E01000700",2011,666,117,549,80
"35065","E01000701",2011,599,51,548,104
"35066","E01000702",2011,572,46,526,107
"35067","E01000703",2011,694,67,627,186
"35068","E01000704",2011,593,30,563,79
"35069","E01000705",2011,565,106,459,104
"35070","E01000706",2011,591,104,487,79
"35071","E01000707",2011,536,9,527,48
"35072","E01000708",2011,650,46,604,84
"35073","E01000709",2011,787,155,632,185
"35074","E01000710",2011,862,58,804,239
"35075","E01000711",2011,1012,119,893,341
"35076","E01000712",2011,862,21,841,251
"35077","E01000713",2011,885,38,847,236
"35078","E01000714",2011,1036,50,986,425
"35079","E01000715",2011,885,47,838,193
"35080","E01000716",2011,702,43,659,128
"35081","E01000717",2011,889,51,838,251
"35082","E01000718",2011,971,321,650,179
"35083","E01000719",2011,853,212,641,109
"35084","E01000720",2011,668,219,449,90
"35085","E01000721",2011,524,301,223,33
"35086","E01000722",2011,704,87,617,111
"35087","E01000723",2011,561,12,549,24
"35088","E01000724",2011,674,381,293,32
"35089","E01000725",2011,775,233,542,122
"35090","E01000726",2011,590,15,575,72
"35091","E01000727",2011,687,78,609,77
"35092","E01000728",2011,657,115,542,74
"35093","E01000729",2011,824,493,331,42
"35094","E01000730",2011,649,355,294,45
"35095","E01000731",2011,532,141,391,29
"35096","E01000732",2011,587,83,504,25
"35097","E01000733",2011,651,137,514,36
"35098","E01000734",2011,507,53,454,51
"35099","E01000735",2011,562,206,356,38
"35100","E01000736",2011,618,188,430,22
"35101","E01000737",2011,580,186,394,39
"35102","E01000738",2011,632,95,537,54
"35103","E01000739",2011,634,336,298,32
"35104","E01000740",2011,871,195,676,374
"35105","E01000741",2011,842,314,528,226
"35106","E01000742",2011,1044,276,768,356
"35107","E01000743",2011,841,397,444,205
"35108","E01000744",2011,682,422,260,76
"35109","E01000745",2011,883,225,658,261
"35110","E01000746",2011,949,200,749,317
"35111","E01000747",2011,773,55,718,118
"35112","E01000748",2011,670,12,658,41
"35113","E01000749",2011,639,47,592,36
"35114","E01000750",2011,665,358,307,21
"35115","E01000751",2011,807,51,756,80
"35116","E01000752",2011,778,57,721,67
"35117","E01000753",2011,750,6,744,48
"35118","E01000754",2011,743,12,731,83
"35119","E01000755",2011,615,7,608,38
"35120","E01000756",2011,594,12,582,36
"35121","E01000757",2011,601,3,598,14
"35122","E01000758",2011,591,36,555,26
"35123","E01000759",2011,549,6,543,26
"35124","E01000760",2011,550,14,536,63
"35125","E01000761",2011,577,2,575,24
"35126","E01000762",2011,743,16,727,119
"35127","E01000763",2011,523,3,520,18
"35128","E01000764",2011,633,84,549,22
"35129","E01000765",2011,679,19,660,94
"35130","E01000766",2011,645,3,642,11
"35131","E01000767",2011,598,3,595,25
"35132","E01000768",2011,613,39,574,72
"35133","E01000769",2011,454,69,385,20
"35134","E01000770",2011,691,6,685,133
"35135","E01000771",2011,620,12,608,47
"35136","E01000772",2011,734,31,703,98
"35137","E01000773",2011,605,89,516,40
"35138","E01000774",2011,581,21,560,62
"35139","E01000775",2011,867,38,829,105
"35140","E01000777",2011,565,8,557,54
"35141","E01000778",2011,618,83,535,35
"35142","E01000779",2011,551,49,502,76
"35143","E01000780",2011,628,181,447,64
"35144","E01000781",2011,614,287,327,52
"35145","E01000782",2011,647,313,334,87
"35146","E01000783",2011,626,243,383,66
"35147","E01000784",2011,582,45,537,67
"35148","E01000785",2011,609,241,368,36
"35149","E01000786",2011,627,27,600,20
"35150","E01000787",2011,667,99,568,52
"35151","E01000788",2011,618,89,529,45
"35152","E01000789",2011,657,448,209,41
"35153","E01000790",2011,872,95,777,225
"35154","E01000791",2011,621,47,574,29
"35155","E01000792",2011,483,61,422,31
"35156","E01000793",2011,643,10,633,23
"35157","E01000794",2011,611,9,602,20
"35158","E01000795",2011,542,116,426,22
"35159","E01000796",2011,638,475,163,50
"35160","E01000797",2011,679,95,584,91
"35161","E01000798",2011,693,393,300,135
"35162","E01000799",2011,719,121,598,179
"35163","E01000800",2011,780,231,549,218
"35164","E01000801",2011,650,128,522,117
"35165","E01000802",2011,750,186,564,149
"35166","E01000803",2011,730,179,551,161
"35167","E01000804",2011,548,25,523,57
"35168","E01000805",2011,717,149,568,145
"35169","E01000806",2011,768,307,461,256
"35170","E01000807",2011,595,17,578,89
"35171","E01000808",2011,625,36,589,25
"35172","E01000809",2011,629,9,620,26
"35173","E01000810",2011,599,1,598,26
"35174","E01000811",2011,571,5,566,84
"35175","E01000812",2011,663,71,592,69
"35176","E01000813",2011,637,5,632,27
"35177","E01000814",2011,564,0,564,18
"35178","E01000815",2011,562,2,560,13
"35179","E01000816",2011,592,44,548,46
"35180","E01000818",2011,568,33,535,28
"35181","E01000819",2011,740,277,463,79
"35182","E01000820",2011,643,141,502,121
"35183","E01000822",2011,727,119,608,152
"35184","E01000823",2011,747,62,685,179
"35185","E01000824",2011,514,80,434,114
"35186","E01000825",2011,807,101,706,217
"35187","E01000826",2011,563,0,563,21
"35188","E01000827",2011,790,36,754,142
"35189","E01000828",2011,766,102,664,115
"35190","E01000829",2011,734,44,690,158
"35191","E01000830",2011,544,2,542,13
"35192","E01000831",2011,789,77,712,118
"35193","E01000832",2011,572,4,568,39
"35194","E01000833",2011,497,3,494,18
"35195","E01000834",2011,461,5,456,22
"35196","E01000835",2011,648,20,628,141
"35197","E01000836",2011,500,4,496,20
"35198","E01000837",2011,647,50,597,63
"35199","E01000838",2011,548,8,540,28
"35200","E01000839",2011,550,4,546,35
"35201","E01000840",2011,685,144,541,12
"35202","E01000841",2011,606,8,598,42
"35203","E01000842",2011,724,83,641,265
"35204","E01000843",2011,846,188,658,322
"35205","E01000844",2011,870,67,803,427
"35206","E01000845",2011,731,93,638,279
"35207","E01000846",2011,616,359,257,87
"35208","E01000847",2011,677,276,401,173
"35209","E01000848",2011,805,73,732,312
"35210","E01000849",2011,862,63,799,407
"35211","E01000850",2011,664,119,545,351
"35212","E01000851",2011,861,147,714,466
"35213","E01000852",2011,625,154,471,297
"35214","E01000853",2011,840,530,310,149
"35215","E01000854",2011,718,243,475,273
"35216","E01000855",2011,1111,185,926,469
"35217","E01000856",2011,628,311,317,181
"35218","E01000857",2011,686,166,520,211
"35219","E01000858",2011,775,444,331,174
"35220","E01000859",2011,807,87,720,308
"35221","E01000860",2011,797,381,416,192
"35222","E01000861",2011,729,229,500,287
"35223","E01000862",2011,816,52,764,268
"35224","E01000863",2011,667,132,535,353
"35225","E01000864",2011,717,201,516,249
"35226","E01000865",2011,451,122,329,125
"35227","E01000866",2011,926,407,519,204
"35228","E01000867",2011,675,306,369,228
"35229","E01000868",2011,584,419,165,74
"35230","E01000869",2011,967,250,717,378
"35231","E01000870",2011,774,350,424,152
"35232","E01000871",2011,632,91,541,169
"35233","E01000872",2011,913,135,778,535
"35234","E01000873",2011,710,98,612,237
"35235","E01000874",2011,704,21,683,273
"35236","E01000875",2011,839,133,706,438
"35237","E01000876",2011,800,342,458,233
"35238","E01000877",2011,726,71,655,340
"35239","E01000878",2011,550,62,488,161
"35240","E01000879",2011,602,50,552,241
"35241","E01000880",2011,621,33,588,259
"35242","E01000881",2011,632,62,570,342
"35243","E01000882",2011,728,20,708,330
"35244","E01000883",2011,638,50,588,346
"35245","E01000884",2011,577,24,553,178
"35246","E01000885",2011,592,50,542,162
"35247","E01000886",2011,606,107,499,156
"35248","E01000887",2011,690,132,558,245
"35249","E01000888",2011,697,214,483,188
"35250","E01000889",2011,657,472,185,66
"35251","E01000890",2011,767,635,132,54
"35252","E01000891",2011,672,460,212,108
"35253","E01000892",2011,823,233,590,234
"35254","E01000893",2011,715,32,683,244
"35255","E01000894",2011,619,26,593,220
"35256","E01000895",2011,841,203,638,311
"35257","E01000896",2011,756,31,725,265
"35258","E01000897",2011,721,16,705,252
"35259","E01000898",2011,850,375,475,269
"35260","E01000899",2011,698,12,686,171
"35261","E01000900",2011,757,325,432,182
"35262","E01000901",2011,703,465,238,94
"35263","E01000902",2011,590,367,223,102
"35264","E01000903",2011,686,220,466,168
"35265","E01000904",2011,918,478,440,220
"35266","E01000905",2011,812,627,185,109
"35267","E01000906",2011,788,101,687,281
"35268","E01000907",2011,627,341,286,86
"35269","E01000908",2011,827,435,392,116
"35270","E01000909",2011,661,123,538,124
"35271","E01000910",2011,588,97,491,126
"35272","E01000911",2011,663,263,400,105
"35273","E01000912",2011,700,359,341,105
"35274","E01000913",2011,722,14,708,140
"35275","E01000914",2011,970,205,765,450
"35276","E01000915",2011,635,375,260,138
"35277","E01000916",2011,881,338,543,270
"35278","E01000917",2011,913,680,233,127
"35279","E01000918",2011,935,381,554,288
"35280","E01000919",2011,834,305,529,312
"35281","E01000920",2011,946,315,631,383
"35282","E01000921",2011,946,199,747,462
"35283","E01000922",2011,653,275,378,173
"35284","E01000923",2011,656,222,434,116
"35285","E01000924",2011,795,197,598,261
"35286","E01000925",2011,629,396,233,101
"35287","E01000926",2011,698,231,467,272
"35288","E01000927",2011,734,158,576,200
"35289","E01000928",2011,682,253,429,134
"35290","E01000929",2011,685,395,290,137
"35291","E01000930",2011,1076,496,580,384
"35292","E01000931",2011,873,371,502,323
"35293","E01000932",2011,947,261,686,357
"35294","E01000933",2011,821,143,678,376
"35295","E01000934",2011,732,340,392,200
"35296","E01000935",2011,624,416,208,111
"35297","E01000936",2011,536,271,265,138
"35298","E01000937",2011,502,124,378,258
"35299","E01000938",2011,737,352,385,288
"35300","E01000939",2011,446,284,162,91
"35301","E01000940",2011,534,352,182,119
"35302","E01000941",2011,557,429,128,62
"35303","E01000942",2011,686,158,528,299
"35304","E01000943",2011,596,150,446,270
"35305","E01000944",2011,667,353,314,202
"35306","E01000945",2011,611,259,352,240
"35307","E01000946",2011,715,221,494,238
"35308","E01000947",2011,871,229,642,421
"35309","E01000948",2011,846,283,563,260
"35310","E01000949",2011,739,591,148,79
"35311","E01000950",2011,550,369,181,96
"35312","E01000951",2011,603,385,218,102
"35313","E01000952",2011,675,411,264,148
"35314","E01000953",2011,708,464,244,109
"35315","E01000954",2011,642,508,134,64
"35316","E01000955",2011,657,552,105,56
"35317","E01000956",2011,608,353,255,164
"35318","E01000957",2011,765,291,474,248
"35319","E01000958",2011,835,394,441,242
"35320","E01000959",2011,698,449,249,128
"35321","E01000960",2011,841,145,696,386
"35322","E01000961",2011,652,250,402,179
"35323","E01000962",2011,745,44,701,355
"35324","E01000963",2011,851,71,780,406
"35325","E01000964",2011,713,216,497,238
"35326","E01000965",2011,764,139,625,297
"35327","E01000966",2011,675,25,650,284
"35328","E01000967",2011,619,77,542,187
"35329","E01000968",2011,760,138,622,316
"35330","E01000969",2011,954,48,906,495
"35331","E01000970",2011,831,61,770,444
"35332","E01000971",2011,649,71,578,243
"35333","E01000972",2011,949,438,511,338
"35334","E01000973",2011,894,252,642,417
"35335","E01000974",2011,821,294,527,306
"35336","E01000975",2011,710,50,660,290
"35337","E01000976",2011,824,117,707,335
"35338","E01000977",2011,918,229,689,319
"35339","E01000978",2011,927,101,826,443
"35340","E01000979",2011,790,58,732,318
"35341","E01000980",2011,566,78,488,99
"35342","E01000981",2011,647,53,594,93
"35343","E01000982",2011,684,72,612,174
"35344","E01000983",2011,665,32,633,138
"35345","E01000984",2011,822,245,577,243
"35346","E01000985",2011,515,25,490,30
"35347","E01000986",2011,677,52,625,110
"35348","E01000987",2011,513,5,508,37
"35349","E01000989",2011,628,23,605,57
"35350","E01000990",2011,538,316,222,31
"35351","E01000991",2011,662,14,648,38
"35352","E01000992",2011,723,309,414,74
"35353","E01000993",2011,616,47,569,103
"35354","E01000994",2011,536,25,511,120
"35355","E01000995",2011,597,29,568,201
"35356","E01000996",2011,443,6,437,97
"35357","E01000997",2011,471,32,439,114
"35358","E01000998",2011,629,108,521,237
"35359","E01000999",2011,436,22,414,83
"35360","E01001000",2011,454,31,423,161
"35361","E01001001",2011,493,91,402,130
"35362","E01001002",2011,498,49,449,132
"35363","E01001003",2011,608,131,477,171
"35364","E01001004",2011,787,182,605,223
"35365","E01001005",2011,536,33,503,191
"35366","E01001006",2011,616,176,440,139
"35367","E01001007",2011,605,71,534,131
"35368","E01001008",2011,538,186,352,100
"35369","E01001009",2011,609,109,500,167
"35370","E01001010",2011,539,237,302,64
"35371","E01001011",2011,755,175,580,266
"35372","E01001012",2011,746,121,625,387
"35373","E01001013",2011,899,439,460,254
"35374","E01001014",2011,1186,385,801,291
"35375","E01001015",2011,515,154,361,39
"35376","E01001016",2011,665,43,622,45
"35377","E01001017",2011,642,9,633,34
"35378","E01001018",2011,639,19,620,41
"35379","E01001019",2011,593,45,548,26
"35380","E01001020",2011,657,41,616,34
"35381","E01001021",2011,590,290,300,37
"35382","E01001022",2011,611,11,600,24
"35383","E01001023",2011,575,51,524,165
"35384","E01001024",2011,532,16,516,46
"35385","E01001025",2011,489,14,475,24
"35386","E01001026",2011,641,80,561,38
"35387","E01001027",2011,534,23,511,46
"35388","E01001028",2011,528,8,520,34
"35389","E01001029",2011,541,23,518,108
"35390","E01001030",2011,462,4,458,31
"35391","E01001031",2011,491,1,490,34
"35392","E01001032",2011,520,2,518,36
"35393","E01001033",2011,694,53,641,176
"35394","E01001034",2011,660,28,632,192
"35395","E01001035",2011,834,63,771,385
"35396","E01001036",2011,628,23,605,125
"35397","E01001037",2011,624,129,495,163
"35398","E01001038",2011,941,109,832,385
"35399","E01001039",2011,583,20,563,67
"35400","E01001040",2011,763,62,701,228
"35401","E01001041",2011,752,95,657,299
"35402","E01001042",2011,836,207,629,322
"35403","E01001043",2011,1202,246,956,545
"35404","E01001044",2011,871,33,838,275
"35405","E01001045",2011,953,159,794,453
"35406","E01001046",2011,850,7,843,393
"35407","E01001047",2011,869,101,768,403
"35408","E01001048",2011,949,150,799,499
"35409","E01001049",2011,505,9,496,63
"35410","E01001050",2011,802,301,501,233
"35411","E01001051",2011,581,391,190,27
"35412","E01001052",2011,470,282,188,23
"35413","E01001053",2011,527,201,326,18
"35414","E01001054",2011,594,266,328,39
"35415","E01001055",2011,585,301,284,38
"35416","E01001056",2011,593,434,159,25
"35417","E01001057",2011,637,541,96,21
"35418","E01001058",2011,521,22,499,39
"35419","E01001059",2011,692,22,670,146
"35420","E01001060",2011,657,48,609,94
"35421","E01001061",2011,642,91,551,130
"35422","E01001062",2011,571,17,554,46
"35423","E01001063",2011,587,11,576,69
"35424","E01001064",2011,613,13,600,41
"35425","E01001065",2011,672,15,657,145
"35426","E01001066",2011,493,270,223,37
"35427","E01001067",2011,578,3,575,30
"35428","E01001068",2011,784,153,631,85
"35429","E01001069",2011,500,29,471,44
"35430","E01001070",2011,659,120,539,36
"35431","E01001071",2011,735,99,636,56
"35432","E01001072",2011,533,5,528,24
"35433","E01001073",2011,618,48,570,137
"35434","E01001074",2011,828,157,671,189
"35435","E01001075",2011,646,55,591,112
"35436","E01001076",2011,581,190,391,89
"35437","E01001077",2011,523,54,469,37
"35438","E01001078",2011,513,224,289,31
"35439","E01001079",2011,639,285,354,57
"35440","E01001080",2011,687,516,171,35
"35441","E01001081",2011,506,190,316,30
"35442","E01001082",2011,560,232,328,28
"35443","E01001083",2011,536,10,526,57
"35444","E01001084",2011,665,24,641,101
"35445","E01001085",2011,612,91,521,159
"35446","E01001086",2011,603,28,575,98
"35447","E01001087",2011,848,144,704,313
"35448","E01001088",2011,592,109,483,91
"35449","E01001089",2011,715,188,527,206
"35450","E01001090",2011,922,231,691,283
"35451","E01001091",2011,562,12,550,120
"35452","E01001092",2011,588,29,559,97
"35453","E01001093",2011,694,50,644,111
"35454","E01001094",2011,521,4,517,44
"35455","E01001095",2011,584,34,550,159
"35456","E01001096",2011,530,18,512,45
"35457","E01001097",2011,1059,126,933,359
"35458","E01001098",2011,515,6,509,31
"35459","E01001099",2011,586,129,457,80
"35460","E01001100",2011,619,36,583,108
"35461","E01001101",2011,509,5,504,17
"35462","E01001102",2011,605,43,562,52
"35463","E01001103",2011,651,32,619,36
"35464","E01001104",2011,642,25,617,38
"35465","E01001105",2011,632,139,493,29
"35466","E01001106",2011,540,56,484,47
"35467","E01001107",2011,662,15,647,106
"35468","E01001108",2011,628,11,617,22
"35469","E01001109",2011,845,271,574,229
"35470","E01001110",2011,771,190,581,328
"35471","E01001111",2011,610,72,538,143
"35472","E01001112",2011,763,254,509,202
"35473","E01001113",2011,795,120,675,299
"35474","E01001114",2011,585,241,344,136
"35475","E01001115",2011,657,278,379,106
"35476","E01001116",2011,528,72,456,140
"35477","E01001117",2011,1113,220,893,411
"35478","E01001118",2011,795,301,494,188
"35479","E01001119",2011,576,24,552,23
"35480","E01001120",2011,480,3,477,32
"35481","E01001121",2011,501,16,485,16
"35482","E01001122",2011,507,6,501,41
"35483","E01001123",2011,598,7,591,24
"35484","E01001124",2011,609,4,605,19
"35485","E01001125",2011,602,11,591,85
"35486","E01001126",2011,598,18,580,42
"35487","E01001127",2011,574,41,533,19
"35488","E01001128",2011,566,310,256,29
"35489","E01001129",2011,502,4,498,13
"35490","E01001130",2011,598,458,140,38
"35491","E01001131",2011,685,102,583,64
"35492","E01001132",2011,607,24,583,38
"35493","E01001133",2011,726,39,687,35
"35494","E01001134",2011,697,37,660,79
"35495","E01001135",2011,631,17,614,53
"35496","E01001136",2011,927,125,802,449
"35497","E01001137",2011,875,144,731,224
"35498","E01001138",2011,774,145,629,186
"35499","E01001139",2011,694,32,662,183
"35500","E01001140",2011,773,73,700,199
"35501","E01001141",2011,568,183,385,155
"35502","E01001142",2011,620,55,565,113
"35503","E01001143",2011,848,259,589,197
"35504","E01001144",2011,797,188,609,284
"35505","E01001145",2011,848,397,451,244
"35506","E01001146",2011,607,63,544,124
"35507","E01001147",2011,620,170,450,158
"35508","E01001148",2011,673,81,592,149
"35509","E01001149",2011,619,49,570,129
"35510","E01001150",2011,620,32,588,123
"35511","E01001151",2011,671,234,437,150
"35512","E01001152",2011,674,111,563,257
"35513","E01001153",2011,591,70,521,117
"35514","E01001154",2011,735,137,598,207
"35515","E01001155",2011,761,345,416,168
"35516","E01001156",2011,721,248,473,121
"35517","E01001157",2011,615,80,535,89
"35518","E01001158",2011,700,122,578,178
"35519","E01001159",2011,741,67,674,170
"35520","E01001160",2011,627,20,607,96
"35521","E01001161",2011,566,264,302,72
"35522","E01001162",2011,767,260,507,154
"35523","E01001163",2011,798,73,725,163
"35524","E01001164",2011,962,205,757,380
"35525","E01001165",2011,676,58,618,180
"35526","E01001166",2011,835,247,588,259
"35527","E01001167",2011,829,113,716,147
"35528","E01001168",2011,740,56,684,183
"35529","E01001169",2011,651,303,348,46
"35530","E01001170",2011,989,187,802,386
"35531","E01001171",2011,681,249,432,126
"35532","E01001172",2011,616,352,264,42
"35533","E01001173",2011,1089,247,842,251
"35534","E01001174",2011,523,40,483,113
"35535","E01001175",2011,527,43,484,147
"35536","E01001176",2011,628,96,532,152
"35537","E01001177",2011,551,185,366,96
"35538","E01001178",2011,505,143,362,201
"35539","E01001179",2011,538,30,508,141
"35540","E01001180",2011,609,42,567,204
"35541","E01001181",2011,759,290,469,194
"35542","E01001182",2011,462,11,451,136
"35543","E01001183",2011,550,59,491,183
"35544","E01001184",2011,456,17,439,84
"35545","E01001185",2011,717,57,660,209
"35546","E01001186",2011,841,186,655,240
"35547","E01001187",2011,809,142,667,186
"35548","E01001188",2011,728,154,574,173
"35549","E01001189",2011,465,66,399,52
"35550","E01001190",2011,616,127,489,78
"35551","E01001191",2011,823,111,712,371
"35552","E01001192",2011,727,174,553,208
"35553","E01001193",2011,583,301,282,35
"35554","E01001194",2011,624,55,569,118
"35555","E01001195",2011,598,20,578,214
"35556","E01001196",2011,762,299,463,187
"35557","E01001197",2011,668,127,541,260
"35558","E01001198",2011,584,76,508,211
"35559","E01001199",2011,694,189,505,242
"35560","E01001200",2011,586,59,527,187
"35561","E01001201",2011,642,114,528,183
"35562","E01001202",2011,871,284,587,329
"35563","E01001203",2011,861,292,569,307
"35564","E01001204",2011,585,75,510,105
"35565","E01001205",2011,598,191,407,158
"35566","E01001206",2011,582,350,232,82
"35567","E01001207",2011,668,65,603,222
"35568","E01001208",2011,498,29,469,47
"35569","E01001209",2011,647,7,640,122
"35570","E01001210",2011,740,410,330,101
"35571","E01001211",2011,705,79,626,208
"35572","E01001212",2011,691,23,668,196
"35573","E01001213",2011,503,80,423,98
"35574","E01001214",2011,477,30,447,101
"35575","E01001215",2011,552,116,436,139
"35576","E01001216",2011,476,52,424,112
"35577","E01001217",2011,455,13,442,84
"35578","E01001218",2011,692,263,429,158
"35579","E01001219",2011,674,363,311,84
"35580","E01001220",2011,471,305,166,51
"35581","E01001221",2011,952,138,814,526
"35582","E01001222",2011,1150,149,1001,586
"35583","E01001223",2011,643,53,590,277
"35584","E01001224",2011,570,26,544,126
"35585","E01001225",2011,807,143,664,300
"35586","E01001226",2011,668,61,607,287
"35587","E01001227",2011,602,42,560,170
"35588","E01001228",2011,792,71,721,350
"35589","E01001229",2011,597,219,378,98
"35590","E01001230",2011,629,47,582,232
"35591","E01001231",2011,696,40,656,203
"35592","E01001232",2011,612,135,477,130
"35593","E01001233",2011,599,140,459,169
"35594","E01001234",2011,640,76,564,318
"35595","E01001235",2011,691,26,665,372
"35596","E01001236",2011,741,120,621,335
"35597","E01001237",2011,652,50,602,276
"35598","E01001238",2011,1236,237,999,562
"35599","E01001239",2011,553,183,370,156
"35600","E01001240",2011,512,107,405,163
"35601","E01001241",2011,503,69,434,177
"35602","E01001242",2011,524,151,373,137
"35603","E01001243",2011,649,221,428,167
"35604","E01001244",2011,1099,323,776,373
"35605","E01001245",2011,823,100,723,248
"35606","E01001246",2011,492,113,379,150
"35607","E01001247",2011,674,56,618,276
"35608","E01001248",2011,581,98,483,108
"35609","E01001249",2011,1025,467,558,321
"35610","E01001250",2011,983,285,698,309
"35611","E01001251",2011,659,34,625,174
"35612","E01001252",2011,768,113,655,320
"35613","E01001253",2011,670,66,604,187
"35614","E01001254",2011,750,115,635,142
"35615","E01001255",2011,608,44,564,117
"35616","E01001257",2011,659,385,274,89
"35617","E01001258",2011,634,69,565,132
"35618","E01001259",2011,510,29,481,140
"35619","E01001260",2011,660,43,617,176
"35620","E01001261",2011,758,114,644,263
"35621","E01001262",2011,558,186,372,77
"35622","E01001263",2011,647,220,427,121
"35623","E01001264",2011,612,132,480,93
"35624","E01001265",2011,627,75,552,208
"35625","E01001266",2011,578,14,564,136
"35626","E01001267",2011,814,252,562,178
"35627","E01001268",2011,629,18,611,105
"35628","E01001269",2011,646,25,621,197
"35629","E01001270",2011,565,24,541,104
"35630","E01001271",2011,593,46,547,142
"35631","E01001272",2011,542,30,512,182
"35632","E01001273",2011,597,10,587,202
"35633","E01001274",2011,585,45,540,238
"35634","E01001275",2011,857,111,746,408
"35635","E01001276",2011,651,16,635,286
"35636","E01001277",2011,668,27,641,293
"35637","E01001278",2011,801,41,760,379
"35638","E01001279",2011,564,7,557,79
"35639","E01001280",2011,782,20,762,318
"35640","E01001281",2011,625,11,614,132
"35641","E01001282",2011,627,291,336,71
"35642","E01001283",2011,712,319,393,86
"35643","E01001284",2011,538,23,515,78
"35644","E01001285",2011,562,141,421,93
"35645","E01001286",2011,620,154,466,107
"35646","E01001287",2011,483,226,257,64
"35647","E01001288",2011,531,52,479,135
"35648","E01001289",2011,476,41,435,101
"35649","E01001290",2011,738,86,652,270
"35650","E01001291",2011,495,29,466,111
"35651","E01001292",2011,504,13,491,103
"35652","E01001293",2011,478,39,439,113
"35653","E01001294",2011,538,24,514,119
"35654","E01001295",2011,521,17,504,97
"35655","E01001296",2011,404,50,354,65
"35656","E01001297",2011,495,51,444,123
"35657","E01001298",2011,529,65,464,113
"35658","E01001299",2011,651,13,638,114
"35659","E01001300",2011,608,13,595,149
"35660","E01001301",2011,707,115,592,263
"35661","E01001302",2011,614,32,582,160
"35662","E01001303",2011,624,23,601,188
"35663","E01001304",2011,705,123,582,208
"35664","E01001305",2011,634,16,618,101
"35665","E01001306",2011,713,17,696,163
"35666","E01001307",2011,633,10,623,170
"35667","E01001308",2011,679,7,672,150
"35668","E01001309",2011,614,22,592,132
"35669","E01001310",2011,663,56,607,139
"35670","E01001311",2011,663,233,430,120
"35671","E01001312",2011,590,48,542,166
"35672","E01001313",2011,516,19,497,121
"35673","E01001314",2011,506,9,497,114
"35674","E01001315",2011,495,70,425,79
"35675","E01001316",2011,620,272,348,122
"35676","E01001317",2011,686,158,528,138
"35677","E01001318",2011,677,284,393,85
"35678","E01001319",2011,490,42,448,87
"35679","E01001320",2011,534,289,245,57
"35680","E01001321",2011,758,145,613,116
"35681","E01001322",2011,627,41,586,164
"35682","E01001323",2011,684,48,636,230
"35683","E01001324",2011,662,99,563,229
"35684","E01001325",2011,602,176,426,52
"35685","E01001326",2011,674,237,437,126
"35686","E01001327",2011,600,165,435,97
"35687","E01001328",2011,620,239,381,107
"35688","E01001329",2011,631,150,481,119
"35689","E01001330",2011,636,317,319,106
"35690","E01001331",2011,618,285,333,143
"35691","E01001332",2011,579,270,309,100
"35692","E01001333",2011,563,178,385,161
"35693","E01001334",2011,522,277,245,66
"35694","E01001335",2011,524,71,453,69
"35695","E01001336",2011,519,138,381,110
"35696","E01001337",2011,452,187,265,53
"35697","E01001338",2011,518,98,420,112
"35698","E01001339",2011,568,267,301,54
"35699","E01001340",2011,506,231,275,114
"35700","E01001341",2011,529,16,513,185
"35701","E01001342",2011,638,15,623,236
"35702","E01001343",2011,483,10,473,107
"35703","E01001344",2011,880,130,750,235
"35704","E01001345",2011,501,61,440,113
"35705","E01001346",2011,634,17,617,134
"35706","E01001347",2011,518,15,503,126
"35707","E01001348",2011,626,26,600,218
"35708","E01001349",2011,507,163,344,79
"35709","E01001350",2011,621,88,533,225
"35710","E01001351",2011,811,195,616,320
"35711","E01001352",2011,571,67,504,239
"35712","E01001353",2011,718,214,504,255
"35713","E01001354",2011,677,53,624,266
"35714","E01001355",2011,760,193,567,230
"35715","E01001356",2011,841,596,245,91
"35716","E01001357",2011,426,205,221,67
"35717","E01001358",2011,586,425,161,60
"35718","E01001359",2011,562,75,487,152
"35719","E01001360",2011,505,24,481,123
"35720","E01001361",2011,460,117,343,143
"35721","E01001362",2011,511,69,442,138
"35722","E01001363",2011,471,57,414,116
"35723","E01001364",2011,516,215,301,66
"35724","E01001365",2011,590,37,553,161
"35725","E01001366",2011,543,66,477,163
"35726","E01001367",2011,527,87,440,218
"35727","E01001368",2011,456,82,374,95
"35728","E01001369",2011,525,68,457,185
"35729","E01001370",2011,532,55,477,155
"35730","E01001371",2011,594,92,502,195
"35731","E01001372",2011,493,66,427,168
"35732","E01001373",2011,412,38,374,107
"35733","E01001374",2011,805,89,716,238
"35734","E01001375",2011,706,11,695,184
"35735","E01001376",2011,743,153,590,260
"35736","E01001377",2011,718,68,650,163
"35737","E01001379",2011,709,24,685,160
"35738","E01001380",2011,762,78,684,234
"35739","E01001381",2011,738,65,673,318
"35740","E01001382",2011,564,13,551,88
"35741","E01001383",2011,662,41,621,187
"35742","E01001384",2011,677,30,647,213
"35743","E01001385",2011,667,17,650,195
"35744","E01001386",2011,735,52,683,203
"35745","E01001387",2011,713,85,628,272
"35746","E01001388",2011,743,315,428,151
"35747","E01001389",2011,726,103,623,271
"35748","E01001390",2011,762,21,741,287
"35749","E01001391",2011,687,62,625,334
"35750","E01001392",2011,665,26,639,139
"35751","E01001393",2011,839,53,786,332
"35752","E01001394",2011,640,81,559,200
"35753","E01001395",2011,620,255,365,97
"35754","E01001396",2011,511,16,495,142
"35755","E01001397",2011,783,73,710,238
"35756","E01001398",2011,491,8,483,38
"35757","E01001399",2011,499,8,491,32
"35758","E01001400",2011,587,7,580,54
"35759","E01001401",2011,501,20,481,35
"35760","E01001402",2011,691,11,680,122
"35761","E01001403",2011,633,24,609,88
"35762","E01001404",2011,525,49,476,73
"35763","E01001405",2011,862,59,803,206
"35764","E01001406",2011,675,97,578,178
"35765","E01001407",2011,613,70,543,83
"35766","E01001408",2011,731,64,667,99
"35767","E01001409",2011,806,136,670,232
"35768","E01001410",2011,755,307,448,152
"35769","E01001411",2011,759,88,671,121
"35770","E01001412",2011,677,131,546,89
"35771","E01001413",2011,612,42,570,40
"35772","E01001414",2011,687,363,324,72
"35773","E01001415",2011,677,106,571,157
"35774","E01001416",2011,598,16,582,26
"35775","E01001417",2011,601,17,584,38
"35776","E01001418",2011,703,122,581,130
"35777","E01001419",2011,794,55,739,218
"35778","E01001420",2011,569,134,435,124
"35779","E01001421",2011,714,174,540,181
"35780","E01001422",2011,559,2,557,36
"35781","E01001423",2011,643,181,462,141
"35782","E01001424",2011,496,240,256,127
"35783","E01001425",2011,737,272,465,230
"35784","E01001426",2011,628,219,409,149
"35785","E01001427",2011,683,362,321,121
"35786","E01001428",2011,611,231,380,114
"35787","E01001429",2011,1134,801,333,145
"35788","E01001430",2011,653,357,296,125
"35789","E01001431",2011,614,176,438,219
"35790","E01001432",2011,700,136,564,216
"35791","E01001433",2011,584,233,351,90
"35792","E01001434",2011,551,53,498,88
"35793","E01001435",2011,489,35,454,80
"35794","E01001436",2011,653,49,604,124
"35795","E01001437",2011,990,377,613,247
"35796","E01001438",2011,566,126,440,126
"35797","E01001439",2011,790,217,573,255
"35798","E01001440",2011,597,117,480,102
"35799","E01001441",2011,637,223,414,102
"35800","E01001442",2011,617,258,359,128
"35801","E01001444",2011,638,45,593,111
"35802","E01001445",2011,980,131,849,311
"35803","E01001446",2011,714,87,627,157
"35804","E01001447",2011,783,279,504,175
"35805","E01001448",2011,655,132,523,159
"35806","E01001449",2011,575,117,458,107
"35807","E01001450",2011,924,78,846,339
"35808","E01001451",2011,661,19,642,98
"35809","E01001452",2011,488,13,475,37
"35810","E01001453",2011,661,28,633,73
"35811","E01001454",2011,660,6,654,92
"35812","E01001455",2011,581,16,565,64
"35813","E01001456",2011,481,2,479,32
"35814","E01001457",2011,798,15,783,211
"35815","E01001458",2011,664,306,358,145
"35816","E01001459",2011,556,34,522,105
"35817","E01001460",2011,660,83,577,305
"35818","E01001461",2011,707,233,474,241
"35819","E01001462",2011,531,106,425,158
"35820","E01001463",2011,513,67,446,98
"35821","E01001464",2011,422,149,273,53
"35822","E01001465",2011,506,32,474,96
"35823","E01001466",2011,620,61,559,200
"35824","E01001467",2011,634,62,572,195
"35825","E01001468",2011,524,75,449,104
"35826","E01001469",2011,633,111,522,78
"35827","E01001470",2011,641,29,612,54
"35828","E01001471",2011,930,21,909,246
"35829","E01001472",2011,771,48,723,180
"35830","E01001473",2011,547,100,447,43
"35831","E01001474",2011,840,17,823,185
"35832","E01001475",2011,635,10,625,46
"35833","E01001476",2011,593,69,524,136
"35834","E01001477",2011,607,179,428,96
"35835","E01001478",2011,544,85,459,78
"35836","E01001479",2011,639,85,554,200
"35837","E01001480",2011,588,60,528,173
"35838","E01001481",2011,556,47,509,103
"35839","E01001482",2011,690,163,527,171
"35840","E01001483",2011,609,123,486,273
"35841","E01001484",2011,516,16,500,97
"35842","E01001485",2011,682,184,498,174
"35843","E01001486",2011,818,363,455,161
"35844","E01001487",2011,723,145,578,188
"35845","E01001488",2011,663,81,582,191
"35846","E01001489",2011,664,91,573,170
"35847","E01001491",2011,722,152,570,218
"35848","E01001492",2011,680,104,576,141
"35849","E01001493",2011,735,230,505,129
"35850","E01001494",2011,510,8,502,58
"35851","E01001495",2011,731,17,714,256
"35852","E01001496",2011,602,12,590,88
"35853","E01001497",2011,531,39,492,90
"35854","E01001498",2011,746,27,719,323
"35855","E01001499",2011,564,30,534,87
"35856","E01001500",2011,554,27,527,148
"35857","E01001501",2011,818,131,687,292
"35858","E01001502",2011,599,124,475,120
"35859","E01001503",2011,654,98,556,144
"35860","E01001504",2011,513,54,459,107
"35861","E01001505",2011,567,117,450,130
"35862","E01001506",2011,565,148,417,155
"35863","E01001507",2011,766,189,577,260
"35864","E01001508",2011,718,125,593,225
"35865","E01001509",2011,688,120,568,236
"35866","E01001510",2011,610,479,131,67
"35867","E01001511",2011,648,25,623,130
"35868","E01001512",2011,782,67,715,201
"35869","E01001513",2011,623,204,419,101
"35870","E01001514",2011,685,120,565,121
"35871","E01001515",2011,755,330,425,183
"35872","E01001516",2011,648,174,474,103
"35873","E01001517",2011,696,376,320,119
"35874","E01001518",2011,684,27,657,199
"35875","E01001519",2011,1141,49,1092,611
"35876","E01001520",2011,673,115,558,138
"35877","E01001521",2011,698,38,660,187
"35878","E01001522",2011,751,86,665,214
"35879","E01001523",2011,738,15,723,132
"35880","E01001524",2011,546,88,458,96
"35881","E01001525",2011,723,35,688,203
"35882","E01001526",2011,639,9,630,91
"35883","E01001527",2011,645,58,587,169
"35884","E01001528",2011,553,273,280,94
"35885","E01001529",2011,635,185,450,251
"35886","E01001530",2011,467,43,424,110
"35887","E01001531",2011,544,1,543,97
"35888","E01001532",2011,687,11,676,130
"35889","E01001533",2011,530,6,524,37
"35890","E01001534",2011,588,19,569,144
"35891","E01001535",2011,505,25,480,72
"35892","E01001536",2011,742,63,679,167
"35893","E01001537",2011,709,26,683,201
"35894","E01001538",2011,603,24,579,23
"35895","E01001539",2011,657,36,621,91
"35896","E01001540",2011,794,23,771,240
"35897","E01001541",2011,650,30,620,100
"35898","E01001542",2011,678,138,540,119
"35899","E01001543",2011,596,15,581,44
"35900","E01001544",2011,610,12,598,57
"35901","E01001545",2011,665,331,334,102
"35902","E01001546",2011,640,106,534,129
"35903","E01001547",2011,659,81,578,135
"35904","E01001548",2011,676,161,515,122
"35905","E01001549",2011,798,227,571,289
"35906","E01001550",2011,570,165,405,75
"35907","E01001551",2011,661,266,395,68
"35908","E01001552",2011,659,64,595,99
"35909","E01001553",2011,530,209,321,100
"35910","E01001554",2011,756,469,287,109
"35911","E01001555",2011,624,83,541,187
"35912","E01001556",2011,543,43,500,73
"35913","E01001557",2011,546,109,437,123
"35914","E01001558",2011,558,201,357,137
"35915","E01001559",2011,743,142,601,236
"35916","E01001560",2011,516,117,399,90
"35917","E01001562",2011,711,337,374,248
"35918","E01001563",2011,669,16,653,212
"35919","E01001564",2011,646,24,622,121
"35920","E01001565",2011,709,95,614,151
"35921","E01001566",2011,626,11,615,154
"35922","E01001567",2011,632,20,612,67
"35923","E01001568",2011,538,13,525,34
"35924","E01001569",2011,778,62,716,276
"35925","E01001570",2011,751,102,649,170
"35926","E01001571",2011,615,81,534,115
"35927","E01001572",2011,628,79,549,133
"35928","E01001573",2011,513,68,445,80
"35929","E01001574",2011,768,489,279,91
"35930","E01001575",2011,599,307,292,64
"35931","E01001576",2011,658,391,267,62
"35932","E01001577",2011,737,362,375,84
"35933","E01001578",2011,809,234,575,207
"35934","E01001579",2011,637,310,327,70
"35935","E01001580",2011,833,85,748,322
"35936","E01001581",2011,838,321,517,192
"35937","E01001582",2011,641,161,480,115
"35938","E01001583",2011,818,142,676,249
"35939","E01001584",2011,713,81,632,204
"35940","E01001585",2011,628,112,516,118
"35941","E01001586",2011,683,271,412,131
"35942","E01001587",2011,921,185,736,215
"35943","E01001588",2011,659,329,330,85
"35944","E01001589",2011,616,263,353,110
"35945","E01001590",2011,701,189,512,150
"35946","E01001591",2011,839,518,321,117
"35947","E01001592",2011,740,110,630,164
"35948","E01001593",2011,728,107,621,127
"35949","E01001594",2011,763,472,291,97
"35950","E01001595",2011,693,373,320,62
"35951","E01001596",2011,597,14,583,49
"35952","E01001597",2011,607,84,523,95
"35953","E01001598",2011,606,65,541,53
"35954","E01001599",2011,615,118,497,48
"35955","E01001600",2011,663,84,579,129
"35956","E01001601",2011,601,67,534,54
"35957","E01001602",2011,718,321,397,43
"35958","E01001603",2011,768,465,303,37
"35959","E01001604",2011,568,66,502,63
"35960","E01001605",2011,571,8,563,22
"35961","E01001606",2011,618,19,599,51
"35962","E01001607",2011,604,146,458,41
"35963","E01001608",2011,592,88,504,44
"35964","E01001609",2011,738,199,539,89
"35965","E01001610",2011,707,107,600,66
"35966","E01001611",2011,741,242,499,54
"35967","E01001613",2011,775,185,590,138
"35968","E01001614",2011,530,16,514,26
"35969","E01001615",2011,756,167,589,185
"35970","E01001617",2011,738,44,694,101
"35971","E01001618",2011,648,191,457,50
"35972","E01001619",2011,818,90,728,173
"35973","E01001620",2011,505,215,290,42
"35974","E01001621",2011,611,253,358,66
"35975","E01001623",2011,664,243,421,102
"35976","E01001624",2011,631,250,381,26
"35977","E01001625",2011,587,314,273,29
"35978","E01001629",2011,852,484,368,194
"35979","E01001631",2011,793,555,238,118
"35980","E01001632",2011,635,107,528,227
"35981","E01001633",2011,652,365,287,101
"35982","E01001634",2011,667,508,159,52
"35983","E01001635",2011,618,113,505,133
"35984","E01001636",2011,593,142,451,193
"35985","E01001637",2011,706,224,482,175
"35986","E01001638",2011,806,473,333,166
"35987","E01001640",2011,881,537,344,198
"35988","E01001641",2011,779,250,529,207
"35989","E01001642",2011,791,124,667,179
"35990","E01001644",2011,1022,211,811,381
"35991","E01001645",2011,714,251,463,63
"35992","E01001646",2011,1179,379,800,356
"35993","E01001647",2011,573,113,460,63
"35994","E01001648",2011,729,153,576,113
"35995","E01001649",2011,569,208,361,58
"35996","E01001650",2011,615,242,373,64
"35997","E01001651",2011,761,380,381,79
"35998","E01001652",2011,681,141,540,131
"35999","E01001653",2011,610,369,241,40
"36000","E01001654",2011,603,302,301,44
"36001","E01001655",2011,637,394,243,59
"36002","E01001656",2011,582,180,402,66
"36003","E01001657",2011,686,113,573,114
"36004","E01001658",2011,723,139,584,131
"36005","E01001659",2011,529,90,439,60
"36006","E01001660",2011,586,262,324,50
"36007","E01001661",2011,588,219,369,39
"36008","E01001662",2011,715,134,581,217
"36009","E01001664",2011,854,266,588,273
"36010","E01001665",2011,788,127,661,255
"36011","E01001666",2011,557,174,383,147
"36012","E01001667",2011,707,448,259,99
"36013","E01001668",2011,1049,549,500,208
"36014","E01001669",2011,689,246,443,87
"36015","E01001671",2011,675,148,527,123
"36016","E01001672",2011,630,131,499,244
"36017","E01001673",2011,685,290,395,205
"36018","E01001674",2011,671,141,530,150
"36019","E01001675",2011,629,173,456,182
"36020","E01001676",2011,646,281,365,155
"36021","E01001677",2011,668,108,560,170
"36022","E01001678",2011,628,71,557,77
"36023","E01001679",2011,520,57,463,64
"36024","E01001680",2011,618,14,604,78
"36025","E01001681",2011,488,100,388,70
"36026","E01001682",2011,565,95,470,52
"36027","E01001683",2011,565,151,414,108
"36028","E01001684",2011,561,199,362,51
"36029","E01001685",2011,610,124,486,94
"36030","E01001686",2011,767,229,538,171
"36031","E01001687",2011,511,193,318,106
"36032","E01001688",2011,937,255,682,293
"36033","E01001690",2011,845,587,258,63
"36034","E01001692",2011,522,369,153,48
"36035","E01001693",2011,610,490,120,43
"36036","E01001694",2011,598,175,423,160
"36037","E01001695",2011,654,419,235,111
"36038","E01001696",2011,506,356,150,107
"36039","E01001697",2011,770,247,523,289
"36040","E01001698",2011,682,388,294,145
"36041","E01001699",2011,602,298,304,220
"36042","E01001700",2011,703,228,475,206
"36043","E01001701",2011,598,197,401,246
"36044","E01001702",2011,475,323,152,48
"36045","E01001703",2011,753,555,198,87
"36046","E01001704",2011,615,171,444,112
"36047","E01001705",2011,760,485,275,131
"36048","E01001706",2011,479,314,165,61
"36049","E01001708",2011,640,199,441,108
"36050","E01001709",2011,494,312,182,89
"36051","E01001710",2011,685,537,148,77
"36052","E01001711",2011,612,157,455,268
"36053","E01001712",2011,935,647,288,151
"36054","E01001713",2011,636,528,108,47
"36055","E01001714",2011,632,377,255,124
"36056","E01001715",2011,673,112,561,372
"36057","E01001716",2011,633,216,417,238
"36058","E01001717",2011,427,153,274,98
"36059","E01001718",2011,824,44,780,458
"36060","E01001719",2011,484,284,200,105
"36061","E01001720",2011,785,99,686,393
"36062","E01001722",2011,860,456,404,221
"36063","E01001723",2011,671,131,540,297
"36064","E01001724",2011,980,170,810,451
"36065","E01001725",2011,573,184,389,226
"36066","E01001726",2011,464,254,210,115
"36067","E01001727",2011,573,136,437,232
"36068","E01001728",2011,627,275,352,222
"36069","E01001729",2011,863,557,306,143
"36070","E01001730",2011,801,575,226,118
"36071","E01001731",2011,1033,543,490,286
"36072","E01001732",2011,696,487,209,87
"36073","E01001733",2011,701,145,556,233
"36074","E01001734",2011,849,257,592,392
"36075","E01001735",2011,661,292,369,118
"36076","E01001736",2011,707,198,509,225
"36077","E01001737",2011,754,200,554,205
"36078","E01001738",2011,785,239,546,262
"36079","E01001739",2011,898,224,674,243
"36080","E01001740",2011,624,419,205,89
"36081","E01001741",2011,599,110,489,155
"36082","E01001742",2011,789,365,424,148
"36083","E01001744",2011,786,366,420,157
"36084","E01001745",2011,958,524,434,261
"36085","E01001746",2011,632,508,124,58
"36086","E01001747",2011,943,235,708,390
"36087","E01001748",2011,1090,370,720,431
"36088","E01001749",2011,743,220,523,205
"36089","E01001750",2011,782,318,464,217
"36090","E01001751",2011,676,72,604,235
"36091","E01001752",2011,1060,355,705,311
"36092","E01001753",2011,687,512,175,87
"36093","E01001754",2011,1135,486,649,391
"36094","E01001755",2011,724,459,265,125
"36095","E01001756",2011,987,215,772,440
"36096","E01001757",2011,654,465,189,96
"36097","E01001758",2011,884,485,399,204
"36098","E01001759",2011,750,369,381,183
"36099","E01001760",2011,765,317,448,306
"36100","E01001761",2011,869,526,343,186
"36101","E01001762",2011,820,256,564,326
"36102","E01001763",2011,742,360,382,181
"36103","E01001764",2011,696,297,399,174
"36104","E01001765",2011,722,579,143,64
"36105","E01001767",2011,628,207,421,218
"36106","E01001768",2011,719,179,540,261
"36107","E01001769",2011,662,253,409,206
"36108","E01001770",2011,784,426,358,176
"36109","E01001772",2011,459,353,106,42
"36110","E01001773",2011,860,464,396,231
"36111","E01001774",2011,875,366,509,295
"36112","E01001775",2011,759,495,264,114
"36113","E01001776",2011,634,436,198,93
"36114","E01001777",2011,1043,472,571,396
"36115","E01001779",2011,1121,589,532,232
"36116","E01001780",2011,916,560,356,188
"36117","E01001781",2011,731,506,225,140
"36118","E01001782",2011,1053,348,705,336
"36119","E01001783",2011,863,634,229,120
"36120","E01001784",2011,797,462,335,180
"36121","E01001785",2011,569,193,376,126
"36122","E01001786",2011,717,515,202,84
"36123","E01001787",2011,628,445,183,56
"36124","E01001788",2011,670,471,199,107
"36125","E01001789",2011,646,220,426,154
"36126","E01001790",2011,492,360,132,70
"36127","E01001791",2011,500,241,259,69
"36128","E01001792",2011,620,197,423,140
"36129","E01001793",2011,656,180,476,203
"36130","E01001794",2011,656,117,539,209
"36131","E01001795",2011,571,112,459,238
"36132","E01001796",2011,737,205,532,311
"36133","E01001798",2011,694,344,350,196
"36134","E01001799",2011,485,85,400,211
"36135","E01001800",2011,643,387,256,169
"36136","E01001801",2011,588,283,305,125
"36137","E01001802",2011,471,234,237,115
"36138","E01001803",2011,719,134,585,259
"36139","E01001804",2011,464,131,333,181
"36140","E01001805",2011,510,114,396,230
"36141","E01001806",2011,714,333,381,156
"36142","E01001807",2011,693,288,405,230
"36143","E01001808",2011,558,80,478,335
"36144","E01001809",2011,610,179,431,250
"36145","E01001811",2011,646,457,189,107
"36146","E01001812",2011,614,278,336,186
"36147","E01001813",2011,525,356,169,108
"36148","E01001814",2011,559,128,431,209
"36149","E01001815",2011,692,446,246,96
"36150","E01001816",2011,640,248,392,114
"36151","E01001819",2011,684,320,364,123
"36152","E01001820",2011,599,382,217,77
"36153","E01001821",2011,644,460,184,76
"36154","E01001822",2011,706,392,314,190
"36155","E01001823",2011,538,193,345,159
"36156","E01001824",2011,539,271,268,136
"36157","E01001825",2011,428,56,372,209
"36158","E01001826",2011,585,229,356,205
"36159","E01001827",2011,716,416,300,165
"36160","E01001828",2011,831,484,347,156
"36161","E01001829",2011,696,79,617,199
"36162","E01001830",2011,932,524,408,248
"36163","E01001831",2011,745,209,536,317
"36164","E01001832",2011,642,180,462,234
"36165","E01001833",2011,931,360,571,268
"36166","E01001834",2011,862,262,600,344
"36167","E01001835",2011,483,90,393,124
"36168","E01001836",2011,857,440,417,193
"36169","E01001837",2011,665,191,474,178
"36170","E01001838",2011,705,561,144,52
"36171","E01001839",2011,941,315,626,402
"36172","E01001840",2011,715,478,237,79
"36173","E01001841",2011,626,304,322,91
"36174","E01001842",2011,631,405,226,91
"36175","E01001843",2011,502,254,248,74
"36176","E01001844",2011,812,347,465,198
"36177","E01001845",2011,680,549,131,62
"36178","E01001846",2011,535,321,214,83
"36179","E01001847",2011,467,216,251,106
"36180","E01001848",2011,655,310,345,133
"36181","E01001849",2011,977,336,641,333
"36182","E01001850",2011,676,503,173,92
"36183","E01001851",2011,696,108,588,234
"36184","E01001852",2011,956,146,810,423
"36185","E01001853",2011,695,116,579,274
"36186","E01001854",2011,887,195,692,351
"36187","E01001855",2011,894,153,741,369
"36188","E01001856",2011,730,287,443,264
"36189","E01001857",2011,733,386,347,203
"36190","E01001858",2011,732,268,464,220
"36191","E01001859",2011,1140,399,741,296
"36192","E01001860",2011,795,351,444,254
"36193","E01001861",2011,654,261,393,184
"36194","E01001862",2011,830,387,443,211
"36195","E01001863",2011,671,156,515,189
"36196","E01001864",2011,761,226,535,279
"36197","E01001865",2011,651,120,531,204
"36198","E01001866",2011,704,93,611,299
"36199","E01001867",2011,612,88,524,263
"36200","E01001868",2011,603,362,241,164
"36201","E01001869",2011,574,93,481,209
"36202","E01001870",2011,1009,131,878,538
"36203","E01001871",2011,769,96,673,340
"36204","E01001872",2011,759,141,618,338
"36205","E01001873",2011,689,250,439,218
"36206","E01001874",2011,966,530,436,218
"36207","E01001875",2011,666,357,309,114
"36208","E01001876",2011,834,615,219,81
"36209","E01001877",2011,603,184,419,178
"36210","E01001878",2011,605,368,237,82
"36211","E01001879",2011,633,207,426,195
"36212","E01001880",2011,757,291,466,251
"36213","E01001881",2011,681,116,565,276
"36214","E01001882",2011,702,77,625,306
"36215","E01001883",2011,734,257,477,272
"36216","E01001884",2011,931,431,500,280
"36217","E01001885",2011,538,423,115,51
"36218","E01001886",2011,628,243,385,159
"36219","E01001887",2011,658,286,372,180
"36220","E01001888",2011,644,101,543,152
"36221","E01001889",2011,593,116,477,190
"36222","E01001890",2011,950,466,484,283
"36223","E01001891",2011,863,63,800,459
"36224","E01001892",2011,605,303,302,121
"36225","E01001893",2011,504,297,207,103
"36226","E01001894",2011,602,262,340,173
"36227","E01001895",2011,674,185,489,219
"36228","E01001896",2011,669,234,435,221
"36229","E01001897",2011,619,146,473,186
"36230","E01001898",2011,736,138,598,337
"36231","E01001899",2011,691,448,243,122
"36232","E01001900",2011,723,370,353,195
"36233","E01001901",2011,695,96,599,227
"36234","E01001902",2011,814,181,633,348
"36235","E01001903",2011,681,262,419,184
"36236","E01001904",2011,681,67,614,242
"36237","E01001905",2011,750,104,646,272
"36238","E01001906",2011,656,94,562,246
"36239","E01001907",2011,563,74,489,187
"36240","E01001908",2011,875,119,756,490
"36241","E01001909",2011,821,282,539,266
"36242","E01001910",2011,840,179,661,398
"36243","E01001911",2011,751,450,301,124
"36244","E01001912",2011,600,351,249,127
"36245","E01001913",2011,774,29,745,383
"36246","E01001914",2011,887,174,713,469
"36247","E01001915",2011,608,91,517,161
"36248","E01001916",2011,689,17,672,186
"36249","E01001917",2011,684,191,493,180
"36250","E01001918",2011,622,85,537,152
"36251","E01001919",2011,639,77,562,138
"36252","E01001920",2011,828,398,430,212
"36253","E01001921",2011,663,147,516,213
"36254","E01001922",2011,671,86,585,198
"36255","E01001923",2011,653,169,484,190
"36256","E01001924",2011,604,41,563,199
"36257","E01001925",2011,624,76,548,168
"36258","E01001926",2011,613,41,572,189
"36259","E01001927",2011,557,35,522,142
"36260","E01001928",2011,722,207,515,199
"36261","E01001929",2011,597,68,529,161
"36262","E01001930",2011,842,315,527,222
"36263","E01001931",2011,709,161,548,291
"36264","E01001932",2011,757,209,548,325
"36265","E01001933",2011,635,124,511,155
"36266","E01001934",2011,699,314,385,150
"36267","E01001935",2011,927,284,643,250
"36268","E01001937",2011,760,94,666,284
"36269","E01001938",2011,616,279,337,106
"36270","E01001939",2011,985,407,578,177
"36271","E01001940",2011,740,284,456,271
"36272","E01001941",2011,717,148,569,372
"36273","E01001942",2011,865,234,631,367
"36274","E01001943",2011,905,278,627,374
"36275","E01001944",2011,869,649,220,107
"36276","E01001945",2011,754,242,512,219
"36277","E01001946",2011,702,269,433,222
"36278","E01001947",2011,591,428,163,72
"36279","E01001948",2011,922,140,782,327
"36280","E01001949",2011,658,59,599,285
"36281","E01001950",2011,636,45,591,255
"36282","E01001951",2011,705,168,537,246
"36283","E01001952",2011,809,130,679,385
"36284","E01001953",2011,610,201,409,255
"36285","E01001954",2011,649,268,381,123
"36286","E01001955",2011,674,410,264,102
"36287","E01001956",2011,603,230,373,110
"36288","E01001957",2011,605,419,186,91
"36289","E01001958",2011,614,484,130,63
"36290","E01001959",2011,588,278,310,73
"36291","E01001960",2011,750,159,591,293
"36292","E01001961",2011,540,378,162,80
"36293","E01001962",2011,641,104,537,104
"36294","E01001963",2011,691,45,646,134
"36295","E01001964",2011,667,69,598,218
"36296","E01001965",2011,657,68,589,115
"36297","E01001966",2011,535,26,509,106
"36298","E01001967",2011,633,36,597,137
"36299","E01001968",2011,778,66,712,303
"36300","E01001969",2011,857,224,633,337
"36301","E01001970",2011,728,293,435,205
"36302","E01001971",2011,784,453,331,141
"36303","E01001972",2011,749,274,475,174
"36304","E01001973",2011,943,230,713,254
"36305","E01001974",2011,959,81,878,433
"36306","E01001975",2011,776,91,685,351
"36307","E01001976",2011,635,180,455,198
"36308","E01001977",2011,605,204,401,190
"36309","E01001978",2011,819,336,483,245
"36310","E01001979",2011,846,313,533,281
"36311","E01001980",2011,673,129,544,229
"36312","E01001981",2011,601,131,470,223
"36313","E01001982",2011,676,146,530,228
"36314","E01001983",2011,612,104,508,164
"36315","E01001984",2011,867,116,751,339
"36316","E01001985",2011,769,53,716,243
"36317","E01001986",2011,744,109,635,228
"36318","E01001987",2011,805,24,781,264
"36319","E01001988",2011,881,117,764,358
"36320","E01001989",2011,766,105,661,208
"36321","E01001990",2011,982,68,914,529
"36322","E01001991",2011,766,50,716,410
"36323","E01001992",2011,672,29,643,188
"36324","E01001993",2011,609,47,562,88
"36325","E01001994",2011,760,65,695,267
"36326","E01001995",2011,898,302,596,108
"36327","E01001996",2011,698,56,642,244
"36328","E01001997",2011,730,28,702,398
"36329","E01001998",2011,865,69,796,423
"36330","E01001999",2011,819,75,744,380
"36331","E01002000",2011,690,73,617,272
"36332","E01002001",2011,677,67,610,303
"36333","E01002002",2011,781,114,667,391
"36334","E01002003",2011,929,252,677,499
"36335","E01002004",2011,710,110,600,225
"36336","E01002005",2011,818,60,758,449
"36337","E01002006",2011,808,59,749,357
"36338","E01002007",2011,799,37,762,328
"36339","E01002008",2011,643,88,555,151
"36340","E01002009",2011,708,28,680,273
"36341","E01002010",2011,718,192,526,149
"36342","E01002011",2011,761,117,644,259
"36343","E01002013",2011,595,67,528,122
"36344","E01002014",2011,797,147,650,328
"36345","E01002015",2011,668,284,384,103
"36346","E01002016",2011,864,260,604,237
"36347","E01002017",2011,751,142,609,252
"36348","E01002018",2011,602,216,386,87
"36349","E01002019",2011,503,20,483,83
"36350","E01002020",2011,706,118,588,248
"36351","E01002021",2011,603,60,543,106
"36352","E01002022",2011,867,31,836,516
"36353","E01002023",2011,609,58,551,124
"36354","E01002024",2011,534,108,426,105
"36355","E01002025",2011,670,27,643,190
"36356","E01002026",2011,711,502,209,101
"36357","E01002027",2011,552,170,382,168
"36358","E01002028",2011,645,179,466,194
"36359","E01002029",2011,740,315,425,174
"36360","E01002030",2011,658,116,542,263
"36361","E01002031",2011,764,132,632,396
"36362","E01002032",2011,759,384,375,154
"36363","E01002033",2011,709,316,393,170
"36364","E01002034",2011,811,462,349,192
"36365","E01002036",2011,637,249,388,157
"36366","E01002037",2011,697,349,348,216
"36367","E01002038",2011,692,313,379,253
"36368","E01002039",2011,639,501,138,65
"36369","E01002040",2011,740,233,507,218
"36370","E01002041",2011,736,283,453,190
"36371","E01002042",2011,541,60,481,212
"36372","E01002043",2011,742,117,625,329
"36373","E01002044",2011,693,73,620,327
"36374","E01002045",2011,803,294,509,257
"36375","E01002046",2011,676,262,414,165
"36376","E01002047",2011,592,74,518,261
"36377","E01002048",2011,690,163,527,224
"36378","E01002049",2011,705,243,462,163
"36379","E01002050",2011,467,55,412,190
"36380","E01002051",2011,667,234,433,257
"36381","E01002052",2011,526,107,419,171
"36382","E01002053",2011,663,294,369,174
"36383","E01002054",2011,697,416,281,131
"36384","E01002055",2011,456,61,395,190
"36385","E01002056",2011,841,326,515,243
"36386","E01002057",2011,557,148,409,180
"36387","E01002058",2011,681,125,556,302
"36388","E01002059",2011,710,237,473,132
"36389","E01002060",2011,763,110,653,216
"36390","E01002061",2011,703,88,615,239
"36391","E01002062",2011,855,118,737,327
"36392","E01002063",2011,713,198,515,226
"36393","E01002064",2011,648,237,411,178
"36394","E01002065",2011,815,205,610,343
"36395","E01002066",2011,781,439,342,165
"36396","E01002067",2011,700,340,360,157
"36397","E01002068",2011,739,193,546,305
"36398","E01002069",2011,880,305,575,347
"36399","E01002070",2011,789,143,646,273
"36400","E01002071",2011,675,349,326,165
"36401","E01002072",2011,680,285,395,175
"36402","E01002073",2011,681,271,410,192
"36403","E01002074",2011,849,372,477,220
"36404","E01002075",2011,595,232,363,140
"36405","E01002076",2011,639,168,471,189
"36406","E01002077",2011,686,400,286,156
"36407","E01002078",2011,951,431,520,209
"36408","E01002079",2011,539,83,456,187
"36409","E01002080",2011,510,80,430,175
"36410","E01002081",2011,615,343,272,140
"36411","E01002082",2011,568,451,117,46
"36412","E01002083",2011,543,33,510,203
"36413","E01002084",2011,619,102,517,196
"36414","E01002085",2011,821,216,605,317
"36415","E01002086",2011,605,219,386,146
"36416","E01002087",2011,714,192,522,266
"36417","E01002088",2011,688,112,576,228
"36418","E01002089",2011,644,549,95,39
"36419","E01002090",2011,531,201,330,99
"36420","E01002091",2011,635,346,289,85
"36421","E01002092",2011,689,211,478,268
"36422","E01002093",2011,645,372,273,84
"36423","E01002094",2011,541,268,273,89
"36424","E01002095",2011,604,344,260,109
"36425","E01002096",2011,583,332,251,57
"36426","E01002097",2011,592,273,319,97
"36427","E01002098",2011,604,101,503,217
"36428","E01002099",2011,813,454,359,175
"36429","E01002100",2011,680,185,495,189
"36430","E01002101",2011,698,56,642,271
"36431","E01002102",2011,752,118,634,362
"36432","E01002103",2011,646,94,552,238
"36433","E01002104",2011,501,105,396,114
"36434","E01002105",2011,861,176,685,455
"36435","E01002106",2011,651,30,621,78
"36436","E01002107",2011,575,5,570,71
"36437","E01002108",2011,559,6,553,56
"36438","E01002109",2011,654,26,628,82
"36439","E01002110",2011,542,6,536,84
"36440","E01002111",2011,681,64,617,114
"36441","E01002112",2011,697,32,665,105
"36442","E01002113",2011,599,121,478,77
"36443","E01002114",2011,986,208,778,192
"36444","E01002115",2011,509,37,472,77
"36445","E01002116",2011,680,18,662,151
"36446","E01002117",2011,675,55,620,128
"36447","E01002118",2011,675,19,656,253
"36448","E01002119",2011,568,71,497,146
"36449","E01002120",2011,488,196,292,78
"36450","E01002121",2011,546,16,530,111
"36451","E01002122",2011,582,16,566,143
"36452","E01002123",2011,527,19,508,169
"36453","E01002124",2011,492,26,466,101
"36454","E01002125",2011,512,39,473,151
"36455","E01002126",2011,1203,123,1080,577
"36456","E01002127",2011,628,18,610,200
"36457","E01002128",2011,784,26,758,410
"36458","E01002129",2011,889,136,753,328
"36459","E01002130",2011,884,82,802,478
"36460","E01002131",2011,586,182,404,119
"36461","E01002132",2011,828,14,814,310
"36462","E01002133",2011,896,456,440,166
"36463","E01002134",2011,603,13,590,199
"36464","E01002135",2011,657,97,560,192
"36465","E01002136",2011,638,25,613,172
"36466","E01002137",2011,468,4,464,139
"36467","E01002138",2011,509,24,485,147
"36468","E01002139",2011,498,289,209,46
"36469","E01002140",2011,607,86,521,103
"36470","E01002141",2011,680,67,613,72
"36471","E01002142",2011,635,10,625,108
"36472","E01002143",2011,529,73,456,109
"36473","E01002144",2011,580,58,522,49
"36474","E01002145",2011,631,80,551,83
"36475","E01002146",2011,519,3,516,38
"36476","E01002147",2011,502,4,498,56
"36477","E01002148",2011,491,31,460,42
"36478","E01002149",2011,479,2,477,25
"36479","E01002150",2011,839,33,806,264
"36480","E01002151",2011,524,255,269,54
"36481","E01002152",2011,638,12,626,103
"36482","E01002153",2011,616,5,611,68
"36483","E01002154",2011,728,87,641,145
"36484","E01002155",2011,641,23,618,58
"36485","E01002156",2011,501,6,495,33
"36486","E01002157",2011,593,20,573,133
"36487","E01002158",2011,491,1,490,38
"36488","E01002159",2011,685,50,635,138
"36489","E01002160",2011,704,22,682,272
"36490","E01002161",2011,728,82,646,173
"36491","E01002162",2011,687,96,591,166
"36492","E01002163",2011,537,12,525,63
"36493","E01002164",2011,683,26,657,198
"36494","E01002165",2011,528,24,504,173
"36495","E01002166",2011,484,20,464,91
"36496","E01002167",2011,477,87,390,113
"36497","E01002168",2011,511,208,303,62
"36498","E01002169",2011,531,113,418,112
"36499","E01002170",2011,408,56,352,49
"36500","E01002171",2011,534,7,527,134
"36501","E01002172",2011,493,44,449,65
"36502","E01002173",2011,529,6,523,76
"36503","E01002174",2011,483,9,474,85
"36504","E01002175",2011,406,12,394,54
"36505","E01002176",2011,535,7,528,132
"36506","E01002177",2011,452,9,443,91
"36507","E01002178",2011,502,16,486,41
"36508","E01002179",2011,795,138,657,245
"36509","E01002180",2011,783,189,594,251
"36510","E01002181",2011,682,13,669,225
"36511","E01002182",2011,689,12,677,253
"36512","E01002183",2011,682,32,650,179
"36513","E01002184",2011,677,94,583,176
"36514","E01002185",2011,585,295,290,62
"36515","E01002186",2011,794,129,665,184
"36516","E01002187",2011,761,103,658,104
"36517","E01002188",2011,638,5,633,55
"36518","E01002189",2011,714,55,659,171
"36519","E01002190",2011,625,14,611,34
"36520","E01002191",2011,667,19,648,86
"36521","E01002192",2011,638,44,594,74
"36522","E01002193",2011,740,126,614,118
"36523","E01002194",2011,657,36,621,48
"36524","E01002195",2011,610,30,580,58
"36525","E01002196",2011,616,8,608,30
"36526","E01002197",2011,420,13,407,56
"36527","E01002198",2011,499,7,492,137
"36528","E01002199",2011,467,12,455,73
"36529","E01002200",2011,505,31,474,102
"36530","E01002201",2011,508,7,501,75
"36531","E01002202",2011,712,52,660,362
"36532","E01002203",2011,524,18,506,125
"36533","E01002204",2011,634,34,600,267
"36534","E01002206",2011,457,5,452,99
"36535","E01002207",2011,524,15,509,92
"36536","E01002208",2011,483,4,479,40
"36537","E01002209",2011,546,7,539,152
"36538","E01002210",2011,504,9,495,89
"36539","E01002211",2011,477,168,309,80
"36540","E01002212",2011,647,95,552,207
"36541","E01002213",2011,1116,117,999,406
"36542","E01002214",2011,612,104,508,140
"36543","E01002215",2011,595,261,334,96
"36544","E01002216",2011,513,25,488,91
"36545","E01002217",2011,552,378,174,49
"36546","E01002218",2011,606,18,588,159
"36547","E01002219",2011,605,54,551,211
"36548","E01002220",2011,493,42,451,74
"36549","E01002221",2011,511,48,463,137
"36550","E01002222",2011,488,19,469,102
"36551","E01002223",2011,591,30,561,111
"36552","E01002224",2011,497,149,348,59
"36553","E01002225",2011,623,15,608,67
"36554","E01002226",2011,1003,109,894,239
"36555","E01002227",2011,611,293,318,52
"36556","E01002228",2011,710,97,613,172
"36557","E01002229",2011,770,124,646,142
"36558","E01002230",2011,637,13,624,64
"36559","E01002231",2011,679,82,597,172
"36560","E01002232",2011,709,91,618,183
"36561","E01002233",2011,754,101,653,269
"36562","E01002234",2011,548,44,504,145
"36563","E01002235",2011,610,210,400,114
"36564","E01002236",2011,582,60,522,162
"36565","E01002237",2011,648,83,565,254
"36566","E01002238",2011,596,35,561,148
"36567","E01002239",2011,635,8,627,127
"36568","E01002240",2011,655,113,542,119
"36569","E01002241",2011,536,101,435,76
"36570","E01002242",2011,613,13,600,88
"36571","E01002243",2011,847,318,529,196
"36572","E01002244",2011,749,88,661,147
"36573","E01002245",2011,630,87,543,93
"36574","E01002246",2011,637,23,614,88
"36575","E01002247",2011,729,39,690,154
"36576","E01002248",2011,592,127,465,92
"36577","E01002249",2011,746,179,567,127
"36578","E01002250",2011,642,33,609,102
"36579","E01002251",2011,526,166,360,46
"36580","E01002252",2011,617,20,597,26
"36581","E01002253",2011,615,2,613,10
"36582","E01002254",2011,636,4,632,35
"36583","E01002255",2011,630,13,617,41
"36584","E01002256",2011,620,15,605,46
"36585","E01002257",2011,651,2,649,49
"36586","E01002258",2011,797,171,626,91
"36587","E01002259",2011,612,20,592,27
"36588","E01002260",2011,566,29,537,63
"36589","E01002261",2011,645,18,627,95
"36590","E01002262",2011,625,117,508,40
"36591","E01002263",2011,609,19,590,34
"36592","E01002264",2011,710,331,379,59
"36593","E01002265",2011,638,19,619,57
"36594","E01002266",2011,600,34,566,30
"36595","E01002267",2011,734,206,528,53
"36596","E01002268",2011,519,40,479,22
"36597","E01002269",2011,678,13,665,45
"36598","E01002270",2011,634,98,536,37
"36599","E01002271",2011,515,2,513,14
"36600","E01002272",2011,536,10,526,42
"36601","E01002273",2011,490,3,487,20
"36602","E01002274",2011,692,8,684,73
"36603","E01002275",2011,517,4,513,22
"36604","E01002276",2011,694,178,516,48
"36605","E01002277",2011,608,246,362,34
"36606","E01002278",2011,631,274,357,33
"36607","E01002279",2011,634,204,430,54
"36608","E01002280",2011,621,334,287,54
"36609","E01002281",2011,756,414,342,77
"36610","E01002282",2011,668,389,279,56
"36611","E01002283",2011,594,202,392,47
"36612","E01002284",2011,765,261,504,52
"36613","E01002285",2011,520,10,510,36
"36614","E01002286",2011,614,5,609,19
"36615","E01002287",2011,602,14,588,46
"36616","E01002288",2011,554,12,542,32
"36617","E01002289",2011,621,51,570,32
"36618","E01002290",2011,641,12,629,25
"36619","E01002291",2011,775,9,766,165
"36620","E01002292",2011,637,104,533,40
"36621","E01002293",2011,801,63,738,191
"36622","E01002294",2011,626,71,555,52
"36623","E01002295",2011,670,66,604,90
"36624","E01002296",2011,691,40,651,41
"36625","E01002297",2011,670,368,302,55
"36626","E01002298",2011,654,47,607,49
"36627","E01002299",2011,664,168,496,51
"36628","E01002300",2011,715,56,659,94
"36629","E01002301",2011,627,44,583,35
"36630","E01002302",2011,598,48,550,51
"36631","E01002303",2011,823,243,580,79
"36632","E01002304",2011,524,47,477,41
"36633","E01002305",2011,608,68,540,38
"36634","E01002306",2011,625,309,316,31
"36635","E01002307",2011,636,154,482,44
"36636","E01002308",2011,670,138,532,69
"36637","E01002309",2011,651,170,481,59
"36638","E01002310",2011,712,301,411,65
"36639","E01002311",2011,668,190,478,53
"36640","E01002312",2011,642,163,479,31
"36641","E01002313",2011,630,202,428,62
"36642","E01002314",2011,623,313,310,40
"36643","E01002315",2011,633,187,446,63
"36644","E01002316",2011,740,438,302,57
"36645","E01002317",2011,544,15,529,19
"36646","E01002318",2011,614,22,592,33
"36647","E01002319",2011,652,111,541,65
"36648","E01002320",2011,537,10,527,32
"36649","E01002321",2011,635,19,616,67
"36650","E01002322",2011,731,30,701,53
"36651","E01002323",2011,627,7,620,44
"36652","E01002324",2011,650,145,505,53
"36653","E01002325",2011,755,248,507,65
"36654","E01002326",2011,627,62,565,88
"36655","E01002327",2011,595,41,554,39
"36656","E01002328",2011,642,21,621,50
"36657","E01002329",2011,643,23,620,61
"36658","E01002330",2011,737,103,634,97
"36659","E01002331",2011,596,39,557,50
"36660","E01002332",2011,683,63,620,57
"36661","E01002333",2011,516,4,512,28
"36662","E01002334",2011,674,15,659,29
"36663","E01002335",2011,592,141,451,48
"36664","E01002336",2011,612,17,595,43
"36665","E01002337",2011,512,61,451,38
"36666","E01002338",2011,523,13,510,57
"36667","E01002339",2011,602,9,593,21
"36668","E01002340",2011,509,10,499,48
"36669","E01002341",2011,557,7,550,13
"36670","E01002342",2011,632,84,548,113
"36671","E01002343",2011,636,7,629,45
"36672","E01002344",2011,638,24,614,88
"36673","E01002345",2011,756,159,597,195
"36674","E01002346",2011,557,105,452,88
"36675","E01002347",2011,526,12,514,63
"36676","E01002348",2011,642,7,635,32
"36677","E01002349",2011,608,47,561,36
"36678","E01002350",2011,711,106,605,220
"36679","E01002351",2011,653,26,627,122
"36680","E01002352",2011,722,49,673,166
"36681","E01002353",2011,832,130,702,151
"36682","E01002354",2011,561,5,556,54
"36683","E01002355",2011,574,10,564,37
"36684","E01002356",2011,1037,367,670,304
"36685","E01002358",2011,791,65,726,224
"36686","E01002359",2011,515,4,511,26
"36687","E01002360",2011,742,145,597,87
"36688","E01002361",2011,822,162,660,201
"36689","E01002362",2011,616,18,598,95
"36690","E01002363",2011,686,215,471,46
"36691","E01002364",2011,542,15,527,35
"36692","E01002365",2011,552,32,520,63
"36693","E01002366",2011,568,35,533,32
"36694","E01002367",2011,658,21,637,133
"36695","E01002368",2011,696,354,342,63
"36696","E01002369",2011,730,71,659,81
"36697","E01002370",2011,846,264,582,86
"36698","E01002371",2011,643,39,604,55
"36699","E01002372",2011,603,26,577,48
"36700","E01002373",2011,628,44,584,55
"36701","E01002374",2011,604,89,515,52
"36702","E01002375",2011,688,189,499,54
"36703","E01002376",2011,520,5,515,35
"36704","E01002377",2011,711,82,629,87
"36705","E01002378",2011,604,14,590,38
"36706","E01002379",2011,659,17,642,147
"36707","E01002380",2011,1036,212,824,258
"36708","E01002381",2011,645,101,544,55
"36709","E01002382",2011,765,43,722,145
"36710","E01002383",2011,659,21,638,45
"36711","E01002384",2011,644,20,624,55
"36712","E01002385",2011,601,16,585,37
"36713","E01002386",2011,871,25,846,221
"36714","E01002387",2011,607,2,605,14
"36715","E01002388",2011,608,3,605,21
"36716","E01002389",2011,623,5,618,18
"36717","E01002390",2011,531,4,527,12
"36718","E01002391",2011,608,23,585,25
"36719","E01002392",2011,618,314,304,66
"36720","E01002393",2011,705,145,560,139
"36721","E01002394",2011,508,52,456,100
"36722","E01002395",2011,424,29,395,82
"36723","E01002396",2011,563,177,386,109
"36724","E01002397",2011,514,66,448,164
"36725","E01002398",2011,493,27,466,126
"36726","E01002399",2011,474,17,457,95
"36727","E01002400",2011,599,136,463,111
"36728","E01002401",2011,609,122,487,151
"36729","E01002402",2011,491,150,341,81
"36730","E01002403",2011,543,155,388,81
"36731","E01002404",2011,675,243,432,109
"36732","E01002405",2011,634,149,485,129
"36733","E01002406",2011,680,134,546,161
"36734","E01002407",2011,725,158,567,165
"36735","E01002408",2011,629,215,414,118
"36736","E01002409",2011,672,205,467,130
"36737","E01002410",2011,638,43,595,128
"36738","E01002411",2011,632,181,451,108
"36739","E01002412",2011,822,96,726,199
"36740","E01002413",2011,594,203,391,84
"36741","E01002414",2011,527,51,476,176
"36742","E01002415",2011,643,9,634,39
"36743","E01002416",2011,593,33,560,42
"36744","E01002417",2011,638,9,629,79
"36745","E01002418",2011,658,91,567,37
"36746","E01002419",2011,611,12,599,87
"36747","E01002420",2011,662,130,532,69
"36748","E01002421",2011,636,40,596,63
"36749","E01002422",2011,494,15,479,93
"36750","E01002423",2011,568,46,522,54
"36751","E01002424",2011,526,15,511,100
"36752","E01002425",2011,613,135,478,124
"36753","E01002426",2011,631,24,607,136
"36754","E01002427",2011,514,21,493,63
"36755","E01002428",2011,496,29,467,56
"36756","E01002429",2011,498,135,363,65
"36757","E01002430",2011,524,15,509,20
"36758","E01002431",2011,489,4,485,26
"36759","E01002432",2011,635,12,623,131
"36760","E01002433",2011,782,148,634,66
"36761","E01002434",2011,504,25,479,28
"36762","E01002435",2011,535,10,525,26
"36763","E01002436",2011,658,80,578,56
"36764","E01002437",2011,608,45,563,37
"36765","E01002438",2011,480,52,428,46
"36766","E01002439",2011,608,139,469,90
"36767","E01002440",2011,618,179,439,28
"36768","E01002441",2011,667,181,486,88
"36769","E01002442",2011,635,172,463,55
"36770","E01002443",2011,547,19,528,207
"36771","E01002444",2011,625,42,583,205
"36772","E01002445",2011,588,265,323,87
"36773","E01002446",2011,592,73,519,174
"36774","E01002447",2011,623,90,533,268
"36775","E01002448",2011,765,111,654,249
"36776","E01002449",2011,710,57,653,305
"36777","E01002450",2011,503,9,494,59
"36778","E01002451",2011,493,32,461,53
"36779","E01002452",2011,500,31,469,56
"36780","E01002453",2011,599,44,555,83
"36781","E01002454",2011,661,162,499,73
"36782","E01002455",2011,652,108,544,119
"36783","E01002456",2011,621,105,516,126
"36784","E01002457",2011,517,181,336,95
"36785","E01002458",2011,543,8,535,37
"36786","E01002459",2011,622,2,620,37
"36787","E01002460",2011,597,51,546,82
"36788","E01002461",2011,516,23,493,42
"36789","E01002462",2011,506,9,497,74
"36790","E01002463",2011,528,24,504,33
"36791","E01002464",2011,623,55,568,40
"36792","E01002465",2011,633,33,600,143
"36793","E01002466",2011,633,11,622,45
"36794","E01002467",2011,639,11,628,57
"36795","E01002468",2011,633,14,619,61
"36796","E01002469",2011,631,14,617,61
"36797","E01002470",2011,702,82,620,177
"36798","E01002471",2011,634,20,614,53
"36799","E01002472",2011,771,80,691,232
"36800","E01002473",2011,636,154,482,40
"36801","E01002474",2011,643,90,553,109
"36802","E01002475",2011,692,183,509,138
"36803","E01002476",2011,611,23,588,87
"36804","E01002477",2011,559,63,496,128
"36805","E01002478",2011,666,57,609,174
"36806","E01002479",2011,628,193,435,40
"36807","E01002480",2011,713,19,694,92
"36808","E01002481",2011,659,202,457,80
"36809","E01002482",2011,617,10,607,51
"36810","E01002483",2011,714,32,682,200
"36811","E01002484",2011,585,143,442,78
"36812","E01002485",2011,762,128,634,212
"36813","E01002486",2011,699,187,512,101
"36814","E01002487",2011,614,150,464,106
"36815","E01002488",2011,533,51,482,99
"36816","E01002489",2011,537,49,488,159
"36817","E01002490",2011,656,50,606,165
"36818","E01002491",2011,519,159,360,88
"36819","E01002492",2011,488,48,440,106
"36820","E01002493",2011,601,256,345,100
"36821","E01002494",2011,637,67,570,89
"36822","E01002495",2011,695,68,627,175
"36823","E01002496",2011,767,91,676,176
"36824","E01002497",2011,759,91,668,220
"36825","E01002498",2011,516,32,484,50
"36826","E01002499",2011,678,63,615,127
"36827","E01002501",2011,506,112,394,88
"36828","E01002502",2011,491,167,324,62
"36829","E01002503",2011,497,133,364,119
"36830","E01002504",2011,726,126,600,180
"36831","E01002505",2011,682,291,391,139
"36832","E01002506",2011,643,233,410,208
"36833","E01002507",2011,465,28,437,103
"36834","E01002508",2011,648,310,338,103
"36835","E01002509",2011,502,7,495,43
"36836","E01002511",2011,613,161,452,69
"36837","E01002512",2011,647,13,634,82
"36838","E01002513",2011,544,68,476,45
"36839","E01002514",2011,885,101,784,245
"36840","E01002515",2011,718,189,529,179
"36841","E01002516",2011,490,9,481,60
"36842","E01002518",2011,490,21,469,92
"36843","E01002519",2011,719,164,555,177
"36844","E01002520",2011,603,143,460,144
"36845","E01002521",2011,909,372,537,247
"36846","E01002523",2011,549,64,485,156
"36847","E01002525",2011,647,58,589,102
"36848","E01002526",2011,635,248,387,81
"36849","E01002527",2011,622,101,521,154
"36850","E01002528",2011,563,174,389,59
"36851","E01002529",2011,771,145,626,227
"36852","E01002530",2011,619,292,327,81
"36853","E01002531",2011,644,108,536,80
"36854","E01002532",2011,886,294,592,213
"36855","E01002533",2011,589,131,458,45
"36856","E01002534",2011,607,105,502,52
"36857","E01002535",2011,828,57,771,266
"36858","E01002536",2011,609,15,594,233
"36859","E01002537",2011,579,11,568,161
"36860","E01002538",2011,746,109,637,61
"36861","E01002539",2011,619,76,543,38
"36862","E01002540",2011,621,137,484,117
"36863","E01002541",2011,785,58,727,137
"36864","E01002542",2011,665,209,456,146
"36865","E01002543",2011,625,183,442,95
"36866","E01002544",2011,555,24,531,123
"36867","E01002545",2011,483,319,164,58
"36868","E01002546",2011,449,16,433,117
"36869","E01002547",2011,492,73,419,113
"36870","E01002548",2011,657,286,371,69
"36871","E01002549",2011,672,118,554,92
"36872","E01002550",2011,795,163,632,272
"36873","E01002551",2011,641,172,469,97
"36874","E01002552",2011,526,159,367,73
"36875","E01002553",2011,603,253,350,101
"36876","E01002554",2011,1073,204,869,377
"36877","E01002555",2011,681,47,634,127
"36878","E01002556",2011,639,92,547,111
"36879","E01002557",2011,743,192,551,134
"36880","E01002558",2011,773,266,507,109
"36881","E01002559",2011,857,242,615,217
"36882","E01002560",2011,615,174,441,61
"36883","E01002561",2011,551,296,255,38
"36884","E01002562",2011,518,215,303,66
"36885","E01002563",2011,635,45,590,171
"36886","E01002564",2011,736,300,436,101
"36887","E01002565",2011,1020,305,715,194
"36888","E01002566",2011,1027,615,412,192
"36889","E01002567",2011,837,122,715,221
"36890","E01002568",2011,1181,643,538,154
"36891","E01002569",2011,792,102,690,214
"36892","E01002570",2011,732,130,602,266
"36893","E01002571",2011,611,27,584,173
"36894","E01002572",2011,710,370,340,94
"36895","E01002573",2011,679,72,607,180
"36896","E01002574",2011,645,47,598,210
"36897","E01002575",2011,688,47,641,220
"36898","E01002576",2011,756,252,504,145
"36899","E01002577",2011,660,74,586,155
"36900","E01002578",2011,612,94,518,107
"36901","E01002579",2011,823,116,707,147
"36902","E01002580",2011,675,204,471,252
"36903","E01002581",2011,862,92,770,296
"36904","E01002582",2011,719,114,605,133
"36905","E01002583",2011,512,41,471,148
"36906","E01002584",2011,493,42,451,172
"36907","E01002585",2011,509,119,390,119
"36908","E01002586",2011,457,12,445,135
"36909","E01002587",2011,605,137,468,173
"36910","E01002588",2011,677,544,133,46
"36911","E01002589",2011,677,250,427,176
"36912","E01002590",2011,726,150,576,139
"36913","E01002591",2011,626,169,457,55
"36914","E01002592",2011,789,229,560,167
"36915","E01002593",2011,725,99,626,127
"36916","E01002594",2011,642,57,585,115
"36917","E01002595",2011,712,239,473,74
"36918","E01002596",2011,772,121,651,277
"36919","E01002598",2011,649,199,450,107
"36920","E01002599",2011,569,185,384,45
"36921","E01002600",2011,520,168,352,59
"36922","E01002601",2011,637,57,580,153
"36923","E01002602",2011,564,29,535,50
"36924","E01002603",2011,666,202,464,121
"36925","E01002604",2011,588,426,162,37
"36926","E01002605",2011,753,241,512,115
"36927","E01002606",2011,671,434,237,43
"36928","E01002607",2011,676,123,553,128
"36929","E01002608",2011,676,253,423,86
"36930","E01002609",2011,655,53,602,71
"36931","E01002610",2011,632,266,366,47
"36932","E01002611",2011,636,124,512,68
"36933","E01002612",2011,699,207,492,102
"36934","E01002613",2011,609,95,514,78
"36935","E01002614",2011,758,67,691,222
"36936","E01002615",2011,606,353,253,40
"36937","E01002616",2011,535,70,465,51
"36938","E01002617",2011,642,41,601,68
"36939","E01002618",2011,512,17,495,81
"36940","E01002619",2011,624,88,536,125
"36941","E01002620",2011,676,196,480,191
"36942","E01002621",2011,594,145,449,126
"36943","E01002622",2011,526,87,439,128
"36944","E01002623",2011,484,132,352,114
"36945","E01002624",2011,480,95,385,126
"36946","E01002625",2011,492,25,467,99
"36947","E01002626",2011,490,50,440,105
"36948","E01002627",2011,609,277,332,107
"36949","E01002628",2011,620,36,584,182
"36950","E01002629",2011,715,162,553,185
"36951","E01002630",2011,569,34,535,214
"36952","E01002631",2011,509,45,464,138
"36953","E01002632",2011,569,100,469,81
"36954","E01002633",2011,623,349,274,81
"36955","E01002634",2011,546,322,224,63
"36956","E01002635",2011,524,44,480,147
"36957","E01002636",2011,609,74,535,126
"36958","E01002637",2011,563,227,336,109
"36959","E01002638",2011,582,236,346,87
"36960","E01002639",2011,497,6,491,173
"36961","E01002640",2011,548,15,533,231
"36962","E01002641",2011,637,157,480,216
"36963","E01002642",2011,735,124,611,354
"36964","E01002643",2011,910,251,659,145
"36965","E01002645",2011,766,199,567,231
"36966","E01002646",2011,712,258,454,215
"36967","E01002647",2011,753,211,542,163
"36968","E01002648",2011,900,123,777,364
"36969","E01002649",2011,692,109,583,295
"36970","E01002650",2011,792,174,618,223
"36971","E01002651",2011,550,64,486,171
"36972","E01002652",2011,516,42,474,139
"36973","E01002653",2011,542,13,529,107
"36974","E01002654",2011,646,23,623,117
"36975","E01002655",2011,622,17,605,153
"36976","E01002656",2011,479,38,441,58
"36977","E01002657",2011,650,25,625,136
"36978","E01002658",2011,501,16,485,98
"36979","E01002659",2011,504,68,436,87
"36980","E01002660",2011,522,75,447,174
"36981","E01002661",2011,518,19,499,169
"36982","E01002662",2011,627,34,593,256
"36983","E01002663",2011,751,273,478,161
"36984","E01002664",2011,596,115,481,221
"36985","E01002665",2011,524,191,333,104
"36986","E01002666",2011,407,40,367,104
"36987","E01002667",2011,651,195,456,129
"36988","E01002668",2011,883,154,729,259
"36989","E01002669",2011,711,300,411,100
"36990","E01002670",2011,708,74,634,154
"36991","E01002671",2011,636,137,499,54
"36992","E01002672",2011,683,302,381,180
"36993","E01002673",2011,621,506,115,35
"36994","E01002674",2011,668,11,657,234
"36995","E01002675",2011,877,100,777,164
"36996","E01002676",2011,559,4,555,141
"36997","E01002677",2011,652,121,531,194
"36998","E01002678",2011,669,10,659,218
"36999","E01002679",2011,643,31,612,177
"37000","E01002680",2011,728,54,674,230
"37001","E01002681",2011,741,256,485,184
"37002","E01002682",2011,927,234,693,124
"37003","E01002683",2011,1037,114,923,255
"37004","E01002684",2011,1096,270,826,323
"37005","E01002686",2011,681,365,316,70
"37006","E01002687",2011,832,81,751,335
"37007","E01002689",2011,796,248,548,130
"37008","E01002690",2011,612,93,519,132
"37009","E01002691",2011,591,11,580,203
"37010","E01002692",2011,911,179,732,378
"37011","E01002693",2011,841,136,705,276
"37012","E01002694",2011,669,464,205,98
"37013","E01002695",2011,795,283,512,315
"37014","E01002696",2011,895,241,654,284
"37015","E01002697",2011,709,464,245,138
"37016","E01002698",2011,1056,318,738,318
"37017","E01002699",2011,775,280,495,205
"37018","E01002700",2011,640,82,558,154
"37019","E01002701",2011,718,458,260,124
"37020","E01002702",2011,870,527,343,218
"37021","E01002703",2011,774,438,336,173
"37022","E01002704",2011,1035,541,494,233
"37023","E01002706",2011,925,523,402,228
"37024","E01002707",2011,901,386,515,316
"37025","E01002708",2011,917,366,551,324
"37026","E01002709",2011,751,395,356,220
"37027","E01002710",2011,679,398,281,109
"37028","E01002711",2011,963,286,677,418
"37029","E01002712",2011,535,184,351,189
"37030","E01002713",2011,820,549,271,102
"37031","E01002714",2011,771,141,630,296
"37032","E01002715",2011,682,414,268,164
"37033","E01002716",2011,1079,614,465,237
"37034","E01002717",2011,590,217,373,132
"37035","E01002718",2011,799,184,615,295
"37036","E01002719",2011,737,206,531,160
"37037","E01002720",2011,993,672,321,140
"37038","E01002721",2011,839,402,437,172
"37039","E01002722",2011,668,399,269,121
"37040","E01002723",2011,781,424,357,173
"37041","E01002724",2011,1025,213,812,357
"37042","E01002725",2011,572,386,186,82
"37043","E01002726",2011,825,351,474,233
"37044","E01002727",2011,871,340,531,255
"37045","E01002728",2011,509,252,257,129
"37046","E01002729",2011,702,271,431,172
"37047","E01002730",2011,812,215,597,359
"37048","E01002731",2011,1164,244,920,503
"37049","E01002732",2011,821,520,301,166
"37050","E01002733",2011,598,97,501,203
"37051","E01002734",2011,696,401,295,239
"37052","E01002735",2011,777,291,486,324
"37053","E01002736",2011,595,450,145,60
"37054","E01002737",2011,788,493,295,142
"37055","E01002738",2011,839,289,550,195
"37056","E01002739",2011,816,219,597,206
"37057","E01002740",2011,806,126,680,255
"37058","E01002741",2011,656,376,280,120
"37059","E01002742",2011,675,114,561,215
"37060","E01002743",2011,726,250,476,206
"37061","E01002744",2011,722,255,467,171
"37062","E01002745",2011,681,200,481,162
"37063","E01002747",2011,675,138,537,230
"37064","E01002748",2011,667,315,352,178
"37065","E01002749",2011,534,238,296,95
"37066","E01002751",2011,880,557,323,165
"37067","E01002752",2011,651,311,340,115
"37068","E01002753",2011,626,291,335,164
"37069","E01002754",2011,614,130,484,180
"37070","E01002755",2011,635,431,204,61
"37071","E01002756",2011,610,195,415,157
"37072","E01002757",2011,590,243,347,92
"37073","E01002758",2011,709,469,240,124
"37074","E01002759",2011,659,168,491,149
"37075","E01002760",2011,626,367,259,94
"37076","E01002762",2011,889,246,643,326
"37077","E01002763",2011,603,256,347,192
"37078","E01002764",2011,796,363,433,187
"37079","E01002765",2011,980,549,431,180
"37080","E01002766",2011,811,529,282,166
"37081","E01002767",2011,982,491,491,178
"37082","E01002768",2011,851,433,418,180
"37083","E01002769",2011,847,279,568,237
"37084","E01002770",2011,718,200,518,250
"37085","E01002771",2011,659,311,348,150
"37086","E01002772",2011,871,296,575,262
"37087","E01002773",2011,696,464,232,86
"37088","E01002774",2011,1005,460,545,284
"37089","E01002775",2011,683,213,470,229
"37090","E01002776",2011,774,357,417,178
"37091","E01002777",2011,833,331,502,211
"37092","E01002778",2011,743,483,260,136
"37093","E01002779",2011,820,253,567,258
"37094","E01002780",2011,763,352,411,158
"37095","E01002781",2011,598,339,259,104
"37096","E01002782",2011,616,411,205,86
"37097","E01002783",2011,718,386,332,152
"37098","E01002784",2011,732,377,355,156
"37099","E01002785",2011,840,212,628,235
"37100","E01002786",2011,828,418,410,229
"37101","E01002787",2011,578,311,267,147
"37102","E01002788",2011,916,222,694,290
"37103","E01002789",2011,810,137,673,204
"37104","E01002790",2011,706,527,179,102
"37105","E01002791",2011,762,220,542,250
"37106","E01002792",2011,877,250,627,310
"37107","E01002793",2011,957,512,445,231
"37108","E01002794",2011,862,265,597,323
"37109","E01002795",2011,863,321,542,287
"37110","E01002796",2011,496,195,301,139
"37111","E01002797",2011,872,454,418,193
"37112","E01002798",2011,922,236,686,220
"37113","E01002799",2011,880,521,359,164
"37114","E01002800",2011,435,337,98,36
"37115","E01002801",2011,806,222,584,240
"37116","E01002802",2011,706,167,539,217
"37117","E01002803",2011,935,306,629,263
"37118","E01002804",2011,754,406,348,188
"37119","E01002805",2011,758,207,551,346
"37120","E01002806",2011,721,255,466,148
"37121","E01002807",2011,824,400,424,228
"37122","E01002808",2011,857,261,596,272
"37123","E01002809",2011,700,260,440,192
"37124","E01002810",2011,748,365,383,153
"37125","E01002811",2011,694,384,310,102
"37126","E01002812",2011,895,57,838,483
"37127","E01002813",2011,835,43,792,341
"37128","E01002814",2011,905,275,630,328
"37129","E01002815",2011,755,55,700,357
"37130","E01002816",2011,693,7,686,406
"37131","E01002817",2011,709,14,695,251
"37132","E01002818",2011,1170,54,1116,673
"37133","E01002819",2011,853,18,835,467
"37134","E01002820",2011,666,26,640,393
"37135","E01002821",2011,692,65,627,316
"37136","E01002822",2011,621,41,580,250
"37137","E01002823",2011,701,374,327,140
"37138","E01002824",2011,684,51,633,291
"37139","E01002825",2011,827,56,771,286
"37140","E01002826",2011,798,29,769,387
"37141","E01002827",2011,903,14,889,363
"37142","E01002828",2011,710,126,584,232
"37143","E01002829",2011,788,408,380,209
"37144","E01002830",2011,917,527,390,170
"37145","E01002831",2011,961,486,475,242
"37146","E01002832",2011,910,416,494,271
"37147","E01002833",2011,793,136,657,336
"37148","E01002834",2011,718,85,633,327
"37149","E01002835",2011,784,12,772,366
"37150","E01002836",2011,795,60,735,401
"37151","E01002837",2011,717,42,675,353
"37152","E01002838",2011,579,31,548,265
"37153","E01002839",2011,978,186,792,484
"37154","E01002840",2011,691,356,335,95
"37155","E01002841",2011,712,210,502,202
"37156","E01002842",2011,514,411,103,34
"37157","E01002843",2011,610,438,172,64
"37158","E01002844",2011,745,89,656,265
"37159","E01002845",2011,738,238,500,178
"37160","E01002846",2011,781,175,606,388
"37161","E01002847",2011,872,84,788,400
"37162","E01002848",2011,894,251,643,363
"37163","E01002849",2011,787,102,685,329
"37164","E01002850",2011,682,88,594,357
"37165","E01002851",2011,918,422,496,326
"37166","E01002852",2011,861,557,304,162
"37167","E01002853",2011,470,380,90,63
"37168","E01002854",2011,488,364,124,41
"37169","E01002855",2011,764,539,225,101
"37170","E01002856",2011,941,438,503,320
"37171","E01002857",2011,580,504,76,29
"37172","E01002858",2011,749,182,567,317
"37173","E01002859",2011,866,48,818,437
"37174","E01002860",2011,777,8,769,336
"37175","E01002861",2011,771,136,635,263
"37176","E01002862",2011,977,417,560,400
"37177","E01002863",2011,792,16,776,385
"37178","E01002864",2011,580,26,554,158
"37179","E01002865",2011,544,11,533,237
"37180","E01002866",2011,848,177,671,294
"37181","E01002867",2011,998,149,849,476
"37182","E01002868",2011,725,22,703,256
"37183","E01002869",2011,768,148,620,285
"37184","E01002870",2011,693,550,143,69
"37185","E01002871",2011,742,48,694,265
"37186","E01002872",2011,726,526,200,73
"37187","E01002873",2011,632,161,471,161
"37188","E01002874",2011,648,197,451,208
"37189","E01002875",2011,681,106,575,196
"37190","E01002876",2011,744,215,529,184
"37191","E01002877",2011,647,443,204,58
"37192","E01002878",2011,868,350,518,185
"37193","E01002879",2011,695,421,274,159
"37194","E01002880",2011,653,512,141,44
"37195","E01002881",2011,544,374,170,56
"37196","E01002882",2011,703,207,496,182
"37197","E01002883",2011,802,28,774,313
"37198","E01002884",2011,710,116,594,363
"37199","E01002885",2011,950,73,877,545
"37200","E01002886",2011,781,78,703,295
"37201","E01002887",2011,807,23,784,434
"37202","E01002888",2011,1149,49,1100,607
"37203","E01002889",2011,579,18,561,286
"37204","E01002890",2011,705,24,681,221
"37205","E01002891",2011,718,55,663,349
"37206","E01002892",2011,920,28,892,475
"37207","E01002893",2011,987,200,787,387
"37208","E01002894",2011,773,63,710,368
"37209","E01002895",2011,610,19,591,210
"37210","E01002896",2011,875,41,834,357
"37211","E01002897",2011,732,82,650,335
"37212","E01002898",2011,739,84,655,240
"37213","E01002899",2011,768,235,533,245
"37214","E01002900",2011,682,9,673,224
"37215","E01002901",2011,560,119,441,167
"37216","E01002902",2011,1009,137,872,439
"37217","E01002903",2011,691,5,686,254
"37218","E01002904",2011,524,471,53,27
"37219","E01002905",2011,672,455,217,74
"37220","E01002906",2011,707,351,356,118
"37221","E01002907",2011,551,501,50,19
"37222","E01002908",2011,602,175,427,163
"37223","E01002909",2011,1152,517,635,269
"37224","E01002910",2011,756,174,582,216
"37225","E01002911",2011,767,29,738,308
"37226","E01002912",2011,809,163,646,301
"37227","E01002913",2011,932,144,788,380
"37228","E01002914",2011,741,15,726,330
"37229","E01002915",2011,479,9,470,38
"37230","E01002916",2011,520,9,511,52
"37231","E01002917",2011,497,1,496,32
"37232","E01002918",2011,615,22,593,103
"37233","E01002919",2011,669,94,575,187
"37234","E01002920",2011,593,31,562,37
"37235","E01002921",2011,857,124,733,402
"37236","E01002922",2011,725,95,630,154
"37237","E01002923",2011,777,447,330,137
"37238","E01002924",2011,560,6,554,36
"37239","E01002925",2011,796,63,733,309
"37240","E01002926",2011,590,13,577,122
"37241","E01002927",2011,614,55,559,84
"37242","E01002928",2011,660,20,640,203
"37243","E01002929",2011,635,20,615,108
"37244","E01002930",2011,683,58,625,251
"37245","E01002931",2011,654,20,634,97
"37246","E01002932",2011,678,277,401,125
"37247","E01002933",2011,807,291,516,117
"37248","E01002934",2011,649,45,604,193
"37249","E01002935",2011,775,42,733,323
"37250","E01002937",2011,645,28,617,97
"37251","E01002938",2011,782,66,716,159
"37252","E01002939",2011,605,77,528,98
"37253","E01002940",2011,604,128,476,42
"37254","E01002941",2011,628,73,555,48
"37255","E01002942",2011,522,31,491,30
"37256","E01002943",2011,507,132,375,36
"37257","E01002944",2011,508,57,451,35
"37258","E01002945",2011,655,38,617,61
"37259","E01002946",2011,603,15,588,52
"37260","E01002947",2011,597,17,580,53
"37261","E01002948",2011,784,140,644,102
"37262","E01002949",2011,677,53,624,55
"37263","E01002950",2011,719,211,508,68
"37264","E01002951",2011,624,19,605,190
"37265","E01002952",2011,486,5,481,71
"37266","E01002953",2011,453,12,441,95
"37267","E01002954",2011,565,79,486,231
"37268","E01002955",2011,513,22,491,123
"37269","E01002956",2011,437,32,405,59
"37270","E01002957",2011,608,260,348,170
"37271","E01002958",2011,659,26,633,101
"37272","E01002959",2011,479,2,477,43
"37273","E01002960",2011,574,25,549,114
"37274","E01002961",2011,609,12,597,77
"37275","E01002962",2011,511,112,399,66
"37276","E01002963",2011,768,71,697,299
"37277","E01002964",2011,982,333,649,278
"37278","E01002965",2011,1071,144,927,450
"37279","E01002966",2011,744,66,678,213
"37280","E01002967",2011,958,29,929,366
"37281","E01002968",2011,1123,71,1052,523
"37282","E01002969",2011,756,590,166,74
"37283","E01002970",2011,570,154,416,139
"37284","E01002971",2011,705,102,603,182
"37285","E01002972",2011,828,123,705,307
"37286","E01002973",2011,465,129,336,116
"37287","E01002974",2011,726,165,561,166
"37288","E01002975",2011,483,28,455,73
"37289","E01002976",2011,641,24,617,67
"37290","E01002977",2011,654,209,445,75
"37291","E01002978",2011,684,22,662,90
"37292","E01002979",2011,614,35,579,86
"37293","E01002980",2011,482,7,475,47
"37294","E01002981",2011,518,10,508,58
"37295","E01002982",2011,517,41,476,52
"37296","E01002983",2011,595,19,576,38
"37297","E01002984",2011,604,138,466,104
"37298","E01002985",2011,603,45,558,147
"37299","E01002986",2011,471,55,416,64
"37300","E01002987",2011,844,107,737,369
"37301","E01002988",2011,572,55,517,214
"37302","E01002989",2011,909,26,883,332
"37303","E01002990",2011,937,54,883,446
"37304","E01002991",2011,710,24,686,237
"37305","E01002992",2011,438,28,410,105
"37306","E01002993",2011,867,48,819,415
"37307","E01002994",2011,602,19,583,134
"37308","E01002995",2011,602,7,595,151
"37309","E01002996",2011,589,14,575,151
"37310","E01002997",2011,588,20,568,126
"37311","E01002998",2011,612,140,472,99
"37312","E01002999",2011,743,95,648,337
"37313","E01003000",2011,587,133,454,67
"37314","E01003001",2011,627,10,617,81
"37315","E01003002",2011,783,189,594,161
"37316","E01003003",2011,574,19,555,156
"37317","E01003004",2011,591,28,563,101
"37318","E01003005",2011,570,22,548,51
"37319","E01003006",2011,611,48,563,103
"37320","E01003007",2011,549,25,524,54
"37321","E01003008",2011,514,4,510,39
"37322","E01003009",2011,773,115,658,109
"37323","E01003010",2011,554,35,519,76
"37324","E01003011",2011,730,52,678,150
"37325","E01003013",2011,854,84,770,509
"37326","E01003014",2011,678,313,365,153
"37327","E01003015",2011,730,460,270,131
"37328","E01003016",2011,526,159,367,226
"37329","E01003017",2011,862,516,346,188
"37330","E01003018",2011,999,145,854,498
"37331","E01003019",2011,914,207,707,323
"37332","E01003020",2011,771,246,525,230
"37333","E01003021",2011,663,366,297,131
"37334","E01003022",2011,770,245,525,211
"37335","E01003023",2011,1063,244,819,396
"37336","E01003024",2011,766,426,340,178
"37337","E01003025",2011,842,307,535,200
"37338","E01003026",2011,656,79,577,250
"37339","E01003027",2011,480,21,459,102
"37340","E01003028",2011,563,143,420,158
"37341","E01003029",2011,860,237,623,317
"37342","E01003030",2011,783,64,719,349
"37343","E01003031",2011,720,282,438,229
"37344","E01003032",2011,759,337,422,204
"37345","E01003033",2011,594,119,475,145
"37346","E01003034",2011,723,239,484,223
"37347","E01003035",2011,710,180,530,323
"37348","E01003036",2011,737,234,503,220
"37349","E01003037",2011,606,337,269,140
"37350","E01003038",2011,689,82,607,231
"37351","E01003039",2011,945,98,847,421
"37352","E01003040",2011,594,136,458,180
"37353","E01003041",2011,678,338,340,183
"37354","E01003042",2011,502,193,309,172
"37355","E01003043",2011,685,224,461,193
"37356","E01003044",2011,606,492,114,58
"37357","E01003045",2011,728,566,162,73
"37358","E01003046",2011,743,543,200,93
"37359","E01003047",2011,751,387,364,230
"37360","E01003048",2011,741,559,182,82
"37361","E01003049",2011,668,353,315,162
"37362","E01003050",2011,773,259,514,265
"37363","E01003051",2011,675,296,379,273
"37364","E01003052",2011,758,535,223,107
"37365","E01003053",2011,757,127,630,314
"37366","E01003054",2011,819,117,702,430
"37367","E01003055",2011,790,305,485,228
"37368","E01003056",2011,838,265,573,351
"37369","E01003057",2011,724,409,315,162
"37370","E01003058",2011,820,191,629,347
"37371","E01003059",2011,625,380,245,115
"37372","E01003060",2011,632,431,201,94
"37373","E01003061",2011,568,236,332,207
"37374","E01003062",2011,795,218,577,279
"37375","E01003063",2011,664,340,324,111
"37376","E01003064",2011,660,61,599,232
"37377","E01003065",2011,666,390,276,71
"37378","E01003066",2011,741,289,452,194
"37379","E01003067",2011,599,105,494,189
"37380","E01003068",2011,657,237,420,135
"37381","E01003069",2011,520,171,349,104
"37382","E01003070",2011,655,372,283,120
"37383","E01003071",2011,1004,227,777,353
"37384","E01003072",2011,769,154,615,223
"37385","E01003073",2011,698,365,333,121
"37386","E01003074",2011,1096,334,762,284
"37387","E01003075",2011,685,474,211,100
"37388","E01003076",2011,836,235,601,386
"37389","E01003077",2011,786,191,595,308
"37390","E01003078",2011,634,92,542,110
"37391","E01003079",2011,757,279,478,204
"37392","E01003080",2011,663,81,582,213
"37393","E01003081",2011,768,194,574,318
"37394","E01003082",2011,651,285,366,118
"37395","E01003083",2011,594,103,491,127
"37396","E01003084",2011,673,92,581,213
"37397","E01003085",2011,697,139,558,108
"37398","E01003086",2011,647,334,313,86
"37399","E01003087",2011,611,346,265,117
"37400","E01003088",2011,737,318,419,215
"37401","E01003089",2011,689,380,309,161
"37402","E01003090",2011,1043,287,756,423
"37403","E01003091",2011,668,277,391,202
"37404","E01003092",2011,717,419,298,146
"37405","E01003093",2011,949,647,302,127
"37406","E01003094",2011,675,280,395,187
"37407","E01003095",2011,760,193,567,265
"37408","E01003096",2011,926,168,758,448
"37409","E01003097",2011,724,437,287,141
"37410","E01003098",2011,645,233,412,163
"37411","E01003099",2011,666,250,416,235
"37412","E01003100",2011,878,102,776,489
"37413","E01003101",2011,685,316,369,220
"37414","E01003102",2011,844,311,533,288
"37415","E01003104",2011,777,167,610,357
"37416","E01003105",2011,780,448,332,106
"37417","E01003106",2011,911,395,516,181
"37418","E01003107",2011,929,247,682,281
"37419","E01003108",2011,755,421,334,141
"37420","E01003109",2011,1093,526,567,270
"37421","E01003110",2011,849,249,600,184
"37422","E01003111",2011,638,469,169,63
"37423","E01003112",2011,771,416,355,145
"37424","E01003113",2011,817,123,694,355
"37425","E01003114",2011,765,70,695,342
"37426","E01003115",2011,669,133,536,267
"37427","E01003116",2011,634,114,520,152
"37428","E01003117",2011,841,154,687,362
"37429","E01003118",2011,688,91,597,278
"37430","E01003119",2011,813,65,748,411
"37431","E01003120",2011,961,116,845,599
"37432","E01003121",2011,691,516,175,85
"37433","E01003122",2011,870,305,565,254
"37434","E01003123",2011,683,163,520,200
"37435","E01003124",2011,619,267,352,210
"37436","E01003125",2011,692,468,224,100
"37437","E01003126",2011,645,308,337,192
"37438","E01003127",2011,755,260,495,220
"37439","E01003128",2011,664,385,279,138
"37440","E01003129",2011,808,217,591,357
"37441","E01003130",2011,739,58,681,293
"37442","E01003131",2011,617,92,525,220
"37443","E01003132",2011,536,263,273,89
"37444","E01003133",2011,765,172,593,290
"37445","E01003134",2011,619,137,482,141
"37446","E01003135",2011,724,289,435,173
"37447","E01003136",2011,735,181,554,284
"37448","E01003137",2011,676,265,411,218
"37449","E01003138",2011,689,61,628,253
"37450","E01003139",2011,542,30,512,165
"37451","E01003140",2011,492,36,456,115
"37452","E01003141",2011,723,165,558,176
"37453","E01003142",2011,453,36,417,103
"37454","E01003143",2011,516,175,341,88
"37455","E01003144",2011,520,26,494,86
"37456","E01003145",2011,783,100,683,399
"37457","E01003146",2011,524,109,415,137
"37458","E01003147",2011,797,150,647,271
"37459","E01003148",2011,762,112,650,248
"37460","E01003149",2011,694,40,654,212
"37461","E01003150",2011,769,246,523,268
"37462","E01003151",2011,820,425,395,200
"37463","E01003152",2011,761,56,705,296
"37464","E01003153",2011,929,60,869,528
"37465","E01003154",2011,786,290,496,177
"37466","E01003155",2011,750,73,677,267
"37467","E01003156",2011,665,214,451,150
"37468","E01003157",2011,577,95,482,114
"37469","E01003158",2011,737,109,628,203
"37470","E01003159",2011,599,336,263,127
"37471","E01003160",2011,558,417,141,69
"37472","E01003161",2011,498,151,347,144
"37473","E01003162",2011,830,532,298,146
"37474","E01003163",2011,588,121,467,118
"37475","E01003164",2011,935,255,680,400
"37476","E01003165",2011,712,204,508,149
"37477","E01003166",2011,1020,169,851,477
"37478","E01003167",2011,681,75,606,150
"37479","E01003168",2011,647,475,172,97
"37480","E01003169",2011,1071,316,755,291
"37481","E01003170",2011,797,92,705,154
"37482","E01003171",2011,827,238,589,262
"37483","E01003172",2011,815,407,408,154
"37484","E01003173",2011,694,66,628,211
"37485","E01003174",2011,829,503,326,186
"37486","E01003175",2011,608,359,249,80
"37487","E01003176",2011,780,413,367,193
"37488","E01003177",2011,703,237,466,236
"37489","E01003178",2011,712,154,558,249
"37490","E01003179",2011,654,481,173,73
"37491","E01003180",2011,662,314,348,139
"37492","E01003181",2011,644,331,313,159
"37493","E01003182",2011,720,330,390,177
"37494","E01003183",2011,631,383,248,106
"37495","E01003184",2011,586,456,130,64
"37496","E01003185",2011,768,333,435,240
"37497","E01003186",2011,876,290,586,301
"37498","E01003187",2011,626,416,210,79
"37499","E01003188",2011,554,374,180,69
"37500","E01003189",2011,624,343,281,60
"37501","E01003190",2011,809,444,365,123
"37502","E01003191",2011,665,277,388,96
"37503","E01003192",2011,741,449,292,77
"37504","E01003193",2011,666,203,463,72
"37505","E01003194",2011,716,292,424,143
"37506","E01003195",2011,637,76,561,125
"37507","E01003196",2011,624,293,331,79
"37508","E01003197",2011,625,312,313,73
"37509","E01003198",2011,639,180,459,114
"37510","E01003199",2011,801,130,671,246
"37511","E01003200",2011,756,95,661,289
"37512","E01003201",2011,680,316,364,120
"37513","E01003202",2011,764,40,724,253
"37514","E01003203",2011,980,341,639,340
"37515","E01003204",2011,603,211,392,140
"37516","E01003205",2011,502,383,119,39
"37517","E01003206",2011,698,154,544,192
"37518","E01003207",2011,615,365,250,175
"37519","E01003209",2011,778,348,430,201
"37520","E01003210",2011,850,210,640,357
"37521","E01003211",2011,753,190,563,267
"37522","E01003212",2011,867,200,667,256
"37523","E01003213",2011,813,171,642,303
"37524","E01003214",2011,745,283,462,208
"37525","E01003215",2011,666,182,484,321
"37526","E01003216",2011,689,104,585,185
"37527","E01003217",2011,622,42,580,97
"37528","E01003218",2011,539,65,474,69
"37529","E01003219",2011,631,57,574,98
"37530","E01003220",2011,604,109,495,149
"37531","E01003221",2011,769,152,617,191
"37532","E01003222",2011,629,92,537,118
"37533","E01003223",2011,603,27,576,103
"37534","E01003224",2011,626,70,556,129
"37535","E01003225",2011,590,35,555,77
"37536","E01003226",2011,709,48,661,241
"37537","E01003227",2011,678,84,594,140
"37538","E01003228",2011,673,72,601,199
"37539","E01003229",2011,742,256,486,210
"37540","E01003230",2011,866,268,598,219
"37541","E01003231",2011,687,130,557,244
"37542","E01003232",2011,649,84,565,125
"37543","E01003233",2011,669,78,591,160
"37544","E01003235",2011,523,151,372,50
"37545","E01003236",2011,648,276,372,108
"37546","E01003237",2011,608,246,362,100
"37547","E01003238",2011,565,222,343,75
"37548","E01003239",2011,564,257,307,56
"37549","E01003240",2011,725,277,448,100
"37550","E01003241",2011,695,298,397,69
"37551","E01003243",2011,581,211,370,116
"37552","E01003244",2011,618,488,130,77
"37553","E01003245",2011,584,425,159,44
"37554","E01003246",2011,559,313,246,125
"37555","E01003247",2011,685,145,540,301
"37556","E01003248",2011,718,361,357,175
"37557","E01003249",2011,897,421,476,226
"37558","E01003250",2011,763,402,361,179
"37559","E01003251",2011,777,547,230,133
"37560","E01003252",2011,613,493,120,39
"37561","E01003253",2011,669,348,321,171
"37562","E01003254",2011,602,80,522,97
"37563","E01003255",2011,964,135,829,406
"37564","E01003256",2011,931,350,581,212
"37565","E01003257",2011,735,256,479,113
"37566","E01003258",2011,594,332,262,88
"37567","E01003259",2011,756,122,634,239
"37568","E01003260",2011,681,127,554,175
"37569","E01003261",2011,619,161,458,93
"37570","E01003262",2011,624,152,472,168
"37571","E01003263",2011,739,241,498,163
"37572","E01003264",2011,728,201,527,128
"37573","E01003265",2011,680,179,501,250
"37574","E01003266",2011,757,402,355,71
"37575","E01003267",2011,598,229,369,53
"37576","E01003268",2011,718,151,567,160
"37577","E01003269",2011,647,193,454,97
"37578","E01003270",2011,678,29,649,120
"37579","E01003271",2011,637,25,612,62
"37580","E01003272",2011,798,157,641,287
"37581","E01003273",2011,666,203,463,105
"37582","E01003274",2011,721,108,613,231
"37583","E01003275",2011,640,229,411,96
"37584","E01003276",2011,700,157,543,106
"37585","E01003277",2011,778,215,563,228
"37586","E01003278",2011,805,181,624,265
"37587","E01003279",2011,654,112,542,133
"37588","E01003280",2011,651,207,444,111
"37589","E01003281",2011,601,98,503,78
"37590","E01003282",2011,1047,211,836,345
"37591","E01003283",2011,923,95,828,257
"37592","E01003284",2011,748,143,605,171
"37593","E01003285",2011,767,57,710,233
"37594","E01003286",2011,786,421,365,124
"37595","E01003287",2011,797,110,687,161
"37596","E01003288",2011,794,374,420,180
"37597","E01003290",2011,725,241,484,273
"37598","E01003291",2011,682,436,246,112
"37599","E01003292",2011,702,65,637,245
"37600","E01003293",2011,676,144,532,243
"37601","E01003295",2011,653,129,524,206
"37602","E01003296",2011,1021,219,802,428
"37603","E01003297",2011,767,124,643,422
"37604","E01003298",2011,475,270,205,89
"37605","E01003299",2011,609,246,363,182
"37606","E01003300",2011,561,358,203,79
"37607","E01003301",2011,767,174,593,305
"37608","E01003302",2011,710,333,377,144
"37609","E01003303",2011,560,213,347,190
"37610","E01003304",2011,903,318,585,376
"37611","E01003305",2011,513,267,246,87
"37612","E01003307",2011,627,130,497,128
"37613","E01003308",2011,734,191,543,178
"37614","E01003309",2011,645,314,331,96
"37615","E01003310",2011,756,282,474,197
"37616","E01003311",2011,605,66,539,96
"37617","E01003312",2011,779,120,659,212
"37618","E01003313",2011,670,317,353,128
"37619","E01003314",2011,683,119,564,161
"37620","E01003315",2011,599,149,450,218
"37621","E01003316",2011,609,92,517,129
"37622","E01003317",2011,688,88,600,210
"37623","E01003318",2011,705,146,559,342
"37624","E01003319",2011,752,186,566,222
"37625","E01003320",2011,650,234,416,154
"37626","E01003321",2011,810,220,590,257
"37627","E01003322",2011,593,108,485,171
"37628","E01003323",2011,624,144,480,168
"37629","E01003324",2011,713,350,363,151
"37630","E01003325",2011,722,207,515,218
"37631","E01003326",2011,638,167,471,143
"37632","E01003327",2011,714,135,579,200
"37633","E01003328",2011,833,263,570,196
"37634","E01003329",2011,666,175,491,134
"37635","E01003330",2011,662,402,260,75
"37636","E01003331",2011,572,194,378,73
"37637","E01003332",2011,679,240,439,129
"37638","E01003333",2011,657,179,478,163
"37639","E01003334",2011,778,267,511,238
"37640","E01003335",2011,594,338,256,61
"37641","E01003336",2011,577,359,218,88
"37642","E01003337",2011,600,424,176,49
"37643","E01003338",2011,771,485,286,158
"37644","E01003339",2011,763,292,471,236
"37645","E01003340",2011,797,128,669,384
"37646","E01003341",2011,581,135,446,165
"37647","E01003342",2011,702,114,588,278
"37648","E01003343",2011,626,175,451,167
"37649","E01003344",2011,719,231,488,210
"37650","E01003345",2011,719,165,554,264
"37651","E01003346",2011,598,203,395,71
"37652","E01003347",2011,638,418,220,93
"37653","E01003348",2011,571,138,433,69
"37654","E01003349",2011,541,273,268,72
"37655","E01003350",2011,519,228,291,52
"37656","E01003351",2011,592,241,351,85
"37657","E01003352",2011,735,308,427,78
"37658","E01003353",2011,632,53,579,112
"37659","E01003354",2011,701,44,657,179
"37660","E01003355",2011,765,23,742,382
"37661","E01003356",2011,696,45,651,203
"37662","E01003357",2011,750,344,406,162
"37663","E01003358",2011,801,29,772,373
"37664","E01003359",2011,816,181,635,266
"37665","E01003360",2011,740,23,717,247
"37666","E01003361",2011,621,41,580,151
"37667","E01003362",2011,499,20,479,43
"37668","E01003363",2011,590,4,586,48
"37669","E01003364",2011,648,28,620,41
"37670","E01003365",2011,497,5,492,41
"37671","E01003366",2011,595,93,502,139
"37672","E01003367",2011,961,72,889,398
"37673","E01003368",2011,578,61,517,151
"37674","E01003369",2011,768,57,711,315
"37675","E01003370",2011,869,84,785,407
"37676","E01003371",2011,626,39,587,200
"37677","E01003372",2011,627,243,384,158
"37678","E01003373",2011,536,296,240,72
"37679","E01003374",2011,546,141,405,119
"37680","E01003375",2011,654,117,537,135
"37681","E01003376",2011,588,254,334,92
"37682","E01003377",2011,526,294,232,85
"37683","E01003378",2011,728,171,557,141
"37684","E01003379",2011,742,323,419,154
"37685","E01003380",2011,680,25,655,174
"37686","E01003381",2011,720,20,700,261
"37687","E01003382",2011,676,26,650,207
"37688","E01003383",2011,692,16,676,301
"37689","E01003384",2011,623,36,587,235
"37690","E01003385",2011,626,27,599,170
"37691","E01003386",2011,722,85,637,256
"37692","E01003387",2011,614,196,418,98
"37693","E01003388",2011,590,153,437,112
"37694","E01003389",2011,631,61,570,202
"37695","E01003390",2011,623,365,258,109
"37696","E01003391",2011,544,260,284,66
"37697","E01003392",2011,501,34,467,130
"37698","E01003393",2011,646,42,604,335
"37699","E01003394",2011,636,14,622,212
"37700","E01003395",2011,503,6,497,94
"37701","E01003396",2011,534,15,519,170
"37702","E01003397",2011,557,27,530,166
"37703","E01003398",2011,583,32,551,157
"37704","E01003399",2011,618,67,551,211
"37705","E01003400",2011,659,40,619,303
"37706","E01003401",2011,647,91,556,254
"37707","E01003402",2011,705,35,670,286
"37708","E01003403",2011,710,45,665,248
"37709","E01003404",2011,912,142,770,329
"37710","E01003405",2011,630,181,449,123
"37711","E01003406",2011,566,197,369,107
"37712","E01003407",2011,768,51,717,364
"37713","E01003408",2011,873,103,770,310
"37714","E01003409",2011,562,151,411,105
"37715","E01003410",2011,630,140,490,202
"37716","E01003411",2011,719,124,595,177
"37717","E01003412",2011,597,158,439,92
"37718","E01003413",2011,709,64,645,150
"37719","E01003414",2011,539,9,530,91
"37720","E01003415",2011,548,11,537,82
"37721","E01003416",2011,534,21,513,70
"37722","E01003417",2011,608,11,597,47
"37723","E01003418",2011,531,7,524,29
"37724","E01003419",2011,642,21,621,64
"37725","E01003420",2011,506,11,495,52
"37726","E01003421",2011,640,70,570,112
"37727","E01003422",2011,513,20,493,51
"37728","E01003423",2011,605,14,591,184
"37729","E01003424",2011,574,3,571,48
"37730","E01003425",2011,508,4,504,45
"37731","E01003426",2011,609,5,604,112
"37732","E01003427",2011,706,38,668,275
"37733","E01003428",2011,649,78,571,164
"37734","E01003429",2011,507,37,470,68
"37735","E01003430",2011,545,235,310,84
"37736","E01003431",2011,545,223,322,64
"37737","E01003432",2011,508,273,235,33
"37738","E01003433",2011,578,72,506,104
"37739","E01003434",2011,506,25,481,71
"37740","E01003435",2011,490,22,468,57
"37741","E01003436",2011,588,170,418,71
"37742","E01003437",2011,764,97,667,133
"37743","E01003438",2011,650,228,422,79
"37744","E01003439",2011,548,121,427,186
"37745","E01003440",2011,627,157,470,103
"37746","E01003441",2011,617,178,439,117
"37747","E01003442",2011,701,44,657,179
"37748","E01003443",2011,633,17,616,117
"37749","E01003444",2011,695,37,658,189
"37750","E01003445",2011,658,60,598,88
"37751","E01003446",2011,799,59,740,351
"37752","E01003447",2011,691,229,462,170
"37753","E01003448",2011,648,211,437,90
"37754","E01003449",2011,677,145,532,127
"37755","E01003450",2011,597,195,402,69
"37756","E01003451",2011,598,78,520,38
"37757","E01003452",2011,806,446,360,76
"37758","E01003453",2011,650,157,493,145
"37759","E01003454",2011,587,51,536,175
"37760","E01003455",2011,749,82,667,278
"37761","E01003456",2011,667,40,627,303
"37762","E01003457",2011,623,36,587,146
"37763","E01003458",2011,693,23,670,226
"37764","E01003459",2011,956,276,680,303
"37765","E01003460",2011,679,90,589,159
"37766","E01003461",2011,712,9,703,299
"37767","E01003462",2011,599,59,540,96
"37768","E01003463",2011,459,4,455,71
"37769","E01003464",2011,550,27,523,102
"37770","E01003465",2011,472,6,466,73
"37771","E01003466",2011,599,4,595,81
"37772","E01003467",2011,601,24,577,83
"37773","E01003468",2011,630,10,620,70
"37774","E01003469",2011,574,47,527,131
"37775","E01003470",2011,607,23,584,118
"37776","E01003471",2011,604,79,525,125
"37777","E01003472",2011,481,4,477,67
"37778","E01003473",2011,505,5,500,158
"37779","E01003474",2011,480,10,470,107
"37780","E01003475",2011,1162,195,967,408
"37781","E01003476",2011,482,104,378,128
"37782","E01003477",2011,573,27,546,177
"37783","E01003478",2011,602,11,591,145
"37784","E01003479",2011,612,118,494,249
"37785","E01003480",2011,662,254,408,207
"37786","E01003481",2011,500,221,279,116
"37787","E01003482",2011,1033,261,772,401
"37788","E01003483",2011,492,287,205,91
"37789","E01003484",2011,566,56,510,254
"37790","E01003485",2011,560,92,468,212
"37791","E01003486",2011,455,372,83,46
"37792","E01003487",2011,424,274,150,67
"37793","E01003488",2011,669,438,231,99
"37794","E01003489",2011,520,255,265,143
"37795","E01003490",2011,539,115,424,199
"37796","E01003491",2011,637,194,443,240
"37797","E01003492",2011,536,43,493,200
"37798","E01003493",2011,732,138,594,281
"37799","E01003494",2011,645,52,593,197
"37800","E01003495",2011,650,38,612,162
"37801","E01003496",2011,591,313,278,170
"37802","E01003497",2011,622,255,367,190
"37803","E01003498",2011,674,327,347,185
"37804","E01003499",2011,862,471,391,193
"37805","E01003500",2011,732,364,368,162
"37806","E01003501",2011,715,279,436,199
"37807","E01003502",2011,669,295,374,187
"37808","E01003503",2011,647,413,234,99
"37809","E01003506",2011,489,273,216,97
"37810","E01003507",2011,807,262,545,239
"37811","E01003508",2011,555,223,332,172
"37812","E01003509",2011,795,134,661,531
"37813","E01003511",2011,452,312,140,51
"37814","E01003512",2011,678,296,382,158
"37815","E01003513",2011,558,67,491,216
"37816","E01003514",2011,532,288,244,109
"37817","E01003515",2011,755,420,335,141
"37818","E01003516",2011,652,402,250,116
"37819","E01003517",2011,605,291,314,115
"37820","E01003518",2011,588,92,496,175
"37821","E01003519",2011,484,153,331,154
"37822","E01003520",2011,583,115,468,265
"37823","E01003521",2011,623,54,569,346
"37824","E01003522",2011,550,74,476,229
"37825","E01003523",2011,669,196,473,190
"37826","E01003524",2011,598,97,501,265
"37827","E01003525",2011,519,54,465,238
"37828","E01003526",2011,550,90,460,175
"37829","E01003527",2011,570,54,516,144
"37830","E01003528",2011,431,243,188,65
"37831","E01003529",2011,597,47,550,238
"37832","E01003530",2011,468,40,428,159
"37833","E01003531",2011,516,113,403,192
"37834","E01003532",2011,513,55,458,174
"37835","E01003533",2011,482,93,389,141
"37836","E01003534",2011,643,52,591,276
"37837","E01003535",2011,548,303,245,88
"37838","E01003536",2011,598,120,478,182
"37839","E01003537",2011,668,100,568,183
"37840","E01003538",2011,652,213,439,195
"37841","E01003539",2011,681,136,545,191
"37842","E01003540",2011,595,259,336,121
"37843","E01003541",2011,570,106,464,155
"37844","E01003542",2011,668,311,357,140
"37845","E01003543",2011,850,239,611,253
"37846","E01003544",2011,664,128,536,257
"37847","E01003545",2011,644,276,368,178
"37848","E01003546",2011,588,218,370,161
"37849","E01003547",2011,699,129,570,170
"37850","E01003548",2011,852,208,644,355
"37851","E01003549",2011,790,275,515,262
"37852","E01003550",2011,631,182,449,195
"37853","E01003551",2011,586,130,456,259
"37854","E01003552",2011,544,122,422,203
"37855","E01003553",2011,733,325,408,251
"37856","E01003554",2011,623,133,490,246
"37857","E01003555",2011,500,76,424,170
"37858","E01003556",2011,629,258,371,219
"37859","E01003557",2011,651,163,488,309
"37860","E01003558",2011,491,78,413,240
"37861","E01003559",2011,1001,236,765,433
"37862","E01003560",2011,448,32,416,156
"37863","E01003561",2011,481,43,438,198
"37864","E01003562",2011,576,46,530,243
"37865","E01003563",2011,538,42,496,239
"37866","E01003564",2011,672,84,588,288
"37867","E01003565",2011,496,62,434,232
"37868","E01003566",2011,507,144,363,203
"37869","E01003567",2011,540,91,449,238
"37870","E01003568",2011,594,84,510,202
"37871","E01003569",2011,509,51,458,257
"37872","E01003570",2011,585,85,500,249
"37873","E01003571",2011,586,52,534,260
"37874","E01003572",2011,446,58,388,171
"37875","E01003573",2011,542,57,485,205
"37876","E01003574",2011,798,161,637,314
"37877","E01003575",2011,491,94,397,153
"37878","E01003576",2011,710,345,365,218
"37879","E01003577",2011,673,445,228,97
"37880","E01003578",2011,601,104,497,326
"37881","E01003579",2011,499,95,404,179
"37882","E01003580",2011,615,188,427,188
"37883","E01003581",2011,486,55,431,203
"37884","E01003582",2011,499,150,349,166
"37885","E01003583",2011,539,62,477,229
"37886","E01003584",2011,638,97,541,186
"37887","E01003585",2011,407,34,373,147
"37888","E01003586",2011,509,55,454,220
"37889","E01003587",2011,823,236,587,318
"37890","E01003588",2011,454,66,388,169
"37891","E01003589",2011,512,40,472,227
"37892","E01003590",2011,572,299,273,122
"37893","E01003591",2011,671,203,468,277
"37894","E01003592",2011,555,150,405,156
"37895","E01003593",2011,559,285,274,120
"37896","E01003594",2011,540,171,369,152
"37897","E01003595",2011,581,297,284,143
"37898","E01003596",2011,577,152,425,205
"37899","E01003597",2011,475,87,388,173
"37900","E01003598",2011,658,402,256,98
"37901","E01003599",2011,488,193,295,137
"37902","E01003600",2011,690,397,293,126
"37903","E01003601",2011,705,265,440,164
"37904","E01003602",2011,605,127,478,202
"37905","E01003603",2011,624,75,549,194
"37906","E01003604",2011,785,265,520,226
"37907","E01003605",2011,724,209,515,227
"37908","E01003606",2011,675,128,547,236
"37909","E01003607",2011,560,206,354,173
"37910","E01003608",2011,714,76,638,231
"37911","E01003609",2011,1058,410,648,396
"37912","E01003611",2011,700,423,277,148
"37913","E01003615",2011,643,212,431,240
"37914","E01003616",2011,658,226,432,257
"37915","E01003617",2011,1103,407,696,448
"37916","E01003618",2011,823,156,667,394
"37917","E01003619",2011,1087,418,669,376
"37918","E01003621",2011,442,57,385,165
"37919","E01003622",2011,496,149,347,169
"37920","E01003623",2011,490,151,339,146
"37921","E01003624",2011,493,169,324,107
"37922","E01003625",2011,484,89,395,190
"37923","E01003626",2011,420,18,402,183
"37924","E01003627",2011,432,46,386,162
"37925","E01003628",2011,420,25,395,146
"37926","E01003629",2011,481,32,449,237
"37927","E01003630",2011,731,381,350,185
"37928","E01003631",2011,727,243,484,278
"37929","E01003632",2011,749,145,604,248
"37930","E01003633",2011,685,499,186,77
"37931","E01003634",2011,602,334,268,121
"37932","E01003635",2011,611,112,499,213
"37933","E01003636",2011,702,347,355,183
"37934","E01003637",2011,593,147,446,212
"37935","E01003638",2011,590,142,448,44
"37936","E01003639",2011,665,144,521,121
"37937","E01003640",2011,648,35,613,110
"37938","E01003641",2011,530,34,496,100
"37939","E01003642",2011,542,98,444,82
"37940","E01003643",2011,622,25,597,94
"37941","E01003644",2011,498,20,478,70
"37942","E01003645",2011,910,67,843,385
"37943","E01003646",2011,572,31,541,153
"37944","E01003647",2011,612,9,603,184
"37945","E01003648",2011,528,2,526,35
"37946","E01003649",2011,521,38,483,63
"37947","E01003650",2011,580,92,488,97
"37948","E01003651",2011,466,3,463,42
"37949","E01003652",2011,482,17,465,63
"37950","E01003653",2011,516,10,506,188
"37951","E01003654",2011,603,76,527,83
"37952","E01003655",2011,642,33,609,117
"37953","E01003656",2011,643,186,457,85
"37954","E01003657",2011,870,61,809,163
"37955","E01003658",2011,699,273,426,97
"37956","E01003659",2011,638,13,625,79
"37957","E01003660",2011,663,13,650,82
"37958","E01003661",2011,651,55,596,74
"37959","E01003662",2011,741,70,671,261
"37960","E01003663",2011,662,41,621,65
"37961","E01003664",2011,575,55,520,67
"37962","E01003665",2011,529,15,514,56
"37963","E01003666",2011,935,152,783,291
"37964","E01003668",2011,755,28,727,225
"37965","E01003669",2011,606,16,590,114
"37966","E01003670",2011,577,89,488,89
"37967","E01003671",2011,552,5,547,25
"37968","E01003672",2011,690,150,540,185
"37969","E01003673",2011,789,34,755,234
"37970","E01003674",2011,1000,84,916,423
"37971","E01003675",2011,490,21,469,103
"37972","E01003676",2011,495,31,464,60
"37973","E01003677",2011,494,6,488,46
"37974","E01003678",2011,479,20,459,48
"37975","E01003679",2011,493,3,490,31
"37976","E01003680",2011,475,3,472,49
"37977","E01003681",2011,683,109,574,140
"37978","E01003682",2011,493,6,487,55
"37979","E01003683",2011,576,42,534,204
"37980","E01003684",2011,496,49,447,133
"37981","E01003685",2011,508,27,481,187
"37982","E01003686",2011,533,43,490,197
"37983","E01003688",2011,532,55,477,192
"37984","E01003689",2011,508,86,422,180
"37985","E01003690",2011,608,50,558,235
"37986","E01003691",2011,413,16,397,95
"37987","E01003692",2011,501,14,487,131
"37988","E01003693",2011,431,10,421,60
"37989","E01003694",2011,448,46,402,68
"37990","E01003695",2011,534,24,510,233
"37991","E01003696",2011,593,31,562,96
"37992","E01003697",2011,492,22,470,89
"37993","E01003698",2011,519,18,501,64
"37994","E01003699",2011,594,22,572,84
"37995","E01003700",2011,849,113,736,144
"37996","E01003701",2011,626,37,589,161
"37997","E01003702",2011,744,39,705,194
"37998","E01003703",2011,968,99,869,165
"37999","E01003704",2011,666,153,513,104
"38000","E01003705",2011,802,69,733,143
"38001","E01003706",2011,613,47,566,126
"38002","E01003707",2011,469,38,431,45
"38003","E01003708",2011,613,203,410,97
"38004","E01003709",2011,570,17,553,66
"38005","E01003710",2011,507,10,497,40
"38006","E01003711",2011,662,84,578,115
"38007","E01003712",2011,536,245,291,60
"38008","E01003713",2011,481,20,461,116
"38009","E01003714",2011,642,34,608,204
"38010","E01003715",2011,564,27,537,201
"38011","E01003716",2011,521,69,452,123
"38012","E01003718",2011,630,39,591,249
"38013","E01003719",2011,633,32,601,244
"38014","E01003720",2011,821,289,532,95
"38015","E01003721",2011,604,93,511,82
"38016","E01003722",2011,690,173,517,72
"38017","E01003723",2011,704,227,477,53
"38018","E01003724",2011,511,61,450,60
"38019","E01003725",2011,650,137,513,138
"38020","E01003726",2011,649,249,400,78
"38021","E01003727",2011,655,212,443,70
"38022","E01003728",2011,810,169,641,312
"38023","E01003729",2011,526,97,429,195
"38024","E01003730",2011,416,30,386,138
"38025","E01003731",2011,447,76,371,133
"38026","E01003732",2011,592,225,367,214
"38027","E01003733",2011,507,38,469,167
"38028","E01003734",2011,517,46,471,171
"38029","E01003735",2011,811,397,414,208
"38030","E01003736",2011,475,83,392,129
"38031","E01003737",2011,575,60,515,66
"38032","E01003738",2011,646,17,629,100
"38033","E01003739",2011,658,60,598,103
"38034","E01003740",2011,621,54,567,87
"38035","E01003741",2011,643,79,564,90
"38036","E01003742",2011,618,33,585,209
"38037","E01003743",2011,496,22,474,144
"38038","E01003744",2011,592,13,579,65
"38039","E01003745",2011,483,1,482,18
"38040","E01003746",2011,661,9,652,78
"38041","E01003747",2011,490,31,459,14
"38042","E01003748",2011,572,6,566,86
"38043","E01003749",2011,681,10,671,139
"38044","E01003750",2011,798,120,678,136
"38045","E01003751",2011,611,42,569,136
"38046","E01003752",2011,838,66,772,186
"38047","E01003753",2011,659,22,637,255
"38048","E01003754",2011,533,43,490,84
"38049","E01003755",2011,571,24,547,109
"38050","E01003756",2011,600,30,570,134
"38051","E01003757",2011,622,57,565,225
"38052","E01003758",2011,810,239,571,256
"38053","E01003759",2011,554,7,547,49
"38054","E01003760",2011,661,55,606,141
"38055","E01003761",2011,698,486,212,92
"38056","E01003762",2011,656,65,591,120
"38057","E01003763",2011,657,17,640,82
"38058","E01003764",2011,835,99,736,232
"38059","E01003765",2011,642,21,621,165
"38060","E01003766",2011,548,20,528,154
"38061","E01003767",2011,567,23,544,245
"38062","E01003768",2011,569,52,517,259
"38063","E01003769",2011,557,33,524,271
"38064","E01003770",2011,848,161,687,189
"38065","E01003771",2011,581,58,523,172
"38066","E01003772",2011,524,9,515,137
"38067","E01003773",2011,579,35,544,132
"38068","E01003774",2011,867,88,779,199
"38069","E01003775",2011,686,17,669,168
"38070","E01003776",2011,932,355,577,235
"38071","E01003777",2011,856,41,815,268
"38072","E01003778",2011,879,50,829,290
"38073","E01003779",2011,708,79,629,141
"38074","E01003780",2011,507,10,497,25
"38075","E01003781",2011,602,43,559,250
"38076","E01003782",2011,518,35,483,229
"38077","E01003783",2011,858,160,698,421
"38078","E01003784",2011,546,40,506,171
"38079","E01003785",2011,704,66,638,379
"38080","E01003786",2011,442,14,428,85
"38081","E01003787",2011,469,17,452,130
"38082","E01003788",2011,645,52,593,354
"38083","E01003789",2011,625,136,489,86
"38084","E01003790",2011,557,117,440,66
"38085","E01003791",2011,540,17,523,42
"38086","E01003792",2011,508,19,489,64
"38087","E01003793",2011,760,230,530,145
"38088","E01003794",2011,544,53,491,59
"38089","E01003795",2011,433,9,424,38
"38090","E01003796",2011,638,78,560,101
"38091","E01003797",2011,523,51,472,53
"38092","E01003798",2011,691,129,562,152
"38093","E01003799",2011,653,37,616,193
"38094","E01003800",2011,640,166,474,119
"38095","E01003801",2011,534,13,521,168
"38096","E01003802",2011,623,30,593,211
"38097","E01003803",2011,632,345,287,79
"38098","E01003804",2011,768,53,715,215
"38099","E01003805",2011,593,19,574,58
"38100","E01003806",2011,523,21,502,68
"38101","E01003807",2011,817,107,710,274
"38102","E01003808",2011,793,75,718,164
"38103","E01003809",2011,657,39,618,94
"38104","E01003810",2011,613,44,569,83
"38105","E01003811",2011,640,20,620,96
"38106","E01003812",2011,772,80,692,182
"38107","E01003813",2011,643,18,625,71
"38108","E01003814",2011,760,69,691,156
"38109","E01003815",2011,824,110,714,239
"38110","E01003816",2011,640,108,532,88
"38111","E01003817",2011,867,94,773,140
"38112","E01003818",2011,661,62,599,95
"38113","E01003819",2011,747,314,433,77
"38114","E01003820",2011,751,159,592,95
"38115","E01003821",2011,784,85,699,349
"38116","E01003822",2011,516,8,508,32
"38117","E01003823",2011,796,25,771,195
"38118","E01003824",2011,649,32,617,84
"38119","E01003825",2011,653,42,611,58
"38120","E01003826",2011,760,346,414,90
"38121","E01003827",2011,800,121,679,199
"38122","E01003828",2011,630,45,585,64
"38123","E01003829",2011,686,250,436,58
"38124","E01003830",2011,734,90,644,132
"38125","E01003831",2011,697,46,651,104
"38126","E01003832",2011,681,351,330,45
"38127","E01003833",2011,658,136,522,103
"38128","E01003834",2011,829,115,714,273
"38129","E01003835",2011,537,19,518,55
"38130","E01003836",2011,613,181,432,60
"38131","E01003837",2011,802,70,732,137
"38132","E01003838",2011,758,88,670,176
"38133","E01003839",2011,916,198,718,197
"38134","E01003840",2011,560,60,500,110
"38135","E01003841",2011,811,360,451,111
"38136","E01003842",2011,619,184,435,53
"38137","E01003843",2011,753,163,590,80
"38138","E01003844",2011,553,50,503,50
"38139","E01003845",2011,622,13,609,42
"38140","E01003846",2011,628,14,614,103
"38141","E01003847",2011,842,42,800,356
"38142","E01003848",2011,817,106,711,236
"38143","E01003849",2011,653,44,609,132
"38144","E01003851",2011,691,9,682,166
"38145","E01003852",2011,652,88,564,170
"38146","E01003853",2011,622,138,484,83
"38147","E01003854",2011,653,91,562,162
"38148","E01003855",2011,831,275,556,198
"38149","E01003856",2011,749,91,658,245
"38150","E01003857",2011,756,75,681,188
"38151","E01003858",2011,678,32,646,153
"38152","E01003859",2011,631,53,578,105
"38153","E01003860",2011,819,98,721,292
"38154","E01003861",2011,855,100,755,279
"38155","E01003862",2011,627,127,500,144
"38156","E01003863",2011,639,239,400,93
"38157","E01003864",2011,671,64,607,177
"38158","E01003865",2011,529,123,406,81
"38159","E01003866",2011,642,9,633,120
"38160","E01003867",2011,576,41,535,130
"38161","E01003868",2011,639,13,626,205
"38162","E01003869",2011,693,13,680,210
"38163","E01003870",2011,721,27,694,145
"38164","E01003871",2011,642,57,585,122
"38165","E01003872",2011,686,25,661,231
"38166","E01003873",2011,850,87,763,308
"38167","E01003874",2011,787,52,735,304
"38168","E01003875",2011,681,70,611,147
"38169","E01003876",2011,865,49,816,367
"38170","E01003877",2011,724,63,661,234
"38171","E01003878",2011,648,374,274,94
"38172","E01003879",2011,613,21,592,237
"38173","E01003880",2011,581,30,551,85
"38174","E01003881",2011,492,29,463,93
"38175","E01003882",2011,793,22,771,214
"38176","E01003883",2011,836,58,778,182
"38177","E01003884",2011,698,88,610,132
"38178","E01003885",2011,647,39,608,156
"38179","E01003886",2011,684,39,645,167
"38180","E01003887",2011,789,30,759,195
"38181","E01003888",2011,896,263,633,217
"38182","E01003889",2011,779,22,757,188
"38183","E01003890",2011,642,20,622,141
"38184","E01003891",2011,826,18,808,179
"38185","E01003892",2011,924,18,906,324
"38186","E01003893",2011,759,38,721,290
"38187","E01003894",2011,760,40,720,271
"38188","E01003895",2011,766,87,679,199
"38189","E01003896",2011,796,24,772,315
"38190","E01003897",2011,848,93,755,264
"38191","E01003898",2011,675,28,647,188
"38192","E01003899",2011,632,18,614,135
"38193","E01003900",2011,614,204,410,64
"38194","E01003901",2011,605,31,574,52
"38195","E01003902",2011,503,16,487,46
"38196","E01003903",2011,580,88,492,62
"38197","E01003904",2011,671,108,563,109
"38198","E01003905",2011,548,18,530,122
"38199","E01003906",2011,649,55,594,122
"38200","E01003907",2011,673,231,442,77
"38201","E01003908",2011,668,18,650,65
"38202","E01003909",2011,606,42,564,119
"38203","E01003910",2011,670,10,660,57
"38204","E01003911",2011,742,455,287,135
"38205","E01003912",2011,571,486,85,43
"38206","E01003913",2011,800,218,582,239
"38207","E01003914",2011,722,223,499,170
"38208","E01003915",2011,811,438,373,124
"38209","E01003916",2011,830,274,556,233
"38210","E01003917",2011,787,356,431,136
"38211","E01003918",2011,653,488,165,77
"38212","E01003919",2011,702,370,332,169
"38213","E01003920",2011,766,542,224,74
"38214","E01003921",2011,673,457,216,160
"38215","E01003922",2011,821,468,353,168
"38216","E01003923",2011,730,315,415,183
"38217","E01003924",2011,802,576,226,153
"38218","E01003925",2011,527,377,150,75
"38219","E01003926",2011,540,351,189,90
"38220","E01003927",2011,995,349,646,354
"38221","E01003929",2011,1074,355,719,415
"38222","E01003930",2011,458,211,247,131
"38223","E01003932",2011,651,337,314,155
"38224","E01003933",2011,537,217,320,123
"38225","E01003934",2011,811,331,480,193
"38226","E01003935",2011,451,256,195,100
"38227","E01003936",2011,552,150,402,248
"38228","E01003937",2011,734,121,613,307
"38229","E01003938",2011,790,403,387,160
"38230","E01003939",2011,836,270,566,324
"38231","E01003940",2011,620,410,210,105
"38232","E01003941",2011,912,295,617,306
"38233","E01003942",2011,561,362,199,93
"38234","E01003943",2011,549,353,196,106
"38235","E01003945",2011,730,121,609,116
"38236","E01003946",2011,726,145,581,135
"38237","E01003947",2011,612,390,222,74
"38238","E01003948",2011,742,87,655,209
"38239","E01003949",2011,871,133,738,264
"38240","E01003950",2011,798,404,394,146
"38241","E01003951",2011,571,93,478,98
"38242","E01003952",2011,692,100,592,211
"38243","E01003953",2011,980,286,694,293
"38244","E01003954",2011,670,111,559,154
"38245","E01003955",2011,822,192,630,205
"38246","E01003956",2011,720,103,617,180
"38247","E01003957",2011,714,133,581,172
"38248","E01003958",2011,699,148,551,152
"38249","E01003960",2011,766,277,489,256
"38250","E01003961",2011,897,601,296,147
"38251","E01003963",2011,662,445,217,123
"38252","E01003964",2011,730,386,344,179
"38253","E01003966",2011,745,426,319,210
"38254","E01003967",2011,600,477,123,55
"38255","E01003968",2011,525,424,101,43
"38256","E01003969",2011,764,249,515,282
"38257","E01003970",2011,579,444,135,59
"38258","E01003971",2011,608,499,109,43
"38259","E01003972",2011,714,453,261,157
"38260","E01003973",2011,739,519,220,148
"38261","E01003974",2011,489,368,121,49
"38262","E01003975",2011,667,441,226,82
"38263","E01003976",2011,916,430,486,266
"38264","E01003977",2011,800,472,328,134
"38265","E01003978",2011,908,337,571,285
"38266","E01003979",2011,809,365,444,240
"38267","E01003980",2011,847,522,325,212
"38268","E01003981",2011,693,363,330,204
"38269","E01003983",2011,730,577,153,73
"38270","E01003984",2011,856,365,491,217
"38271","E01003986",2011,549,431,118,50
"38272","E01003987",2011,754,524,230,102
"38273","E01003988",2011,898,557,341,152
"38274","E01003989",2011,720,514,206,100
"38275","E01003990",2011,769,527,242,94
"38276","E01003991",2011,559,365,194,67
"38277","E01003992",2011,590,392,198,85
"38278","E01003993",2011,630,471,159,55
"38279","E01003994",2011,622,341,281,150
"38280","E01003995",2011,738,465,273,109
"38281","E01003997",2011,472,200,272,100
"38282","E01003998",2011,632,279,353,154
"38283","E01003999",2011,602,287,315,132
"38284","E01004000",2011,839,328,511,189
"38285","E01004001",2011,718,485,233,70
"38286","E01004002",2011,639,124,515,117
"38287","E01004003",2011,755,484,271,96
"38288","E01004004",2011,1069,433,636,251
"38289","E01004005",2011,882,567,315,158
"38290","E01004006",2011,772,271,501,192
"38291","E01004007",2011,436,329,107,41
"38292","E01004008",2011,808,533,275,102
"38293","E01004010",2011,601,290,311,144
"38294","E01004011",2011,724,526,198,81
"38295","E01004012",2011,934,462,472,210
"38296","E01004013",2011,606,378,228,103
"38297","E01004014",2011,710,477,233,104
"38298","E01004015",2011,690,154,536,175
"38299","E01004016",2011,934,209,725,174
"38300","E01004017",2011,627,92,535,148
"38301","E01004018",2011,780,56,724,197
"38302","E01004019",2011,912,362,550,177
"38303","E01004020",2011,730,412,318,107
"38304","E01004021",2011,1032,156,876,480
"38305","E01004022",2011,1146,543,603,172
"38306","E01004023",2011,703,404,299,113
"38307","E01004024",2011,819,549,270,143
"38308","E01004027",2011,993,432,561,330
"38309","E01004028",2011,713,434,279,117
"38310","E01004029",2011,819,140,679,336
"38311","E01004030",2011,726,386,340,152
"38312","E01004031",2011,880,344,536,215
"38313","E01004032",2011,714,36,678,309
"38314","E01004033",2011,699,435,264,122
"38315","E01004034",2011,635,387,248,118
"38316","E01004035",2011,687,489,198,90
"38317","E01004036",2011,806,505,301,191
"38318","E01004037",2011,878,376,502,242
"38319","E01004038",2011,920,347,573,283
"38320","E01004039",2011,633,176,457,219
"38321","E01004040",2011,680,538,142,58
"38322","E01004041",2011,699,462,237,142
"38323","E01004042",2011,762,510,252,128
"38324","E01004043",2011,599,229,370,107
"38325","E01004044",2011,556,357,199,68
"38326","E01004045",2011,601,457,144,51
"38327","E01004046",2011,674,186,488,148
"38328","E01004047",2011,607,386,221,85
"38329","E01004048",2011,645,231,414,118
"38330","E01004049",2011,507,290,217,83
"38331","E01004050",2011,652,88,564,216
"38332","E01004051",2011,613,96,517,108
"38333","E01004052",2011,798,200,598,223
"38334","E01004053",2011,877,92,785,332
"38335","E01004054",2011,782,62,720,294
"38336","E01004055",2011,513,384,129,33
"38337","E01004056",2011,906,299,607,314
"38338","E01004057",2011,668,207,461,170
"38339","E01004058",2011,855,9,846,384
"38340","E01004059",2011,662,24,638,353
"38341","E01004060",2011,785,366,419,237
"38342","E01004061",2011,772,190,582,205
"38343","E01004062",2011,830,299,531,233
"38344","E01004063",2011,847,266,581,193
"38345","E01004064",2011,808,428,380,168
"38346","E01004065",2011,625,129,496,165
"38347","E01004066",2011,844,386,458,152
"38348","E01004067",2011,831,486,345,171
"38349","E01004068",2011,829,463,366,100
"38350","E01004069",2011,497,32,465,67
"38351","E01004070",2011,779,176,603,143
"38352","E01004071",2011,663,234,429,119
"38353","E01004072",2011,617,64,553,112
"38354","E01004073",2011,736,89,647,187
"38355","E01004074",2011,631,58,573,99
"38356","E01004075",2011,657,58,599,105
"38357","E01004076",2011,616,112,504,76
"38358","E01004077",2011,629,56,573,74
"38359","E01004078",2011,686,126,560,106
"38360","E01004079",2011,489,5,484,22
"38361","E01004080",2011,506,2,504,28
"38362","E01004081",2011,615,59,556,74
"38363","E01004082",2011,496,5,491,29
"38364","E01004083",2011,612,413,199,31
"38365","E01004084",2011,504,3,501,22
"38366","E01004085",2011,582,8,574,45
"38367","E01004086",2011,592,81,511,71
"38368","E01004087",2011,522,4,518,20
"38369","E01004088",2011,733,640,93,19
"38370","E01004089",2011,549,321,228,31
"38371","E01004090",2011,540,302,238,65
"38372","E01004091",2011,474,4,470,8
"38373","E01004092",2011,585,9,576,79
"38374","E01004093",2011,598,14,584,88
"38375","E01004094",2011,748,25,723,162
"38376","E01004095",2011,635,4,631,106
"38377","E01004096",2011,756,77,679,305
"38378","E01004097",2011,625,13,612,110
"38379","E01004098",2011,504,18,486,84
"38380","E01004099",2011,711,146,565,143
"38381","E01004100",2011,536,23,513,61
"38382","E01004101",2011,531,13,518,47
"38383","E01004102",2011,556,46,510,78
"38384","E01004103",2011,734,35,699,177
"38385","E01004104",2011,551,8,543,28
"38386","E01004105",2011,647,55,592,59
"38387","E01004106",2011,522,1,521,17
"38388","E01004107",2011,619,117,502,60
"38389","E01004108",2011,595,34,561,47
"38390","E01004109",2011,638,163,475,47
"38391","E01004110",2011,790,47,743,249
"38392","E01004111",2011,578,40,538,57
"38393","E01004112",2011,668,2,666,80
"38394","E01004114",2011,595,4,591,27
"38395","E01004115",2011,664,3,661,65
"38396","E01004116",2011,640,43,597,34
"38397","E01004117",2011,508,8,500,22
"38398","E01004118",2011,669,24,645,124
"38399","E01004119",2011,506,2,504,30
"38400","E01004120",2011,547,5,542,27
"38401","E01004121",2011,627,24,603,133
"38402","E01004122",2011,517,39,478,31
"38403","E01004123",2011,838,280,558,201
"38404","E01004124",2011,655,214,441,62
"38405","E01004125",2011,630,297,333,58
"38406","E01004126",2011,564,262,302,51
"38407","E01004127",2011,630,179,451,57
"38408","E01004128",2011,528,233,295,45
"38409","E01004129",2011,750,397,353,67
"38410","E01004130",2011,644,47,597,59
"38411","E01004131",2011,613,28,585,72
"38412","E01004132",2011,514,4,510,37
"38413","E01004133",2011,533,4,529,29
"38414","E01004134",2011,555,31,524,85
"38415","E01004135",2011,517,5,512,63
"38416","E01004136",2011,550,27,523,36
"38417","E01004137",2011,763,28,735,292
"38418","E01004138",2011,697,95,602,141
"38419","E01004139",2011,595,33,562,149
"38420","E01004140",2011,746,316,430,166
"38421","E01004141",2011,724,182,542,118
"38422","E01004142",2011,1052,453,599,229
"38423","E01004143",2011,626,75,551,109
"38424","E01004144",2011,633,12,621,85
"38425","E01004145",2011,786,56,730,92
"38426","E01004146",2011,686,78,608,120
"38427","E01004147",2011,603,50,553,36
"38428","E01004148",2011,643,198,445,81
"38429","E01004149",2011,813,68,745,151
"38430","E01004150",2011,936,251,685,317
"38431","E01004151",2011,790,48,742,323
"38432","E01004152",2011,849,153,696,286
"38433","E01004153",2011,903,95,808,337
"38434","E01004154",2011,561,16,545,66
"38435","E01004155",2011,822,17,805,266
"38436","E01004156",2011,892,41,851,419
"38437","E01004157",2011,452,4,448,23
"38438","E01004158",2011,696,22,674,210
"38439","E01004159",2011,629,28,601,81
"38440","E01004160",2011,672,20,652,184
"38441","E01004161",2011,594,12,582,78
"38442","E01004162",2011,745,54,691,261
"38443","E01004163",2011,615,31,584,40
"38444","E01004164",2011,639,51,588,87
"38445","E01004165",2011,705,109,596,133
"38446","E01004166",2011,658,84,574,95
"38447","E01004167",2011,527,199,328,63
"38448","E01004168",2011,579,22,557,53
"38449","E01004169",2011,460,119,341,59
"38450","E01004170",2011,751,41,710,184
"38451","E01004171",2011,558,38,520,51
"38452","E01004172",2011,748,190,558,167
"38453","E01004173",2011,520,106,414,30
"38454","E01004174",2011,664,59,605,164
"38455","E01004175",2011,690,84,606,84
"38456","E01004176",2011,583,65,518,106
"38457","E01004177",2011,911,244,667,200
"38458","E01004178",2011,950,103,847,293
"38459","E01004179",2011,599,15,584,90
"38460","E01004180",2011,616,8,608,33
"38461","E01004181",2011,756,101,655,135
"38462","E01004182",2011,653,266,387,85
"38463","E01004183",2011,663,291,372,71
"38464","E01004184",2011,598,275,323,49
"38465","E01004185",2011,565,300,265,73
"38466","E01004186",2011,790,94,696,216
"38467","E01004187",2011,640,178,462,46
"38468","E01004188",2011,724,116,608,169
"38469","E01004189",2011,750,334,416,51
"38470","E01004190",2011,499,3,496,39
"38471","E01004191",2011,657,10,647,106
"38472","E01004192",2011,753,92,661,125
"38473","E01004193",2011,923,97,826,154
"38474","E01004194",2011,609,52,557,61
"38475","E01004195",2011,661,37,624,192
"38476","E01004196",2011,567,9,558,55
"38477","E01004197",2011,964,422,542,317
"38478","E01004198",2011,606,378,228,125
"38479","E01004199",2011,574,408,166,89
"38480","E01004200",2011,585,115,470,328
"38481","E01004201",2011,619,324,295,135
"38482","E01004202",2011,713,218,495,255
"38483","E01004203",2011,689,226,463,256
"38484","E01004204",2011,631,382,249,101
"38485","E01004205",2011,688,409,279,169
"38486","E01004206",2011,554,333,221,125
"38487","E01004207",2011,515,293,222,116
"38488","E01004208",2011,788,101,687,406
"38489","E01004209",2011,466,324,142,77
"38490","E01004211",2011,720,186,534,307
"38491","E01004212",2011,720,284,436,257
"38492","E01004214",2011,665,502,163,89
"38493","E01004215",2011,1168,341,827,476
"38494","E01004216",2011,737,170,567,309
"38495","E01004217",2011,779,293,486,203
"38496","E01004218",2011,731,116,615,262
"38497","E01004219",2011,851,418,433,246
"38498","E01004221",2011,802,220,582,317
"38499","E01004222",2011,1048,637,411,175
"38500","E01004223",2011,938,645,293,146
"38501","E01004224",2011,806,369,437,261
"38502","E01004225",2011,1147,114,1033,507
"38503","E01004226",2011,676,334,342,160
"38504","E01004228",2011,769,264,505,189
"38505","E01004229",2011,551,221,330,143
"38506","E01004230",2011,803,347,456,218
"38507","E01004231",2011,629,351,278,150
"38508","E01004232",2011,603,100,503,224
"38509","E01004233",2011,751,431,320,137
"38510","E01004234",2011,903,238,665,278
"38511","E01004235",2011,513,363,150,82
"38512","E01004236",2011,497,299,198,105
"38513","E01004237",2011,506,241,265,120
"38514","E01004238",2011,1058,486,572,362
"38515","E01004239",2011,533,341,192,70
"38516","E01004240",2011,574,348,226,101
"38517","E01004241",2011,570,370,200,112
"38518","E01004242",2011,898,428,470,292
"38519","E01004243",2011,614,363,251,128
"38520","E01004244",2011,686,422,264,131
"38521","E01004245",2011,433,308,125,57
"38522","E01004246",2011,747,187,560,172
"38523","E01004247",2011,714,363,351,225
"38524","E01004248",2011,441,320,121,73
"38525","E01004249",2011,758,476,282,135
"38526","E01004250",2011,866,583,283,138
"38527","E01004251",2011,779,422,357,154
"38528","E01004252",2011,1107,488,619,349
"38529","E01004253",2011,829,499,330,139
"38530","E01004254",2011,1046,73,973,542
"38531","E01004255",2011,647,310,337,172
"38532","E01004256",2011,611,328,283,142
"38533","E01004257",2011,618,318,300,176
"38534","E01004258",2011,713,179,534,219
"38535","E01004259",2011,812,257,555,281
"38536","E01004260",2011,636,311,325,131
"38537","E01004261",2011,550,253,297,204
"38538","E01004262",2011,495,228,267,144
"38539","E01004263",2011,529,333,196,93
"38540","E01004264",2011,457,240,217,105
"38541","E01004266",2011,583,265,318,131
"38542","E01004267",2011,707,281,426,242
"38543","E01004268",2011,688,430,258,178
"38544","E01004269",2011,726,377,349,201
"38545","E01004270",2011,745,167,578,329
"38546","E01004271",2011,548,365,183,102
"38547","E01004272",2011,639,429,210,111
"38548","E01004273",2011,594,411,183,90
"38549","E01004274",2011,654,290,364,203
"38550","E01004275",2011,768,179,589,288
"38551","E01004276",2011,996,12,984,534
"38552","E01004277",2011,898,26,872,547
"38553","E01004280",2011,769,277,492,257
"38554","E01004281",2011,831,59,772,480
"38555","E01004283",2011,756,396,360,181
"38556","E01004284",2011,884,524,360,103
"38557","E01004285",2011,658,443,215,94
"38558","E01004286",2011,817,464,353,104
"38559","E01004287",2011,854,440,414,179
"38560","E01004288",2011,525,354,171,70
"38561","E01004289",2011,670,323,347,158
"38562","E01004290",2011,575,155,420,237
"38563","E01004291",2011,1051,127,924,411
"38564","E01004292",2011,818,48,770,351
"38565","E01004293",2011,1133,143,990,466
"38566","E01004294",2011,877,221,656,311
"38567","E01004295",2011,500,291,209,106
"38568","E01004296",2011,684,293,391,201
"38569","E01004297",2011,909,89,820,346
"38570","E01004298",2011,635,365,270,148
"38571","E01004300",2011,522,327,195,87
"38572","E01004301",2011,413,189,224,97
"38573","E01004302",2011,637,311,326,141
"38574","E01004303",2011,967,411,556,250
"38575","E01004304",2011,653,345,308,144
"38576","E01004305",2011,699,384,315,156
"38577","E01004306",2011,687,192,495,277
"38578","E01004307",2011,1014,166,848,539
"38579","E01004308",2011,504,177,327,130
"38580","E01004309",2011,902,394,508,297
"38581","E01004310",2011,793,315,478,316
"38582","E01004311",2011,644,353,291,132
"38583","E01004312",2011,628,386,242,138
"38584","E01004313",2011,812,349,463,255
"38585","E01004314",2011,493,89,404,147
"38586","E01004315",2011,718,324,394,188
"38587","E01004316",2011,455,235,220,115
"38588","E01004317",2011,1193,283,910,588
"38589","E01004318",2011,630,399,231,125
"38590","E01004319",2011,595,236,359,225
"38591","E01004321",2011,711,403,308,184
"38592","E01004322",2011,502,248,254,138
"38593","E01004323",2011,480,178,302,154
"38594","E01004324",2011,485,240,245,97
"38595","E01004325",2011,1033,168,865,657
"38596","E01004326",2011,623,242,381,232
"38597","E01004327",2011,465,184,281,106
"38598","E01004328",2011,671,100,571,258
"38599","E01004329",2011,671,101,570,243
"38600","E01004330",2011,625,65,560,219
"38601","E01004331",2011,675,142,533,234
"38602","E01004332",2011,633,132,501,253
"38603","E01004333",2011,611,249,362,153
"38604","E01004334",2011,637,439,198,65
"38605","E01004335",2011,645,474,171,98
"38606","E01004336",2011,564,98,466,257
"38607","E01004337",2011,717,324,393,170
"38608","E01004338",2011,580,49,531,274
"38609","E01004339",2011,661,122,539,267
"38610","E01004340",2011,698,348,350,191
"38611","E01004341",2011,665,330,335,190
"38612","E01004342",2011,789,184,605,232
"38613","E01004343",2011,647,37,610,96
"38614","E01004344",2011,667,182,485,137
"38615","E01004345",2011,624,69,555,145
"38616","E01004346",2011,557,88,469,85
"38617","E01004347",2011,809,113,696,202
"38618","E01004348",2011,973,123,850,321
"38619","E01004349",2011,547,178,369,36
"38620","E01004350",2011,915,323,592,110
"38621","E01004351",2011,645,49,596,41
"38622","E01004352",2011,813,37,776,151
"38623","E01004353",2011,798,69,729,104
"38624","E01004354",2011,749,34,715,180
"38625","E01004355",2011,673,157,516,86
"38626","E01004356",2011,590,116,474,60
"38627","E01004357",2011,574,72,502,43
"38628","E01004358",2011,788,162,626,107
"38629","E01004359",2011,610,83,527,46
"38630","E01004360",2011,492,16,476,24
"38631","E01004361",2011,492,14,478,39
"38632","E01004362",2011,676,111,565,242
"38633","E01004363",2011,506,22,484,110
"38634","E01004364",2011,563,158,405,139
"38635","E01004365",2011,700,117,583,322
"38636","E01004366",2011,642,45,597,177
"38637","E01004367",2011,537,61,476,164
"38638","E01004368",2011,720,76,644,303
"38639","E01004369",2011,615,62,553,318
"38640","E01004370",2011,636,44,592,249
"38641","E01004371",2011,615,64,551,237
"38642","E01004372",2011,744,37,707,362
"38643","E01004373",2011,621,82,539,263
"38644","E01004374",2011,688,57,631,259
"38645","E01004375",2011,647,60,587,306
"38646","E01004376",2011,654,69,585,306
"38647","E01004377",2011,626,52,574,86
"38648","E01004378",2011,677,158,519,109
"38649","E01004379",2011,523,13,510,53
"38650","E01004380",2011,607,159,448,65
"38651","E01004381",2011,674,54,620,110
"38652","E01004382",2011,501,287,214,47
"38653","E01004383",2011,575,63,512,48
"38654","E01004384",2011,695,243,452,87
"38655","E01004385",2011,650,254,396,65
"38656","E01004386",2011,642,16,626,35
"38657","E01004387",2011,525,11,514,41
"38658","E01004388",2011,649,108,541,154
"38659","E01004389",2011,706,216,490,81
"38660","E01004390",2011,652,268,384,46
"38661","E01004391",2011,846,161,685,275
"38662","E01004392",2011,879,120,759,344
"38663","E01004393",2011,1023,303,720,239
"38664","E01004394",2011,744,267,477,198
"38665","E01004395",2011,565,58,507,149
"38666","E01004396",2011,647,45,602,214
"38667","E01004397",2011,849,102,747,339
"38668","E01004398",2011,679,344,335,82
"38669","E01004399",2011,594,342,252,61
"38670","E01004400",2011,641,114,527,183
"38671","E01004401",2011,803,175,628,221
"38672","E01004402",2011,663,185,478,128
"38673","E01004403",2011,602,198,404,97
"38674","E01004404",2011,882,274,608,294
"38675","E01004405",2011,566,130,436,148
"38676","E01004406",2011,731,87,644,360
"38677","E01004407",2011,493,315,178,87
"38678","E01004408",2011,676,136,540,178
"38679","E01004409",2011,711,161,550,231
"38680","E01004410",2011,852,423,429,172
"38681","E01004411",2011,648,88,560,277
"38682","E01004412",2011,740,124,616,229
"38683","E01004413",2011,685,277,408,40
"38684","E01004414",2011,615,37,578,82
"38685","E01004415",2011,583,137,446,45
"38686","E01004416",2011,632,102,530,61
"38687","E01004417",2011,650,107,543,102
"38688","E01004418",2011,649,87,562,99
"38689","E01004419",2011,637,28,609,131
"38690","E01004420",2011,790,239,551,262
"38691","E01004421",2011,604,85,519,152
"38692","E01004422",2011,589,43,546,158
"38693","E01004423",2011,697,240,457,231
"38694","E01004424",2011,627,159,468,237
"38695","E01004425",2011,848,161,687,298
"38696","E01004426",2011,590,59,531,150
"38697","E01004427",2011,852,42,810,454
"38698","E01004428",2011,653,474,179,71
"38699","E01004429",2011,653,212,441,178
"38700","E01004430",2011,827,79,748,423
"38701","E01004432",2011,652,61,591,242
"38702","E01004434",2011,737,211,526,197
"38703","E01004435",2011,749,158,591,302
"38704","E01004436",2011,580,117,463,196
"38705","E01004437",2011,762,185,577,309
"38706","E01004438",2011,772,76,696,332
"38707","E01004439",2011,619,124,495,214
"38708","E01004440",2011,794,110,684,345
"38709","E01004441",2011,635,70,565,181
"38710","E01004442",2011,668,63,605,229
"38711","E01004443",2011,586,87,499,208
"38712","E01004444",2011,966,321,645,334
"38713","E01004445",2011,624,116,508,184
"38714","E01004446",2011,677,92,585,209
"38715","E01004447",2011,653,52,601,194
"38716","E01004448",2011,759,149,610,261
"38717","E01004449",2011,599,372,227,65
"38718","E01004450",2011,605,11,594,41
"38719","E01004451",2011,641,80,561,52
"38720","E01004452",2011,692,110,582,128
"38721","E01004453",2011,658,34,624,142
"38722","E01004454",2011,640,66,574,88
"38723","E01004455",2011,544,108,436,99
"38724","E01004456",2011,539,362,177,23
"38725","E01004457",2011,738,149,589,220
"38726","E01004458",2011,681,81,600,208
"38727","E01004459",2011,535,396,139,37
"38728","E01004460",2011,671,144,527,177
"38729","E01004461",2011,794,47,747,312
"38730","E01004462",2011,639,93,546,220
"38731","E01004463",2011,906,154,752,273
"38732","E01004464",2011,643,373,270,104
"38733","E01004465",2011,543,77,466,107
"38734","E01004466",2011,638,76,562,139
"38735","E01004467",2011,881,343,538,306
"38736","E01004468",2011,657,42,615,151
"38737","E01004469",2011,627,328,299,97
"38738","E01004470",2011,602,166,436,168
"38739","E01004471",2011,668,222,446,166
"38740","E01004472",2011,742,55,687,216
"38741","E01004473",2011,746,105,641,247
"38742","E01004474",2011,918,120,798,458
"38743","E01004475",2011,622,106,516,221
"38744","E01004476",2011,824,112,712,398
"38745","E01004477",2011,607,31,576,126
"38746","E01004478",2011,538,40,498,87
"38747","E01004479",2011,613,81,532,160
"38748","E01004480",2011,678,36,642,248
"38749","E01004481",2011,716,60,656,343
"38750","E01004482",2011,626,85,541,228
"38751","E01004483",2011,1011,60,951,465
"38752","E01004484",2011,652,98,554,249
"38753","E01004485",2011,691,119,572,258
"38754","E01004486",2011,784,143,641,323
"38755","E01004487",2011,715,193,522,240
"38756","E01004488",2011,625,133,492,163
"38757","E01004489",2011,612,145,467,198
"38758","E01004490",2011,614,29,585,181
"38759","E01004491",2011,971,539,432,157
"38760","E01004492",2011,744,127,617,217
"38761","E01004493",2011,803,103,700,275
"38762","E01004494",2011,762,205,557,241
"38763","E01004495",2011,523,191,332,130
"38764","E01004496",2011,951,114,837,428
"38765","E01004497",2011,541,97,444,98
"38766","E01004498",2011,784,46,738,293
"38767","E01004499",2011,713,94,619,285
"38768","E01004500",2011,807,99,708,335
"38769","E01004501",2011,712,193,519,197
"38770","E01004502",2011,670,31,639,182
"38771","E01004503",2011,738,125,613,285
"38772","E01004504",2011,566,22,544,205
"38773","E01004505",2011,838,47,791,311
"38774","E01004506",2011,955,80,875,434
"38775","E01004507",2011,962,98,864,474
"38776","E01004508",2011,986,192,794,350
"38777","E01004509",2011,1122,141,981,508
"38778","E01004510",2011,917,123,794,325
"38779","E01004511",2011,712,28,684,301
"38780","E01004512",2011,618,99,519,171
"38781","E01004513",2011,833,177,656,234
"38782","E01004514",2011,799,88,711,234
"38783","E01004515",2011,739,171,568,245
"38784","E01004516",2011,510,39,471,79
"38785","E01004517",2011,810,84,726,360
"38786","E01004518",2011,650,44,606,151
"38787","E01004519",2011,632,102,530,166
"38788","E01004520",2011,459,63,396,101
"38789","E01004521",2011,768,102,666,198
"38790","E01004522",2011,628,61,567,207
"38791","E01004523",2011,722,202,520,152
"38792","E01004524",2011,774,302,472,207
"38793","E01004525",2011,659,23,636,382
"38794","E01004526",2011,655,115,540,266
"38795","E01004527",2011,578,41,537,221
"38796","E01004528",2011,655,166,489,206
"38797","E01004529",2011,902,115,787,356
"38798","E01004530",2011,789,104,685,284
"38799","E01004531",2011,649,182,467,160
"38800","E01004532",2011,644,148,496,165
"38801","E01004533",2011,569,189,380,144
"38802","E01004534",2011,825,115,710,261
"38803","E01004535",2011,731,516,215,98
"38804","E01004536",2011,928,331,597,332
"38805","E01004537",2011,799,477,322,139
"38806","E01004538",2011,909,377,532,198
"38807","E01004539",2011,800,514,286,111
"38808","E01004540",2011,1002,386,616,218
"38809","E01004541",2011,762,461,301,116
"38810","E01004542",2011,618,65,553,148
"38811","E01004543",2011,717,55,662,233
"38812","E01004544",2011,606,87,519,147
"38813","E01004545",2011,850,35,815,439
"38814","E01004546",2011,640,60,580,209
"38815","E01004547",2011,551,161,390,123
"38816","E01004548",2011,1054,93,961,491
"38817","E01004549",2011,672,115,557,196
"38818","E01004550",2011,570,151,419,146
"38819","E01004551",2011,884,388,496,285
"38820","E01004552",2011,913,70,843,480
"38821","E01004553",2011,766,118,648,276
"38822","E01004554",2011,653,36,617,192
"38823","E01004555",2011,587,24,563,106
"38824","E01004556",2011,590,30,560,149
"38825","E01004557",2011,650,65,585,207
"38826","E01004558",2011,675,71,604,191
"38827","E01004559",2011,503,47,456,116
"38828","E01004560",2011,959,132,827,349
"38829","E01004562",2011,754,374,380,166
"38830","E01004563",2011,879,369,510,279
"38831","E01004564",2011,820,254,566,259
"38832","E01004565",2011,815,251,564,279
"38833","E01004566",2011,821,92,729,321
"38834","E01004567",2011,982,506,476,217
"38835","E01004568",2011,458,303,155,76
"38836","E01004569",2011,737,246,491,224
"38837","E01004570",2011,745,439,306,188
"38838","E01004571",2011,651,305,346,166
"38839","E01004572",2011,706,213,493,183
"38840","E01004573",2011,631,124,507,153
"38841","E01004574",2011,727,478,249,139
"38842","E01004575",2011,691,371,320,119
"38843","E01004576",2011,592,254,338,121
"38844","E01004577",2011,907,188,719,322
"38845","E01004579",2011,744,232,512,163
"38846","E01004580",2011,892,149,743,389
"38847","E01004581",2011,892,164,728,317
"38848","E01004582",2011,976,78,898,314
"38849","E01004583",2011,876,134,742,256
"38850","E01004584",2011,703,505,198,94
"38851","E01004585",2011,858,147,711,301
"38852","E01004586",2011,848,94,754,354
"38853","E01004587",2011,735,75,660,226
"38854","E01004588",2011,858,74,784,363
"38855","E01004589",2011,706,37,669,277
"38856","E01004590",2011,807,361,446,160
"38857","E01004591",2011,811,263,548,258
"38858","E01004592",2011,795,402,393,134
"38859","E01004593",2011,852,64,788,334
"38860","E01004594",2011,590,9,581,149
"38861","E01004595",2011,796,55,741,295
"38862","E01004596",2011,646,14,632,186
"38863","E01004597",2011,779,157,622,169
"38864","E01004598",2011,818,60,758,253
"38865","E01004599",2011,575,15,560,101
"38866","E01004600",2011,893,453,440,236
"38867","E01004601",2011,1006,192,814,301
"38868","E01004602",2011,706,33,673,297
"38869","E01004604",2011,593,13,580,116
"38870","E01004605",2011,785,156,629,166
"38871","E01004606",2011,754,23,731,328
"38872","E01004607",2011,718,26,692,215
"38873","E01004608",2011,785,157,628,247
"38874","E01004609",2011,996,58,938,487
"38875","E01004610",2011,632,70,562,208
"38876","E01004611",2011,570,54,516,173
"38877","E01004612",2011,558,44,514,254
"38878","E01004613",2011,677,201,476,243
"38879","E01004614",2011,855,162,693,346
"38880","E01004615",2011,757,338,419,204
"38881","E01004616",2011,816,65,751,481
"38882","E01004617",2011,638,128,510,286
"38883","E01004618",2011,527,23,504,147
"38884","E01004619",2011,536,76,460,108
"38885","E01004620",2011,702,127,575,186
"38886","E01004621",2011,659,74,585,209
"38887","E01004622",2011,533,119,414,147
"38888","E01004623",2011,712,81,631,179
"38889","E01004624",2011,624,101,523,135
"38890","E01004625",2011,469,8,461,45
"38891","E01004626",2011,724,18,706,215
"38892","E01004627",2011,631,99,532,149
"38893","E01004628",2011,911,200,711,292
"38894","E01004629",2011,609,72,537,149
"38895","E01004630",2011,679,342,337,152
"38896","E01004631",2011,643,156,487,205
"38897","E01004632",2011,593,67,526,157
"38898","E01004633",2011,623,293,330,190
"38899","E01004634",2011,697,118,579,246
"38900","E01004635",2011,691,77,614,246
"38901","E01004636",2011,650,113,537,205
"38902","E01004637",2011,602,143,459,179
"38903","E01004638",2011,519,24,495,75
"38904","E01004639",2011,783,68,715,318
"38905","E01004640",2011,797,29,768,275
"38906","E01004641",2011,818,227,591,143
"38907","E01004642",2011,761,201,560,162
"38908","E01004643",2011,851,290,561,230
"38909","E01004644",2011,870,205,665,133
"38910","E01004645",2011,844,383,461,172
"38911","E01004646",2011,616,94,522,233
"38912","E01004647",2011,685,147,538,218
"38913","E01004648",2011,1122,71,1051,510
"38914","E01004649",2011,716,45,671,298
"38915","E01004650",2011,932,20,912,443
"38916","E01004651",2011,1137,99,1038,609
"38917","E01004652",2011,958,87,871,574
"38918","E01004653",2011,929,171,758,318
"38919","E01004654",2011,1204,188,1016,506
"38920","E01004656",2011,1178,305,873,448
"38921","E01004657",2011,827,33,794,536
"38922","E01004658",2011,744,20,724,492
"38923","E01004659",2011,961,58,903,536
"38924","E01004660",2011,873,55,818,384
"38925","E01004661",2011,892,87,805,519
"38926","E01004662",2011,1040,71,969,679
"38927","E01004663",2011,851,160,691,286
"38928","E01004665",2011,611,383,228,87
"38929","E01004666",2011,553,253,300,170
"38930","E01004667",2011,743,348,395,192
"38931","E01004668",2011,645,198,447,152
"38932","E01004669",2011,758,369,389,158
"38933","E01004670",2011,948,738,210,82
"38934","E01004674",2011,843,488,355,142
"38935","E01004675",2011,1098,540,558,337
"38936","E01004676",2011,794,197,597,356
"38937","E01004677",2011,876,317,559,289
"38938","E01004678",2011,889,334,555,278
"38939","E01004679",2011,935,482,453,281
"38940","E01004680",2011,708,16,692,308
"38941","E01004681",2011,1150,74,1076,625
"38942","E01004682",2011,765,89,676,425
"38943","E01004683",2011,767,23,744,321
"38944","E01004684",2011,701,50,651,394
"38945","E01004686",2011,848,31,817,555
"38946","E01004687",2011,799,11,788,308
"38947","E01004688",2011,486,9,477,175
"38948","E01004689",2011,510,35,475,188
"38949","E01004690",2011,627,32,595,245
"38950","E01004691",2011,816,52,764,360
"38951","E01004692",2011,644,11,633,255
"38952","E01004693",2011,735,54,681,336
"38953","E01004694",2011,949,51,898,605
"38954","E01004695",2011,669,17,652,418
"38955","E01004696",2011,760,337,423,179
"38956","E01004697",2011,816,83,733,418
"38957","E01004698",2011,754,45,709,474
"38958","E01004699",2011,1165,59,1106,736
"38959","E01004700",2011,941,65,876,582
"38960","E01004701",2011,843,27,816,426
"38961","E01004702",2011,994,512,482,253
"38962","E01004703",2011,1027,92,935,360
"38963","E01004705",2011,700,40,660,303
"38964","E01004706",2011,735,54,681,347
"38965","E01004707",2011,798,12,786,353
"38966","E01004708",2011,788,197,591,327
"38967","E01004709",2011,765,184,581,268
"38968","E01004710",2011,635,303,332,155
"38969","E01004711",2011,759,348,411,228
"38970","E01004712",2011,842,67,775,442
"38971","E01004713",2011,939,31,908,540
"38972","E01004714",2011,1177,111,1066,657
"38973","E01004715",2011,824,237,587,321
"38974","E01004716",2011,724,57,667,311
"38975","E01004717",2011,898,32,866,614
"38976","E01004718",2011,850,394,456,219
"38977","E01004719",2011,786,438,348,106
"38978","E01004720",2011,777,414,363,81
"38979","E01004721",2011,879,531,348,167
"38980","E01004722",2011,849,579,270,133
"38981","E01004723",2011,997,492,505,319
"38982","E01004724",2011,850,119,731,409
"38983","E01004725",2011,799,384,415,239
"38984","E01004726",2011,824,31,793,346
"38985","E01004727",2011,977,6,971,463
"38986","E01004728",2011,808,161,647,306
"38987","E01004729",2011,856,418,438,219
"38988","E01004730",2011,804,11,793,327
"38989","E01004731",2011,910,64,846,443
"38990","E01004732",2011,697,538,159,84
"38991","E01004733",2011,926,136,790,370
"38992","E01004734",2011,1104,347,757,544
"38993","E01004735",2011,977,397,580,349
"38994","E01004736",2011,729,14,715,375
"38995","E01004737",2011,683,339,344,151
"38996","E01004738",2011,722,78,644,337
"38997","E01004739",2011,950,72,878,835
"38998","E01004740",2011,776,455,321,107
"38999","E01004741",2011,698,281,417,186
"39000","E01004742",2011,779,127,652,348
"39001","E01004743",2011,713,271,442,214
"39002","E01004744",2011,744,321,423,232
"39003","E01004745",2011,1125,332,793,321
"39004","E01004746",2011,757,444,313,138
"39005","E01004747",2011,1127,346,781,364
"39006","E01004748",2011,615,37,578,206
"39007","E01004749",2011,1185,170,1015,481
"39008","E01004750",2011,951,368,583,292
"39009","E01004751",2011,943,108,835,374
"39010","E01004752",2011,905,396,509,252
"39011","E01004753",2011,1041,374,667,336
"39012","E01004754",2011,600,385,215,85
"39013","E01004755",2011,963,433,530,302
"39014","E01004756",2011,866,258,608,370
"39015","E01004757",2011,600,313,287,144
"39016","E01004760",2011,771,301,470,209
"39017","E01004761",2011,1085,108,977,542
"39018","E01004762",2011,1136,275,861,478
"39019","E01004763",2011,1076,154,922,671
"39020","E01004765",2011,1103,288,815,433
"39021","E01004766",2011,795,112,683,166
"39022","E01004767",2011,768,57,711,191
"39023","E01004768",2011,605,5,600,29
"39024","E01004769",2011,685,2,683,55
"39025","E01004770",2011,616,6,610,41
"39026","E01004771",2011,636,1,635,49
"39027","E01004772",2011,731,359,372,39
"39028","E01004773",2011,852,14,838,248
"39029","E01004774",2011,706,152,554,89
"39030","E01004775",2011,614,13,601,57
"39031","E01004776",2011,794,129,665,149
"39032","E01004777",2011,705,141,564,128
"39033","E01004778",2011,517,18,499,43
"39034","E01004779",2011,588,100,488,56
"39035","E01004780",2011,871,17,854,110
"39036","E01004781",2011,792,43,749,154
"39037","E01004782",2011,494,133,361,31
"39038","E01004783",2011,636,13,623,45
"39039","E01004784",2011,508,4,504,16
"39040","E01004785",2011,641,84,557,36
"39041","E01004786",2011,648,54,594,37
"39042","E01004787",2011,778,496,282,48
"39043","E01004788",2011,609,2,607,28
"39044","E01004789",2011,591,4,587,33
"39045","E01004790",2011,644,73,571,54
"39046","E01004791",2011,607,33,574,45
"39047","E01004792",2011,642,1,641,32
"39048","E01004793",2011,658,386,272,35
"39049","E01004794",2011,678,385,293,42
"39050","E01004795",2011,700,253,447,50
"39051","E01004796",2011,643,25,618,76
"39052","E01004797",2011,507,228,279,38
"39053","E01004798",2011,689,214,475,50
"39054","E01004799",2011,598,7,591,41
"39055","E01004800",2011,529,7,522,35
"39056","E01004801",2011,690,446,244,59
"39057","E01004802",2011,750,449,301,67
"39058","E01004803",2011,709,1,708,120
"39059","E01004804",2011,602,17,585,34
"39060","E01004805",2011,676,20,656,56
"39061","E01004806",2011,650,19,631,47
"39062","E01004807",2011,543,1,542,59
"39063","E01004808",2011,687,3,684,58
"39064","E01004809",2011,893,155,738,159
"39065","E01004810",2011,626,15,611,41
"39066","E01004811",2011,633,227,406,132
"39067","E01004812",2011,624,103,521,213
"39068","E01004813",2011,530,111,419,127
"39069","E01004814",2011,582,97,485,119
"39070","E01004815",2011,589,140,449,64
"39071","E01004816",2011,513,96,417,56
"39072","E01004817",2011,754,230,524,187
"39073","E01004818",2011,713,201,512,264
"39074","E01004819",2011,596,46,550,103
"39075","E01004820",2011,645,296,349,98
"39076","E01004822",2011,625,275,350,91
"39077","E01004823",2011,838,563,275,75
"39078","E01004824",2011,496,80,416,70
"39079","E01004825",2011,631,298,333,79
"39080","E01004826",2011,634,187,447,155
"39081","E01004827",2011,684,285,399,101
"39082","E01004828",2011,652,164,488,147
"39083","E01004829",2011,498,95,403,136
"39084","E01004830",2011,741,186,555,165
"39085","E01004831",2011,654,23,631,101
"39086","E01004832",2011,650,28,622,130
"39087","E01004833",2011,636,20,616,76
"39088","E01004834",2011,579,33,546,117
"39089","E01004835",2011,577,26,551,30
"39090","E01004836",2011,588,6,582,54
"39091","E01004837",2011,599,7,592,20
"39092","E01004838",2011,642,152,490,125
"39093","E01004839",2011,944,593,351,109
"39094","E01004840",2011,715,79,636,92
"39095","E01004841",2011,669,450,219,40
"39096","E01004842",2011,732,55,677,53
"39097","E01004843",2011,621,8,613,55
"39098","E01004844",2011,612,6,606,21
"39099","E01004845",2011,692,42,650,134
"39100","E01004846",2011,512,138,374,114
"39101","E01004847",2011,638,248,390,104
"39102","E01004848",2011,714,442,272,112
"39103","E01004849",2011,548,115,433,116
"39104","E01004850",2011,762,402,360,109
"39105","E01004851",2011,674,361,313,84
"39106","E01004852",2011,484,97,387,86
"39107","E01004853",2011,517,206,311,74
"39108","E01004854",2011,460,57,403,116
"39109","E01004855",2011,613,78,535,117
"39110","E01004856",2011,637,210,427,124
"39111","E01004857",2011,636,180,456,145
"39112","E01004858",2011,755,220,535,142
"39113","E01004859",2011,704,361,343,84
"39114","E01004860",2011,691,121,570,99
"39115","E01004861",2011,623,312,311,70
"39116","E01004862",2011,610,335,275,62
"39117","E01004863",2011,646,302,344,68
"39118","E01004864",2011,697,62,635,98
"39119","E01004865",2011,653,161,492,128
"39120","E01004866",2011,780,417,363,93
"39121","E01004867",2011,632,48,584,120
"39122","E01004868",2011,692,90,602,207
"39123","E01004869",2011,848,184,664,303
"39124","E01004870",2011,794,49,745,358
"39125","E01004871",2011,545,49,496,174
"39126","E01004872",2011,619,145,474,81
"39127","E01004873",2011,626,203,423,58
"39128","E01004874",2011,683,206,477,50
"39129","E01004875",2011,653,78,575,47
"39130","E01004876",2011,792,318,474,73
"39131","E01004877",2011,689,448,241,55
"39132","E01004878",2011,541,67,474,67
"39133","E01004879",2011,520,229,291,55
"39134","E01004880",2011,508,12,496,43
"39135","E01004881",2011,748,190,558,135
"39136","E01004882",2011,594,93,501,66
"39137","E01004883",2011,627,18,609,99
"39138","E01004884",2011,685,12,673,46
"39139","E01004885",2011,530,11,519,18
"39140","E01004886",2011,610,224,386,61
"39141","E01004887",2011,618,210,408,28
"39142","E01004888",2011,554,138,416,23
"39143","E01004889",2011,608,154,454,54
"39144","E01004890",2011,673,26,647,143
"39145","E01004891",2011,756,59,697,70
"39146","E01004892",2011,693,23,670,43
"39147","E01004893",2011,592,4,588,33
"39148","E01004894",2011,797,76,721,143
"39149","E01004895",2011,588,169,419,40
"39150","E01004896",2011,556,4,552,25
"39151","E01004897",2011,474,4,470,46
"39152","E01004899",2011,622,84,538,70
"39153","E01004900",2011,624,23,601,87
"39154","E01004901",2011,739,20,719,59
"39155","E01004902",2011,802,150,652,144
"39156","E01004903",2011,575,30,545,39
"39157","E01004904",2011,696,86,610,99
"39158","E01004905",2011,679,157,522,74
"39159","E01004906",2011,810,291,519,103
"39160","E01004907",2011,541,155,386,54
"39161","E01004908",2011,570,59,511,40
"39162","E01004909",2011,632,218,414,39
"39163","E01004910",2011,970,79,891,285
"39164","E01004911",2011,745,237,508,88
"39165","E01004912",2011,642,21,621,53
"39166","E01004913",2011,768,95,673,130
"39167","E01004914",2011,519,19,500,27
"39168","E01004915",2011,536,7,529,27
"39169","E01004916",2011,666,173,493,58
"39170","E01004917",2011,869,163,706,104
"39171","E01004918",2011,520,6,514,39
"39172","E01004919",2011,656,12,644,73
"39173","E01004920",2011,658,156,502,59
"39174","E01004921",2011,737,59,678,99
"39175","E01004922",2011,775,178,597,183
"39176","E01004923",2011,663,10,653,184
"39177","E01004924",2011,604,9,595,33
"39178","E01004925",2011,646,26,620,59
"39179","E01004926",2011,510,285,225,32
"39180","E01004927",2011,1008,439,569,252
"39181","E01004928",2011,684,80,604,213
"39182","E01004929",2011,867,265,602,147
"39183","E01004930",2011,646,42,604,51
"39184","E01004931",2011,767,271,496,102
"39185","E01004932",2011,717,33,684,202
"39186","E01004933",2011,569,7,562,77
"39187","E01004934",2011,560,118,442,38
"39188","E01004935",2011,705,33,672,72
"39189","E01004936",2011,950,61,889,204
"39190","E01004937",2011,558,15,543,39
"39191","E01004938",2011,632,349,283,36
"39192","E01004939",2011,686,148,538,78
"39193","E01004940",2011,616,29,587,42
"39194","E01004941",2011,726,218,508,64
"39195","E01004942",2011,639,354,285,60
"39196","E01004943",2011,650,95,555,136
"39197","E01004944",2011,630,23,607,58
"39198","E01004945",2011,658,36,622,39
"39199","E01004946",2011,798,492,306,45
"39200","E01004947",2011,653,86,567,141
"39201","E01004948",2011,836,191,645,165
"39202","E01004949",2011,596,1,595,23
"39203","E01004950",2011,612,48,564,11
"39204","E01004951",2011,653,2,651,24
"39205","E01004952",2011,619,5,614,17
"39206","E01004953",2011,628,63,565,28
"39207","E01004954",2011,658,105,553,82
"39208","E01004955",2011,550,98,452,68
"39209","E01004956",2011,696,169,527,103
"39210","E01004957",2011,813,464,349,58
"39211","E01004958",2011,661,151,510,162
"39212","E01004959",2011,728,163,565,135
"39213","E01004960",2011,632,468,164,39
"39214","E01004961",2011,647,172,475,67
"39215","E01004962",2011,708,9,699,140
"39216","E01004963",2011,673,82,591,48
"39217","E01004964",2011,832,61,771,241
"39218","E01004965",2011,486,20,466,21
"39219","E01004966",2011,719,222,497,92
"39220","E01004967",2011,472,3,469,16
"39221","E01004968",2011,627,4,623,43
"39222","E01004969",2011,705,35,670,142
"39223","E01004970",2011,605,21,584,40
"39224","E01004971",2011,598,2,596,46
"39225","E01004972",2011,573,201,372,53
"39226","E01004973",2011,658,22,636,106
"39227","E01004974",2011,603,13,590,79
"39228","E01004975",2011,757,127,630,191
"39229","E01004976",2011,638,185,453,66
"39230","E01004977",2011,767,108,659,124
"39231","E01004978",2011,654,50,604,102
"39232","E01004979",2011,630,187,443,172
"39233","E01004980",2011,596,60,536,185
"39234","E01004981",2011,632,71,561,69
"39235","E01004982",2011,635,19,616,33
"39236","E01004983",2011,545,16,529,149
"39237","E01004984",2011,573,9,564,66
"39238","E01004985",2011,577,16,561,29
"39239","E01004986",2011,806,136,670,180
"39240","E01004987",2011,649,332,317,29
"39241","E01004988",2011,637,66,571,89
"39242","E01004989",2011,567,5,562,77
"39243","E01004990",2011,634,113,521,112
"39244","E01004991",2011,588,64,524,101
"39245","E01004992",2011,637,35,602,161
"39246","E01004993",2011,551,152,399,43
"39247","E01004994",2011,614,164,450,137
"39248","E01004995",2011,640,7,633,39
"39249","E01004996",2011,731,258,473,177
"39250","E01004997",2011,594,37,557,103
"39251","E01004998",2011,641,13,628,74
"39252","E01004999",2011,596,32,564,44
"39253","E01005000",2011,574,5,569,52
"39254","E01005001",2011,493,28,465,28
"39255","E01005002",2011,635,71,564,38
"39256","E01005003",2011,654,93,561,111
"39257","E01005004",2011,849,556,293,52
"39258","E01005005",2011,632,23,609,52
"39259","E01005006",2011,647,125,522,40
"39260","E01005007",2011,710,14,696,101
"39261","E01005008",2011,875,347,528,175
"39262","E01005009",2011,742,204,538,223
"39263","E01005010",2011,660,52,608,64
"39264","E01005011",2011,589,8,581,48
"39265","E01005012",2011,755,205,550,95
"39266","E01005013",2011,956,262,694,203
"39267","E01005014",2011,746,50,696,212
"39268","E01005015",2011,688,201,487,67
"39269","E01005016",2011,718,18,700,121
"39270","E01005017",2011,707,52,655,65
"39271","E01005018",2011,713,115,598,126
"39272","E01005019",2011,620,27,593,49
"39273","E01005020",2011,507,2,505,19
"39274","E01005021",2011,410,3,407,26
"39275","E01005022",2011,644,7,637,78
"39276","E01005023",2011,554,69,485,30
"39277","E01005024",2011,511,113,398,172
"39278","E01005025",2011,685,58,627,111
"39279","E01005026",2011,545,30,515,152
"39280","E01005027",2011,732,102,630,180
"39281","E01005028",2011,803,396,407,67
"39282","E01005029",2011,660,56,604,114
"39283","E01005030",2011,733,292,441,174
"39284","E01005031",2011,627,154,473,54
"39285","E01005032",2011,523,195,328,83
"39286","E01005033",2011,614,15,599,158
"39287","E01005034",2011,640,22,618,100
"39288","E01005035",2011,626,60,566,88
"39289","E01005036",2011,1030,365,665,304
"39290","E01005037",2011,628,5,623,84
"39291","E01005038",2011,531,6,525,50
"39292","E01005039",2011,699,205,494,101
"39293","E01005040",2011,696,59,637,101
"39294","E01005041",2011,519,3,516,55
"39295","E01005042",2011,608,57,551,81
"39296","E01005043",2011,496,3,493,99
"39297","E01005044",2011,471,32,439,165
"39298","E01005045",2011,682,103,579,113
"39299","E01005046",2011,643,0,643,43
"39300","E01005047",2011,568,2,566,42
"39301","E01005048",2011,666,3,663,21
"39302","E01005049",2011,738,11,727,70
"39303","E01005050",2011,819,32,787,113
"39304","E01005051",2011,658,58,600,86
"39305","E01005052",2011,582,3,579,18
"39306","E01005053",2011,640,47,593,78
"39307","E01005054",2011,641,33,608,82
"39308","E01005055",2011,584,4,580,40
"39309","E01005056",2011,604,4,600,47
"39310","E01005057",2011,630,54,576,83
"39311","E01005058",2011,505,1,504,25
"39312","E01005059",2011,733,159,574,95
"39313","E01005060",2011,734,63,671,106
"39314","E01005061",2011,743,629,114,42
"39315","E01005062",2011,772,342,430,247
"39316","E01005063",2011,614,414,200,60
"39317","E01005065",2011,916,599,317,161
"39318","E01005066",2011,501,340,161,87
"39319","E01005067",2011,587,401,186,79
"39320","E01005068",2011,704,391,313,37
"39321","E01005069",2011,641,79,562,82
"39322","E01005070",2011,740,421,319,102
"39323","E01005071",2011,684,254,430,105
"39324","E01005072",2011,811,318,493,134
"39325","E01005073",2011,615,106,509,48
"39326","E01005074",2011,644,290,354,63
"39327","E01005075",2011,612,236,376,63
"39328","E01005076",2011,782,62,720,536
"39329","E01005077",2011,630,378,252,47
"39330","E01005078",2011,824,103,721,360
"39331","E01005079",2011,628,149,479,77
"39332","E01005081",2011,784,484,300,48
"39333","E01005082",2011,659,280,379,71
"39334","E01005083",2011,888,25,863,601
"39335","E01005084",2011,867,228,639,135
"39336","E01005085",2011,599,315,284,111
"39337","E01005086",2011,715,437,278,71
"39338","E01005087",2011,792,506,286,115
"39339","E01005088",2011,687,512,175,42
"39340","E01005089",2011,699,439,260,76
"39341","E01005090",2011,745,551,194,50
"39342","E01005091",2011,867,537,330,148
"39343","E01005092",2011,720,288,432,193
"39344","E01005093",2011,678,317,361,142
"39345","E01005094",2011,660,291,369,165
"39346","E01005097",2011,650,446,204,46
"39347","E01005098",2011,777,474,303,74
"39348","E01005099",2011,726,502,224,39
"39349","E01005100",2011,658,213,445,53
"39350","E01005101",2011,723,298,425,93
"39351","E01005102",2011,626,47,579,101
"39352","E01005103",2011,835,389,446,97
"39353","E01005104",2011,842,379,463,200
"39354","E01005105",2011,809,338,471,192
"39355","E01005106",2011,825,378,447,203
"39356","E01005107",2011,740,467,273,90
"39357","E01005108",2011,1053,611,442,184
"39358","E01005111",2011,622,236,386,42
"39359","E01005112",2011,676,252,424,57
"39360","E01005113",2011,830,483,347,61
"39361","E01005114",2011,810,70,740,126
"39362","E01005115",2011,785,276,509,54
"39363","E01005116",2011,973,295,678,144
"39364","E01005117",2011,938,584,354,79
"39365","E01005118",2011,497,110,387,78
"39366","E01005119",2011,629,283,346,51
"39367","E01005120",2011,661,153,508,91
"39368","E01005121",2011,599,306,293,67
"39369","E01005122",2011,641,268,373,47
"39370","E01005123",2011,622,371,251,37
"39371","E01005124",2011,686,381,305,94
"39372","E01005125",2011,635,227,408,102
"39373","E01005126",2011,819,48,771,188
"39374","E01005128",2011,766,26,740,562
"39375","E01005129",2011,709,492,217,135
"39376","E01005130",2011,767,586,181,75
"39377","E01005132",2011,661,408,253,77
"39378","E01005133",2011,596,341,255,137
"39379","E01005135",2011,624,312,312,69
"39380","E01005136",2011,637,151,486,73
"39381","E01005138",2011,787,589,198,39
"39382","E01005139",2011,714,151,563,66
"39383","E01005140",2011,1185,208,977,284
"39384","E01005141",2011,805,543,262,33
"39385","E01005142",2011,729,553,176,58
"39386","E01005143",2011,792,246,546,249
"39387","E01005145",2011,801,80,721,346
"39388","E01005146",2011,852,81,771,286
"39389","E01005147",2011,914,571,343,169
"39390","E01005149",2011,474,37,437,146
"39391","E01005150",2011,930,121,809,592
"39392","E01005151",2011,717,168,549,206
"39393","E01005152",2011,600,14,586,103
"39394","E01005153",2011,820,148,672,243
"39395","E01005154",2011,669,40,629,354
"39396","E01005155",2011,683,18,665,175
"39397","E01005156",2011,635,19,616,167
"39398","E01005157",2011,614,6,608,65
"39399","E01005158",2011,711,196,515,171
"39400","E01005159",2011,621,28,593,209
"39401","E01005160",2011,721,84,637,165
"39402","E01005161",2011,657,11,646,134
"39403","E01005162",2011,679,124,555,154
"39404","E01005163",2011,661,41,620,152
"39405","E01005164",2011,694,226,468,251
"39406","E01005165",2011,976,340,636,409
"39407","E01005166",2011,716,126,590,305
"39408","E01005167",2011,565,140,425,175
"39409","E01005168",2011,522,29,493,55
"39410","E01005169",2011,487,17,470,73
"39411","E01005170",2011,584,7,577,107
"39412","E01005171",2011,711,41,670,177
"39413","E01005172",2011,803,85,718,300
"39414","E01005173",2011,703,47,656,200
"39415","E01005174",2011,624,12,612,131
"39416","E01005175",2011,693,115,578,126
"39417","E01005176",2011,936,88,848,433
"39418","E01005177",2011,643,70,573,141
"39419","E01005178",2011,742,258,484,174
"39420","E01005179",2011,953,134,819,442
"39421","E01005180",2011,782,422,360,91
"39422","E01005181",2011,683,84,599,237
"39423","E01005182",2011,469,245,224,54
"39424","E01005183",2011,670,362,308,61
"39425","E01005184",2011,779,93,686,444
"39426","E01005185",2011,534,54,480,413
"39427","E01005186",2011,945,346,599,224
"39428","E01005187",2011,787,143,644,317
"39429","E01005188",2011,703,58,645,164
"39430","E01005189",2011,826,495,331,130
"39431","E01005190",2011,881,223,658,241
"39432","E01005191",2011,800,243,557,239
"39433","E01005192",2011,679,78,601,174
"39434","E01005193",2011,818,108,710,257
"39435","E01005194",2011,940,171,769,386
"39436","E01005195",2011,735,483,252,105
"39437","E01005196",2011,894,502,392,172
"39438","E01005197",2011,697,263,434,161
"39439","E01005198",2011,649,403,246,67
"39440","E01005199",2011,895,85,810,352
"39441","E01005200",2011,764,195,569,178
"39442","E01005201",2011,816,216,600,365
"39443","E01005202",2011,783,432,351,158
"39444","E01005203",2011,927,671,256,123
"39445","E01005205",2011,937,516,421,177
"39446","E01005206",2011,747,95,652,231
"39447","E01005207",2011,817,52,765,357
"39448","E01005208",2011,1110,355,755,521
"39449","E01005209",2011,868,458,410,292
"39450","E01005210",2011,638,367,271,199
"39451","E01005212",2011,696,355,341,192
"39452","E01005213",2011,1178,693,485,282
"39453","E01005214",2011,1013,190,823,477
"39454","E01005215",2011,756,94,662,229
"39455","E01005216",2011,611,38,573,109
"39456","E01005217",2011,678,20,658,135
"39457","E01005218",2011,632,143,489,175
"39458","E01005219",2011,916,126,790,425
"39459","E01005220",2011,728,69,659,260
"39460","E01005221",2011,779,59,720,315
"39461","E01005222",2011,897,212,685,242
"39462","E01005223",2011,549,123,426,99
"39463","E01005224",2011,715,83,632,296
"39464","E01005225",2011,837,253,584,162
"39465","E01005226",2011,683,34,649,262
"39466","E01005227",2011,698,186,512,220
"39467","E01005228",2011,755,545,210,84
"39468","E01005229",2011,609,17,592,64
"39469","E01005230",2011,819,257,562,373
"39470","E01005231",2011,633,54,579,484
"39471","E01005232",2011,713,218,495,199
"39472","E01005233",2011,770,237,533,255
"39473","E01005234",2011,633,194,439,201
"39474","E01005235",2011,719,387,332,104
"39475","E01005236",2011,702,199,503,339
"39476","E01005237",2011,533,81,452,162
"39477","E01005238",2011,564,89,475,176
"39478","E01005239",2011,660,455,205,67
"39479","E01005240",2011,1003,415,588,312
"39480","E01005241",2011,1009,208,801,394
"39481","E01005242",2011,1008,454,554,379
"39482","E01005243",2011,1084,694,390,211
"39483","E01005244",2011,926,248,678,473
"39484","E01005245",2011,871,625,246,93
"39485","E01005246",2011,738,446,292,156
"39486","E01005247",2011,627,54,573,64
"39487","E01005248",2011,573,25,548,28
"39488","E01005249",2011,777,208,569,96
"39489","E01005250",2011,750,286,464,87
"39490","E01005251",2011,633,265,368,62
"39491","E01005252",2011,763,331,432,51
"39492","E01005253",2011,639,283,356,48
"39493","E01005254",2011,683,53,630,72
"39494","E01005255",2011,824,582,242,71
"39495","E01005256",2011,854,409,445,178
"39496","E01005257",2011,820,485,335,103
"39497","E01005258",2011,781,205,576,149
"39498","E01005259",2011,782,352,430,191
"39499","E01005260",2011,592,37,555,91
"39500","E01005261",2011,651,410,241,54
"39501","E01005262",2011,861,291,570,130
"39502","E01005263",2011,825,356,469,93
"39503","E01005264",2011,617,262,355,53
"39504","E01005265",2011,682,316,366,71
"39505","E01005266",2011,835,354,481,112
"39506","E01005267",2011,664,104,560,62
"39507","E01005268",2011,994,77,917,252
"39508","E01005269",2011,617,78,539,54
"39509","E01005270",2011,675,341,334,95
"39510","E01005271",2011,694,83,611,484
"39511","E01005272",2011,755,447,308,63
"39512","E01005273",2011,553,125,428,299
"39513","E01005274",2011,682,223,459,194
"39514","E01005275",2011,818,49,769,523
"39515","E01005276",2011,643,39,604,336
"39516","E01005277",2011,778,22,756,362
"39517","E01005278",2011,541,64,477,213
"39518","E01005279",2011,817,294,523,174
"39519","E01005280",2011,528,198,330,70
"39520","E01005281",2011,542,128,414,254
"39521","E01005282",2011,550,69,481,165
"39522","E01005283",2011,408,37,371,321
"39523","E01005284",2011,834,109,725,535
"39524","E01005285",2011,476,225,251,152
"39525","E01005286",2011,738,74,664,406
"39526","E01005287",2011,652,279,373,155
"39527","E01005288",2011,640,156,484,323
"39528","E01005289",2011,641,430,211,40
"39529","E01005290",2011,675,400,275,50
"39530","E01005291",2011,714,485,229,36
"39531","E01005292",2011,696,400,296,61
"39532","E01005293",2011,521,56,465,59
"39533","E01005294",2011,645,125,520,57
"39534","E01005295",2011,1124,166,958,297
"39535","E01005296",2011,614,54,560,146
"39536","E01005297",2011,916,152,764,352
"39537","E01005298",2011,641,63,578,198
"39538","E01005299",2011,533,21,512,105
"39539","E01005300",2011,490,7,483,89
"39540","E01005301",2011,612,14,598,184
"39541","E01005302",2011,930,190,740,450
"39542","E01005304",2011,657,82,575,344
"39543","E01005305",2011,592,8,584,223
"39544","E01005306",2011,687,63,624,175
"39545","E01005307",2011,721,53,668,304
"39546","E01005308",2011,625,216,409,122
"39547","E01005309",2011,963,82,881,705
"39548","E01005310",2011,579,187,392,295
"39549","E01005311",2011,615,45,570,267
"39550","E01005312",2011,618,136,482,363
"39551","E01005313",2011,618,318,300,58
"39552","E01005314",2011,635,294,341,49
"39553","E01005315",2011,715,410,305,67
"39554","E01005316",2011,702,197,505,159
"39555","E01005317",2011,774,326,448,80
"39556","E01005318",2011,782,295,487,122
"39557","E01005319",2011,880,357,523,153
"39558","E01005320",2011,631,118,513,161
"39559","E01005321",2011,596,142,454,139
"39560","E01005322",2011,523,259,264,108
"39561","E01005323",2011,621,178,443,102
"39562","E01005324",2011,612,377,235,41
"39563","E01005325",2011,419,298,121,34
"39564","E01005326",2011,554,92,462,72
"39565","E01005327",2011,757,101,656,79
"39566","E01005328",2011,696,379,317,61
"39567","E01005329",2011,616,4,612,59
"39568","E01005330",2011,626,12,614,39
"39569","E01005331",2011,635,61,574,88
"39570","E01005332",2011,979,184,795,171
"39571","E01005333",2011,499,3,496,14
"39572","E01005334",2011,541,6,535,33
"39573","E01005335",2011,540,4,536,43
"39574","E01005336",2011,630,2,628,26
"39575","E01005337",2011,655,83,572,134
"39576","E01005338",2011,752,311,441,85
"39577","E01005339",2011,589,11,578,23
"39578","E01005340",2011,606,244,362,44
"39579","E01005341",2011,602,85,517,71
"39580","E01005342",2011,662,288,374,75
"39581","E01005343",2011,547,167,380,43
"39582","E01005344",2011,656,151,505,147
"39583","E01005345",2011,620,16,604,51
"39584","E01005346",2011,610,50,560,48
"39585","E01005347",2011,540,33,507,76
"39586","E01005348",2011,625,302,323,55
"39587","E01005349",2011,538,105,433,108
"39588","E01005350",2011,989,782,207,48
"39589","E01005351",2011,467,86,381,86
"39590","E01005352",2011,461,165,296,59
"39591","E01005353",2011,657,426,231,47
"39592","E01005354",2011,541,114,427,89
"39593","E01005355",2011,630,43,587,102
"39594","E01005356",2011,503,17,486,40
"39595","E01005357",2011,616,23,593,21
"39596","E01005358",2011,735,168,567,78
"39597","E01005359",2011,757,30,727,61
"39598","E01005360",2011,648,171,477,33
"39599","E01005361",2011,728,22,706,42
"39600","E01005362",2011,612,59,553,64
"39601","E01005363",2011,699,106,593,145
"39602","E01005364",2011,709,13,696,47
"39603","E01005365",2011,624,13,611,55
"39604","E01005366",2011,699,287,412,33
"39605","E01005367",2011,572,7,565,30
"39606","E01005368",2011,729,136,593,162
"39607","E01005369",2011,655,158,497,158
"39608","E01005370",2011,714,353,361,93
"39609","E01005371",2011,554,74,480,134
"39610","E01005372",2011,518,106,412,62
"39611","E01005373",2011,507,17,490,30
"39612","E01005374",2011,621,131,490,52
"39613","E01005375",2011,652,11,641,36
"39614","E01005376",2011,558,200,358,103
"39615","E01005377",2011,498,337,161,50
"39616","E01005378",2011,663,43,620,130
"39617","E01005379",2011,507,364,143,36
"39618","E01005380",2011,533,308,225,23
"39619","E01005381",2011,642,327,315,73
"39620","E01005382",2011,598,212,386,100
"39621","E01005383",2011,718,216,502,78
"39622","E01005386",2011,626,339,287,45
"39623","E01005387",2011,631,31,600,79
"39624","E01005388",2011,596,80,516,64
"39625","E01005389",2011,727,270,457,119
"39626","E01005390",2011,604,30,574,55
"39627","E01005391",2011,651,131,520,31
"39628","E01005392",2011,767,376,391,76
"39629","E01005393",2011,524,41,483,20
"39630","E01005394",2011,654,58,596,40
"39631","E01005395",2011,610,15,595,43
"39632","E01005396",2011,589,80,509,25
"39633","E01005397",2011,637,87,550,68
"39634","E01005398",2011,656,14,642,97
"39635","E01005399",2011,698,12,686,71
"39636","E01005400",2011,753,333,420,52
"39637","E01005401",2011,689,19,670,42
"39638","E01005402",2011,622,60,562,85
"39639","E01005403",2011,644,54,590,64
"39640","E01005406",2011,594,14,580,44
"39641","E01005407",2011,724,3,721,91
"39642","E01005408",2011,794,73,721,92
"39643","E01005409",2011,664,3,661,108
"39644","E01005410",2011,599,15,584,34
"39645","E01005411",2011,721,86,635,80
"39646","E01005412",2011,784,19,765,109
"39647","E01005413",2011,654,10,644,52
"39648","E01005414",2011,525,20,505,68
"39649","E01005415",2011,508,119,389,25
"39650","E01005416",2011,599,4,595,98
"39651","E01005417",2011,635,12,623,63
"39652","E01005418",2011,585,10,575,35
"39653","E01005419",2011,638,6,632,101
"39654","E01005420",2011,716,161,555,76
"39655","E01005421",2011,735,168,567,170
"39656","E01005422",2011,533,337,196,35
"39657","E01005427",2011,497,130,367,64
"39658","E01005428",2011,532,32,500,142
"39659","E01005429",2011,479,108,371,75
"39660","E01005430",2011,714,85,629,155
"39661","E01005431",2011,717,57,660,153
"39662","E01005432",2011,648,401,247,77
"39663","E01005433",2011,666,400,266,114
"39664","E01005434",2011,657,255,402,171
"39665","E01005435",2011,490,22,468,111
"39666","E01005436",2011,520,9,511,65
"39667","E01005437",2011,529,14,515,114
"39668","E01005438",2011,966,91,875,233
"39669","E01005439",2011,654,42,612,80
"39670","E01005440",2011,625,176,449,44
"39671","E01005441",2011,792,344,448,56
"39672","E01005442",2011,588,14,574,38
"39673","E01005443",2011,552,5,547,23
"39674","E01005444",2011,672,46,626,132
"39675","E01005445",2011,672,110,562,180
"39676","E01005446",2011,605,91,514,59
"39677","E01005447",2011,701,230,471,113
"39678","E01005448",2011,781,453,328,104
"39679","E01005449",2011,578,253,325,57
"39680","E01005450",2011,627,87,540,173
"39681","E01005451",2011,482,7,475,69
"39682","E01005452",2011,543,8,535,41
"39683","E01005453",2011,537,8,529,37
"39684","E01005454",2011,569,57,512,32
"39685","E01005455",2011,619,24,595,89
"39686","E01005456",2011,785,321,464,107
"39687","E01005459",2011,407,209,198,37
"39688","E01005460",2011,753,157,596,122
"39689","E01005461",2011,536,78,458,79
"39690","E01005462",2011,552,68,484,75
"39691","E01005463",2011,406,151,255,70
"39692","E01005464",2011,643,336,307,60
"39693","E01005465",2011,761,140,621,169
"39694","E01005466",2011,1072,764,308,63
"39695","E01005467",2011,800,464,336,81
"39696","E01005468",2011,602,15,587,65
"39697","E01005469",2011,716,26,690,115
"39698","E01005470",2011,474,75,399,116
"39699","E01005471",2011,562,48,514,116
"39700","E01005472",2011,663,234,429,95
"39701","E01005473",2011,492,79,413,92
"39702","E01005474",2011,480,39,441,49
"39703","E01005475",2011,597,191,406,91
"39704","E01005476",2011,708,42,666,135
"39705","E01005477",2011,815,179,636,257
"39706","E01005478",2011,682,109,573,84
"39707","E01005479",2011,711,104,607,83
"39708","E01005480",2011,739,184,555,60
"39709","E01005481",2011,602,85,517,66
"39710","E01005482",2011,1173,872,301,119
"39711","E01005483",2011,812,491,321,99
"39712","E01005484",2011,907,541,366,102
"39713","E01005485",2011,622,127,495,134
"39714","E01005486",2011,566,51,515,204
"39715","E01005487",2011,568,74,494,141
"39716","E01005488",2011,581,2,579,57
"39717","E01005489",2011,503,26,477,47
"39718","E01005490",2011,410,151,259,45
"39719","E01005491",2011,697,142,555,75
"39720","E01005492",2011,614,9,605,32
"39721","E01005493",2011,669,11,658,67
"39722","E01005494",2011,704,89,615,103
"39723","E01005495",2011,684,97,587,102
"39724","E01005496",2011,537,301,236,35
"39725","E01005497",2011,682,305,377,59
"39726","E01005498",2011,587,57,530,144
"39727","E01005499",2011,649,34,615,102
"39728","E01005500",2011,647,69,578,83
"39729","E01005501",2011,892,438,454,169
"39730","E01005502",2011,715,144,571,129
"39731","E01005503",2011,522,2,520,26
"39732","E01005504",2011,638,141,497,104
"39733","E01005505",2011,780,166,614,113
"39734","E01005506",2011,671,192,479,70
"39735","E01005507",2011,711,35,676,186
"39736","E01005508",2011,729,17,712,38
"39737","E01005509",2011,964,499,465,141
"39738","E01005510",2011,440,13,427,18
"39739","E01005511",2011,503,50,453,40
"39740","E01005512",2011,685,160,525,83
"39741","E01005513",2011,599,315,284,55
"39742","E01005514",2011,658,234,424,72
"39743","E01005515",2011,706,429,277,57
"39744","E01005516",2011,552,4,548,62
"39745","E01005517",2011,651,23,628,62
"39746","E01005518",2011,591,92,499,68
"39747","E01005519",2011,615,46,569,51
"39748","E01005520",2011,811,81,730,121
"39749","E01005521",2011,627,48,579,106
"39750","E01005522",2011,658,68,590,178
"39751","E01005523",2011,800,61,739,142
"39752","E01005524",2011,638,74,564,76
"39753","E01005525",2011,818,413,405,71
"39754","E01005526",2011,678,196,482,92
"39755","E01005527",2011,636,369,267,47
"39756","E01005528",2011,674,212,462,66
"39757","E01005529",2011,795,461,334,64
"39758","E01005530",2011,645,7,638,24
"39759","E01005531",2011,509,49,460,86
"39760","E01005532",2011,669,296,373,58
"39761","E01005533",2011,836,128,708,142
"39762","E01005534",2011,642,113,529,102
"39763","E01005535",2011,690,121,569,130
"39764","E01005536",2011,653,106,547,128
"39765","E01005537",2011,566,9,557,38
"39766","E01005538",2011,581,180,401,65
"39767","E01005539",2011,694,168,526,127
"39768","E01005540",2011,581,37,544,79
"39769","E01005541",2011,704,63,641,126
"39770","E01005542",2011,623,234,389,61
"39771","E01005543",2011,523,51,472,43
"39772","E01005544",2011,609,5,604,32
"39773","E01005545",2011,481,10,471,24
"39774","E01005546",2011,618,177,441,40
"39775","E01005547",2011,630,92,538,83
"39776","E01005548",2011,655,247,408,76
"39777","E01005549",2011,588,8,580,18
"39778","E01005550",2011,630,13,617,22
"39779","E01005551",2011,797,417,380,63
"39780","E01005552",2011,882,528,354,76
"39781","E01005553",2011,759,302,457,97
"39782","E01005554",2011,583,79,504,52
"39783","E01005555",2011,525,30,495,51
"39784","E01005556",2011,669,17,652,147
"39785","E01005557",2011,499,6,493,24
"39786","E01005558",2011,711,155,556,98
"39787","E01005559",2011,691,341,350,72
"39788","E01005560",2011,695,16,679,120
"39789","E01005561",2011,598,47,551,91
"39790","E01005562",2011,691,149,542,99
"39791","E01005563",2011,631,94,537,149
"39792","E01005564",2011,641,146,495,174
"39793","E01005565",2011,558,234,324,39
"39794","E01005566",2011,810,206,604,153
"39795","E01005567",2011,647,134,513,101
"39796","E01005568",2011,632,379,253,93
"39797","E01005569",2011,641,237,404,58
"39798","E01005570",2011,572,11,561,86
"39799","E01005571",2011,653,7,646,60
"39800","E01005572",2011,638,5,633,50
"39801","E01005573",2011,561,33,528,23
"39802","E01005574",2011,680,19,661,88
"39803","E01005575",2011,722,6,716,98
"39804","E01005576",2011,557,4,553,38
"39805","E01005577",2011,637,17,620,64
"39806","E01005578",2011,489,166,323,68
"39807","E01005579",2011,538,347,191,30
"39808","E01005580",2011,585,34,551,149
"39809","E01005581",2011,599,197,402,98
"39810","E01005583",2011,464,146,318,84
"39811","E01005585",2011,463,60,403,86
"39812","E01005586",2011,664,390,274,44
"39813","E01005587",2011,508,6,502,37
"39814","E01005588",2011,688,233,455,66
"39815","E01005589",2011,653,41,612,156
"39816","E01005590",2011,527,91,436,109
"39817","E01005591",2011,626,60,566,98
"39818","E01005592",2011,615,248,367,69
"39819","E01005593",2011,569,213,356,62
"39820","E01005594",2011,582,88,494,53
"39821","E01005595",2011,792,442,350,87
"39822","E01005596",2011,753,18,735,95
"39823","E01005597",2011,672,37,635,114
"39824","E01005598",2011,675,7,668,81
"39825","E01005599",2011,809,409,400,97
"39826","E01005600",2011,612,115,497,124
"39827","E01005601",2011,662,283,379,101
"39828","E01005602",2011,775,489,286,73
"39829","E01005603",2011,653,113,540,171
"39830","E01005604",2011,702,150,552,69
"39831","E01005605",2011,668,96,572,144
"39832","E01005609",2011,852,535,317,134
"39833","E01005610",2011,472,355,117,21
"39834","E01005611",2011,898,444,454,188
"39835","E01005612",2011,1031,820,211,93
"39836","E01005613",2011,984,564,420,234
"39837","E01005614",2011,529,169,360,162
"39838","E01005615",2011,695,186,509,256
"39839","E01005616",2011,620,238,382,37
"39840","E01005617",2011,611,69,542,64
"39841","E01005618",2011,666,240,426,82
"39842","E01005619",2011,528,123,405,66
"39843","E01005620",2011,1060,137,923,192
"39844","E01005621",2011,768,193,575,154
"39845","E01005622",2011,665,100,565,137
"39846","E01005623",2011,498,12,486,50
"39847","E01005624",2011,677,358,319,37
"39848","E01005625",2011,601,36,565,90
"39849","E01005626",2011,507,5,502,30
"39850","E01005627",2011,477,15,462,32
"39851","E01005628",2011,692,59,633,183
"39852","E01005629",2011,618,135,483,74
"39853","E01005630",2011,648,94,554,103
"39854","E01005631",2011,1021,675,346,155
"39855","E01005632",2011,916,142,774,305
"39856","E01005633",2011,597,213,384,40
"39857","E01005634",2011,601,11,590,62
"39858","E01005635",2011,704,88,616,210
"39859","E01005636",2011,680,80,600,125
"39860","E01005637",2011,628,118,510,103
"39861","E01005638",2011,759,222,537,189
"39862","E01005639",2011,605,414,191,33
"39863","E01005640",2011,546,218,328,46
"39864","E01005641",2011,640,206,434,75
"39865","E01005642",2011,512,14,498,58
"39866","E01005643",2011,671,75,596,64
"39867","E01005644",2011,631,15,616,70
"39868","E01005645",2011,603,35,568,31
"39869","E01005646",2011,527,98,429,180
"39870","E01005647",2011,675,83,592,211
"39871","E01005648",2011,861,58,803,268
"39872","E01005649",2011,682,58,624,207
"39873","E01005650",2011,597,237,360,136
"39874","E01005651",2011,537,167,370,119
"39875","E01005652",2011,548,173,375,56
"39876","E01005653",2011,626,279,347,131
"39877","E01005654",2011,754,110,644,264
"39878","E01005655",2011,716,438,278,216
"39879","E01005656",2011,645,126,519,176
"39880","E01005657",2011,709,188,521,129
"39881","E01005658",2011,662,525,137,20
"39882","E01005659",2011,631,204,427,79
"39883","E01005660",2011,675,397,278,48
"39884","E01005661",2011,725,244,481,83
"39885","E01005662",2011,617,377,240,48
"39886","E01005663",2011,618,202,416,107
"39887","E01005664",2011,630,407,223,49
"39888","E01005665",2011,629,469,160,33
"39889","E01005667",2011,879,579,300,91
"39890","E01005670",2011,822,318,504,147
"39891","E01005671",2011,745,271,474,111
"39892","E01005672",2011,608,56,552,125
"39893","E01005673",2011,642,127,515,102
"39894","E01005674",2011,574,138,436,69
"39895","E01005675",2011,712,49,663,180
"39896","E01005676",2011,554,11,543,63
"39897","E01005677",2011,696,90,606,107
"39898","E01005678",2011,653,307,346,35
"39899","E01005679",2011,670,387,283,41
"39900","E01005680",2011,723,333,390,218
"39901","E01005681",2011,568,447,121,49
"39902","E01005682",2011,1035,957,78,21
"39903","E01005683",2011,777,571,206,85
"39904","E01005686",2011,621,91,530,105
"39905","E01005687",2011,800,110,690,150
"39906","E01005688",2011,657,131,526,51
"39907","E01005689",2011,575,342,233,38
"39908","E01005690",2011,678,94,584,62
"39909","E01005691",2011,697,71,626,101
"39910","E01005692",2011,734,327,407,143
"39911","E01005693",2011,611,11,600,67
"39912","E01005694",2011,686,42,644,101
"39913","E01005695",2011,620,4,616,44
"39914","E01005696",2011,626,94,532,55
"39915","E01005697",2011,676,26,650,57
"39916","E01005698",2011,801,437,364,92
"39917","E01005699",2011,639,13,626,48
"39918","E01005700",2011,661,91,570,98
"39919","E01005701",2011,619,25,594,59
"39920","E01005702",2011,927,205,722,148
"39921","E01005703",2011,704,365,339,50
"39922","E01005704",2011,591,97,494,72
"39923","E01005705",2011,869,197,672,129
"39924","E01005706",2011,655,266,389,69
"39925","E01005707",2011,783,346,437,102
"39926","E01005708",2011,750,215,535,145
"39927","E01005709",2011,605,359,246,38
"39928","E01005710",2011,608,106,502,31
"39929","E01005711",2011,659,41,618,81
"39930","E01005712",2011,728,123,605,157
"39931","E01005713",2011,632,7,625,36
"39932","E01005714",2011,617,215,402,24
"39933","E01005715",2011,724,35,689,70
"39934","E01005716",2011,668,5,663,60
"39935","E01005717",2011,543,3,540,36
"39936","E01005718",2011,822,144,678,135
"39937","E01005719",2011,915,330,585,237
"39938","E01005720",2011,1121,239,882,506
"39939","E01005721",2011,766,189,577,169
"39940","E01005722",2011,709,249,460,148
"39941","E01005723",2011,639,317,322,79
"39942","E01005724",2011,643,91,552,52
"39943","E01005725",2011,559,308,251,61
"39944","E01005726",2011,615,138,477,99
"39945","E01005727",2011,653,116,537,176
"39946","E01005728",2011,584,21,563,55
"39947","E01005729",2011,743,512,231,77
"39948","E01005730",2011,711,79,632,97
"39949","E01005731",2011,594,317,277,47
"39950","E01005732",2011,558,272,286,29
"39951","E01005733",2011,503,220,283,32
"39952","E01005734",2011,618,86,532,80
"39953","E01005735",2011,579,4,575,43
"39954","E01005736",2011,626,5,621,77
"39955","E01005737",2011,604,6,598,38
"39956","E01005738",2011,768,9,759,103
"39957","E01005739",2011,614,3,611,57
"39958","E01005740",2011,708,30,678,80
"39959","E01005741",2011,685,45,640,56
"39960","E01005742",2011,673,29,644,77
"39961","E01005743",2011,583,11,572,72
"39962","E01005744",2011,605,74,531,93
"39963","E01005745",2011,595,60,535,68
"39964","E01005746",2011,777,421,356,36
"39965","E01005747",2011,587,7,580,58
"39966","E01005748",2011,659,12,647,18
"39967","E01005749",2011,731,13,718,100
"39968","E01005750",2011,703,14,689,111
"39969","E01005751",2011,586,8,578,97
"39970","E01005752",2011,626,219,407,47
"39971","E01005753",2011,672,349,323,47
"39972","E01005754",2011,945,682,263,37
"39973","E01005755",2011,672,322,350,47
"39974","E01005756",2011,764,565,199,18
"39975","E01005757",2011,709,92,617,159
"39976","E01005758",2011,1148,795,353,137
"39977","E01005759",2011,690,39,651,107
"39978","E01005760",2011,848,89,759,267
"39979","E01005761",2011,550,150,400,67
"39980","E01005762",2011,664,441,223,30
"39981","E01005763",2011,648,249,399,46
"39982","E01005764",2011,777,147,630,155
"39983","E01005765",2011,578,12,566,61
"39984","E01005766",2011,695,165,530,218
"39985","E01005767",2011,591,9,582,27
"39986","E01005768",2011,615,5,610,44
"39987","E01005769",2011,663,28,635,133
"39988","E01005770",2011,629,43,586,73
"39989","E01005771",2011,545,23,522,52
"39990","E01005772",2011,573,37,536,51
"39991","E01005773",2011,635,54,581,62
"39992","E01005774",2011,684,348,336,44
"39993","E01005775",2011,624,15,609,34
"39994","E01005776",2011,598,11,587,51
"39995","E01005777",2011,682,116,566,56
"39996","E01005778",2011,641,54,587,82
"39997","E01005779",2011,580,17,563,72
"39998","E01005780",2011,557,34,523,72
"39999","E01005781",2011,820,360,460,96
"40000","E01005782",2011,552,9,543,40
"40001","E01005783",2011,654,55,599,52
"40002","E01005784",2011,529,3,526,33
"40003","E01005785",2011,641,27,614,66
"40004","E01005786",2011,610,5,605,48
"40005","E01005787",2011,474,7,467,12
"40006","E01005788",2011,603,27,576,45
"40007","E01005789",2011,655,20,635,82
"40008","E01005790",2011,511,119,392,26
"40009","E01005791",2011,647,72,575,53
"40010","E01005792",2011,603,3,600,31
"40011","E01005793",2011,621,22,599,98
"40012","E01005794",2011,504,1,503,19
"40013","E01005795",2011,527,6,521,33
"40014","E01005796",2011,497,3,494,38
"40015","E01005797",2011,670,107,563,173
"40016","E01005798",2011,787,125,662,155
"40017","E01005799",2011,701,343,358,61
"40018","E01005800",2011,693,27,666,61
"40019","E01005801",2011,634,30,604,130
"40020","E01005802",2011,597,19,578,55
"40021","E01005803",2011,602,2,600,37
"40022","E01005804",2011,481,111,370,77
"40023","E01005805",2011,591,28,563,29
"40024","E01005806",2011,495,2,493,19
"40025","E01005807",2011,623,3,620,23
"40026","E01005808",2011,526,2,524,29
"40027","E01005809",2011,498,1,497,44
"40028","E01005810",2011,658,23,635,83
"40029","E01005811",2011,636,6,630,76
"40030","E01005812",2011,479,1,478,19
"40031","E01005813",2011,612,2,610,57
"40032","E01005814",2011,547,2,545,19
"40033","E01005815",2011,586,1,585,23
"40034","E01005816",2011,699,32,667,185
"40035","E01005817",2011,636,55,581,125
"40036","E01005818",2011,557,116,441,72
"40037","E01005819",2011,651,14,637,56
"40038","E01005820",2011,642,55,587,118
"40039","E01005821",2011,679,95,584,103
"40040","E01005822",2011,886,407,479,176
"40041","E01005823",2011,696,135,561,86
"40042","E01005824",2011,610,64,546,43
"40043","E01005825",2011,692,93,599,79
"40044","E01005826",2011,597,278,319,34
"40045","E01005827",2011,598,41,557,31
"40046","E01005828",2011,586,393,193,35
"40047","E01005829",2011,498,189,309,24
"40048","E01005830",2011,707,96,611,94
"40049","E01005831",2011,664,24,640,117
"40050","E01005832",2011,623,84,539,46
"40051","E01005833",2011,464,134,330,30
"40052","E01005834",2011,631,167,464,51
"40053","E01005835",2011,564,10,554,36
"40054","E01005836",2011,851,50,801,97
"40055","E01005837",2011,672,19,653,63
"40056","E01005838",2011,852,28,824,236
"40057","E01005839",2011,522,3,519,16
"40058","E01005840",2011,732,90,642,116
"40059","E01005841",2011,625,21,604,47
"40060","E01005842",2011,673,5,668,43
"40061","E01005843",2011,619,9,610,38
"40062","E01005844",2011,553,3,550,55
"40063","E01005845",2011,604,11,593,47
"40064","E01005846",2011,614,37,577,43
"40065","E01005847",2011,619,11,608,70
"40066","E01005848",2011,730,4,726,60
"40067","E01005849",2011,607,1,606,24
"40068","E01005850",2011,759,144,615,62
"40069","E01005851",2011,611,1,610,38
"40070","E01005852",2011,695,41,654,162
"40071","E01005853",2011,655,207,448,47
"40072","E01005854",2011,739,6,733,95
"40073","E01005855",2011,594,0,594,82
"40074","E01005856",2011,661,28,633,81
"40075","E01005857",2011,595,10,585,75
"40076","E01005858",2011,790,1,789,152
"40077","E01005859",2011,625,34,591,201
"40078","E01005860",2011,580,18,562,38
"40079","E01005861",2011,714,110,604,75
"40080","E01005862",2011,604,41,563,36
"40081","E01005863",2011,776,46,730,154
"40082","E01005864",2011,624,24,600,182
"40083","E01005865",2011,632,14,618,102
"40084","E01005866",2011,821,77,744,308
"40085","E01005867",2011,660,34,626,101
"40086","E01005868",2011,576,2,574,56
"40087","E01005869",2011,610,54,556,33
"40088","E01005870",2011,600,40,560,111
"40089","E01005871",2011,597,24,573,127
"40090","E01005872",2011,802,105,697,150
"40091","E01005873",2011,578,27,551,42
"40092","E01005874",2011,924,447,477,172
"40093","E01005875",2011,656,13,643,70
"40094","E01005876",2011,610,30,580,66
"40095","E01005877",2011,617,113,504,101
"40096","E01005878",2011,637,221,416,55
"40097","E01005879",2011,592,92,500,62
"40098","E01005880",2011,643,33,610,72
"40099","E01005881",2011,506,3,503,27
"40100","E01005882",2011,489,4,485,21
"40101","E01005883",2011,663,6,657,57
"40102","E01005884",2011,585,9,576,17
"40103","E01005885",2011,637,37,600,120
"40104","E01005886",2011,656,94,562,118
"40105","E01005887",2011,595,175,420,65
"40106","E01005888",2011,592,83,509,54
"40107","E01005889",2011,686,151,535,83
"40108","E01005890",2011,579,104,475,70
"40109","E01005891",2011,569,8,561,43
"40110","E01005892",2011,560,64,496,97
"40111","E01005893",2011,837,142,695,277
"40112","E01005894",2011,573,22,551,69
"40113","E01005895",2011,491,105,386,50
"40114","E01005896",2011,776,54,722,191
"40115","E01005897",2011,599,140,459,48
"40116","E01005898",2011,723,112,611,45
"40117","E01005899",2011,744,51,693,74
"40118","E01005900",2011,770,184,586,90
"40119","E01005901",2011,621,40,581,31
"40120","E01005902",2011,736,325,411,41
"40121","E01005903",2011,623,4,619,21
"40122","E01005904",2011,624,18,606,43
"40123","E01005905",2011,614,269,345,46
"40124","E01005906",2011,646,1,645,21
"40125","E01005907",2011,609,5,604,40
"40126","E01005908",2011,575,0,575,23
"40127","E01005909",2011,645,36,609,38
"40128","E01005910",2011,707,197,510,66
"40129","E01005911",2011,540,20,520,20
"40130","E01005912",2011,610,2,608,62
"40131","E01005913",2011,649,37,612,32
"40132","E01005914",2011,675,106,569,72
"40133","E01005915",2011,722,178,544,112
"40134","E01005916",2011,708,68,640,151
"40135","E01005917",2011,847,204,643,203
"40136","E01005918",2011,894,724,170,42
"40137","E01005919",2011,716,310,406,55
"40138","E01005920",2011,636,19,617,40
"40139","E01005921",2011,690,112,578,158
"40140","E01005922",2011,635,25,610,77
"40141","E01005923",2011,626,2,624,19
"40142","E01005924",2011,528,0,528,43
"40143","E01005925",2011,612,50,562,48
"40144","E01005926",2011,485,3,482,30
"40145","E01005927",2011,491,7,484,17
"40146","E01005928",2011,674,142,532,58
"40147","E01005929",2011,610,10,600,52
"40148","E01005930",2011,600,7,593,26
"40149","E01005931",2011,643,31,612,39
"40150","E01005932",2011,535,5,530,15
"40151","E01005933",2011,548,298,250,38
"40152","E01005934",2011,614,110,504,40
"40153","E01005935",2011,656,314,342,99
"40154","E01005936",2011,637,67,570,46
"40155","E01005937",2011,692,193,499,91
"40156","E01005938",2011,670,153,517,58
"40157","E01005939",2011,494,7,487,37
"40158","E01005940",2011,596,72,524,35
"40159","E01005941",2011,731,156,575,210
"40160","E01005942",2011,701,49,652,106
"40161","E01005943",2011,828,50,778,211
"40162","E01005944",2011,554,20,534,77
"40163","E01005945",2011,743,341,402,93
"40164","E01005946",2011,676,73,603,146
"40165","E01005947",2011,756,183,573,198
"40166","E01005948",2011,959,411,548,337
"40167","E01005949",2011,715,121,594,155
"40168","E01005950",2011,584,110,474,178
"40169","E01005951",2011,731,140,591,178
"40170","E01005952",2011,1181,941,240,138
"40171","E01005953",2011,797,271,526,179
"40172","E01005954",2011,777,296,481,76
"40173","E01005955",2011,632,9,623,44
"40174","E01005956",2011,578,64,514,29
"40175","E01005957",2011,589,29,560,73
"40176","E01005958",2011,659,278,381,49
"40177","E01005959",2011,655,218,437,51
"40178","E01005960",2011,723,240,483,150
"40179","E01005961",2011,562,14,548,83
"40180","E01005962",2011,597,47,550,48
"40181","E01005963",2011,509,34,475,53
"40182","E01005964",2011,660,42,618,100
"40183","E01005965",2011,662,289,373,71
"40184","E01005966",2011,539,97,442,78
"40185","E01005967",2011,694,373,321,42
"40186","E01005968",2011,628,4,624,73
"40187","E01005969",2011,573,12,561,61
"40188","E01005970",2011,652,8,644,61
"40189","E01005971",2011,632,55,577,111
"40190","E01005972",2011,737,138,599,147
"40191","E01005973",2011,597,28,569,54
"40192","E01005974",2011,742,78,664,208
"40193","E01005975",2011,680,125,555,131
"40194","E01005976",2011,624,241,383,38
"40195","E01005977",2011,658,50,608,66
"40196","E01005978",2011,605,242,363,53
"40197","E01005979",2011,777,199,578,58
"40198","E01005980",2011,641,229,412,62
"40199","E01005981",2011,791,375,416,59
"40200","E01005982",2011,583,195,388,31
"40201","E01005983",2011,707,22,685,72
"40202","E01005984",2011,773,462,311,70
"40203","E01005985",2011,709,28,681,45
"40204","E01005986",2011,531,85,446,48
"40205","E01005987",2011,711,4,707,60
"40206","E01005988",2011,636,4,632,63
"40207","E01005989",2011,512,8,504,37
"40208","E01005990",2011,620,31,589,55
"40209","E01005991",2011,617,54,563,56
"40210","E01005992",2011,592,101,491,113
"40211","E01005993",2011,615,61,554,46
"40212","E01005994",2011,605,65,540,108
"40213","E01005995",2011,508,15,493,24
"40214","E01005996",2011,804,123,681,117
"40215","E01005997",2011,673,88,585,91
"40216","E01005998",2011,729,20,709,138
"40217","E01005999",2011,840,218,622,204
"40218","E01006000",2011,822,352,470,124
"40219","E01006001",2011,647,55,592,100
"40220","E01006002",2011,560,73,487,69
"40221","E01006003",2011,617,16,601,89
"40222","E01006004",2011,603,8,595,74
"40223","E01006005",2011,634,242,392,105
"40224","E01006006",2011,604,4,600,81
"40225","E01006007",2011,655,47,608,154
"40226","E01006008",2011,615,64,551,93
"40227","E01006009",2011,569,43,526,71
"40228","E01006010",2011,671,264,407,108
"40229","E01006011",2011,682,330,352,56
"40230","E01006012",2011,777,101,676,132
"40231","E01006013",2011,548,72,476,61
"40232","E01006014",2011,478,142,336,29
"40233","E01006015",2011,531,32,499,38
"40234","E01006016",2011,979,509,470,161
"40235","E01006017",2011,536,1,535,17
"40236","E01006018",2011,560,7,553,23
"40237","E01006019",2011,803,430,373,48
"40238","E01006020",2011,607,154,453,35
"40239","E01006021",2011,610,24,586,66
"40240","E01006022",2011,790,106,684,207
"40241","E01006023",2011,790,356,434,82
"40242","E01006024",2011,675,5,670,39
"40243","E01006025",2011,593,333,260,20
"40244","E01006026",2011,744,119,625,124
"40245","E01006027",2011,621,344,277,43
"40246","E01006028",2011,883,401,482,128
"40247","E01006029",2011,718,127,591,150
"40248","E01006030",2011,748,245,503,79
"40249","E01006031",2011,661,306,355,73
"40250","E01006032",2011,547,193,354,55
"40251","E01006033",2011,635,168,467,98
"40252","E01006034",2011,931,298,633,117
"40253","E01006035",2011,954,272,682,129
"40254","E01006036",2011,819,236,583,143
"40255","E01006037",2011,605,5,600,26
"40256","E01006038",2011,655,55,600,55
"40257","E01006039",2011,440,76,364,83
"40258","E01006040",2011,564,97,467,158
"40259","E01006041",2011,662,40,622,144
"40260","E01006042",2011,770,43,727,114
"40261","E01006043",2011,606,66,540,80
"40262","E01006044",2011,612,83,529,32
"40263","E01006045",2011,542,3,539,32
"40264","E01006046",2011,618,8,610,67
"40265","E01006047",2011,572,75,497,74
"40266","E01006048",2011,729,56,673,119
"40267","E01006049",2011,714,84,630,106
"40268","E01006050",2011,797,513,284,28
"40269","E01006051",2011,735,90,645,82
"40270","E01006052",2011,661,327,334,37
"40271","E01006053",2011,818,12,806,122
"40272","E01006054",2011,759,266,493,66
"40273","E01006055",2011,639,29,610,103
"40274","E01006056",2011,507,295,212,42
"40275","E01006057",2011,644,15,629,107
"40276","E01006058",2011,945,51,894,275
"40277","E01006059",2011,612,20,592,84
"40278","E01006060",2011,687,254,433,138
"40279","E01006061",2011,962,372,590,57
"40280","E01006062",2011,813,14,799,78
"40281","E01006063",2011,564,25,539,34
"40282","E01006064",2011,724,384,340,48
"40283","E01006065",2011,500,250,250,21
"40284","E01006066",2011,598,83,515,118
"40285","E01006067",2011,727,20,707,59
"40286","E01006068",2011,834,184,650,257
"40287","E01006069",2011,650,297,353,49
"40288","E01006070",2011,628,11,617,111
"40289","E01006071",2011,650,24,626,27
"40290","E01006072",2011,671,5,666,28
"40291","E01006073",2011,721,249,472,134
"40292","E01006074",2011,619,199,420,40
"40293","E01006075",2011,887,38,849,224
"40294","E01006076",2011,779,40,739,136
"40295","E01006077",2011,776,119,657,216
"40296","E01006078",2011,856,92,764,269
"40297","E01006079",2011,879,35,844,240
"40298","E01006080",2011,788,45,743,154
"40299","E01006081",2011,503,0,503,27
"40300","E01006082",2011,675,3,672,118
"40301","E01006083",2011,488,3,485,39
"40302","E01006084",2011,641,5,636,95
"40303","E01006085",2011,622,15,607,75
"40304","E01006086",2011,675,131,544,67
"40305","E01006087",2011,584,71,513,81
"40306","E01006088",2011,654,28,626,124
"40307","E01006089",2011,632,51,581,125
"40308","E01006090",2011,906,120,786,154
"40309","E01006091",2011,980,109,871,152
"40310","E01006092",2011,515,279,236,34
"40311","E01006093",2011,608,11,597,60
"40312","E01006094",2011,593,5,588,30
"40313","E01006095",2011,682,8,674,56
"40314","E01006096",2011,559,3,556,65
"40315","E01006097",2011,852,38,814,250
"40316","E01006098",2011,515,1,514,42
"40317","E01006099",2011,558,21,537,87
"40318","E01006100",2011,611,64,547,79
"40319","E01006101",2011,557,0,557,28
"40320","E01006102",2011,574,99,475,36
"40321","E01006103",2011,602,2,600,42
"40322","E01006104",2011,747,94,653,99
"40323","E01006105",2011,777,474,303,50
"40324","E01006106",2011,617,162,455,43
"40325","E01006107",2011,723,249,474,94
"40326","E01006108",2011,680,498,182,24
"40327","E01006109",2011,781,618,163,62
"40328","E01006110",2011,671,140,531,113
"40329","E01006111",2011,568,290,278,103
"40330","E01006112",2011,561,240,321,90
"40331","E01006113",2011,468,17,451,64
"40332","E01006114",2011,574,178,396,65
"40333","E01006115",2011,632,165,467,94
"40334","E01006116",2011,536,9,527,60
"40335","E01006117",2011,637,35,602,18
"40336","E01006118",2011,608,175,433,40
"40337","E01006119",2011,636,30,606,30
"40338","E01006120",2011,560,2,558,36
"40339","E01006121",2011,614,35,579,51
"40340","E01006122",2011,672,21,651,36
"40341","E01006123",2011,659,31,628,69
"40342","E01006124",2011,596,9,587,18
"40343","E01006125",2011,602,78,524,33
"40344","E01006126",2011,711,274,437,36
"40345","E01006127",2011,631,41,590,40
"40346","E01006128",2011,720,36,684,65
"40347","E01006129",2011,632,175,457,34
"40348","E01006130",2011,752,75,677,51
"40349","E01006131",2011,646,44,602,62
"40350","E01006132",2011,673,117,556,49
"40351","E01006133",2011,664,5,659,31
"40352","E01006134",2011,528,1,527,33
"40353","E01006135",2011,619,23,596,46
"40354","E01006136",2011,614,2,612,58
"40355","E01006137",2011,492,3,489,22
"40356","E01006138",2011,794,155,639,62
"40357","E01006139",2011,709,3,706,125
"40358","E01006140",2011,639,49,590,69
"40359","E01006141",2011,585,117,468,61
"40360","E01006142",2011,751,166,585,81
"40361","E01006143",2011,709,70,639,126
"40362","E01006144",2011,718,353,365,117
"40363","E01006145",2011,677,271,406,74
"40364","E01006146",2011,658,37,621,71
"40365","E01006147",2011,542,3,539,27
"40366","E01006148",2011,690,25,665,119
"40367","E01006149",2011,659,108,551,98
"40368","E01006150",2011,709,55,654,151
"40369","E01006151",2011,562,10,552,33
"40370","E01006152",2011,621,2,619,24
"40371","E01006153",2011,637,31,606,24
"40372","E01006154",2011,634,23,611,109
"40373","E01006155",2011,676,36,640,119
"40374","E01006156",2011,676,174,502,36
"40375","E01006157",2011,609,81,528,67
"40376","E01006158",2011,772,301,471,62
"40377","E01006159",2011,715,269,446,50
"40378","E01006160",2011,963,239,724,329
"40379","E01006161",2011,900,28,872,292
"40380","E01006162",2011,701,3,698,177
"40381","E01006163",2011,826,8,818,265
"40382","E01006164",2011,727,74,653,77
"40383","E01006165",2011,874,81,793,225
"40384","E01006166",2011,705,189,516,62
"40385","E01006167",2011,772,540,232,24
"40386","E01006168",2011,837,565,272,49
"40387","E01006169",2011,683,42,641,61
"40388","E01006170",2011,687,113,574,58
"40389","E01006171",2011,799,329,470,64
"40390","E01006172",2011,678,86,592,28
"40391","E01006173",2011,606,17,589,32
"40392","E01006174",2011,815,41,774,161
"40393","E01006175",2011,749,388,361,32
"40394","E01006176",2011,757,94,663,99
"40395","E01006177",2011,613,275,338,38
"40396","E01006178",2011,781,52,729,106
"40397","E01006179",2011,854,320,534,81
"40398","E01006180",2011,794,86,708,218
"40399","E01006181",2011,656,134,522,94
"40400","E01006182",2011,598,18,580,46
"40401","E01006183",2011,632,39,593,68
"40402","E01006184",2011,731,217,514,56
"40403","E01006185",2011,1015,426,589,323
"40404","E01006186",2011,792,156,636,204
"40405","E01006187",2011,1156,206,950,265
"40406","E01006188",2011,566,96,470,155
"40407","E01006189",2011,918,163,755,148
"40408","E01006190",2011,647,4,643,40
"40409","E01006191",2011,645,12,633,49
"40410","E01006192",2011,632,15,617,45
"40411","E01006193",2011,624,12,612,60
"40412","E01006194",2011,983,108,875,261
"40413","E01006195",2011,658,6,652,41
"40414","E01006196",2011,692,5,687,39
"40415","E01006197",2011,600,26,574,67
"40416","E01006198",2011,667,131,536,107
"40417","E01006199",2011,742,179,563,111
"40418","E01006200",2011,671,203,468,52
"40419","E01006201",2011,657,87,570,100
"40420","E01006202",2011,626,83,543,138
"40421","E01006203",2011,516,5,511,26
"40422","E01006204",2011,692,77,615,50
"40423","E01006205",2011,563,27,536,38
"40424","E01006206",2011,776,206,570,64
"40425","E01006207",2011,795,467,328,60
"40426","E01006208",2011,653,189,464,40
"40427","E01006209",2011,630,19,611,30
"40428","E01006210",2011,675,91,584,42
"40429","E01006211",2011,642,188,454,35
"40430","E01006212",2011,570,53,517,39
"40431","E01006213",2011,710,244,466,164
"40432","E01006214",2011,596,90,506,123
"40433","E01006215",2011,735,284,451,107
"40434","E01006216",2011,883,82,801,118
"40435","E01006217",2011,934,233,701,119
"40436","E01006218",2011,864,123,741,226
"40437","E01006219",2011,523,9,514,64
"40438","E01006220",2011,768,259,509,71
"40439","E01006221",2011,695,10,685,112
"40440","E01006222",2011,644,9,635,42
"40441","E01006223",2011,717,16,701,141
"40442","E01006224",2011,518,2,516,34
"40443","E01006225",2011,645,42,603,58
"40444","E01006226",2011,750,37,713,81
"40445","E01006227",2011,621,49,572,53
"40446","E01006228",2011,730,55,675,167
"40447","E01006229",2011,669,8,661,100
"40448","E01006230",2011,584,48,536,27
"40449","E01006231",2011,620,34,586,32
"40450","E01006232",2011,761,13,748,110
"40451","E01006233",2011,555,4,551,18
"40452","E01006234",2011,536,87,449,37
"40453","E01006235",2011,698,317,381,52
"40454","E01006236",2011,660,15,645,62
"40455","E01006237",2011,603,29,574,36
"40456","E01006238",2011,762,282,480,94
"40457","E01006239",2011,1008,575,433,61
"40458","E01006240",2011,629,389,240,39
"40459","E01006241",2011,762,275,487,82
"40460","E01006242",2011,760,65,695,85
"40461","E01006243",2011,876,18,858,143
"40462","E01006244",2011,848,155,693,211
"40463","E01006245",2011,1081,123,958,197
"40464","E01006246",2011,732,200,532,68
"40465","E01006247",2011,555,40,515,30
"40466","E01006248",2011,796,565,231,27
"40467","E01006249",2011,642,257,385,41
"40468","E01006250",2011,676,4,672,65
"40469","E01006251",2011,604,8,596,60
"40470","E01006252",2011,639,20,619,58
"40471","E01006253",2011,666,189,477,59
"40472","E01006254",2011,634,373,261,42
"40473","E01006255",2011,655,14,641,64
"40474","E01006256",2011,606,40,566,104
"40475","E01006257",2011,532,5,527,100
"40476","E01006258",2011,715,52,663,123
"40477","E01006259",2011,542,55,487,48
"40478","E01006260",2011,638,258,380,37
"40479","E01006261",2011,655,126,529,52
"40480","E01006262",2011,623,266,357,40
"40481","E01006263",2011,641,8,633,23
"40482","E01006264",2011,523,6,517,17
"40483","E01006265",2011,619,35,584,96
"40484","E01006266",2011,626,10,616,30
"40485","E01006267",2011,790,453,337,33
"40486","E01006268",2011,717,94,623,125
"40487","E01006269",2011,735,146,589,78
"40488","E01006270",2011,664,302,362,38
"40489","E01006271",2011,742,41,701,108
"40490","E01006272",2011,701,64,637,136
"40491","E01006273",2011,662,177,485,74
"40492","E01006274",2011,663,248,415,74
"40493","E01006275",2011,654,338,316,45
"40494","E01006276",2011,868,22,846,117
"40495","E01006277",2011,628,14,614,23
"40496","E01006278",2011,697,59,638,53
"40497","E01006279",2011,613,6,607,42
"40498","E01006280",2011,627,95,532,58
"40499","E01006281",2011,725,4,721,66
"40500","E01006282",2011,686,150,536,57
"40501","E01006283",2011,682,246,436,90
"40502","E01006284",2011,649,197,452,68
"40503","E01006285",2011,714,4,710,42
"40504","E01006286",2011,642,60,582,31
"40505","E01006287",2011,478,9,469,27
"40506","E01006288",2011,736,396,340,31
"40507","E01006289",2011,863,486,377,55
"40508","E01006290",2011,619,7,612,56
"40509","E01006291",2011,676,128,548,99
"40510","E01006292",2011,648,30,618,66
"40511","E01006293",2011,729,211,518,81
"40512","E01006294",2011,909,60,849,268
"40513","E01006295",2011,803,183,620,130
"40514","E01006296",2011,710,321,389,96
"40515","E01006297",2011,772,326,446,129
"40516","E01006298",2011,677,278,399,85
"40517","E01006299",2011,827,25,802,110
"40518","E01006300",2011,610,33,577,23
"40519","E01006301",2011,532,15,517,23
"40520","E01006302",2011,658,29,629,82
"40521","E01006303",2011,601,7,594,54
"40522","E01006304",2011,632,89,543,41
"40523","E01006305",2011,707,409,298,45
"40524","E01006306",2011,861,448,413,150
"40525","E01006307",2011,635,233,402,69
"40526","E01006308",2011,684,188,496,131
"40527","E01006309",2011,633,194,439,109
"40528","E01006310",2011,698,245,453,143
"40529","E01006311",2011,650,228,422,61
"40530","E01006312",2011,618,9,609,44
"40531","E01006313",2011,458,177,281,30
"40532","E01006314",2011,740,8,732,71
"40533","E01006315",2011,518,4,514,31
"40534","E01006316",2011,618,18,600,57
"40535","E01006317",2011,662,107,555,54
"40536","E01006318",2011,627,8,619,33
"40537","E01006319",2011,523,23,500,59
"40538","E01006320",2011,560,3,557,31
"40539","E01006321",2011,703,12,691,50
"40540","E01006322",2011,677,140,537,146
"40541","E01006323",2011,638,90,548,190
"40542","E01006324",2011,614,155,459,88
"40543","E01006325",2011,628,53,575,84
"40544","E01006326",2011,659,64,595,143
"40545","E01006327",2011,620,339,281,61
"40546","E01006328",2011,680,54,626,236
"40547","E01006329",2011,476,116,360,79
"40548","E01006330",2011,668,23,645,43
"40549","E01006331",2011,640,21,619,29
"40550","E01006332",2011,856,75,781,226
"40551","E01006333",2011,843,81,762,227
"40552","E01006334",2011,837,41,796,324
"40553","E01006335",2011,777,79,698,216
"40554","E01006336",2011,734,490,244,44
"40555","E01006337",2011,658,115,543,56
"40556","E01006338",2011,735,100,635,162
"40557","E01006339",2011,595,19,576,39
"40558","E01006340",2011,645,182,463,87
"40559","E01006341",2011,755,239,516,108
"40560","E01006342",2011,686,229,457,82
"40561","E01006343",2011,649,11,638,49
"40562","E01006344",2011,596,261,335,44
"40563","E01006345",2011,672,25,647,33
"40564","E01006346",2011,974,129,845,200
"40565","E01006347",2011,642,5,637,34
"40566","E01006348",2011,680,5,675,43
"40567","E01006349",2011,886,100,786,313
"40568","E01006350",2011,742,445,297,62
"40569","E01006351",2011,930,630,300,96
"40570","E01006352",2011,754,105,649,182
"40571","E01006353",2011,656,40,616,75
"40572","E01006354",2011,648,199,449,75
"40573","E01006355",2011,694,20,674,117
"40574","E01006356",2011,608,263,345,30
"40575","E01006357",2011,654,443,211,32
"40576","E01006358",2011,805,182,623,135
"40577","E01006359",2011,610,146,464,79
"40578","E01006360",2011,729,498,231,31
"40579","E01006361",2011,690,382,308,61
"40580","E01006362",2011,748,11,737,63
"40581","E01006363",2011,725,7,718,28
"40582","E01006364",2011,814,211,603,73
"40583","E01006365",2011,820,21,799,83
"40584","E01006366",2011,798,188,610,59
"40585","E01006367",2011,699,20,679,27
"40586","E01006368",2011,716,51,665,74
"40587","E01006369",2011,910,241,669,230
"40588","E01006370",2011,834,75,759,317
"40589","E01006371",2011,661,7,654,100
"40590","E01006372",2011,660,2,658,70
"40591","E01006373",2011,642,7,635,78
"40592","E01006374",2011,693,10,683,62
"40593","E01006375",2011,674,17,657,152
"40594","E01006376",2011,694,293,401,44
"40595","E01006377",2011,667,13,654,39
"40596","E01006378",2011,591,8,583,35
"40597","E01006379",2011,689,18,671,80
"40598","E01006380",2011,746,327,419,54
"40599","E01006381",2011,709,24,685,81
"40600","E01006382",2011,517,6,511,23
"40601","E01006383",2011,636,78,558,35
"40602","E01006384",2011,601,8,593,61
"40603","E01006385",2011,611,10,601,23
"40604","E01006386",2011,984,756,228,67
"40605","E01006387",2011,539,60,479,90
"40606","E01006388",2011,744,228,516,41
"40607","E01006389",2011,512,76,436,50
"40608","E01006390",2011,699,117,582,70
"40609","E01006391",2011,667,34,633,41
"40610","E01006392",2011,622,321,301,74
"40611","E01006393",2011,605,2,603,49
"40612","E01006394",2011,648,2,646,19
"40613","E01006395",2011,859,3,856,38
"40614","E01006396",2011,566,12,554,54
"40615","E01006397",2011,576,242,334,28
"40616","E01006398",2011,507,148,359,60
"40617","E01006399",2011,701,110,591,125
"40618","E01006400",2011,504,2,502,25
"40619","E01006401",2011,565,3,562,22
"40620","E01006402",2011,471,4,467,12
"40621","E01006403",2011,682,2,680,32
"40622","E01006404",2011,703,183,520,125
"40623","E01006405",2011,646,194,452,72
"40624","E01006406",2011,626,31,595,48
"40625","E01006407",2011,591,8,583,39
"40626","E01006408",2011,644,213,431,55
"40627","E01006409",2011,590,6,584,21
"40628","E01006410",2011,538,16,522,23
"40629","E01006411",2011,834,551,283,72
"40630","E01006412",2011,591,328,263,48
"40631","E01006413",2011,866,674,192,52
"40632","E01006414",2011,610,307,303,33
"40633","E01006415",2011,825,216,609,84
"40634","E01006416",2011,665,244,421,78
"40635","E01006417",2011,711,446,265,68
"40636","E01006418",2011,549,216,333,48
"40637","E01006419",2011,628,7,621,59
"40638","E01006420",2011,764,29,735,73
"40639","E01006421",2011,428,10,418,26
"40640","E01006422",2011,528,13,515,25
"40641","E01006423",2011,528,11,517,34
"40642","E01006424",2011,803,14,789,57
"40643","E01006425",2011,559,108,451,38
"40644","E01006426",2011,556,275,281,42
"40645","E01006427",2011,618,33,585,33
"40646","E01006428",2011,630,192,438,43
"40647","E01006429",2011,463,220,243,32
"40648","E01006430",2011,611,349,262,41
"40649","E01006431",2011,765,155,610,95
"40650","E01006432",2011,671,233,438,53
"40651","E01006433",2011,633,161,472,33
"40652","E01006434",2011,631,210,421,95
"40653","E01006435",2011,653,237,416,41
"40654","E01006436",2011,636,294,342,57
"40655","E01006437",2011,618,248,370,58
"40656","E01006438",2011,510,48,462,50
"40657","E01006439",2011,686,149,537,94
"40658","E01006440",2011,622,280,342,85
"40659","E01006441",2011,993,277,716,81
"40660","E01006442",2011,614,404,210,32
"40661","E01006443",2011,667,318,349,60
"40662","E01006444",2011,521,262,259,56
"40663","E01006445",2011,539,266,273,38
"40664","E01006446",2011,566,186,380,68
"40665","E01006447",2011,632,254,378,137
"40666","E01006448",2011,720,321,399,101
"40667","E01006449",2011,623,133,490,82
"40668","E01006450",2011,619,249,370,84
"40669","E01006451",2011,606,135,471,82
"40670","E01006452",2011,618,39,579,134
"40671","E01006453",2011,515,295,220,26
"40672","E01006454",2011,512,39,473,29
"40673","E01006455",2011,701,208,493,148
"40674","E01006456",2011,670,138,532,45
"40675","E01006457",2011,522,11,511,19
"40676","E01006458",2011,593,110,483,70
"40677","E01006459",2011,614,39,575,87
"40678","E01006460",2011,661,373,288,59
"40679","E01006461",2011,619,253,366,45
"40680","E01006462",2011,639,42,597,71
"40681","E01006463",2011,971,315,656,238
"40682","E01006464",2011,727,209,518,38
"40683","E01006465",2011,635,55,580,34
"40684","E01006466",2011,776,164,612,107
"40685","E01006467",2011,558,369,189,25
"40686","E01006470",2011,585,312,273,36
"40687","E01006471",2011,624,6,618,40
"40688","E01006472",2011,638,25,613,44
"40689","E01006473",2011,490,17,473,29
"40690","E01006474",2011,637,8,629,47
"40691","E01006475",2011,555,6,549,52
"40692","E01006476",2011,568,3,565,16
"40693","E01006477",2011,575,113,462,69
"40694","E01006478",2011,613,170,443,89
"40695","E01006479",2011,590,108,482,59
"40696","E01006480",2011,613,270,343,55
"40697","E01006481",2011,642,252,390,55
"40698","E01006482",2011,587,132,455,76
"40699","E01006483",2011,614,199,415,54
"40700","E01006484",2011,567,185,382,62
"40701","E01006485",2011,615,32,583,57
"40702","E01006486",2011,491,3,488,45
"40703","E01006487",2011,630,7,623,60
"40704","E01006488",2011,686,4,682,30
"40705","E01006489",2011,581,40,541,65
"40706","E01006490",2011,1032,19,1013,153
"40707","E01006491",2011,761,8,753,86
"40708","E01006492",2011,515,122,393,35
"40709","E01006493",2011,433,286,147,27
"40710","E01006494",2011,526,309,217,42
"40711","E01006495",2011,689,255,434,66
"40712","E01006496",2011,606,149,457,42
"40713","E01006497",2011,472,54,418,37
"40714","E01006498",2011,548,25,523,41
"40715","E01006499",2011,681,59,622,109
"40716","E01006500",2011,464,196,268,22
"40717","E01006501",2011,562,45,517,81
"40718","E01006502",2011,767,3,764,60
"40719","E01006503",2011,544,24,520,26
"40720","E01006504",2011,573,263,310,47
"40721","E01006505",2011,700,318,382,43
"40722","E01006506",2011,550,9,541,107
"40723","E01006507",2011,636,232,404,81
"40724","E01006508",2011,576,102,474,74
"40725","E01006509",2011,695,265,430,93
"40726","E01006510",2011,493,15,478,54
"40727","E01006512",2011,799,220,579,401
"40728","E01006513",2011,909,131,778,625
"40729","E01006514",2011,1115,512,603,474
"40730","E01006515",2011,641,402,239,140
"40731","E01006518",2011,835,451,384,154
"40732","E01006519",2011,514,10,504,28
"40733","E01006520",2011,1182,360,822,619
"40734","E01006521",2011,928,244,684,288
"40735","E01006522",2011,1094,350,744,523
"40736","E01006523",2011,830,280,550,282
"40737","E01006524",2011,583,15,568,207
"40738","E01006525",2011,486,7,479,55
"40739","E01006526",2011,654,78,576,94
"40740","E01006527",2011,638,179,459,71
"40741","E01006528",2011,613,72,541,176
"40742","E01006529",2011,559,21,538,101
"40743","E01006530",2011,616,11,605,40
"40744","E01006531",2011,674,81,593,29
"40745","E01006532",2011,617,25,592,30
"40746","E01006533",2011,614,112,502,47
"40747","E01006534",2011,649,172,477,45
"40748","E01006535",2011,656,147,509,39
"40749","E01006536",2011,815,240,575,84
"40750","E01006537",2011,964,83,881,307
"40751","E01006538",2011,527,31,496,60
"40752","E01006539",2011,601,8,593,68
"40753","E01006540",2011,771,290,481,282
"40754","E01006541",2011,803,221,582,134
"40755","E01006542",2011,583,142,441,155
"40756","E01006543",2011,509,27,482,58
"40757","E01006544",2011,738,328,410,171
"40758","E01006545",2011,646,18,628,220
"40759","E01006546",2011,583,30,553,237
"40760","E01006547",2011,718,110,608,329
"40761","E01006548",2011,759,93,666,306
"40762","E01006549",2011,949,240,709,561
"40763","E01006550",2011,483,37,446,272
"40764","E01006551",2011,751,520,231,118
"40765","E01006552",2011,869,372,497,301
"40766","E01006553",2011,642,45,597,326
"40767","E01006554",2011,649,107,542,316
"40768","E01006556",2011,1016,522,494,334
"40769","E01006557",2011,635,28,607,385
"40770","E01006558",2011,739,293,446,235
"40771","E01006560",2011,996,782,214,56
"40772","E01006562",2011,714,333,381,150
"40773","E01006563",2011,908,607,301,174
"40774","E01006564",2011,800,251,549,93
"40775","E01006565",2011,638,146,492,59
"40776","E01006566",2011,577,55,522,54
"40777","E01006567",2011,892,439,453,100
"40778","E01006568",2011,629,99,530,78
"40779","E01006569",2011,613,197,416,40
"40780","E01006570",2011,595,31,564,105
"40781","E01006571",2011,612,225,387,49
"40782","E01006572",2011,501,269,232,37
"40783","E01006573",2011,778,245,533,166
"40784","E01006574",2011,612,246,366,56
"40785","E01006575",2011,578,83,495,90
"40786","E01006576",2011,713,13,700,94
"40787","E01006577",2011,597,5,592,54
"40788","E01006578",2011,554,12,542,84
"40789","E01006579",2011,618,6,612,42
"40790","E01006580",2011,515,6,509,24
"40791","E01006581",2011,607,6,601,54
"40792","E01006582",2011,585,8,577,47
"40793","E01006583",2011,467,4,463,14
"40794","E01006584",2011,611,65,546,76
"40795","E01006585",2011,641,317,324,45
"40796","E01006586",2011,921,236,685,233
"40797","E01006587",2011,717,161,556,147
"40798","E01006588",2011,702,53,649,211
"40799","E01006589",2011,599,19,580,39
"40800","E01006590",2011,701,39,662,257
"40801","E01006591",2011,671,10,661,183
"40802","E01006592",2011,624,9,615,72
"40803","E01006593",2011,662,20,642,237
"40804","E01006594",2011,579,10,569,53
"40805","E01006595",2011,812,43,769,147
"40806","E01006596",2011,597,8,589,101
"40807","E01006597",2011,683,13,670,80
"40808","E01006598",2011,604,416,188,45
"40809","E01006599",2011,482,343,139,40
"40810","E01006600",2011,592,199,393,57
"40811","E01006603",2011,594,203,391,43
"40812","E01006604",2011,571,161,410,46
"40813","E01006605",2011,696,306,390,61
"40814","E01006606",2011,723,154,569,143
"40815","E01006607",2011,641,245,396,44
"40816","E01006608",2011,563,124,439,124
"40817","E01006609",2011,576,101,475,137
"40818","E01006610",2011,669,229,440,154
"40819","E01006611",2011,742,138,604,328
"40820","E01006612",2011,740,415,325,52
"40821","E01006613",2011,611,212,399,52
"40822","E01006614",2011,667,105,562,231
"40823","E01006615",2011,663,167,496,211
"40824","E01006616",2011,613,195,418,64
"40825","E01006617",2011,650,50,600,131
"40826","E01006618",2011,692,184,508,49
"40827","E01006619",2011,734,42,692,172
"40828","E01006620",2011,625,110,515,48
"40829","E01006621",2011,584,22,562,57
"40830","E01006622",2011,586,6,580,41
"40831","E01006623",2011,527,11,516,18
"40832","E01006624",2011,702,158,544,117
"40833","E01006625",2011,609,52,557,53
"40834","E01006626",2011,593,78,515,39
"40835","E01006627",2011,600,86,514,61
"40836","E01006628",2011,651,58,593,126
"40837","E01006629",2011,573,98,475,90
"40838","E01006630",2011,555,424,131,55
"40839","E01006632",2011,884,476,408,141
"40840","E01006633",2011,699,432,267,102
"40841","E01006637",2011,670,363,307,85
"40842","E01006638",2011,518,280,238,68
"40843","E01006639",2011,640,115,525,111
"40844","E01006640",2011,760,113,647,81
"40845","E01006641",2011,633,39,594,97
"40846","E01006642",2011,590,317,273,52
"40847","E01006643",2011,740,324,416,101
"40848","E01006644",2011,963,336,627,196
"40849","E01006645",2011,690,410,280,54
"40850","E01006646",2011,1006,491,515,274
"40851","E01006647",2011,636,494,142,26
"40852","E01006648",2011,1075,476,599,363
"40853","E01006651",2011,592,21,571,44
"40854","E01006652",2011,633,14,619,134
"40855","E01006653",2011,656,199,457,73
"40856","E01006654",2011,627,112,515,133
"40857","E01006655",2011,706,172,534,106
"40858","E01006656",2011,669,33,636,168
"40859","E01006657",2011,582,73,509,166
"40860","E01006658",2011,634,301,333,74
"40861","E01006659",2011,548,213,335,116
"40862","E01006660",2011,616,227,389,58
"40863","E01006661",2011,749,376,373,73
"40864","E01006662",2011,785,409,376,80
"40865","E01006663",2011,510,180,330,72
"40866","E01006664",2011,822,314,508,190
"40867","E01006665",2011,630,12,618,83
"40868","E01006666",2011,514,7,507,43
"40869","E01006667",2011,618,134,484,58
"40870","E01006668",2011,590,8,582,77
"40871","E01006669",2011,551,65,486,60
"40872","E01006670",2011,607,34,573,71
"40873","E01006671",2011,499,113,386,35
"40874","E01006672",2011,798,387,411,95
"40875","E01006673",2011,954,598,356,263
"40876","E01006674",2011,826,602,224,108
"40877","E01006675",2011,1132,423,709,514
"40878","E01006676",2011,761,455,306,126
"40879","E01006677",2011,477,335,142,46
"40880","E01006678",2011,1059,656,403,161
"40881","E01006679",2011,920,651,269,150
"40882","E01006680",2011,605,15,590,26
"40883","E01006681",2011,719,193,526,87
"40884","E01006682",2011,498,4,494,27
"40885","E01006683",2011,594,10,584,24
"40886","E01006684",2011,999,10,989,266
"40887","E01006685",2011,604,15,589,97
"40888","E01006686",2011,531,7,524,32
"40889","E01006687",2011,933,211,722,122
"40890","E01006688",2011,712,72,640,181
"40891","E01006689",2011,717,43,674,79
"40892","E01006690",2011,801,276,525,319
"40893","E01006691",2011,647,172,475,248
"40894","E01006692",2011,989,255,734,336
"40895","E01006693",2011,838,491,347,105
"40896","E01006694",2011,891,171,720,480
"40897","E01006695",2011,1029,373,656,430
"40898","E01006696",2011,768,252,516,231
"40899","E01006697",2011,828,145,683,372
"40900","E01006698",2011,725,95,630,211
"40901","E01006699",2011,777,479,298,112
"40902","E01006700",2011,653,167,486,205
"40903","E01006701",2011,671,188,483,110
"40904","E01006702",2011,740,301,439,150
"40905","E01006703",2011,818,458,360,120
"40906","E01006705",2011,689,60,629,277
"40907","E01006706",2011,582,360,222,29
"40908","E01006707",2011,553,316,237,18
"40909","E01006708",2011,754,275,479,57
"40910","E01006709",2011,685,314,371,34
"40911","E01006710",2011,592,70,522,106
"40912","E01006711",2011,685,129,556,197
"40913","E01006712",2011,569,34,535,161
"40914","E01006713",2011,604,19,585,147
"40915","E01006716",2011,701,167,534,203
"40916","E01006717",2011,576,17,559,110
"40917","E01006718",2011,678,100,578,119
"40918","E01006719",2011,638,51,587,149
"40919","E01006720",2011,905,269,636,411
"40920","E01006721",2011,912,341,571,331
"40921","E01006722",2011,608,42,566,333
"40922","E01006723",2011,749,126,623,374
"40923","E01006724",2011,554,44,510,258
"40924","E01006725",2011,739,154,585,244
"40925","E01006726",2011,659,117,542,270
"40926","E01006727",2011,665,36,629,217
"40927","E01006728",2011,855,295,560,303
"40928","E01006729",2011,539,337,202,24
"40929","E01006730",2011,542,269,273,26
"40930","E01006731",2011,486,186,300,61
"40931","E01006732",2011,644,552,92,22
"40932","E01006734",2011,625,405,220,55
"40933","E01006735",2011,571,290,281,53
"40934","E01006736",2011,582,238,344,60
"40935","E01006737",2011,562,253,309,47
"40936","E01006738",2011,662,275,387,65
"40937","E01006739",2011,707,433,274,55
"40938","E01006740",2011,604,396,208,58
"40939","E01006741",2011,778,345,433,59
"40940","E01006742",2011,591,147,444,76
"40941","E01006743",2011,1008,235,773,278
"40942","E01006744",2011,739,95,644,178
"40943","E01006745",2011,907,164,743,407
"40944","E01006746",2011,655,294,361,162
"40945","E01006747",2011,857,279,578,436
"40946","E01006748",2011,756,136,620,389
"40947","E01006751",2011,831,440,391,209
"40948","E01006752",2011,489,100,389,159
"40949","E01006753",2011,666,361,305,56
"40950","E01006754",2011,781,380,401,127
"40951","E01006755",2011,690,466,224,68
"40952","E01006756",2011,757,427,330,103
"40953","E01006757",2011,621,302,319,63
"40954","E01006758",2011,639,318,321,46
"40955","E01006759",2011,460,47,413,153
"40956","E01006760",2011,826,226,600,398
"40957","E01006761",2011,793,224,569,200
"40958","E01006762",2011,725,274,451,104
"40959","E01006763",2011,652,36,616,213
"40960","E01006764",2011,667,84,583,266
"40961","E01006765",2011,659,119,540,137
"40962","E01006766",2011,574,119,455,239
"40963","E01006767",2011,779,135,644,281
"40964","E01006768",2011,587,63,524,204
"40965","E01006769",2011,712,440,272,33
"40966","E01006770",2011,445,195,250,27
"40967","E01006771",2011,694,405,289,65
"40968","E01006772",2011,480,95,385,29
"40969","E01006773",2011,554,18,536,51
"40970","E01006774",2011,552,33,519,33
"40971","E01006775",2011,556,322,234,25
"40972","E01006776",2011,844,452,392,115
"40973","E01006778",2011,1124,551,573,307
"40974","E01006779",2011,902,620,282,61
"40975","E01006780",2011,619,32,587,133
"40976","E01006781",2011,600,28,572,56
"40977","E01006782",2011,691,52,639,195
"40978","E01006783",2011,645,30,615,168
"40979","E01006784",2011,586,23,563,149
"40980","E01006785",2011,781,46,735,269
"40981","E01006786",2011,764,77,687,105
"40982","E01006787",2011,691,109,582,292
"40983","E01006788",2011,681,47,634,131
"40984","E01006790",2011,801,389,412,194
"40985","E01006791",2011,873,379,494,198
"40986","E01006792",2011,557,37,520,26
"40987","E01006793",2011,759,165,594,177
"40988","E01006794",2011,711,38,673,151
"40989","E01006795",2011,628,14,614,95
"40990","E01006796",2011,581,6,575,29
"40991","E01006797",2011,707,251,456,62
"40992","E01006798",2011,609,22,587,69
"40993","E01006799",2011,1145,502,643,191
"40994","E01006800",2011,679,8,671,57
"40995","E01006801",2011,609,3,606,39
"40996","E01006802",2011,747,146,601,50
"40997","E01006803",2011,601,8,593,32
"40998","E01006804",2011,660,74,586,32
"40999","E01006805",2011,620,146,474,37
"41000","E01006806",2011,623,10,613,24
"41001","E01006807",2011,587,7,580,12
"41002","E01006808",2011,539,4,535,26
"41003","E01006809",2011,608,7,601,36
"41004","E01006810",2011,493,11,482,9
"41005","E01006811",2011,613,114,499,30
"41006","E01006812",2011,593,276,317,34
"41007","E01006813",2011,697,165,532,91
"41008","E01006814",2011,602,13,589,18
"41009","E01006815",2011,557,120,437,43
"41010","E01006816",2011,706,372,334,90
"41011","E01006817",2011,623,361,262,62
"41012","E01006818",2011,530,37,493,26
"41013","E01006819",2011,608,130,478,56
"41014","E01006820",2011,611,219,392,90
"41015","E01006821",2011,652,308,344,68
"41016","E01006822",2011,559,23,536,25
"41017","E01006823",2011,570,4,566,15
"41018","E01006824",2011,517,3,514,15
"41019","E01006825",2011,607,2,605,32
"41020","E01006826",2011,648,260,388,26
"41021","E01006827",2011,614,10,604,52
"41022","E01006828",2011,877,16,861,52
"41023","E01006829",2011,518,12,506,65
"41024","E01006830",2011,538,312,226,48
"41025","E01006831",2011,662,81,581,133
"41026","E01006832",2011,781,230,551,136
"41027","E01006833",2011,754,30,724,142
"41028","E01006834",2011,610,137,473,139
"41029","E01006835",2011,647,68,579,77
"41030","E01006836",2011,600,146,454,52
"41031","E01006837",2011,614,84,530,57
"41032","E01006838",2011,718,135,583,120
"41033","E01006839",2011,572,114,458,29
"41034","E01006840",2011,669,62,607,56
"41035","E01006841",2011,645,42,603,20
"41036","E01006842",2011,657,288,369,75
"41037","E01006843",2011,543,114,429,54
"41038","E01006844",2011,771,216,555,148
"41039","E01006845",2011,685,72,613,157
"41040","E01006846",2011,616,31,585,32
"41041","E01006847",2011,685,423,262,28
"41042","E01006848",2011,629,72,557,54
"41043","E01006849",2011,648,346,302,23
"41044","E01006850",2011,738,338,400,48
"41045","E01006851",2011,559,90,469,25
"41046","E01006852",2011,525,10,515,18
"41047","E01006853",2011,577,65,512,34
"41048","E01006854",2011,640,109,531,69
"41049","E01006855",2011,638,146,492,36
"41050","E01006856",2011,614,20,594,101
"41051","E01006857",2011,606,29,577,40
"41052","E01006858",2011,597,211,386,63
"41053","E01006859",2011,694,25,669,84
"41054","E01006860",2011,625,165,460,62
"41055","E01006861",2011,631,408,223,39
"41056","E01006862",2011,581,252,329,32
"41057","E01006863",2011,829,273,556,179
"41058","E01006864",2011,818,52,766,146
"41059","E01006865",2011,840,394,446,66
"41060","E01006866",2011,642,289,353,39
"41061","E01006867",2011,784,65,719,61
"41062","E01006868",2011,656,264,392,65
"41063","E01006869",2011,655,177,478,81
"41064","E01006870",2011,648,64,584,168
"41065","E01006871",2011,669,313,356,96
"41066","E01006872",2011,777,265,512,250
"41067","E01006873",2011,495,309,186,40
"41068","E01006874",2011,583,262,321,139
"41069","E01006875",2011,509,125,384,108
"41070","E01006876",2011,679,32,647,136
"41071","E01006877",2011,734,218,516,131
"41072","E01006878",2011,648,69,579,93
"41073","E01006879",2011,598,173,425,46
"41074","E01006880",2011,763,331,432,136
"41075","E01006881",2011,735,262,473,148
"41076","E01006882",2011,499,13,486,14
"41077","E01006883",2011,607,25,582,58
"41078","E01006884",2011,623,57,566,31
"41079","E01006885",2011,546,15,531,32
"41080","E01006886",2011,578,6,572,29
"41081","E01006887",2011,592,103,489,47
"41082","E01006888",2011,499,7,492,25
"41083","E01006889",2011,570,12,558,34
"41084","E01006890",2011,616,51,565,72
"41085","E01006891",2011,538,52,486,26
"41086","E01006892",2011,482,19,463,28
"41087","E01006893",2011,617,42,575,83
"41088","E01006894",2011,584,51,533,33
"41089","E01006895",2011,645,4,641,34
"41090","E01006896",2011,660,5,655,33
"41091","E01006897",2011,629,76,553,46
"41092","E01006898",2011,744,195,549,55
"41093","E01006899",2011,813,130,683,171
"41094","E01006900",2011,1066,71,995,159
"41095","E01006901",2011,533,12,521,58
"41096","E01006903",2011,752,322,430,93
"41097","E01006904",2011,670,166,504,71
"41098","E01006905",2011,584,295,289,22
"41099","E01006906",2011,661,42,619,125
"41100","E01006907",2011,668,107,561,69
"41101","E01006908",2011,604,278,326,59
"41102","E01006909",2011,497,336,161,31
"41103","E01006910",2011,749,232,517,115
"41104","E01006911",2011,616,15,601,33
"41105","E01006912",2011,613,239,374,80
"41106","E01006913",2011,525,254,271,18
"41107","E01006914",2011,527,6,521,15
"41108","E01006915",2011,671,170,501,65
"41109","E01006916",2011,660,80,580,81
"41110","E01006917",2011,674,22,652,22
"41111","E01006918",2011,511,15,496,60
"41112","E01006919",2011,643,282,361,84
"41113","E01006920",2011,699,49,650,85
"41114","E01006921",2011,596,5,591,19
"41115","E01006922",2011,605,2,603,30
"41116","E01006923",2011,682,0,682,30
"41117","E01006924",2011,681,232,449,73
"41118","E01006925",2011,598,131,467,46
"41119","E01006926",2011,717,6,711,43
"41120","E01006927",2011,755,95,660,68
"41121","E01006928",2011,583,42,541,42
"41122","E01006929",2011,616,16,600,97
"41123","E01006930",2011,620,73,547,73
"41124","E01006931",2011,642,24,618,45
"41125","E01006932",2011,592,3,589,38
"41126","E01006933",2011,595,39,556,75
"41127","E01006934",2011,648,17,631,125
"41128","E01006935",2011,688,3,685,131
"41129","E01006936",2011,765,5,760,126
"41130","E01006937",2011,482,0,482,14
"41131","E01006938",2011,535,42,493,38
"41132","E01006939",2011,663,27,636,113
"41133","E01006940",2011,599,12,587,104
"41134","E01006941",2011,696,14,682,118
"41135","E01006942",2011,640,52,588,110
"41136","E01006943",2011,479,1,478,12
"41137","E01006944",2011,902,90,812,230
"41138","E01006945",2011,802,13,789,316
"41139","E01006946",2011,680,19,661,57
"41140","E01006947",2011,609,6,603,45
"41141","E01006948",2011,655,243,412,68
"41142","E01006949",2011,730,142,588,78
"41143","E01006950",2011,800,113,687,406
"41144","E01006951",2011,773,50,723,145
"41145","E01006952",2011,627,327,300,69
"41146","E01006953",2011,666,243,423,95
"41147","E01006954",2011,680,63,617,175
"41148","E01006955",2011,621,28,593,91
"41149","E01006956",2011,679,49,630,207
"41150","E01006957",2011,857,352,505,193
"41151","E01006958",2011,718,124,594,221
"41152","E01006959",2011,666,56,610,133
"41153","E01006960",2011,445,7,438,34
"41154","E01006961",2011,632,121,511,156
"41155","E01006962",2011,647,183,464,70
"41156","E01006963",2011,633,189,444,180
"41157","E01006964",2011,645,164,481,154
"41158","E01006965",2011,580,223,357,43
"41159","E01006966",2011,640,127,513,113
"41160","E01006967",2011,753,314,439,138
"41161","E01006968",2011,1052,120,932,575
"41162","E01006969",2011,667,16,651,270
"41163","E01006970",2011,770,19,751,372
"41164","E01006971",2011,807,11,796,215
"41165","E01006972",2011,907,146,761,114
"41166","E01006973",2011,643,12,631,103
"41167","E01006974",2011,681,4,677,83
"41168","E01006976",2011,594,76,518,54
"41169","E01006977",2011,880,462,418,86
"41170","E01006978",2011,569,21,548,58
"41171","E01006979",2011,619,329,290,54
"41172","E01006980",2011,656,370,286,39
"41173","E01006981",2011,618,273,345,75
"41174","E01006982",2011,557,50,507,105
"41175","E01006983",2011,686,58,628,103
"41176","E01006984",2011,498,244,254,48
"41177","E01006985",2011,599,17,582,22
"41178","E01006986",2011,515,0,515,24
"41179","E01006987",2011,540,4,536,31
"41180","E01006988",2011,625,111,514,44
"41181","E01006989",2011,557,1,556,19
"41182","E01006990",2011,477,1,476,17
"41183","E01006991",2011,603,1,602,16
"41184","E01006992",2011,444,51,393,24
"41185","E01006993",2011,586,3,583,13
"41186","E01006994",2011,649,12,637,228
"41187","E01006995",2011,488,22,466,52
"41188","E01006996",2011,645,17,628,226
"41189","E01006997",2011,613,12,601,126
"41190","E01006998",2011,699,24,675,206
"41191","E01006999",2011,685,46,639,88
"41192","E01007000",2011,517,128,389,57
"41193","E01007001",2011,670,58,612,142
"41194","E01007002",2011,585,6,579,57
"41195","E01007003",2011,568,177,391,183
"41196","E01007004",2011,654,283,371,104
"41197","E01007005",2011,602,340,262,99
"41198","E01007006",2011,605,256,349,117
"41199","E01007007",2011,635,456,179,35
"41200","E01007008",2011,644,312,332,114
"41201","E01007009",2011,654,313,341,183
"41202","E01007010",2011,519,281,238,80
"41203","E01007011",2011,666,368,298,113
"41204","E01007012",2011,600,110,490,124
"41205","E01007013",2011,684,165,519,225
"41206","E01007014",2011,650,55,595,42
"41207","E01007016",2011,738,234,504,138
"41208","E01007017",2011,746,328,418,119
"41209","E01007019",2011,530,329,201,40
"41210","E01007020",2011,580,175,405,38
"41211","E01007021",2011,541,1,540,23
"41212","E01007022",2011,597,158,439,78
"41213","E01007023",2011,529,6,523,30
"41214","E01007024",2011,478,253,225,21
"41215","E01007025",2011,534,6,528,10
"41216","E01007026",2011,515,185,330,32
"41217","E01007027",2011,892,13,879,47
"41218","E01007028",2011,593,16,577,66
"41219","E01007029",2011,612,12,600,26
"41220","E01007030",2011,636,57,579,86
"41221","E01007031",2011,586,34,552,44
"41222","E01007032",2011,550,5,545,50
"41223","E01007033",2011,646,10,636,71
"41224","E01007034",2011,579,12,567,36
"41225","E01007035",2011,620,23,597,109
"41226","E01007036",2011,538,3,535,42
"41227","E01007037",2011,656,33,623,32
"41228","E01007038",2011,611,136,475,34
"41229","E01007039",2011,512,24,488,36
"41230","E01007040",2011,747,40,707,83
"41231","E01007041",2011,570,74,496,48
"41232","E01007042",2011,546,43,503,37
"41233","E01007043",2011,611,16,595,26
"41234","E01007044",2011,621,42,579,25
"41235","E01007045",2011,486,16,470,22
"41236","E01007046",2011,637,38,599,54
"41237","E01007047",2011,655,206,449,32
"41238","E01007048",2011,635,315,320,54
"41239","E01007049",2011,652,180,472,56
"41240","E01007050",2011,488,63,425,31
"41241","E01007051",2011,509,240,269,36
"41242","E01007052",2011,548,193,355,39
"41243","E01007053",2011,556,48,508,48
"41244","E01007054",2011,613,185,428,56
"41245","E01007055",2011,580,215,365,88
"41246","E01007056",2011,672,14,658,129
"41247","E01007057",2011,656,9,647,142
"41248","E01007058",2011,630,8,622,160
"41249","E01007059",2011,608,12,596,83
"41250","E01007060",2011,590,110,480,92
"41251","E01007061",2011,567,18,549,101
"41252","E01007062",2011,597,13,584,90
"41253","E01007063",2011,635,42,593,102
"41254","E01007064",2011,473,14,459,43
"41255","E01007065",2011,501,3,498,39
"41256","E01007066",2011,601,18,583,66
"41257","E01007067",2011,591,2,589,58
"41258","E01007068",2011,481,5,476,13
"41259","E01007069",2011,660,87,573,59
"41260","E01007070",2011,602,1,601,22
"41261","E01007071",2011,503,19,484,11
"41262","E01007072",2011,685,44,641,42
"41263","E01007073",2011,499,0,499,14
"41264","E01007074",2011,622,109,513,42
"41265","E01007075",2011,615,3,612,55
"41266","E01007076",2011,575,15,560,63
"41267","E01007077",2011,593,23,570,43
"41268","E01007078",2011,646,7,639,43
"41269","E01007079",2011,650,10,640,62
"41270","E01007080",2011,612,22,590,52
"41271","E01007081",2011,722,19,703,71
"41272","E01007082",2011,614,3,611,59
"41273","E01007083",2011,476,78,398,31
"41274","E01007084",2011,539,6,533,28
"41275","E01007085",2011,580,254,326,48
"41276","E01007086",2011,501,223,278,39
"41277","E01007087",2011,614,310,304,39
"41278","E01007088",2011,575,164,411,25
"41279","E01007089",2011,603,233,370,36
"41280","E01007090",2011,543,277,266,22
"41281","E01007091",2011,607,151,456,45
"41282","E01007092",2011,459,149,310,36
"41283","E01007095",2011,706,3,703,54
"41284","E01007096",2011,567,3,564,25
"41285","E01007097",2011,654,10,644,48
"41286","E01007098",2011,624,24,600,32
"41287","E01007099",2011,655,58,597,53
"41288","E01007100",2011,593,35,558,34
"41289","E01007101",2011,608,0,608,34
"41290","E01007102",2011,579,10,569,110
"41291","E01007103",2011,614,5,609,48
"41292","E01007104",2011,563,9,554,73
"41293","E01007105",2011,709,96,613,83
"41294","E01007106",2011,630,95,535,46
"41295","E01007107",2011,485,2,483,28
"41296","E01007108",2011,599,29,570,30
"41297","E01007109",2011,675,74,601,112
"41298","E01007110",2011,706,21,685,77
"41299","E01007111",2011,593,4,589,25
"41300","E01007112",2011,655,48,607,70
"41301","E01007113",2011,586,27,559,42
"41302","E01007114",2011,591,159,432,69
"41303","E01007115",2011,673,124,549,80
"41304","E01007116",2011,683,17,666,106
"41305","E01007117",2011,640,10,630,66
"41306","E01007118",2011,656,210,446,40
"41307","E01007119",2011,614,274,340,83
"41308","E01007120",2011,543,225,318,54
"41309","E01007121",2011,686,421,265,83
"41310","E01007122",2011,720,486,234,104
"41311","E01007123",2011,733,365,368,175
"41312","E01007124",2011,614,445,169,33
"41313","E01007125",2011,784,115,669,203
"41314","E01007126",2011,1170,641,529,292
"41315","E01007127",2011,670,303,367,176
"41316","E01007128",2011,926,546,380,193
"41317","E01007129",2011,761,222,539,287
"41318","E01007130",2011,716,89,627,278
"41319","E01007131",2011,724,144,580,254
"41320","E01007133",2011,679,510,169,90
"41321","E01007135",2011,635,16,619,58
"41322","E01007136",2011,699,241,458,69
"41323","E01007137",2011,779,160,619,116
"41324","E01007138",2011,782,242,540,173
"41325","E01007139",2011,683,91,592,149
"41326","E01007140",2011,787,48,739,160
"41327","E01007141",2011,861,217,644,213
"41328","E01007142",2011,761,59,702,98
"41329","E01007143",2011,703,67,636,128
"41330","E01007144",2011,545,10,535,114
"41331","E01007145",2011,537,5,532,13
"41332","E01007146",2011,714,2,712,105
"41333","E01007147",2011,606,2,604,36
"41334","E01007148",2011,664,1,663,21
"41335","E01007149",2011,621,1,620,17
"41336","E01007150",2011,593,3,590,29
"41337","E01007151",2011,636,11,625,45
"41338","E01007152",2011,771,140,631,111
"41339","E01007153",2011,643,220,423,48
"41340","E01007154",2011,621,29,592,28
"41341","E01007155",2011,919,278,641,295
"41342","E01007156",2011,660,38,622,126
"41343","E01007157",2011,601,6,595,99
"41344","E01007158",2011,684,6,678,119
"41345","E01007159",2011,721,13,708,97
"41346","E01007160",2011,822,118,704,189
"41347","E01007161",2011,646,44,602,62
"41348","E01007162",2011,556,298,258,39
"41349","E01007163",2011,907,63,844,99
"41350","E01007164",2011,737,71,666,99
"41351","E01007165",2011,570,1,569,39
"41352","E01007166",2011,636,6,630,40
"41353","E01007167",2011,615,127,488,54
"41354","E01007168",2011,777,221,556,61
"41355","E01007169",2011,761,112,649,89
"41356","E01007170",2011,634,28,606,48
"41357","E01007171",2011,617,10,607,44
"41358","E01007172",2011,608,38,570,29
"41359","E01007173",2011,590,34,556,57
"41360","E01007174",2011,646,70,576,93
"41361","E01007175",2011,844,267,577,224
"41362","E01007176",2011,739,121,618,167
"41363","E01007177",2011,684,165,519,67
"41364","E01007178",2011,711,108,603,133
"41365","E01007179",2011,612,122,490,231
"41366","E01007180",2011,685,85,600,159
"41367","E01007181",2011,640,15,625,174
"41368","E01007182",2011,736,58,678,106
"41369","E01007183",2011,527,4,523,31
"41370","E01007184",2011,642,22,620,59
"41371","E01007185",2011,699,41,658,125
"41372","E01007186",2011,660,2,658,42
"41373","E01007187",2011,653,1,652,18
"41374","E01007188",2011,616,2,614,26
"41375","E01007189",2011,717,3,714,40
"41376","E01007190",2011,641,0,641,33
"41377","E01007191",2011,534,1,533,12
"41378","E01007192",2011,611,146,465,28
"41379","E01007193",2011,740,4,736,163
"41380","E01007194",2011,668,28,640,133
"41381","E01007195",2011,647,4,643,28
"41382","E01007196",2011,749,17,732,118
"41383","E01007197",2011,662,11,651,72
"41384","E01007198",2011,836,70,766,231
"41385","E01007199",2011,602,1,601,20
"41386","E01007200",2011,655,20,635,41
"41387","E01007201",2011,640,9,631,87
"41388","E01007202",2011,623,72,551,129
"41389","E01007203",2011,860,30,830,125
"41390","E01007204",2011,677,447,230,51
"41391","E01007205",2011,619,185,434,58
"41392","E01007206",2011,730,91,639,112
"41393","E01007207",2011,685,367,318,58
"41394","E01007208",2011,734,103,631,103
"41395","E01007209",2011,685,300,385,46
"41396","E01007210",2011,869,297,572,97
"41397","E01007211",2011,502,13,489,50
"41398","E01007212",2011,618,23,595,75
"41399","E01007213",2011,648,6,642,95
"41400","E01007214",2011,691,137,554,130
"41401","E01007215",2011,784,196,588,293
"41402","E01007216",2011,661,27,634,181
"41403","E01007217",2011,790,12,778,284
"41404","E01007218",2011,654,49,605,237
"41405","E01007219",2011,628,30,598,174
"41406","E01007220",2011,548,155,393,157
"41407","E01007221",2011,651,24,627,97
"41408","E01007222",2011,707,8,699,76
"41409","E01007223",2011,556,36,520,74
"41410","E01007224",2011,610,4,606,44
"41411","E01007225",2011,771,11,760,50
"41412","E01007226",2011,746,5,741,79
"41413","E01007227",2011,645,233,412,77
"41414","E01007228",2011,706,247,459,49
"41415","E01007229",2011,699,17,682,197
"41416","E01007230",2011,566,17,549,98
"41417","E01007231",2011,728,13,715,221
"41418","E01007232",2011,619,12,607,169
"41419","E01007233",2011,765,76,689,231
"41420","E01007234",2011,715,23,692,199
"41421","E01007235",2011,607,6,601,98
"41422","E01007236",2011,593,45,548,123
"41423","E01007237",2011,866,100,766,292
"41424","E01007238",2011,873,208,665,335
"41425","E01007239",2011,781,137,644,233
"41426","E01007240",2011,861,105,756,352
"41427","E01007241",2011,703,43,660,87
"41428","E01007242",2011,864,21,843,127
"41429","E01007243",2011,824,95,729,115
"41430","E01007244",2011,913,37,876,339
"41431","E01007245",2011,639,6,633,52
"41432","E01007246",2011,592,6,586,37
"41433","E01007247",2011,658,3,655,76
"41434","E01007248",2011,577,14,563,63
"41435","E01007249",2011,592,198,394,72
"41436","E01007250",2011,559,28,531,24
"41437","E01007251",2011,542,46,496,72
"41438","E01007252",2011,655,6,649,56
"41439","E01007253",2011,727,235,492,38
"41440","E01007254",2011,607,7,600,36
"41441","E01007255",2011,655,71,584,36
"41442","E01007256",2011,746,5,741,46
"41443","E01007257",2011,626,282,344,105
"41444","E01007258",2011,624,7,617,42
"41445","E01007259",2011,496,4,492,12
"41446","E01007260",2011,643,24,619,24
"41447","E01007261",2011,615,8,607,21
"41448","E01007262",2011,637,3,634,31
"41449","E01007263",2011,627,177,450,49
"41450","E01007264",2011,656,2,654,38
"41451","E01007265",2011,531,34,497,30
"41452","E01007266",2011,617,22,595,29
"41453","E01007267",2011,622,50,572,52
"41454","E01007268",2011,581,4,577,54
"41455","E01007269",2011,815,321,494,204
"41456","E01007270",2011,778,198,580,251
"41457","E01007271",2011,745,71,674,232
"41458","E01007272",2011,605,106,499,177
"41459","E01007273",2011,667,244,423,201
"41460","E01007274",2011,670,405,265,125
"41461","E01007275",2011,680,30,650,238
"41462","E01007276",2011,605,19,586,123
"41463","E01007277",2011,648,146,502,217
"41464","E01007278",2011,658,141,517,235
"41465","E01007279",2011,667,36,631,37
"41466","E01007280",2011,741,11,730,71
"41467","E01007281",2011,594,33,561,53
"41468","E01007282",2011,665,7,658,158
"41469","E01007283",2011,492,1,491,21
"41470","E01007284",2011,691,4,687,31
"41471","E01007285",2011,638,14,624,54
"41472","E01007286",2011,639,68,571,57
"41473","E01007287",2011,871,52,819,64
"41474","E01007288",2011,746,133,613,54
"41475","E01007289",2011,664,461,203,63
"41476","E01007290",2011,835,340,495,245
"41477","E01007291",2011,917,322,595,240
"41478","E01007292",2011,679,238,441,186
"41479","E01007293",2011,713,469,244,125
"41480","E01007294",2011,673,69,604,238
"41481","E01007295",2011,522,169,353,161
"41482","E01007296",2011,813,171,642,253
"41483","E01007297",2011,618,159,459,50
"41484","E01007298",2011,598,7,591,36
"41485","E01007299",2011,589,56,533,47
"41486","E01007300",2011,794,289,505,96
"41487","E01007301",2011,707,77,630,55
"41488","E01007302",2011,711,112,599,111
"41489","E01007303",2011,700,345,355,80
"41490","E01007304",2011,641,278,363,80
"41491","E01007305",2011,734,10,724,82
"41492","E01007306",2011,726,6,720,98
"41493","E01007307",2011,700,2,698,142
"41494","E01007308",2011,731,7,724,116
"41495","E01007309",2011,621,7,614,56
"41496","E01007310",2011,528,5,523,59
"41497","E01007311",2011,616,1,615,59
"41498","E01007312",2011,662,91,571,52
"41499","E01007313",2011,761,127,634,138
"41500","E01007314",2011,605,11,594,123
"41501","E01007315",2011,611,4,607,69
"41502","E01007316",2011,598,1,597,52
"41503","E01007317",2011,653,304,349,41
"41504","E01007318",2011,644,264,380,78
"41505","E01007319",2011,613,22,591,28
"41506","E01007320",2011,673,278,395,83
"41507","E01007321",2011,655,43,612,53
"41508","E01007322",2011,905,90,815,216
"41509","E01007323",2011,614,203,411,46
"41510","E01007324",2011,747,268,479,69
"41511","E01007325",2011,613,358,255,24
"41512","E01007326",2011,651,255,396,33
"41513","E01007327",2011,804,380,424,50
"41514","E01007328",2011,801,349,452,63
"41515","E01007329",2011,637,159,478,44
"41516","E01007330",2011,725,119,606,80
"41517","E01007331",2011,823,61,762,100
"41518","E01007332",2011,979,237,742,193
"41519","E01007333",2011,494,54,440,103
"41520","E01007334",2011,554,9,545,51
"41521","E01007335",2011,603,48,555,38
"41522","E01007336",2011,764,71,693,300
"41523","E01007337",2011,870,75,795,288
"41524","E01007338",2011,916,486,430,143
"41525","E01007339",2011,728,108,620,275
"41526","E01007340",2011,744,29,715,268
"41527","E01007341",2011,513,274,239,39
"41528","E01007342",2011,563,24,539,71
"41529","E01007343",2011,650,198,452,65
"41530","E01007344",2011,889,121,768,148
"41531","E01007345",2011,675,53,622,141
"41532","E01007346",2011,664,97,567,102
"41533","E01007347",2011,666,65,601,64
"41534","E01007348",2011,613,193,420,38
"41535","E01007349",2011,668,156,512,103
"41536","E01007350",2011,523,48,475,30
"41537","E01007351",2011,643,108,535,80
"41538","E01007352",2011,623,267,356,64
"41539","E01007353",2011,657,66,591,122
"41540","E01007354",2011,697,70,627,107
"41541","E01007355",2011,594,20,574,37
"41542","E01007356",2011,602,31,571,34
"41543","E01007357",2011,598,150,448,58
"41544","E01007358",2011,643,25,618,98
"41545","E01007359",2011,660,130,530,95
"41546","E01007360",2011,659,139,520,41
"41547","E01007361",2011,698,32,666,124
"41548","E01007362",2011,691,12,679,51
"41549","E01007363",2011,769,311,458,53
"41550","E01007364",2011,593,210,383,47
"41551","E01007365",2011,514,189,325,62
"41552","E01007366",2011,847,30,817,129
"41553","E01007367",2011,473,9,464,131
"41554","E01007368",2011,698,81,617,147
"41555","E01007369",2011,687,63,624,239
"41556","E01007370",2011,605,151,454,93
"41557","E01007371",2011,817,172,645,111
"41558","E01007372",2011,540,230,310,81
"41559","E01007373",2011,675,224,451,125
"41560","E01007374",2011,657,49,608,65
"41561","E01007375",2011,685,118,567,64
"41562","E01007376",2011,639,128,511,145
"41563","E01007377",2011,443,97,346,87
"41564","E01007378",2011,750,406,344,74
"41565","E01007379",2011,695,44,651,62
"41566","E01007380",2011,737,29,708,77
"41567","E01007381",2011,661,66,595,40
"41568","E01007382",2011,689,152,537,90
"41569","E01007383",2011,513,39,474,43
"41570","E01007384",2011,703,54,649,61
"41571","E01007385",2011,668,228,440,48
"41572","E01007386",2011,769,6,763,66
"41573","E01007387",2011,619,102,517,50
"41574","E01007388",2011,694,77,617,103
"41575","E01007389",2011,666,44,622,54
"41576","E01007390",2011,646,80,566,59
"41577","E01007391",2011,684,304,380,65
"41578","E01007392",2011,609,260,349,49
"41579","E01007393",2011,811,154,657,150
"41580","E01007394",2011,565,172,393,91
"41581","E01007395",2011,820,326,494,61
"41582","E01007396",2011,740,100,640,119
"41583","E01007397",2011,677,254,423,63
"41584","E01007398",2011,769,114,655,42
"41585","E01007399",2011,895,70,825,127
"41586","E01007400",2011,848,91,757,71
"41587","E01007402",2011,657,314,343,48
"41588","E01007403",2011,613,296,317,26
"41589","E01007404",2011,606,29,577,30
"41590","E01007405",2011,590,102,488,38
"41591","E01007406",2011,837,405,432,55
"41592","E01007408",2011,637,86,551,84
"41593","E01007409",2011,624,32,592,83
"41594","E01007410",2011,854,342,512,97
"41595","E01007411",2011,489,349,140,18
"41596","E01007413",2011,605,260,345,53
"41597","E01007414",2011,706,218,488,127
"41598","E01007415",2011,634,111,523,82
"41599","E01007416",2011,517,270,247,23
"41600","E01007417",2011,734,47,687,212
"41601","E01007418",2011,602,63,539,104
"41602","E01007419",2011,714,46,668,70
"41603","E01007420",2011,618,94,524,37
"41604","E01007421",2011,563,19,544,107
"41605","E01007422",2011,635,51,584,57
"41606","E01007423",2011,705,139,566,57
"41607","E01007424",2011,726,131,595,66
"41608","E01007425",2011,632,20,612,42
"41609","E01007426",2011,692,93,599,65
"41610","E01007427",2011,671,80,591,69
"41611","E01007428",2011,654,36,618,78
"41612","E01007429",2011,726,281,445,52
"41613","E01007430",2011,896,18,878,92
"41614","E01007431",2011,543,67,476,26
"41615","E01007432",2011,577,74,503,41
"41616","E01007433",2011,678,142,536,64
"41617","E01007434",2011,837,137,700,138
"41618","E01007435",2011,723,318,405,61
"41619","E01007436",2011,568,88,480,31
"41620","E01007437",2011,626,143,483,58
"41621","E01007438",2011,629,107,522,29
"41622","E01007439",2011,507,39,468,24
"41623","E01007440",2011,665,124,541,126
"41624","E01007441",2011,737,55,682,184
"41625","E01007442",2011,642,22,620,36
"41626","E01007443",2011,1005,158,847,436
"41627","E01007444",2011,768,154,614,81
"41628","E01007445",2011,731,88,643,193
"41629","E01007446",2011,642,76,566,89
"41630","E01007447",2011,657,243,414,54
"41631","E01007448",2011,773,68,705,255
"41632","E01007449",2011,815,23,792,212
"41633","E01007450",2011,709,302,407,49
"41634","E01007451",2011,728,208,520,90
"41635","E01007452",2011,634,48,586,85
"41636","E01007453",2011,646,380,266,25
"41637","E01007455",2011,587,73,514,22
"41638","E01007456",2011,766,43,723,94
"41639","E01007457",2011,689,211,478,70
"41640","E01007458",2011,619,93,526,90
"41641","E01007459",2011,733,78,655,51
"41642","E01007460",2011,612,108,504,35
"41643","E01007461",2011,776,291,485,63
"41644","E01007462",2011,658,298,360,40
"41645","E01007463",2011,782,453,329,49
"41646","E01007464",2011,600,190,410,57
"41647","E01007465",2011,629,143,486,49
"41648","E01007466",2011,640,174,466,138
"41649","E01007467",2011,645,171,474,72
"41650","E01007468",2011,607,4,603,37
"41651","E01007469",2011,543,71,472,51
"41652","E01007470",2011,553,104,449,69
"41653","E01007471",2011,591,73,518,46
"41654","E01007472",2011,654,263,391,66
"41655","E01007473",2011,616,95,521,141
"41656","E01007474",2011,649,349,300,72
"41657","E01007475",2011,627,7,620,74
"41658","E01007476",2011,643,139,504,54
"41659","E01007477",2011,598,31,567,57
"41660","E01007478",2011,653,93,560,83
"41661","E01007479",2011,674,130,544,87
"41662","E01007480",2011,549,103,446,70
"41663","E01007482",2011,641,243,398,66
"41664","E01007483",2011,610,25,585,65
"41665","E01007484",2011,626,95,531,66
"41666","E01007485",2011,592,6,586,51
"41667","E01007486",2011,635,17,618,67
"41668","E01007487",2011,691,199,492,50
"41669","E01007488",2011,726,29,697,95
"41670","E01007489",2011,722,25,697,124
"41671","E01007490",2011,631,69,562,71
"41672","E01007491",2011,661,61,600,208
"41673","E01007492",2011,664,305,359,52
"41674","E01007493",2011,715,34,681,70
"41675","E01007494",2011,675,40,635,147
"41676","E01007495",2011,757,176,581,226
"41677","E01007496",2011,606,291,315,83
"41678","E01007497",2011,542,151,391,58
"41679","E01007498",2011,657,97,560,156
"41680","E01007499",2011,655,364,291,48
"41681","E01007500",2011,577,251,326,58
"41682","E01007501",2011,643,19,624,44
"41683","E01007502",2011,1080,15,1065,210
"41684","E01007503",2011,683,19,664,73
"41685","E01007504",2011,622,124,498,77
"41686","E01007505",2011,721,86,635,80
"41687","E01007506",2011,545,182,363,71
"41688","E01007507",2011,496,171,325,72
"41689","E01007508",2011,695,195,500,197
"41690","E01007509",2011,814,246,568,193
"41691","E01007510",2011,734,123,611,183
"41692","E01007511",2011,609,247,362,77
"41693","E01007512",2011,717,78,639,59
"41694","E01007513",2011,641,153,488,58
"41695","E01007514",2011,664,8,656,215
"41696","E01007515",2011,661,189,472,68
"41697","E01007516",2011,570,63,507,52
"41698","E01007517",2011,701,50,651,240
"41699","E01007518",2011,603,86,517,34
"41700","E01007519",2011,527,65,462,72
"41701","E01007520",2011,605,5,600,35
"41702","E01007521",2011,599,59,540,48
"41703","E01007522",2011,755,339,416,67
"41704","E01007523",2011,661,9,652,108
"41705","E01007524",2011,720,37,683,92
"41706","E01007525",2011,671,202,469,63
"41707","E01007526",2011,667,26,641,68
"41708","E01007527",2011,1015,14,1001,338
"41709","E01007528",2011,634,207,427,57
"41710","E01007529",2011,654,98,556,320
"41711","E01007530",2011,512,50,462,215
"41712","E01007531",2011,792,218,574,199
"41713","E01007532",2011,1017,801,216,103
"41714","E01007533",2011,623,148,475,109
"41715","E01007534",2011,916,124,792,479
"41716","E01007535",2011,638,42,596,213
"41717","E01007536",2011,890,36,854,222
"41718","E01007537",2011,706,108,598,72
"41719","E01007538",2011,590,133,457,55
"41720","E01007539",2011,545,104,441,91
"41721","E01007540",2011,639,75,564,57
"41722","E01007541",2011,646,155,491,58
"41723","E01007542",2011,787,347,440,79
"41724","E01007543",2011,687,379,308,34
"41725","E01007544",2011,750,543,207,29
"41726","E01007545",2011,616,60,556,115
"41727","E01007546",2011,619,63,556,135
"41728","E01007547",2011,607,66,541,159
"41729","E01007548",2011,425,144,281,39
"41730","E01007549",2011,653,278,375,55
"41731","E01007550",2011,696,192,504,49
"41732","E01007551",2011,725,41,684,81
"41733","E01007552",2011,603,36,567,59
"41734","E01007553",2011,715,39,676,73
"41735","E01007554",2011,676,24,652,104
"41736","E01007555",2011,626,278,348,57
"41737","E01007556",2011,533,149,384,67
"41738","E01007557",2011,419,3,416,83
"41739","E01007558",2011,622,56,566,55
"41740","E01007559",2011,405,18,387,22
"41741","E01007560",2011,644,18,626,57
"41742","E01007561",2011,556,3,553,41
"41743","E01007562",2011,610,38,572,85
"41744","E01007563",2011,525,138,387,66
"41745","E01007564",2011,605,225,380,78
"41746","E01007565",2011,641,22,619,77
"41747","E01007566",2011,780,401,379,54
"41748","E01007567",2011,516,57,459,91
"41749","E01007568",2011,595,248,347,66
"41750","E01007569",2011,627,195,432,67
"41751","E01007570",2011,645,56,589,52
"41752","E01007571",2011,690,48,642,160
"41753","E01007572",2011,574,102,472,31
"41754","E01007573",2011,667,400,267,55
"41755","E01007574",2011,638,174,464,150
"41756","E01007575",2011,627,437,190,17
"41757","E01007576",2011,646,81,565,102
"41758","E01007577",2011,711,150,561,264
"41759","E01007578",2011,685,174,511,126
"41760","E01007579",2011,691,140,551,102
"41761","E01007580",2011,620,102,518,26
"41762","E01007581",2011,626,4,622,50
"41763","E01007582",2011,615,4,611,74
"41764","E01007583",2011,632,23,609,84
"41765","E01007584",2011,671,3,668,137
"41766","E01007585",2011,630,36,594,67
"41767","E01007586",2011,654,42,612,52
"41768","E01007587",2011,728,188,540,118
"41769","E01007588",2011,669,89,580,80
"41770","E01007589",2011,715,59,656,33
"41771","E01007590",2011,476,83,393,57
"41772","E01007591",2011,607,69,538,69
"41773","E01007592",2011,641,193,448,126
"41774","E01007593",2011,508,84,424,61
"41775","E01007594",2011,825,26,799,107
"41776","E01007595",2011,633,177,456,76
"41777","E01007596",2011,499,4,495,36
"41778","E01007597",2011,683,380,303,69
"41779","E01007598",2011,665,16,649,67
"41780","E01007599",2011,715,28,687,56
"41781","E01007600",2011,604,9,595,25
"41782","E01007601",2011,610,34,576,32
"41783","E01007602",2011,614,13,601,61
"41784","E01007603",2011,603,4,599,94
"41785","E01007604",2011,574,13,561,41
"41786","E01007605",2011,633,52,581,52
"41787","E01007606",2011,607,3,604,42
"41788","E01007607",2011,607,169,438,69
"41789","E01007608",2011,623,110,513,133
"41790","E01007609",2011,1023,188,835,123
"41791","E01007610",2011,813,14,799,94
"41792","E01007611",2011,583,96,487,49
"41793","E01007612",2011,638,32,606,80
"41794","E01007613",2011,673,53,620,52
"41795","E01007614",2011,532,9,523,36
"41796","E01007615",2011,641,97,544,75
"41797","E01007616",2011,587,41,546,54
"41798","E01007617",2011,643,5,638,39
"41799","E01007618",2011,505,8,497,44
"41800","E01007619",2011,716,5,711,45
"41801","E01007620",2011,701,10,691,66
"41802","E01007621",2011,539,3,536,62
"41803","E01007622",2011,666,13,653,51
"41804","E01007623",2011,585,136,449,49
"41805","E01007624",2011,750,10,740,96
"41806","E01007625",2011,620,35,585,57
"41807","E01007626",2011,546,145,401,116
"41808","E01007627",2011,701,259,442,80
"41809","E01007628",2011,541,229,312,71
"41810","E01007629",2011,663,309,354,87
"41811","E01007630",2011,652,58,594,52
"41812","E01007631",2011,534,2,532,19
"41813","E01007632",2011,615,81,534,77
"41814","E01007633",2011,514,93,421,73
"41815","E01007634",2011,653,193,460,105
"41816","E01007635",2011,618,155,463,50
"41817","E01007636",2011,654,181,473,111
"41818","E01007637",2011,655,49,606,96
"41819","E01007638",2011,706,227,479,116
"41820","E01007639",2011,899,169,730,220
"41821","E01007640",2011,725,22,703,80
"41822","E01007641",2011,588,51,537,76
"41823","E01007642",2011,649,179,470,78
"41824","E01007643",2011,662,262,400,107
"41825","E01007644",2011,587,9,578,115
"41826","E01007645",2011,830,72,758,377
"41827","E01007646",2011,607,6,601,228
"41828","E01007647",2011,692,51,641,189
"41829","E01007648",2011,854,94,760,440
"41830","E01007649",2011,616,10,606,123
"41831","E01007650",2011,826,194,632,104
"41832","E01007651",2011,676,209,467,99
"41833","E01007652",2011,770,325,445,99
"41834","E01007653",2011,638,19,619,136
"41835","E01007654",2011,609,36,573,189
"41836","E01007655",2011,868,133,735,437
"41837","E01007656",2011,638,193,445,58
"41838","E01007657",2011,582,14,568,52
"41839","E01007658",2011,581,16,565,56
"41840","E01007659",2011,472,7,465,34
"41841","E01007660",2011,488,21,467,15
"41842","E01007661",2011,574,52,522,39
"41843","E01007662",2011,470,231,239,19
"41844","E01007663",2011,637,7,630,56
"41845","E01007664",2011,828,53,775,51
"41846","E01007665",2011,702,79,623,44
"41847","E01007666",2011,570,37,533,50
"41848","E01007667",2011,579,129,450,49
"41849","E01007668",2011,690,397,293,72
"41850","E01007669",2011,647,48,599,31
"41851","E01007670",2011,610,6,604,32
"41852","E01007671",2011,822,13,809,114
"41853","E01007672",2011,589,14,575,38
"41854","E01007673",2011,640,223,417,53
"41855","E01007674",2011,817,18,799,55
"41856","E01007675",2011,653,76,577,83
"41857","E01007676",2011,719,235,484,76
"41858","E01007677",2011,558,269,289,92
"41859","E01007678",2011,662,49,613,74
"41860","E01007679",2011,748,207,541,74
"41861","E01007680",2011,684,105,579,156
"41862","E01007681",2011,576,40,536,33
"41863","E01007682",2011,555,79,476,42
"41864","E01007683",2011,582,60,522,41
"41865","E01007684",2011,666,15,651,104
"41866","E01007685",2011,597,4,593,49
"41867","E01007686",2011,686,51,635,64
"41868","E01007687",2011,644,89,555,40
"41869","E01007688",2011,654,31,623,304
"41870","E01007689",2011,623,112,511,25
"41871","E01007690",2011,694,22,672,58
"41872","E01007691",2011,884,63,821,47
"41873","E01007692",2011,712,86,626,58
"41874","E01007693",2011,941,167,774,125
"41875","E01007694",2011,737,247,490,74
"41876","E01007695",2011,972,113,859,85
"41877","E01007696",2011,662,87,575,191
"41878","E01007697",2011,662,316,346,29
"41879","E01007698",2011,634,30,604,89
"41880","E01007699",2011,755,186,569,89
"41881","E01007700",2011,719,66,653,109
"41882","E01007701",2011,723,233,490,132
"41883","E01007702",2011,614,61,553,168
"41884","E01007703",2011,500,36,464,24
"41885","E01007704",2011,670,145,525,40
"41886","E01007705",2011,593,7,586,49
"41887","E01007706",2011,556,21,535,56
"41888","E01007707",2011,649,44,605,26
"41889","E01007708",2011,761,365,396,64
"41890","E01007709",2011,611,7,604,24
"41891","E01007710",2011,656,10,646,39
"41892","E01007711",2011,688,8,680,45
"41893","E01007712",2011,747,26,721,92
"41894","E01007713",2011,632,6,626,29
"41895","E01007714",2011,990,392,598,306
"41896","E01007715",2011,643,151,492,243
"41897","E01007716",2011,744,288,456,184
"41898","E01007717",2011,813,203,610,139
"41899","E01007718",2011,653,245,408,109
"41900","E01007719",2011,525,266,259,46
"41901","E01007720",2011,638,149,489,51
"41902","E01007721",2011,711,296,415,94
"41903","E01007723",2011,589,240,349,43
"41904","E01007724",2011,584,15,569,158
"41905","E01007725",2011,477,32,445,39
"41906","E01007726",2011,733,346,387,91
"41907","E01007727",2011,684,322,362,54
"41908","E01007728",2011,483,84,399,36
"41909","E01007729",2011,846,517,329,38
"41910","E01007730",2011,702,342,360,63
"41911","E01007731",2011,566,103,463,89
"41912","E01007732",2011,766,415,351,30
"41913","E01007733",2011,629,293,336,28
"41914","E01007734",2011,768,401,367,60
"41915","E01007735",2011,556,329,227,45
"41916","E01007736",2011,678,341,337,115
"41917","E01007737",2011,595,362,233,54
"41918","E01007738",2011,554,259,295,66
"41919","E01007739",2011,619,353,266,28
"41920","E01007740",2011,595,248,347,32
"41921","E01007741",2011,680,9,671,46
"41922","E01007742",2011,607,131,476,29
"41923","E01007743",2011,502,35,467,20
"41924","E01007744",2011,713,134,579,99
"41925","E01007745",2011,677,254,423,30
"41926","E01007746",2011,587,98,489,29
"41927","E01007747",2011,537,178,359,50
"41928","E01007748",2011,648,113,535,39
"41929","E01007749",2011,762,25,737,93
"41930","E01007750",2011,642,37,605,47
"41931","E01007751",2011,834,140,694,142
"41932","E01007752",2011,619,7,612,57
"41933","E01007753",2011,670,123,547,42
"41934","E01007754",2011,523,33,490,48
"41935","E01007755",2011,573,11,562,42
"41936","E01007756",2011,601,28,573,29
"41937","E01007757",2011,674,46,628,64
"41938","E01007758",2011,565,93,472,133
"41939","E01007759",2011,670,181,489,60
"41940","E01007760",2011,786,148,638,252
"41941","E01007761",2011,701,165,536,61
"41942","E01007762",2011,582,95,487,42
"41943","E01007763",2011,674,133,541,171
"41944","E01007764",2011,691,367,324,115
"41945","E01007765",2011,641,43,598,151
"41946","E01007766",2011,519,204,315,28
"41947","E01007767",2011,671,118,553,160
"41948","E01007768",2011,816,320,496,143
"41949","E01007769",2011,614,135,479,238
"41950","E01007770",2011,613,193,420,67
"41951","E01007771",2011,620,23,597,75
"41952","E01007772",2011,556,136,420,81
"41953","E01007773",2011,642,124,518,111
"41954","E01007774",2011,605,134,471,73
"41955","E01007775",2011,545,299,246,48
"41956","E01007776",2011,652,208,444,84
"41957","E01007777",2011,651,187,464,48
"41958","E01007778",2011,593,87,506,14
"41959","E01007779",2011,582,263,319,46
"41960","E01007780",2011,616,130,486,18
"41961","E01007781",2011,656,237,419,41
"41962","E01007782",2011,597,217,380,52
"41963","E01007783",2011,813,351,462,78
"41964","E01007784",2011,762,118,644,210
"41965","E01007785",2011,519,62,457,39
"41966","E01007786",2011,486,16,470,38
"41967","E01007787",2011,1197,83,1114,201
"41968","E01007788",2011,659,54,605,87
"41969","E01007789",2011,739,215,524,94
"41970","E01007790",2011,696,169,527,238
"41971","E01007791",2011,551,108,443,85
"41972","E01007792",2011,484,9,475,18
"41973","E01007793",2011,628,195,433,29
"41974","E01007794",2011,553,237,316,35
"41975","E01007795",2011,634,25,609,28
"41976","E01007796",2011,573,253,320,45
"41977","E01007797",2011,580,118,462,38
"41978","E01007798",2011,543,21,522,14
"41979","E01007799",2011,613,190,423,41
"41980","E01007800",2011,698,103,595,163
"41981","E01007801",2011,614,23,591,66
"41982","E01007802",2011,581,48,533,49
"41983","E01007803",2011,547,92,455,62
"41984","E01007804",2011,661,308,353,24
"41985","E01007805",2011,641,344,297,28
"41986","E01007806",2011,518,231,287,30
"41987","E01007807",2011,607,155,452,39
"41988","E01007808",2011,590,1,589,24
"41989","E01007809",2011,726,260,466,73
"41990","E01007810",2011,793,135,658,72
"41991","E01007811",2011,579,12,567,36
"41992","E01007812",2011,544,202,342,36
"41993","E01007813",2011,591,92,499,57
"41994","E01007814",2011,474,67,407,39
"41995","E01007815",2011,705,77,628,199
"41996","E01007816",2011,649,178,471,33
"41997","E01007817",2011,638,188,450,39
"41998","E01007818",2011,674,31,643,42
"41999","E01007819",2011,627,88,539,36
"42000","E01007820",2011,625,67,558,161
"42001","E01007821",2011,670,215,455,35
"42002","E01007822",2011,710,340,370,84
"42003","E01007823",2011,820,185,635,64
"42004","E01007824",2011,562,1,561,17
"42005","E01007825",2011,603,7,596,22
"42006","E01007826",2011,582,2,580,17
"42007","E01007827",2011,701,18,683,66
"42008","E01007828",2011,749,138,611,94
"42009","E01007829",2011,731,27,704,179
"42010","E01007830",2011,663,121,542,45
"42011","E01007831",2011,672,8,664,173
"42012","E01007832",2011,686,37,649,108
"42013","E01007833",2011,795,180,615,24
"42014","E01007834",2011,767,141,626,63
"42015","E01007835",2011,618,91,527,34
"42016","E01007836",2011,698,74,624,53
"42017","E01007838",2011,644,88,556,48
"42018","E01007839",2011,667,19,648,44
"42019","E01007841",2011,637,22,615,39
"42020","E01007842",2011,685,158,527,41
"42021","E01007843",2011,776,355,421,44
"42022","E01007846",2011,642,33,609,68
"42023","E01007847",2011,643,225,418,59
"42024","E01007848",2011,689,369,320,55
"42025","E01007849",2011,866,257,609,178
"42026","E01007850",2011,619,45,574,48
"42027","E01007851",2011,524,168,356,49
"42028","E01007852",2011,637,65,572,115
"42029","E01007853",2011,691,90,601,56
"42030","E01007854",2011,645,235,410,70
"42031","E01007855",2011,785,79,706,250
"42032","E01007856",2011,543,213,330,48
"42033","E01007857",2011,650,315,335,40
"42034","E01007858",2011,649,30,619,168
"42035","E01007859",2011,459,24,435,248
"42036","E01007860",2011,607,87,520,294
"42037","E01007861",2011,676,7,669,84
"42038","E01007862",2011,682,60,622,319
"42039","E01007863",2011,660,59,601,236
"42040","E01007864",2011,521,12,509,398
"42041","E01007865",2011,762,48,714,155
"42042","E01007866",2011,572,51,521,280
"42043","E01007867",2011,634,77,557,409
"42044","E01007868",2011,493,46,447,188
"42045","E01007869",2011,508,98,410,84
"42046","E01007870",2011,738,217,521,143
"42047","E01007871",2011,855,459,396,63
"42048","E01007872",2011,627,59,568,124
"42049","E01007873",2011,647,301,346,87
"42050","E01007874",2011,669,379,290,73
"42051","E01007875",2011,607,292,315,117
"42052","E01007877",2011,418,47,371,106
"42053","E01007878",2011,649,325,324,43
"42054","E01007879",2011,712,95,617,225
"42055","E01007881",2011,675,214,461,93
"42056","E01007882",2011,614,21,593,181
"42057","E01007883",2011,414,198,216,59
"42058","E01007885",2011,692,475,217,68
"42059","E01007886",2011,672,418,254,60
"42060","E01007887",2011,605,124,481,40
"42061","E01007888",2011,553,19,534,32
"42062","E01007889",2011,1044,29,1015,89
"42063","E01007890",2011,585,16,569,28
"42064","E01007891",2011,659,10,649,28
"42065","E01007892",2011,639,348,291,41
"42066","E01007893",2011,627,19,608,24
"42067","E01007894",2011,639,25,614,95
"42068","E01007895",2011,645,231,414,25
"42069","E01007896",2011,551,6,545,19
"42070","E01007897",2011,622,10,612,44
"42071","E01007898",2011,619,10,609,59
"42072","E01007899",2011,612,14,598,23
"42073","E01007900",2011,760,197,563,70
"42074","E01007901",2011,712,386,326,25
"42075","E01007902",2011,792,482,310,78
"42076","E01007903",2011,589,137,452,74
"42077","E01007904",2011,675,420,255,59
"42078","E01007905",2011,513,219,294,86
"42079","E01007906",2011,631,179,452,139
"42080","E01007907",2011,585,24,561,84
"42081","E01007908",2011,658,6,652,93
"42082","E01007909",2011,869,88,781,115
"42083","E01007910",2011,727,274,453,72
"42084","E01007911",2011,592,10,582,33
"42085","E01007912",2011,696,139,557,48
"42086","E01007913",2011,477,70,407,156
"42087","E01007914",2011,494,84,410,149
"42088","E01007915",2011,609,1,608,18
"42089","E01007916",2011,735,457,278,48
"42090","E01007917",2011,691,116,575,44
"42091","E01007918",2011,752,129,623,72
"42092","E01007919",2011,784,480,304,40
"42093","E01007920",2011,688,5,683,57
"42094","E01007921",2011,750,74,676,60
"42095","E01007922",2011,578,9,569,16
"42096","E01007923",2011,813,55,758,72
"42097","E01007924",2011,702,158,544,35
"42098","E01007925",2011,753,107,646,52
"42099","E01007926",2011,708,23,685,51
"42100","E01007927",2011,656,8,648,16
"42101","E01007928",2011,706,17,689,32
"42102","E01007929",2011,641,10,631,62
"42103","E01007930",2011,543,6,537,18
"42104","E01007931",2011,644,2,642,26
"42105","E01007932",2011,595,27,568,35
"42106","E01007933",2011,632,16,616,20
"42107","E01007934",2011,590,43,547,55
"42108","E01007935",2011,557,5,552,157
"42109","E01007936",2011,662,9,653,190
"42110","E01007937",2011,575,5,570,50
"42111","E01007938",2011,591,2,589,24
"42112","E01007939",2011,653,31,622,39
"42113","E01007940",2011,630,250,380,134
"42114","E01007941",2011,656,319,337,44
"42115","E01007942",2011,518,68,450,124
"42116","E01007943",2011,794,516,278,49
"42117","E01007944",2011,593,67,526,228
"42118","E01007945",2011,747,373,374,45
"42119","E01007946",2011,623,358,265,36
"42120","E01007947",2011,868,664,204,41
"42121","E01007948",2011,612,344,268,44
"42122","E01007949",2011,502,36,466,138
"42123","E01007950",2011,634,313,321,26
"42124","E01007951",2011,695,48,647,149
"42125","E01007952",2011,644,5,639,45
"42126","E01007953",2011,844,280,564,64
"42127","E01007954",2011,650,5,645,49
"42128","E01007955",2011,538,34,504,15
"42129","E01007956",2011,910,22,888,74
"42130","E01007957",2011,645,3,642,34
"42131","E01007958",2011,618,4,614,48
"42132","E01007959",2011,595,2,593,26
"42133","E01007960",2011,694,24,670,223
"42134","E01007961",2011,591,22,569,41
"42135","E01007962",2011,628,146,482,249
"42136","E01007963",2011,721,220,501,49
"42137","E01007964",2011,716,189,527,65
"42138","E01007965",2011,839,409,430,33
"42139","E01007966",2011,652,182,470,46
"42140","E01007967",2011,780,330,450,46
"42141","E01007968",2011,622,264,358,57
"42142","E01007969",2011,626,125,501,53
"42143","E01007970",2011,986,720,266,51
"42144","E01007971",2011,619,184,435,40
"42145","E01007972",2011,613,9,604,30
"42146","E01007973",2011,640,32,608,33
"42147","E01007974",2011,561,52,509,47
"42148","E01007975",2011,814,335,479,126
"42149","E01007976",2011,664,199,465,68
"42150","E01007977",2011,849,580,269,34
"42151","E01007978",2011,759,58,701,299
"42152","E01007979",2011,666,444,222,48
"42153","E01007980",2011,669,41,628,152
"42154","E01007981",2011,602,17,585,155
"42155","E01007982",2011,802,327,475,64
"42156","E01007983",2011,651,14,637,147
"42157","E01007984",2011,590,6,584,22
"42158","E01007985",2011,662,14,648,96
"42159","E01007986",2011,662,7,655,190
"42160","E01007987",2011,593,13,580,82
"42161","E01007988",2011,651,70,581,50
"42162","E01007989",2011,607,8,599,124
"42163","E01007990",2011,661,162,499,31
"42164","E01007991",2011,623,295,328,47
"42165","E01007992",2011,698,53,645,112
"42166","E01007993",2011,689,222,467,45
"42167","E01007994",2011,607,14,593,102
"42168","E01007995",2011,696,14,682,209
"42169","E01007996",2011,702,89,613,140
"42170","E01007997",2011,644,65,579,15
"42171","E01007998",2011,891,512,379,20
"42172","E01007999",2011,562,66,496,31
"42173","E01008000",2011,690,98,592,95
"42174","E01008001",2011,662,146,516,67
"42175","E01008002",2011,695,39,656,43
"42176","E01008003",2011,634,87,547,41
"42177","E01008004",2011,739,189,550,68
"42178","E01008005",2011,711,69,642,55
"42179","E01008006",2011,637,40,597,60
"42180","E01008007",2011,826,447,379,47
"42181","E01008008",2011,741,355,386,68
"42182","E01008009",2011,615,359,256,59
"42183","E01008010",2011,592,202,390,48
"42184","E01008011",2011,684,504,180,45
"42185","E01008012",2011,964,492,472,221
"42186","E01008013",2011,527,288,239,65
"42187","E01008014",2011,686,202,484,104
"42188","E01008015",2011,741,386,355,58
"42189","E01008016",2011,621,141,480,54
"42190","E01008017",2011,709,455,254,57
"42191","E01008018",2011,553,311,242,30
"42192","E01008019",2011,735,188,547,47
"42193","E01008020",2011,613,42,571,49
"42194","E01008021",2011,561,7,554,23
"42195","E01008022",2011,773,501,272,47
"42196","E01008023",2011,924,18,906,134
"42197","E01008024",2011,755,105,650,73
"42198","E01008025",2011,860,121,739,114
"42199","E01008027",2011,699,247,452,40
"42200","E01008028",2011,665,162,503,80
"42201","E01008029",2011,598,225,373,31
"42202","E01008030",2011,558,37,521,62
"42203","E01008031",2011,630,189,441,32
"42204","E01008032",2011,637,172,465,71
"42205","E01008033",2011,604,99,505,33
"42206","E01008034",2011,684,191,493,64
"42207","E01008035",2011,473,1,472,27
"42208","E01008036",2011,601,13,588,61
"42209","E01008037",2011,720,288,432,30
"42210","E01008038",2011,742,10,732,37
"42211","E01008039",2011,609,39,570,42
"42212","E01008040",2011,693,125,568,38
"42213","E01008041",2011,563,21,542,41
"42214","E01008042",2011,643,19,624,195
"42215","E01008043",2011,684,7,677,71
"42216","E01008044",2011,621,9,612,39
"42217","E01008045",2011,541,46,495,102
"42218","E01008046",2011,704,21,683,255
"42219","E01008047",2011,607,18,589,297
"42220","E01008048",2011,537,21,516,257
"42221","E01008049",2011,763,146,617,163
"42222","E01008050",2011,593,10,583,265
"42223","E01008051",2011,642,36,606,215
"42224","E01008052",2011,791,28,763,269
"42225","E01008053",2011,565,258,307,25
"42226","E01008054",2011,537,282,255,34
"42227","E01008055",2011,607,330,277,39
"42228","E01008056",2011,594,178,416,29
"42229","E01008057",2011,600,290,310,34
"42230","E01008058",2011,620,104,516,30
"42231","E01008059",2011,633,310,323,44
"42232","E01008060",2011,624,354,270,34
"42233","E01008061",2011,649,307,342,62
"42234","E01008062",2011,608,383,225,28
"42235","E01008063",2011,702,213,489,36
"42236","E01008064",2011,628,11,617,316
"42237","E01008065",2011,965,750,215,107
"42238","E01008066",2011,456,32,424,291
"42239","E01008067",2011,472,68,404,325
"42240","E01008068",2011,891,499,392,257
"42241","E01008069",2011,573,44,529,306
"42242","E01008072",2011,656,283,373,112
"42243","E01008073",2011,700,228,472,176
"42244","E01008074",2011,561,16,545,223
"42245","E01008075",2011,623,349,274,54
"42246","E01008076",2011,625,315,310,35
"42247","E01008077",2011,692,266,426,52
"42248","E01008078",2011,650,121,529,52
"42249","E01008079",2011,505,8,497,29
"42250","E01008080",2011,672,153,519,63
"42251","E01008081",2011,795,448,347,56
"42252","E01008082",2011,811,496,315,42
"42253","E01008083",2011,709,398,311,43
"42254","E01008084",2011,818,537,281,50
"42255","E01008085",2011,617,311,306,31
"42256","E01008086",2011,575,258,317,27
"42257","E01008087",2011,667,26,641,74
"42258","E01008088",2011,658,114,544,43
"42259","E01008089",2011,672,276,396,99
"42260","E01008090",2011,742,411,331,44
"42261","E01008091",2011,647,26,621,119
"42262","E01008092",2011,726,472,254,31
"42263","E01008093",2011,773,85,688,219
"42264","E01008094",2011,471,216,255,34
"42265","E01008095",2011,629,233,396,228
"42266","E01008096",2011,939,499,440,167
"42267","E01008097",2011,710,428,282,42
"42268","E01008098",2011,632,373,259,49
"42269","E01008099",2011,654,61,593,147
"42270","E01008100",2011,551,341,210,26
"42271","E01008101",2011,823,397,426,57
"42272","E01008102",2011,540,323,217,37
"42273","E01008103",2011,598,364,234,46
"42274","E01008104",2011,511,107,404,222
"42275","E01008105",2011,734,102,632,402
"42276","E01008107",2011,630,304,326,148
"42277","E01008108",2011,722,82,640,443
"42278","E01008109",2011,727,177,550,320
"42279","E01008111",2011,574,38,536,349
"42280","E01008112",2011,575,75,500,254
"42281","E01008113",2011,648,65,583,215
"42282","E01008114",2011,841,402,439,356
"42283","E01008115",2011,538,127,411,332
"42284","E01008116",2011,552,317,235,20
"42285","E01008117",2011,555,307,248,20
"42286","E01008118",2011,616,299,317,22
"42287","E01008119",2011,469,228,241,21
"42288","E01008122",2011,548,355,193,25
"42289","E01008123",2011,519,261,258,30
"42290","E01008124",2011,663,431,232,62
"42291","E01008125",2011,612,198,414,26
"42292","E01008126",2011,646,48,598,22
"42293","E01008128",2011,723,49,674,121
"42294","E01008129",2011,578,49,529,58
"42295","E01008130",2011,647,88,559,32
"42296","E01008131",2011,650,68,582,31
"42297","E01008132",2011,558,9,549,15
"42298","E01008133",2011,744,182,562,47
"42299","E01008134",2011,616,99,517,47
"42300","E01008135",2011,758,36,722,112
"42301","E01008136",2011,584,136,448,35
"42302","E01008137",2011,626,6,620,24
"42303","E01008138",2011,630,287,343,28
"42304","E01008139",2011,707,104,603,102
"42305","E01008140",2011,848,171,677,102
"42306","E01008141",2011,667,25,642,47
"42307","E01008142",2011,623,104,519,58
"42308","E01008143",2011,776,116,660,84
"42309","E01008144",2011,716,36,680,130
"42310","E01008145",2011,712,302,410,30
"42311","E01008146",2011,523,1,522,12
"42312","E01008147",2011,617,54,563,37
"42313","E01008148",2011,637,122,515,28
"42314","E01008149",2011,653,6,647,60
"42315","E01008150",2011,638,129,509,73
"42316","E01008151",2011,699,33,666,264
"42317","E01008152",2011,665,92,573,38
"42318","E01008153",2011,839,117,722,214
"42319","E01008154",2011,807,127,680,169
"42320","E01008155",2011,722,122,600,213
"42321","E01008156",2011,674,11,663,68
"42322","E01008157",2011,859,496,363,88
"42323","E01008158",2011,730,270,460,46
"42324","E01008159",2011,762,11,751,224
"42325","E01008160",2011,657,86,571,80
"42326","E01008161",2011,805,55,750,200
"42327","E01008162",2011,1191,324,867,325
"42328","E01008163",2011,678,201,477,192
"42329","E01008164",2011,638,147,491,261
"42330","E01008165",2011,594,336,258,45
"42331","E01008166",2011,1023,640,383,267
"42332","E01008167",2011,721,137,584,250
"42333","E01008168",2011,1097,474,623,371
"42334","E01008169",2011,416,44,372,152
"42335","E01008170",2011,986,424,562,264
"42336","E01008171",2011,559,38,521,306
"42337","E01008172",2011,779,172,607,42
"42338","E01008173",2011,615,272,343,63
"42339","E01008174",2011,903,324,579,72
"42340","E01008175",2011,681,55,626,170
"42341","E01008176",2011,621,63,558,39
"42342","E01008177",2011,609,75,534,69
"42343","E01008178",2011,687,192,495,72
"42344","E01008179",2011,519,87,432,45
"42345","E01008180",2011,636,406,230,37
"42346","E01008181",2011,644,119,525,37
"42347","E01008182",2011,744,295,449,63
"42348","E01008183",2011,650,159,491,79
"42349","E01008184",2011,641,52,589,36
"42350","E01008185",2011,581,277,304,29
"42351","E01008186",2011,938,73,865,264
"42352","E01008187",2011,789,267,522,67
"42353","E01008188",2011,610,109,501,42
"42354","E01008189",2011,645,375,270,22
"42355","E01008190",2011,560,42,518,18
"42356","E01008191",2011,767,432,335,38
"42357","E01008192",2011,677,295,382,35
"42358","E01008193",2011,493,40,453,8
"42359","E01008194",2011,602,36,566,21
"42360","E01008195",2011,881,157,724,89
"42361","E01008196",2011,823,120,703,82
"42362","E01008197",2011,695,10,685,101
"42363","E01008198",2011,600,177,423,60
"42364","E01008199",2011,636,6,630,119
"42365","E01008200",2011,558,13,545,39
"42366","E01008201",2011,629,396,233,39
"42367","E01008202",2011,803,250,553,124
"42368","E01008203",2011,877,218,659,317
"42369","E01008204",2011,739,460,279,65
"42370","E01008205",2011,676,44,632,76
"42371","E01008206",2011,741,103,638,52
"42372","E01008207",2011,591,32,559,33
"42373","E01008208",2011,739,239,500,90
"42374","E01008209",2011,990,237,753,260
"42375","E01008210",2011,617,234,383,112
"42376","E01008211",2011,743,109,634,109
"42377","E01008212",2011,694,388,306,79
"42378","E01008213",2011,645,220,425,25
"42379","E01008214",2011,746,544,202,66
"42380","E01008215",2011,823,483,340,117
"42381","E01008216",2011,743,418,325,53
"42382","E01008217",2011,731,253,478,71
"42383","E01008218",2011,766,464,302,49
"42384","E01008219",2011,725,217,508,68
"42385","E01008220",2011,576,410,166,28
"42386","E01008221",2011,718,350,368,34
"42387","E01008222",2011,654,248,406,33
"42388","E01008223",2011,800,478,322,54
"42389","E01008224",2011,801,201,600,31
"42390","E01008225",2011,800,225,575,32
"42391","E01008226",2011,669,196,473,66
"42392","E01008227",2011,662,502,160,36
"42393","E01008228",2011,551,248,303,48
"42394","E01008229",2011,635,143,492,37
"42395","E01008230",2011,630,213,417,70
"42396","E01008231",2011,689,358,331,35
"42397","E01008232",2011,589,295,294,29
"42398","E01008233",2011,606,40,566,43
"42399","E01008234",2011,1034,43,991,149
"42400","E01008235",2011,630,25,605,26
"42401","E01008236",2011,761,137,624,130
"42402","E01008237",2011,593,5,588,26
"42403","E01008238",2011,677,18,659,93
"42404","E01008239",2011,634,44,590,52
"42405","E01008240",2011,643,209,434,18
"42406","E01008241",2011,710,251,459,31
"42407","E01008242",2011,701,336,365,31
"42408","E01008243",2011,733,96,637,94
"42409","E01008244",2011,1009,201,808,251
"42410","E01008245",2011,632,79,553,43
"42411","E01008246",2011,633,204,429,53
"42412","E01008247",2011,761,338,423,29
"42413","E01008248",2011,724,32,692,47
"42414","E01008249",2011,721,45,676,54
"42415","E01008250",2011,592,151,441,35
"42416","E01008251",2011,913,62,851,401
"42417","E01008252",2011,729,121,608,307
"42418","E01008253",2011,818,48,770,441
"42419","E01008254",2011,663,117,546,285
"42420","E01008255",2011,753,243,510,68
"42421","E01008256",2011,775,114,661,55
"42422","E01008257",2011,669,342,327,86
"42423","E01008258",2011,1154,546,608,216
"42424","E01008259",2011,1038,686,352,58
"42425","E01008260",2011,629,18,611,28
"42426","E01008261",2011,642,291,351,41
"42427","E01008262",2011,789,152,637,229
"42428","E01008263",2011,672,284,388,71
"42429","E01008264",2011,599,15,584,27
"42430","E01008265",2011,622,161,461,50
"42431","E01008266",2011,643,102,541,53
"42432","E01008267",2011,700,139,561,37
"42433","E01008268",2011,628,84,544,41
"42434","E01008269",2011,645,3,642,33
"42435","E01008270",2011,603,5,598,16
"42436","E01008271",2011,606,10,596,36
"42437","E01008272",2011,651,49,602,53
"42438","E01008273",2011,628,60,568,57
"42439","E01008274",2011,632,178,454,38
"42440","E01008275",2011,648,5,643,44
"42441","E01008276",2011,741,183,558,63
"42442","E01008277",2011,668,188,480,23
"42443","E01008278",2011,603,21,582,18
"42444","E01008279",2011,655,13,642,49
"42445","E01008280",2011,877,382,495,87
"42446","E01008281",2011,657,272,385,34
"42447","E01008282",2011,665,323,342,42
"42448","E01008283",2011,604,8,596,35
"42449","E01008284",2011,617,130,487,31
"42450","E01008285",2011,664,348,316,39
"42451","E01008286",2011,661,212,449,45
"42452","E01008287",2011,820,131,689,54
"42453","E01008288",2011,626,143,483,90
"42454","E01008289",2011,603,360,243,35
"42455","E01008290",2011,543,199,344,112
"42456","E01008291",2011,901,612,289,179
"42457","E01008292",2011,560,17,543,30
"42458","E01008293",2011,639,52,587,90
"42459","E01008294",2011,618,10,608,84
"42460","E01008295",2011,604,350,254,34
"42461","E01008296",2011,690,221,469,48
"42462","E01008297",2011,626,371,255,43
"42463","E01008298",2011,584,149,435,76
"42464","E01008299",2011,527,238,289,34
"42465","E01008300",2011,665,264,401,57
"42466","E01008301",2011,913,182,731,297
"42467","E01008302",2011,780,405,375,114
"42468","E01008303",2011,1060,752,308,147
"42469","E01008304",2011,1078,852,226,111
"42470","E01008305",2011,921,669,252,132
"42471","E01008306",2011,720,169,551,49
"42472","E01008307",2011,500,193,307,52
"42473","E01008308",2011,616,200,416,73
"42474","E01008309",2011,728,4,724,32
"42475","E01008311",2011,689,11,678,76
"42476","E01008312",2011,503,20,483,83
"42477","E01008313",2011,476,40,436,53
"42478","E01008314",2011,473,42,431,58
"42479","E01008315",2011,627,95,532,79
"42480","E01008316",2011,650,7,643,75
"42481","E01008317",2011,593,4,589,51
"42482","E01008318",2011,631,297,334,52
"42483","E01008319",2011,685,6,679,34
"42484","E01008320",2011,611,68,543,57
"42485","E01008321",2011,725,37,688,123
"42486","E01008322",2011,585,11,574,28
"42487","E01008323",2011,702,47,655,211
"42488","E01008324",2011,547,215,332,51
"42489","E01008325",2011,663,337,326,36
"42490","E01008326",2011,582,23,559,42
"42491","E01008327",2011,586,378,208,40
"42492","E01008328",2011,576,10,566,22
"42493","E01008329",2011,624,136,488,53
"42494","E01008330",2011,617,265,352,57
"42495","E01008331",2011,593,297,296,166
"42496","E01008332",2011,906,439,467,307
"42497","E01008333",2011,536,111,425,150
"42498","E01008334",2011,833,175,658,277
"42499","E01008335",2011,674,48,626,272
"42500","E01008336",2011,674,301,373,49
"42501","E01008337",2011,578,322,256,32
"42502","E01008338",2011,498,117,381,82
"42503","E01008339",2011,663,327,336,69
"42504","E01008340",2011,628,400,228,46
"42505","E01008341",2011,618,209,409,58
"42506","E01008342",2011,722,56,666,89
"42507","E01008343",2011,606,68,538,52
"42508","E01008344",2011,701,153,548,102
"42509","E01008345",2011,849,490,359,52
"42510","E01008346",2011,520,118,402,136
"42511","E01008347",2011,552,59,493,63
"42512","E01008348",2011,406,205,201,34
"42513","E01008349",2011,482,23,459,120
"42514","E01008350",2011,571,174,397,48
"42515","E01008351",2011,620,72,548,59
"42516","E01008352",2011,612,125,487,67
"42517","E01008353",2011,696,216,480,68
"42518","E01008354",2011,767,227,540,117
"42519","E01008355",2011,745,44,701,125
"42520","E01008356",2011,587,132,455,61
"42521","E01008357",2011,689,12,677,60
"42522","E01008358",2011,759,20,739,460
"42523","E01008359",2011,577,118,459,278
"42524","E01008360",2011,768,65,703,412
"42525","E01008361",2011,686,164,522,368
"42526","E01008362",2011,730,216,514,355
"42527","E01008363",2011,806,9,797,195
"42528","E01008364",2011,715,47,668,376
"42529","E01008365",2011,572,13,559,68
"42530","E01008366",2011,636,11,625,384
"42531","E01008367",2011,785,51,734,452
"42532","E01008368",2011,554,33,521,329
"42533","E01008369",2011,680,50,630,375
"42534","E01008370",2011,822,113,709,378
"42535","E01008371",2011,572,6,566,82
"42536","E01008372",2011,728,83,645,443
"42537","E01008373",2011,727,15,712,579
"42538","E01008374",2011,632,98,534,50
"42539","E01008375",2011,721,318,403,50
"42540","E01008376",2011,468,18,450,18
"42541","E01008377",2011,845,298,547,138
"42542","E01008378",2011,535,19,516,30
"42543","E01008379",2011,703,317,386,48
"42544","E01008380",2011,739,489,250,124
"42545","E01008381",2011,651,10,641,73
"42546","E01008382",2011,504,313,191,27
"42547","E01008383",2011,646,292,354,61
"42548","E01008384",2011,597,101,496,44
"42549","E01008385",2011,656,131,525,158
"42550","E01008386",2011,570,117,453,31
"42551","E01008387",2011,624,23,601,94
"42552","E01008388",2011,836,580,256,87
"42553","E01008389",2011,788,566,222,28
"42554","E01008390",2011,814,586,228,59
"42555","E01008391",2011,590,383,207,34
"42556","E01008392",2011,764,221,543,173
"42557","E01008394",2011,439,88,351,290
"42558","E01008395",2011,765,494,271,149
"42559","E01008396",2011,683,342,341,252
"42560","E01008397",2011,531,198,333,243
"42561","E01008398",2011,868,650,218,128
"42562","E01008399",2011,800,593,207,69
"42563","E01008400",2011,703,431,272,50
"42564","E01008401",2011,607,248,359,34
"42565","E01008402",2011,654,147,507,70
"42566","E01008403",2011,632,29,603,61
"42567","E01008404",2011,804,239,565,120
"42568","E01008405",2011,639,246,393,52
"42569","E01008406",2011,766,490,276,145
"42570","E01008407",2011,758,329,429,314
"42571","E01008409",2011,718,62,656,317
"42572","E01008410",2011,708,244,464,266
"42573","E01008411",2011,696,104,592,403
"42574","E01008412",2011,637,57,580,285
"42575","E01008413",2011,614,214,400,270
"42576","E01008415",2011,516,188,328,85
"42577","E01008416",2011,728,48,680,72
"42578","E01008418",2011,869,13,856,163
"42579","E01008419",2011,632,20,612,138
"42580","E01008420",2011,555,31,524,69
"42581","E01008421",2011,664,11,653,142
"42582","E01008422",2011,644,32,612,135
"42583","E01008423",2011,530,20,510,38
"42584","E01008424",2011,759,78,681,270
"42585","E01008425",2011,1030,805,225,39
"42586","E01008426",2011,640,457,183,32
"42587","E01008427",2011,581,442,139,33
"42588","E01008428",2011,543,199,344,40
"42589","E01008429",2011,620,357,263,45
"42590","E01008430",2011,614,144,470,95
"42591","E01008431",2011,616,47,569,105
"42592","E01008432",2011,629,159,470,84
"42593","E01008433",2011,634,76,558,24
"42594","E01008434",2011,603,52,551,29
"42595","E01008435",2011,629,291,338,32
"42596","E01008436",2011,781,488,293,39
"42597","E01008437",2011,567,452,115,52
"42598","E01008438",2011,850,719,131,40
"42599","E01008439",2011,805,634,171,65
"42600","E01008441",2011,772,334,438,57
"42601","E01008442",2011,620,4,616,26
"42602","E01008443",2011,608,12,596,37
"42603","E01008444",2011,664,28,636,42
"42604","E01008445",2011,800,104,696,77
"42605","E01008446",2011,641,4,637,24
"42606","E01008447",2011,609,33,576,35
"42607","E01008448",2011,633,3,630,29
"42608","E01008449",2011,575,112,463,329
"42609","E01008450",2011,574,302,272,36
"42610","E01008451",2011,839,123,716,270
"42611","E01008452",2011,497,32,465,47
"42612","E01008453",2011,569,24,545,84
"42613","E01008455",2011,500,38,462,194
"42614","E01008456",2011,674,333,341,37
"42615","E01008457",2011,787,437,350,55
"42616","E01008458",2011,700,28,672,69
"42617","E01008459",2011,724,527,197,27
"42618","E01008460",2011,605,271,334,47
"42619","E01008461",2011,623,211,412,33
"42620","E01008462",2011,545,197,348,49
"42621","E01008463",2011,607,234,373,31
"42622","E01008464",2011,655,88,567,61
"42623","E01008465",2011,641,93,548,37
"42624","E01008466",2011,559,7,552,26
"42625","E01008467",2011,635,75,560,54
"42626","E01008468",2011,633,230,403,39
"42627","E01008469",2011,757,89,668,114
"42628","E01008470",2011,643,203,440,49
"42629","E01008471",2011,660,178,482,37
"42630","E01008472",2011,673,71,602,44
"42631","E01008473",2011,527,51,476,30
"42632","E01008474",2011,614,288,326,48
"42633","E01008475",2011,687,18,669,45
"42634","E01008476",2011,793,312,481,67
"42635","E01008477",2011,659,319,340,44
"42636","E01008478",2011,775,390,385,50
"42637","E01008479",2011,647,42,605,63
"42638","E01008480",2011,716,294,422,48
"42639","E01008481",2011,614,233,381,63
"42640","E01008482",2011,824,233,591,197
"42641","E01008483",2011,757,23,734,251
"42642","E01008484",2011,639,226,413,182
"42643","E01008485",2011,644,501,143,37
"42644","E01008486",2011,661,188,473,74
"42645","E01008487",2011,692,192,500,33
"42646","E01008488",2011,647,233,414,66
"42647","E01008489",2011,752,377,375,50
"42648","E01008490",2011,768,139,629,86
"42649","E01008491",2011,622,239,383,51
"42650","E01008492",2011,750,284,466,101
"42651","E01008493",2011,641,71,570,34
"42652","E01008494",2011,734,187,547,48
"42653","E01008495",2011,736,10,726,25
"42654","E01008496",2011,775,169,606,138
"42655","E01008497",2011,651,8,643,25
"42656","E01008498",2011,718,10,708,26
"42657","E01008499",2011,727,190,537,52
"42658","E01008500",2011,728,101,627,66
"42659","E01008501",2011,772,72,700,59
"42660","E01008502",2011,697,213,484,43
"42661","E01008503",2011,771,232,539,116
"42662","E01008504",2011,646,13,633,21
"42663","E01008505",2011,805,179,626,107
"42664","E01008506",2011,613,205,408,35
"42665","E01008507",2011,626,91,535,25
"42666","E01008508",2011,617,244,373,25
"42667","E01008509",2011,747,374,373,59
"42668","E01008510",2011,755,137,618,133
"42669","E01008511",2011,780,229,551,146
"42670","E01008512",2011,763,450,313,37
"42671","E01008513",2011,1137,430,707,156
"42672","E01008514",2011,774,302,472,71
"42673","E01008516",2011,649,54,595,54
"42674","E01008517",2011,598,3,595,30
"42675","E01008518",2011,783,103,680,62
"42676","E01008519",2011,659,134,525,65
"42677","E01008520",2011,573,48,525,53
"42678","E01008521",2011,689,17,672,84
"42679","E01008522",2011,658,18,640,42
"42680","E01008523",2011,483,4,479,34
"42681","E01008524",2011,1119,359,760,341
"42682","E01008525",2011,724,38,686,108
"42683","E01008526",2011,617,17,600,30
"42684","E01008527",2011,745,16,729,181
"42685","E01008528",2011,634,7,627,153
"42686","E01008529",2011,751,30,721,112
"42687","E01008530",2011,783,127,656,72
"42688","E01008531",2011,631,8,623,50
"42689","E01008532",2011,701,199,502,64
"42690","E01008533",2011,631,285,346,34
"42691","E01008534",2011,619,15,604,39
"42692","E01008535",2011,652,92,560,68
"42693","E01008536",2011,748,88,660,205
"42694","E01008537",2011,661,182,479,88
"42695","E01008538",2011,520,4,516,49
"42696","E01008539",2011,719,85,634,146
"42697","E01008540",2011,743,387,356,132
"42698","E01008541",2011,792,342,450,142
"42699","E01008542",2011,726,421,305,91
"42700","E01008543",2011,931,285,646,201
"42701","E01008544",2011,964,424,540,273
"42702","E01008545",2011,665,455,210,92
"42703","E01008546",2011,604,2,602,14
"42704","E01008547",2011,601,13,588,33
"42705","E01008548",2011,528,2,526,10
"42706","E01008549",2011,681,10,671,45
"42707","E01008550",2011,634,8,626,73
"42708","E01008551",2011,661,2,659,26
"42709","E01008552",2011,748,62,686,93
"42710","E01008553",2011,831,30,801,185
"42711","E01008554",2011,674,171,503,49
"42712","E01008555",2011,671,222,449,43
"42713","E01008556",2011,849,23,826,86
"42714","E01008557",2011,617,7,610,19
"42715","E01008558",2011,855,59,796,177
"42716","E01008559",2011,786,83,703,215
"42717","E01008560",2011,857,97,760,215
"42718","E01008561",2011,879,327,552,170
"42719","E01008562",2011,639,68,571,62
"42720","E01008563",2011,594,1,593,27
"42721","E01008564",2011,633,9,624,49
"42722","E01008565",2011,874,260,614,78
"42723","E01008567",2011,587,196,391,71
"42724","E01008568",2011,683,166,517,50
"42725","E01008569",2011,647,296,351,32
"42726","E01008570",2011,599,58,541,73
"42727","E01008571",2011,875,362,513,126
"42728","E01008572",2011,925,135,790,373
"42729","E01008573",2011,838,157,681,330
"42730","E01008574",2011,692,101,591,65
"42731","E01008575",2011,693,240,453,123
"42732","E01008576",2011,840,233,607,150
"42733","E01008577",2011,660,136,524,66
"42734","E01008578",2011,602,163,439,54
"42735","E01008579",2011,726,11,715,35
"42736","E01008580",2011,607,16,591,88
"42737","E01008581",2011,656,15,641,30
"42738","E01008582",2011,634,189,445,58
"42739","E01008583",2011,616,174,442,63
"42740","E01008584",2011,668,49,619,224
"42741","E01008585",2011,651,44,607,114
"42742","E01008586",2011,674,46,628,127
"42743","E01008587",2011,638,59,579,138
"42744","E01008588",2011,676,43,633,174
"42745","E01008589",2011,562,5,557,22
"42746","E01008590",2011,749,253,496,141
"42747","E01008591",2011,763,127,636,286
"42748","E01008592",2011,689,57,632,224
"42749","E01008593",2011,569,294,275,44
"42750","E01008594",2011,738,301,437,71
"42751","E01008595",2011,813,111,702,214
"42752","E01008596",2011,576,270,306,101
"42753","E01008597",2011,1046,51,995,211
"42754","E01008598",2011,648,23,625,138
"42755","E01008599",2011,729,266,463,71
"42756","E01008600",2011,623,249,374,140
"42757","E01008601",2011,635,339,296,32
"42758","E01008602",2011,631,341,290,40
"42759","E01008603",2011,648,333,315,21
"42760","E01008604",2011,769,414,355,94
"42761","E01008605",2011,508,109,399,28
"42762","E01008606",2011,651,344,307,52
"42763","E01008607",2011,604,387,217,29
"42764","E01008608",2011,544,304,240,26
"42765","E01008609",2011,648,312,336,44
"42766","E01008610",2011,637,355,282,34
"42767","E01008611",2011,602,44,558,44
"42768","E01008612",2011,640,65,575,52
"42769","E01008613",2011,757,273,484,117
"42770","E01008614",2011,676,190,486,30
"42771","E01008615",2011,679,164,515,64
"42772","E01008616",2011,643,17,626,39
"42773","E01008617",2011,621,40,581,40
"42774","E01008618",2011,512,5,507,19
"42775","E01008619",2011,712,6,706,42
"42776","E01008620",2011,657,48,609,31
"42777","E01008621",2011,604,2,602,18
"42778","E01008622",2011,713,97,616,21
"42779","E01008624",2011,590,240,350,19
"42780","E01008625",2011,718,492,226,28
"42781","E01008627",2011,611,13,598,53
"42782","E01008628",2011,624,316,308,28
"42783","E01008629",2011,595,97,498,33
"42784","E01008630",2011,627,373,254,32
"42785","E01008631",2011,614,218,396,27
"42786","E01008632",2011,571,310,261,16
"42787","E01008633",2011,603,262,341,33
"42788","E01008634",2011,622,393,229,53
"42789","E01008635",2011,633,113,520,43
"42790","E01008636",2011,596,189,407,24
"42791","E01008637",2011,629,237,392,28
"42792","E01008638",2011,612,20,592,119
"42793","E01008639",2011,848,374,474,115
"42794","E01008640",2011,889,199,690,131
"42795","E01008641",2011,818,441,377,63
"42796","E01008642",2011,578,12,566,42
"42797","E01008643",2011,620,149,471,27
"42798","E01008644",2011,753,375,378,38
"42799","E01008645",2011,668,326,342,31
"42800","E01008646",2011,609,162,447,26
"42801","E01008647",2011,659,38,621,38
"42802","E01008648",2011,668,134,534,35
"42803","E01008649",2011,701,349,352,27
"42804","E01008650",2011,599,51,548,25
"42805","E01008651",2011,778,516,262,31
"42806","E01008652",2011,514,182,332,67
"42807","E01008653",2011,526,296,230,28
"42808","E01008654",2011,600,100,500,126
"42809","E01008655",2011,663,315,348,65
"42810","E01008656",2011,604,181,423,24
"42811","E01008657",2011,578,43,535,36
"42812","E01008658",2011,581,315,266,36
"42813","E01008659",2011,634,234,400,30
"42814","E01008660",2011,655,116,539,64
"42815","E01008661",2011,512,219,293,19
"42816","E01008662",2011,514,238,276,27
"42817","E01008663",2011,637,297,340,32
"42818","E01008664",2011,696,197,499,196
"42819","E01008665",2011,762,278,484,169
"42820","E01008666",2011,803,592,211,89
"42821","E01008667",2011,899,400,499,158
"42822","E01008668",2011,813,311,502,186
"42823","E01008669",2011,649,372,277,59
"42824","E01008670",2011,744,327,417,46
"42825","E01008671",2011,647,262,385,99
"42826","E01008672",2011,588,183,405,30
"42827","E01008673",2011,524,12,512,75
"42828","E01008674",2011,512,8,504,25
"42829","E01008675",2011,757,60,697,222
"42830","E01008676",2011,538,81,457,106
"42831","E01008677",2011,590,35,555,80
"42832","E01008678",2011,626,52,574,150
"42833","E01008679",2011,625,62,563,108
"42834","E01008680",2011,604,62,542,23
"42835","E01008681",2011,637,10,627,24
"42836","E01008682",2011,509,260,249,40
"42837","E01008683",2011,729,67,662,210
"42838","E01008684",2011,589,258,331,28
"42839","E01008685",2011,806,199,607,47
"42840","E01008686",2011,726,180,546,34
"42841","E01008687",2011,844,192,652,59
"42842","E01008688",2011,654,275,379,40
"42843","E01008689",2011,769,445,324,36
"42844","E01008690",2011,646,270,376,38
"42845","E01008691",2011,494,33,461,14
"42846","E01008692",2011,615,225,390,35
"42847","E01008693",2011,555,167,388,64
"42848","E01008694",2011,618,251,367,54
"42849","E01008695",2011,606,242,364,47
"42850","E01008696",2011,490,86,404,16
"42851","E01008697",2011,571,243,328,28
"42852","E01008698",2011,724,368,356,59
"42853","E01008699",2011,605,267,338,50
"42854","E01008700",2011,516,65,451,159
"42855","E01008701",2011,650,82,568,217
"42856","E01008702",2011,566,419,147,41
"42857","E01008703",2011,1089,525,564,444
"42858","E01008704",2011,650,80,570,163
"42859","E01008705",2011,485,83,402,165
"42860","E01008706",2011,668,72,596,210
"42861","E01008707",2011,547,13,534,189
"42862","E01008708",2011,695,236,459,55
"42863","E01008709",2011,687,281,406,175
"42864","E01008711",2011,687,138,549,116
"42865","E01008712",2011,774,390,384,66
"42866","E01008713",2011,630,6,624,38
"42867","E01008714",2011,528,249,279,55
"42868","E01008715",2011,587,110,477,77
"42869","E01008716",2011,592,19,573,12
"42870","E01008717",2011,683,225,458,55
"42871","E01008718",2011,610,168,442,37
"42872","E01008719",2011,557,126,431,103
"42873","E01008720",2011,618,97,521,85
"42874","E01008721",2011,626,46,580,47
"42875","E01008722",2011,644,23,621,41
"42876","E01008723",2011,572,4,568,38
"42877","E01008724",2011,483,7,476,15
"42878","E01008725",2011,619,36,583,21
"42879","E01008726",2011,670,9,661,59
"42880","E01008727",2011,769,18,751,92
"42881","E01008728",2011,583,16,567,38
"42882","E01008729",2011,462,243,219,33
"42883","E01008730",2011,647,382,265,41
"42884","E01008731",2011,519,271,248,31
"42885","E01008732",2011,940,294,646,76
"42886","E01008733",2011,882,483,399,52
"42887","E01008734",2011,637,25,612,25
"42888","E01008735",2011,1032,281,751,392
"42889","E01008736",2011,609,153,456,214
"42890","E01008737",2011,627,94,533,219
"42891","E01008738",2011,605,70,535,199
"42892","E01008739",2011,606,205,401,55
"42893","E01008740",2011,609,7,602,71
"42894","E01008741",2011,619,67,552,70
"42895","E01008742",2011,754,107,647,110
"42896","E01008743",2011,725,425,300,48
"42897","E01008744",2011,750,223,527,143
"42898","E01008745",2011,728,43,685,49
"42899","E01008746",2011,714,363,351,68
"42900","E01008747",2011,656,193,463,32
"42901","E01008748",2011,655,200,455,29
"42902","E01008749",2011,638,58,580,29
"42903","E01008750",2011,762,115,647,57
"42904","E01008751",2011,462,164,298,24
"42905","E01008752",2011,692,296,396,69
"42906","E01008753",2011,559,124,435,59
"42907","E01008754",2011,694,278,416,61
"42908","E01008755",2011,589,130,459,85
"42909","E01008756",2011,652,312,340,54
"42910","E01008757",2011,648,83,565,162
"42911","E01008758",2011,601,79,522,38
"42912","E01008759",2011,664,12,652,101
"42913","E01008760",2011,626,11,615,82
"42914","E01008761",2011,588,4,584,41
"42915","E01008762",2011,639,305,334,84
"42916","E01008763",2011,607,238,369,57
"42917","E01008764",2011,652,154,498,65
"42918","E01008765",2011,603,61,542,30
"42919","E01008766",2011,911,333,578,62
"42920","E01008767",2011,632,141,491,45
"42921","E01008768",2011,585,80,505,67
"42922","E01008769",2011,775,223,552,94
"42923","E01008770",2011,600,127,473,32
"42924","E01008771",2011,618,165,453,29
"42925","E01008772",2011,585,62,523,26
"42926","E01008773",2011,675,302,373,94
"42927","E01008774",2011,591,74,517,36
"42928","E01008775",2011,601,24,577,30
"42929","E01008776",2011,494,179,315,39
"42930","E01008777",2011,886,644,242,47
"42931","E01008778",2011,609,171,438,53
"42932","E01008779",2011,689,161,528,91
"42933","E01008780",2011,848,322,526,81
"42934","E01008781",2011,633,5,628,63
"42935","E01008782",2011,607,21,586,24
"42936","E01008783",2011,622,8,614,56
"42937","E01008784",2011,648,18,630,35
"42938","E01008785",2011,624,4,620,29
"42939","E01008786",2011,648,44,604,77
"42940","E01008787",2011,710,34,676,172
"42941","E01008788",2011,758,30,728,143
"42942","E01008789",2011,642,19,623,143
"42943","E01008790",2011,657,78,579,105
"42944","E01008791",2011,1011,478,533,300
"42945","E01008792",2011,505,4,501,43
"42946","E01008793",2011,823,479,344,91
"42947","E01008795",2011,722,129,593,41
"42948","E01008796",2011,621,62,559,82
"42949","E01008797",2011,833,52,781,47
"42950","E01008799",2011,641,55,586,39
"42951","E01008800",2011,582,339,243,42
"42952","E01008801",2011,658,17,641,40
"42953","E01008802",2011,643,103,540,37
"42954","E01008803",2011,650,173,477,85
"42955","E01008804",2011,663,248,415,43
"42956","E01008805",2011,660,135,525,128
"42957","E01008808",2011,634,14,620,89
"42958","E01008809",2011,693,170,523,49
"42959","E01008810",2011,712,303,409,59
"42960","E01008811",2011,690,126,564,62
"42961","E01008812",2011,751,358,393,69
"42962","E01008813",2011,643,255,388,45
"42963","E01008814",2011,661,155,506,59
"42964","E01008817",2011,465,311,154,36
"42965","E01008819",2011,630,264,366,38
"42966","E01008820",2011,558,38,520,144
"42967","E01008821",2011,539,250,289,49
"42968","E01008822",2011,732,331,401,67
"42969","E01008823",2011,606,325,281,49
"42970","E01008824",2011,625,363,262,61
"42971","E01008825",2011,687,279,408,34
"42972","E01008826",2011,606,237,369,45
"42973","E01008827",2011,524,298,226,40
"42974","E01008828",2011,643,366,277,44
"42975","E01008829",2011,627,393,234,37
"42976","E01008830",2011,573,19,554,214
"42977","E01008831",2011,1131,242,889,603
"42978","E01008832",2011,632,26,606,152
"42979","E01008833",2011,637,8,629,126
"42980","E01008834",2011,967,221,746,438
"42981","E01008835",2011,611,7,604,147
"42982","E01008836",2011,704,434,270,158
"42983","E01008837",2011,633,274,359,100
"42984","E01008838",2011,680,357,323,60
"42985","E01008839",2011,671,404,267,51
"42986","E01008840",2011,586,210,376,66
"42987","E01008841",2011,528,299,229,48
"42988","E01008842",2011,592,154,438,33
"42989","E01008843",2011,555,37,518,49
"42990","E01008844",2011,688,153,535,53
"42991","E01008845",2011,672,88,584,75
"42992","E01008846",2011,464,259,205,40
"42993","E01008847",2011,513,257,256,57
"42994","E01008848",2011,608,136,472,30
"42995","E01008849",2011,499,291,208,47
"42996","E01008850",2011,625,41,584,40
"42997","E01008851",2011,753,262,491,92
"42998","E01008852",2011,531,77,454,29
"42999","E01008853",2011,619,306,313,52
"43000","E01008854",2011,812,160,652,309
"43001","E01008855",2011,644,176,468,51
"43002","E01008856",2011,629,51,578,37
"43003","E01008857",2011,630,256,374,39
"43004","E01008858",2011,598,381,217,41
"43005","E01008859",2011,534,285,249,51
"43006","E01008860",2011,596,245,351,47
"43007","E01008861",2011,649,175,474,48
"43008","E01008862",2011,567,50,517,16
"43009","E01008863",2011,633,50,583,20
"43010","E01008864",2011,540,51,489,22
"43011","E01008865",2011,608,218,390,38
"43012","E01008866",2011,606,209,397,56
"43013","E01008867",2011,803,454,349,86
"43014","E01008868",2011,513,36,477,28
"43015","E01008869",2011,523,100,423,26
"43016","E01008870",2011,595,51,544,45
"43017","E01008871",2011,602,219,383,51
"43018","E01008872",2011,663,109,554,51
"43019","E01008873",2011,540,51,489,32
"43020","E01008874",2011,671,369,302,37
"43021","E01008875",2011,674,226,448,83
"43022","E01008876",2011,579,40,539,26
"43023","E01008877",2011,634,32,602,50
"43024","E01008878",2011,635,147,488,43
"43025","E01008879",2011,617,145,472,59
"43026","E01008880",2011,512,156,356,30
"43027","E01008881",2011,619,182,437,70
"43028","E01008882",2011,687,241,446,91
"43029","E01008883",2011,651,115,536,135
"43030","E01008884",2011,682,130,552,233
"43031","E01008885",2011,504,12,492,60
"43032","E01008886",2011,714,159,555,139
"43033","E01008887",2011,626,134,492,132
"43034","E01008888",2011,639,15,624,87
"43035","E01008889",2011,659,74,585,187
"43036","E01008890",2011,705,74,631,185
"43037","E01008891",2011,689,134,555,83
"43038","E01008892",2011,518,162,356,118
"43039","E01008893",2011,725,70,655,208
"43040","E01008894",2011,658,180,478,224
"43041","E01008895",2011,771,90,681,134
"43042","E01008896",2011,564,206,358,75
"43043","E01008897",2011,602,151,451,63
"43044","E01008898",2011,563,220,343,74
"43045","E01008899",2011,478,250,228,69
"43046","E01008901",2011,573,237,336,78
"43047","E01008905",2011,421,110,311,64
"43048","E01008906",2011,476,201,275,79
"43049","E01008907",2011,560,337,223,85
"43050","E01008909",2011,472,243,229,37
"43051","E01008910",2011,661,436,225,53
"43052","E01008911",2011,596,452,144,43
"43053","E01008913",2011,681,511,170,32
"43054","E01008914",2011,895,529,366,220
"43055","E01008915",2011,506,43,463,160
"43056","E01008916",2011,454,101,353,114
"43057","E01008917",2011,523,86,437,37
"43058","E01008918",2011,753,386,367,51
"43059","E01008919",2011,704,220,484,88
"43060","E01008920",2011,556,60,496,45
"43061","E01008921",2011,630,162,468,77
"43062","E01008923",2011,637,326,311,49
"43063","E01008924",2011,623,128,495,49
"43064","E01008925",2011,515,12,503,45
"43065","E01008927",2011,644,337,307,52
"43066","E01008928",2011,684,389,295,36
"43067","E01008929",2011,676,354,322,49
"43068","E01008930",2011,605,165,440,60
"43069","E01008931",2011,647,298,349,39
"43070","E01008932",2011,670,222,448,86
"43071","E01008933",2011,549,83,466,65
"43072","E01008934",2011,547,47,500,61
"43073","E01008935",2011,675,279,396,82
"43074","E01008936",2011,643,215,428,41
"43075","E01008937",2011,607,214,393,63
"43076","E01008938",2011,588,200,388,70
"43077","E01008939",2011,673,167,506,67
"43078","E01008940",2011,594,196,398,86
"43079","E01008941",2011,585,196,389,49
"43080","E01008942",2011,618,192,426,48
"43081","E01008943",2011,562,162,400,62
"43082","E01008944",2011,733,196,537,87
"43083","E01008945",2011,745,114,631,120
"43084","E01008946",2011,643,148,495,68
"43085","E01008947",2011,543,53,490,78
"43086","E01008948",2011,627,26,601,71
"43087","E01008949",2011,515,6,509,27
"43088","E01008950",2011,718,385,333,34
"43089","E01008951",2011,574,167,407,69
"43090","E01008952",2011,761,56,705,272
"43091","E01008953",2011,638,101,537,114
"43092","E01008954",2011,585,272,313,40
"43093","E01008955",2011,666,65,601,144
"43094","E01008956",2011,577,92,485,52
"43095","E01008957",2011,708,93,615,174
"43096","E01008958",2011,787,482,305,48
"43097","E01008959",2011,790,170,620,101
"43098","E01008960",2011,625,54,571,100
"43099","E01008961",2011,738,27,711,261
"43100","E01008962",2011,818,362,456,87
"43101","E01008963",2011,572,96,476,77
"43102","E01008964",2011,634,184,450,62
"43103","E01008965",2011,587,27,560,59
"43104","E01008966",2011,688,253,435,111
"43105","E01008967",2011,665,70,595,46
"43106","E01008968",2011,697,49,648,78
"43107","E01008969",2011,697,80,617,86
"43108","E01008970",2011,621,189,432,60
"43109","E01008971",2011,716,110,606,89
"43110","E01008972",2011,741,259,482,63
"43111","E01008973",2011,848,119,729,111
"43112","E01008974",2011,1153,128,1025,213
"43113","E01008975",2011,669,56,613,59
"43114","E01008976",2011,679,261,418,49
"43115","E01008977",2011,698,154,544,96
"43116","E01008978",2011,744,586,158,20
"43117","E01008979",2011,765,370,395,37
"43118","E01008980",2011,681,350,331,32
"43119","E01008981",2011,587,51,536,52
"43120","E01008982",2011,667,61,606,269
"43121","E01008984",2011,754,363,391,193
"43122","E01008986",2011,859,130,729,496
"43123","E01008987",2011,637,211,426,258
"43124","E01008988",2011,975,128,847,534
"43125","E01008989",2011,930,267,663,377
"43126","E01008990",2011,468,9,459,157
"43127","E01008991",2011,581,9,572,79
"43128","E01008992",2011,482,16,466,125
"43129","E01008994",2011,673,175,498,165
"43130","E01008995",2011,725,532,193,63
"43131","E01008996",2011,599,264,335,107
"43132","E01008997",2011,599,142,457,118
"43133","E01008998",2011,639,159,480,114
"43134","E01008999",2011,522,77,445,105
"43135","E01009000",2011,794,188,606,298
"43136","E01009001",2011,694,83,611,111
"43137","E01009002",2011,653,385,268,50
"43138","E01009003",2011,690,26,664,183
"43139","E01009005",2011,643,112,531,93
"43140","E01009006",2011,763,33,730,202
"43141","E01009007",2011,777,124,653,356
"43142","E01009008",2011,603,56,547,67
"43143","E01009009",2011,637,129,508,58
"43144","E01009011",2011,783,175,608,113
"43145","E01009012",2011,590,14,576,104
"43146","E01009013",2011,857,136,721,265
"43147","E01009014",2011,657,153,504,111
"43148","E01009015",2011,786,147,639,221
"43149","E01009016",2011,732,299,433,81
"43150","E01009017",2011,491,28,463,93
"43151","E01009018",2011,697,93,604,180
"43152","E01009019",2011,612,237,375,78
"43153","E01009020",2011,557,144,413,64
"43154","E01009021",2011,654,248,406,87
"43155","E01009022",2011,612,107,505,84
"43156","E01009023",2011,572,17,555,77
"43157","E01009024",2011,606,222,384,88
"43158","E01009025",2011,584,230,354,47
"43159","E01009026",2011,581,172,409,137
"43160","E01009028",2011,622,179,443,102
"43161","E01009029",2011,528,110,418,82
"43162","E01009030",2011,480,19,461,59
"43163","E01009031",2011,601,38,563,62
"43164","E01009032",2011,587,26,561,66
"43165","E01009033",2011,677,205,472,97
"43166","E01009034",2011,533,4,529,78
"43167","E01009035",2011,637,65,572,98
"43168","E01009036",2011,540,8,532,62
"43169","E01009037",2011,700,98,602,90
"43170","E01009039",2011,641,6,635,68
"43171","E01009040",2011,628,6,622,50
"43172","E01009041",2011,627,15,612,78
"43173","E01009042",2011,539,4,535,163
"43174","E01009043",2011,652,90,562,123
"43175","E01009044",2011,463,32,431,96
"43176","E01009045",2011,598,46,552,101
"43177","E01009046",2011,610,57,553,70
"43178","E01009047",2011,552,269,283,82
"43179","E01009048",2011,567,268,299,93
"43180","E01009049",2011,570,90,480,118
"43181","E01009050",2011,652,242,410,157
"43182","E01009051",2011,478,92,386,155
"43183","E01009053",2011,435,117,318,106
"43184","E01009054",2011,417,19,398,69
"43185","E01009056",2011,749,300,449,133
"43186","E01009057",2011,647,265,382,123
"43187","E01009058",2011,465,31,434,120
"43188","E01009059",2011,569,292,277,96
"43189","E01009060",2011,426,124,302,105
"43190","E01009061",2011,432,80,352,78
"43191","E01009062",2011,476,156,320,82
"43192","E01009064",2011,600,132,468,91
"43193","E01009065",2011,661,39,622,173
"43194","E01009066",2011,601,84,517,55
"43195","E01009067",2011,677,56,621,164
"43196","E01009068",2011,714,76,638,229
"43197","E01009069",2011,823,94,729,296
"43198","E01009070",2011,687,53,634,114
"43199","E01009071",2011,789,213,576,179
"43200","E01009072",2011,802,104,698,262
"43201","E01009073",2011,657,454,203,45
"43202","E01009074",2011,667,334,333,87
"43203","E01009075",2011,829,401,428,201
"43204","E01009077",2011,718,113,605,117
"43205","E01009078",2011,626,97,529,210
"43206","E01009079",2011,719,399,320,58
"43207","E01009080",2011,412,223,189,42
"43208","E01009081",2011,558,296,262,53
"43209","E01009082",2011,500,108,392,67
"43210","E01009083",2011,559,238,321,46
"43211","E01009084",2011,515,46,469,66
"43212","E01009085",2011,505,9,496,54
"43213","E01009086",2011,605,66,539,86
"43214","E01009087",2011,582,9,573,89
"43215","E01009088",2011,711,166,545,46
"43216","E01009089",2011,495,3,492,66
"43217","E01009090",2011,540,42,498,92
"43218","E01009091",2011,663,226,437,74
"43219","E01009092",2011,632,334,298,62
"43220","E01009093",2011,648,252,396,106
"43221","E01009094",2011,532,177,355,73
"43222","E01009095",2011,637,49,588,126
"43223","E01009096",2011,774,410,364,46
"43224","E01009097",2011,792,518,274,34
"43225","E01009098",2011,933,359,574,108
"43226","E01009099",2011,811,562,249,60
"43227","E01009100",2011,839,258,581,98
"43228","E01009101",2011,626,321,305,25
"43229","E01009102",2011,630,204,426,108
"43230","E01009103",2011,657,433,224,29
"43231","E01009104",2011,646,219,427,99
"43232","E01009105",2011,653,71,582,60
"43233","E01009106",2011,587,124,463,35
"43234","E01009107",2011,829,468,361,73
"43235","E01009108",2011,557,93,464,19
"43236","E01009109",2011,516,371,145,34
"43237","E01009110",2011,649,241,408,62
"43238","E01009111",2011,550,71,479,46
"43239","E01009112",2011,600,145,455,42
"43240","E01009113",2011,624,384,240,39
"43241","E01009114",2011,680,302,378,46
"43242","E01009115",2011,618,310,308,30
"43243","E01009116",2011,579,5,574,42
"43244","E01009117",2011,820,547,273,45
"43245","E01009118",2011,677,170,507,56
"43246","E01009119",2011,641,108,533,94
"43247","E01009120",2011,628,62,566,82
"43248","E01009121",2011,926,361,565,112
"43249","E01009122",2011,665,291,374,84
"43250","E01009123",2011,611,119,492,102
"43251","E01009124",2011,639,436,203,55
"43252","E01009125",2011,689,163,526,81
"43253","E01009126",2011,542,4,538,64
"43254","E01009127",2011,586,232,354,92
"43255","E01009128",2011,532,199,333,68
"43256","E01009129",2011,581,245,336,80
"43257","E01009130",2011,608,230,378,69
"43258","E01009131",2011,517,167,350,61
"43259","E01009132",2011,616,213,403,113
"43260","E01009133",2011,610,259,351,64
"43261","E01009134",2011,664,279,385,63
"43262","E01009135",2011,597,60,537,49
"43263","E01009136",2011,798,352,446,46
"43264","E01009137",2011,581,168,413,76
"43265","E01009138",2011,547,15,532,189
"43266","E01009139",2011,576,38,538,186
"43267","E01009140",2011,732,125,607,212
"43268","E01009141",2011,825,576,249,86
"43269","E01009143",2011,660,494,166,56
"43270","E01009145",2011,719,98,621,273
"43271","E01009146",2011,892,630,262,155
"43272","E01009147",2011,657,101,556,316
"43273","E01009151",2011,614,104,510,177
"43274","E01009152",2011,624,152,472,193
"43275","E01009153",2011,850,333,517,247
"43276","E01009155",2011,602,310,292,22
"43277","E01009157",2011,632,336,296,38
"43278","E01009158",2011,762,186,576,115
"43279","E01009159",2011,753,35,718,137
"43280","E01009160",2011,736,507,229,41
"43281","E01009161",2011,617,231,386,38
"43282","E01009162",2011,653,53,600,122
"43283","E01009163",2011,635,248,387,66
"43284","E01009164",2011,634,101,533,75
"43285","E01009165",2011,659,182,477,135
"43286","E01009166",2011,559,129,430,79
"43287","E01009167",2011,603,67,536,65
"43288","E01009168",2011,621,28,593,58
"43289","E01009169",2011,682,84,598,69
"43290","E01009170",2011,627,22,605,48
"43291","E01009171",2011,694,179,515,60
"43292","E01009172",2011,548,212,336,46
"43293","E01009173",2011,656,277,379,61
"43294","E01009174",2011,533,195,338,57
"43295","E01009175",2011,593,36,557,142
"43296","E01009176",2011,670,119,551,106
"43297","E01009177",2011,647,41,606,140
"43298","E01009178",2011,707,80,627,215
"43299","E01009179",2011,651,68,583,94
"43300","E01009182",2011,666,260,406,201
"43301","E01009183",2011,572,26,546,104
"43302","E01009184",2011,724,149,575,255
"43303","E01009185",2011,736,69,667,218
"43304","E01009186",2011,760,122,638,188
"43305","E01009187",2011,686,125,561,148
"43306","E01009188",2011,665,115,550,170
"43307","E01009189",2011,605,41,564,98
"43308","E01009192",2011,614,61,553,115
"43309","E01009194",2011,679,151,528,137
"43310","E01009195",2011,678,147,531,132
"43311","E01009197",2011,452,109,343,94
"43312","E01009198",2011,449,80,369,135
"43313","E01009199",2011,577,172,405,186
"43314","E01009200",2011,659,353,306,98
"43315","E01009201",2011,695,371,324,53
"43316","E01009202",2011,593,384,209,53
"43317","E01009203",2011,1145,966,179,64
"43318","E01009204",2011,706,506,200,60
"43319","E01009205",2011,615,54,561,56
"43320","E01009206",2011,658,36,622,70
"43321","E01009207",2011,663,13,650,67
"43322","E01009208",2011,618,25,593,50
"43323","E01009209",2011,975,217,758,172
"43324","E01009210",2011,796,203,593,140
"43325","E01009211",2011,676,31,645,83
"43326","E01009212",2011,767,270,497,74
"43327","E01009213",2011,699,127,572,74
"43328","E01009214",2011,788,410,378,54
"43329","E01009215",2011,884,493,391,67
"43330","E01009216",2011,816,155,661,62
"43331","E01009217",2011,660,7,653,78
"43332","E01009218",2011,635,112,523,24
"43333","E01009219",2011,609,82,527,88
"43334","E01009220",2011,628,110,518,87
"43335","E01009221",2011,593,61,532,51
"43336","E01009222",2011,604,200,404,92
"43337","E01009223",2011,676,86,590,92
"43338","E01009224",2011,620,20,600,60
"43339","E01009225",2011,764,255,509,83
"43340","E01009226",2011,663,16,647,133
"43341","E01009227",2011,693,25,668,98
"43342","E01009228",2011,677,27,650,103
"43343","E01009229",2011,637,8,629,101
"43344","E01009230",2011,655,12,643,104
"43345","E01009231",2011,758,8,750,82
"43346","E01009232",2011,606,21,585,98
"43347","E01009233",2011,628,197,431,65
"43348","E01009234",2011,623,28,595,94
"43349","E01009235",2011,625,8,617,100
"43350","E01009236",2011,636,56,580,96
"43351","E01009237",2011,604,88,516,107
"43352","E01009238",2011,632,62,570,69
"43353","E01009239",2011,495,131,364,166
"43354","E01009240",2011,610,7,603,113
"43355","E01009241",2011,608,7,601,128
"43356","E01009242",2011,605,9,596,161
"43357","E01009243",2011,626,51,575,68
"43358","E01009244",2011,620,57,563,109
"43359","E01009245",2011,565,31,534,76
"43360","E01009246",2011,637,29,608,86
"43361","E01009247",2011,571,5,566,67
"43362","E01009248",2011,696,20,676,110
"43363","E01009249",2011,629,78,551,77
"43364","E01009250",2011,689,67,622,92
"43365","E01009251",2011,627,27,600,56
"43366","E01009252",2011,621,20,601,122
"43367","E01009253",2011,624,64,560,69
"43368","E01009254",2011,669,214,455,96
"43369","E01009255",2011,633,120,513,80
"43370","E01009256",2011,663,145,518,79
"43371","E01009257",2011,596,151,445,67
"43372","E01009258",2011,661,299,362,69
"43373","E01009259",2011,670,346,324,47
"43374","E01009260",2011,640,21,619,83
"43375","E01009261",2011,667,12,655,98
"43376","E01009262",2011,520,19,501,69
"43377","E01009263",2011,650,156,494,162
"43378","E01009264",2011,585,148,437,366
"43379","E01009265",2011,572,86,486,121
"43380","E01009266",2011,615,73,542,208
"43381","E01009267",2011,567,60,507,73
"43382","E01009268",2011,432,19,413,55
"43383","E01009269",2011,544,94,450,174
"43384","E01009270",2011,646,246,400,117
"43385","E01009271",2011,535,110,425,124
"43386","E01009272",2011,487,194,293,57
"43387","E01009273",2011,512,73,439,114
"43388","E01009274",2011,739,213,526,178
"43389","E01009275",2011,476,143,333,77
"43390","E01009276",2011,528,4,524,55
"43391","E01009278",2011,540,5,535,87
"43392","E01009279",2011,445,5,440,40
"43393","E01009280",2011,571,158,413,142
"43394","E01009281",2011,660,229,431,60
"43395","E01009282",2011,639,102,537,174
"43396","E01009283",2011,593,46,547,154
"43397","E01009284",2011,664,100,564,348
"43398","E01009286",2011,504,21,483,384
"43399","E01009288",2011,437,20,417,120
"43400","E01009289",2011,561,64,497,417
"43401","E01009290",2011,465,25,440,373
"43402","E01009291",2011,624,174,450,80
"43403","E01009292",2011,666,8,658,155
"43404","E01009293",2011,601,15,586,208
"43405","E01009294",2011,809,202,607,142
"43406","E01009295",2011,677,91,586,175
"43407","E01009296",2011,581,34,547,237
"43408","E01009297",2011,727,242,485,55
"43409","E01009298",2011,577,230,347,70
"43410","E01009299",2011,646,267,379,62
"43411","E01009300",2011,713,318,395,90
"43412","E01009301",2011,806,398,408,110
"43413","E01009302",2011,635,65,570,61
"43414","E01009303",2011,723,212,511,106
"43415","E01009304",2011,836,288,548,48
"43416","E01009305",2011,753,389,364,40
"43417","E01009306",2011,684,232,452,58
"43418","E01009307",2011,759,361,398,59
"43419","E01009308",2011,805,339,466,72
"43420","E01009309",2011,657,328,329,56
"43421","E01009310",2011,803,305,498,67
"43422","E01009311",2011,583,184,399,63
"43423","E01009312",2011,614,52,562,44
"43424","E01009313",2011,630,111,519,51
"43425","E01009314",2011,661,133,528,78
"43426","E01009315",2011,783,144,639,125
"43427","E01009316",2011,683,93,590,84
"43428","E01009317",2011,760,217,543,78
"43429","E01009318",2011,627,9,618,56
"43430","E01009319",2011,653,10,643,89
"43431","E01009320",2011,609,6,603,101
"43432","E01009321",2011,791,459,332,70
"43433","E01009322",2011,603,285,318,40
"43434","E01009323",2011,569,196,373,33
"43435","E01009324",2011,727,22,705,76
"43436","E01009325",2011,493,136,357,87
"43437","E01009326",2011,560,165,395,87
"43438","E01009327",2011,412,30,382,121
"43439","E01009328",2011,525,29,496,93
"43440","E01009329",2011,645,104,541,192
"43441","E01009331",2011,557,35,522,138
"43442","E01009332",2011,539,310,229,76
"43443","E01009333",2011,436,107,329,119
"43444","E01009334",2011,425,55,370,78
"43445","E01009335",2011,479,31,448,103
"43446","E01009337",2011,479,63,416,136
"43447","E01009338",2011,408,82,326,107
"43448","E01009339",2011,455,85,370,117
"43449","E01009340",2011,941,96,845,290
"43450","E01009341",2011,544,274,270,79
"43451","E01009342",2011,438,52,386,111
"43452","E01009343",2011,525,112,413,142
"43453","E01009344",2011,460,126,334,135
"43454","E01009345",2011,527,284,243,87
"43455","E01009346",2011,540,135,405,122
"43456","E01009347",2011,755,460,295,83
"43457","E01009348",2011,801,272,529,168
"43458","E01009349",2011,595,181,414,169
"43459","E01009350",2011,454,142,312,90
"43460","E01009351",2011,564,141,423,158
"43461","E01009352",2011,465,119,346,81
"43462","E01009353",2011,460,71,389,100
"43463","E01009354",2011,520,197,323,99
"43464","E01009355",2011,522,197,325,125
"43465","E01009358",2011,691,206,485,209
"43466","E01009359",2011,710,229,481,196
"43467","E01009360",2011,920,311,609,245
"43468","E01009361",2011,827,313,514,241
"43469","E01009362",2011,516,392,124,43
"43470","E01009363",2011,547,230,317,77
"43471","E01009364",2011,515,390,125,26
"43472","E01009365",2011,554,268,286,105
"43473","E01009366",2011,517,181,336,108
"43474","E01009367",2011,490,128,362,112
"43475","E01009368",2011,417,211,206,61
"43476","E01009371",2011,478,136,342,116
"43477","E01009372",2011,420,57,363,88
"43478","E01009373",2011,466,90,376,95
"43479","E01009374",2011,423,230,193,38
"43480","E01009375",2011,522,180,342,103
"43481","E01009376",2011,564,204,360,177
"43482","E01009377",2011,452,246,206,80
"43483","E01009378",2011,1060,421,639,363
"43484","E01009379",2011,686,391,295,80
"43485","E01009380",2011,465,89,376,148
"43486","E01009382",2011,448,44,404,108
"43487","E01009383",2011,418,91,327,107
"43488","E01009384",2011,725,345,380,200
"43489","E01009385",2011,615,110,505,252
"43490","E01009389",2011,474,41,433,73
"43491","E01009390",2011,659,117,542,325
"43492","E01009391",2011,522,38,484,211
"43493","E01009392",2011,444,11,433,121
"43494","E01009393",2011,473,21,452,167
"43495","E01009394",2011,755,44,711,180
"43496","E01009395",2011,566,116,450,168
"43497","E01009396",2011,478,47,431,118
"43498","E01009397",2011,450,167,283,85
"43499","E01009399",2011,416,83,333,108
"43500","E01009400",2011,525,116,409,111
"43501","E01009401",2011,636,190,446,167
"43502","E01009403",2011,615,196,419,67
"43503","E01009404",2011,632,213,419,62
"43504","E01009405",2011,604,125,479,84
"43505","E01009406",2011,775,258,517,96
"43506","E01009407",2011,733,178,555,166
"43507","E01009408",2011,657,157,500,98
"43508","E01009409",2011,724,113,611,189
"43509","E01009410",2011,764,134,630,168
"43510","E01009411",2011,871,23,848,230
"43511","E01009412",2011,651,62,589,226
"43512","E01009413",2011,655,81,574,175
"43513","E01009414",2011,768,87,681,210
"43514","E01009415",2011,672,6,666,46
"43515","E01009416",2011,1008,40,968,110
"43516","E01009417",2011,608,100,508,47
"43517","E01009418",2011,645,137,508,41
"43518","E01009419",2011,579,65,514,53
"43519","E01009420",2011,632,40,592,44
"43520","E01009421",2011,639,3,636,18
"43521","E01009422",2011,864,17,847,120
"43522","E01009423",2011,759,174,585,85
"43523","E01009424",2011,689,33,656,142
"43524","E01009425",2011,846,81,765,108
"43525","E01009426",2011,607,8,599,34
"43526","E01009427",2011,702,65,637,124
"43527","E01009428",2011,650,3,647,28
"43528","E01009429",2011,588,3,585,37
"43529","E01009430",2011,648,36,612,48
"43530","E01009431",2011,611,5,606,30
"43531","E01009432",2011,642,143,499,60
"43532","E01009433",2011,746,4,742,66
"43533","E01009434",2011,626,13,613,70
"43534","E01009435",2011,711,19,692,71
"43535","E01009436",2011,539,4,535,22
"43536","E01009437",2011,806,103,703,90
"43537","E01009438",2011,608,9,599,51
"43538","E01009439",2011,619,22,597,58
"43539","E01009440",2011,630,6,624,33
"43540","E01009441",2011,639,118,521,136
"43541","E01009442",2011,605,14,591,24
"43542","E01009443",2011,536,2,534,65
"43543","E01009444",2011,623,5,618,28
"43544","E01009445",2011,686,301,385,57
"43545","E01009446",2011,1008,149,859,126
"43546","E01009447",2011,629,95,534,52
"43547","E01009448",2011,673,198,475,48
"43548","E01009449",2011,949,54,895,320
"43549","E01009450",2011,679,28,651,62
"43550","E01009451",2011,652,46,606,156
"43551","E01009452",2011,682,61,621,61
"43552","E01009453",2011,526,33,493,38
"43553","E01009454",2011,655,4,651,96
"43554","E01009455",2011,721,373,348,55
"43555","E01009456",2011,660,18,642,63
"43556","E01009457",2011,608,8,600,14
"43557","E01009458",2011,784,217,567,70
"43558","E01009459",2011,665,2,663,82
"43559","E01009460",2011,833,102,731,238
"43560","E01009461",2011,522,12,510,19
"43561","E01009462",2011,798,154,644,161
"43562","E01009463",2011,619,4,615,62
"43563","E01009464",2011,530,3,527,31
"43564","E01009465",2011,503,8,495,24
"43565","E01009466",2011,668,9,659,94
"43566","E01009467",2011,662,104,558,40
"43567","E01009468",2011,626,9,617,46
"43568","E01009469",2011,591,7,584,60
"43569","E01009470",2011,532,3,529,12
"43570","E01009471",2011,701,14,687,100
"43571","E01009472",2011,635,25,610,45
"43572","E01009473",2011,682,60,622,113
"43573","E01009474",2011,635,61,574,65
"43574","E01009475",2011,589,194,395,72
"43575","E01009476",2011,570,211,359,87
"43576","E01009477",2011,573,159,414,114
"43577","E01009478",2011,655,318,337,85
"43578","E01009479",2011,607,190,417,108
"43579","E01009480",2011,583,152,431,102
"43580","E01009481",2011,696,35,661,142
"43581","E01009482",2011,472,158,314,80
"43582","E01009483",2011,504,127,377,113
"43583","E01009484",2011,515,214,301,80
"43584","E01009485",2011,488,76,412,80
"43585","E01009486",2011,587,45,542,148
"43586","E01009487",2011,604,63,541,138
"43587","E01009488",2011,688,360,328,87
"43588","E01009489",2011,526,120,406,125
"43589","E01009490",2011,669,253,416,86
"43590","E01009491",2011,470,94,376,84
"43591","E01009492",2011,542,128,414,117
"43592","E01009493",2011,792,433,359,177
"43593","E01009494",2011,629,541,88,44
"43594","E01009495",2011,501,205,296,27
"43595","E01009496",2011,627,54,573,37
"43596","E01009497",2011,728,188,540,95
"43597","E01009498",2011,688,284,404,80
"43598","E01009499",2011,673,210,463,56
"43599","E01009500",2011,637,277,360,57
"43600","E01009501",2011,629,226,403,106
"43601","E01009502",2011,648,226,422,62
"43602","E01009503",2011,615,210,405,70
"43603","E01009504",2011,619,124,495,64
"43604","E01009505",2011,690,306,384,80
"43605","E01009506",2011,635,32,603,46
"43606","E01009507",2011,606,242,364,108
"43607","E01009508",2011,597,108,489,68
"43608","E01009509",2011,634,98,536,200
"43609","E01009510",2011,670,330,340,54
"43610","E01009511",2011,507,219,288,53
"43611","E01009512",2011,610,159,451,78
"43612","E01009513",2011,616,198,418,94
"43613","E01009514",2011,594,273,321,67
"43614","E01009515",2011,637,119,518,72
"43615","E01009516",2011,531,101,430,70
"43616","E01009517",2011,665,193,472,56
"43617","E01009518",2011,697,56,641,86
"43618","E01009519",2011,606,14,592,47
"43619","E01009520",2011,717,31,686,57
"43620","E01009521",2011,613,7,606,88
"43621","E01009522",2011,647,188,459,71
"43622","E01009523",2011,609,4,605,43
"43623","E01009524",2011,680,153,527,59
"43624","E01009525",2011,575,9,566,64
"43625","E01009526",2011,599,14,585,67
"43626","E01009527",2011,654,57,597,90
"43627","E01009528",2011,679,21,658,53
"43628","E01009529",2011,621,19,602,91
"43629","E01009530",2011,561,11,550,51
"43630","E01009531",2011,761,104,657,111
"43631","E01009532",2011,577,30,547,71
"43632","E01009535",2011,558,15,543,41
"43633","E01009536",2011,613,8,605,67
"43634","E01009537",2011,612,179,433,64
"43635","E01009538",2011,601,173,428,51
"43636","E01009539",2011,774,460,314,72
"43637","E01009540",2011,779,539,240,67
"43638","E01009541",2011,816,236,580,128
"43639","E01009542",2011,893,529,364,90
"43640","E01009543",2011,560,7,553,30
"43641","E01009544",2011,749,145,604,146
"43642","E01009548",2011,1038,79,959,405
"43643","E01009549",2011,668,6,662,93
"43644","E01009550",2011,770,14,756,197
"43645","E01009552",2011,719,189,530,93
"43646","E01009553",2011,687,125,562,404
"43647","E01009554",2011,571,12,559,162
"43648","E01009555",2011,601,3,598,75
"43649","E01009556",2011,772,100,672,264
"43650","E01009557",2011,539,4,535,30
"43651","E01009558",2011,643,13,630,191
"43652","E01009559",2011,606,28,578,78
"43653","E01009560",2011,547,4,543,43
"43654","E01009561",2011,767,130,637,88
"43655","E01009562",2011,709,54,655,52
"43656","E01009563",2011,619,3,616,32
"43657","E01009564",2011,587,116,471,226
"43658","E01009565",2011,458,23,435,118
"43659","E01009566",2011,569,144,425,233
"43660","E01009567",2011,660,126,534,224
"43661","E01009568",2011,541,71,470,159
"43662","E01009569",2011,494,121,373,157
"43663","E01009570",2011,596,118,478,217
"43664","E01009571",2011,673,315,358,190
"43665","E01009572",2011,797,313,484,276
"43666","E01009573",2011,525,163,362,134
"43667","E01009574",2011,559,253,306,136
"43668","E01009575",2011,481,85,396,138
"43669","E01009576",2011,684,163,521,98
"43670","E01009577",2011,527,352,175,42
"43671","E01009578",2011,564,30,534,41
"43672","E01009579",2011,695,478,217,54
"43673","E01009580",2011,547,28,519,159
"43674","E01009581",2011,638,339,299,49
"43675","E01009582",2011,738,136,602,116
"43676","E01009583",2011,672,100,572,156
"43677","E01009584",2011,603,145,458,62
"43678","E01009585",2011,390,329,61,18
"43679","E01009586",2011,651,11,640,64
"43680","E01009587",2011,572,18,554,181
"43681","E01009588",2011,681,263,418,113
"43682","E01009589",2011,591,75,516,124
"43683","E01009590",2011,523,38,485,61
"43684","E01009591",2011,580,15,565,113
"43685","E01009592",2011,640,137,503,134
"43686","E01009593",2011,633,15,618,124
"43687","E01009594",2011,532,40,492,47
"43688","E01009596",2011,564,58,506,184
"43689","E01009597",2011,642,50,592,143
"43690","E01009598",2011,642,10,632,76
"43691","E01009599",2011,607,51,556,157
"43692","E01009604",2011,566,43,523,115
"43693","E01009605",2011,650,297,353,81
"43694","E01009606",2011,537,23,514,102
"43695","E01009607",2011,803,517,286,81
"43696","E01009608",2011,621,115,506,121
"43697","E01009609",2011,610,111,499,111
"43698","E01009610",2011,637,188,449,126
"43699","E01009611",2011,772,454,318,84
"43700","E01009612",2011,566,287,279,70
"43701","E01009613",2011,502,8,494,70
"43702","E01009614",2011,585,4,581,92
"43703","E01009615",2011,678,17,661,251
"43704","E01009616",2011,608,17,591,142
"43705","E01009617",2011,473,25,448,88
"43706","E01009618",2011,612,7,605,67
"43707","E01009619",2011,831,97,734,370
"43708","E01009620",2011,608,66,542,99
"43709","E01009621",2011,536,79,457,129
"43710","E01009622",2011,655,224,431,116
"43711","E01009623",2011,678,142,536,143
"43712","E01009624",2011,622,22,600,200
"43713","E01009625",2011,867,50,817,199
"43714","E01009626",2011,632,34,598,161
"43715","E01009627",2011,712,120,592,189
"43716","E01009628",2011,632,62,570,106
"43717","E01009629",2011,1079,117,962,451
"43718","E01009630",2011,708,175,533,195
"43719","E01009631",2011,577,221,356,154
"43720","E01009632",2011,943,391,552,375
"43721","E01009633",2011,713,142,571,329
"43722","E01009634",2011,679,67,612,332
"43723","E01009635",2011,886,154,732,562
"43724","E01009636",2011,967,152,815,511
"43725","E01009637",2011,481,165,316,141
"43726","E01009638",2011,732,541,191,97
"43727","E01009639",2011,545,96,449,174
"43728","E01009640",2011,707,249,458,265
"43729","E01009641",2011,902,307,595,415
"43730","E01009642",2011,963,282,681,564
"43731","E01009643",2011,591,3,588,103
"43732","E01009644",2011,679,18,661,101
"43733","E01009645",2011,572,6,566,90
"43734","E01009646",2011,619,4,615,97
"43735","E01009647",2011,785,11,774,224
"43736","E01009648",2011,607,6,601,96
"43737","E01009649",2011,582,13,569,91
"43738","E01009650",2011,790,92,698,462
"43739","E01009651",2011,874,549,325,164
"43740","E01009652",2011,619,26,593,61
"43741","E01009653",2011,625,5,620,70
"43742","E01009654",2011,710,9,701,134
"43743","E01009655",2011,789,257,532,149
"43744","E01009656",2011,713,198,515,178
"43745","E01009657",2011,627,8,619,109
"43746","E01009658",2011,585,19,566,125
"43747","E01009659",2011,765,241,524,287
"43748","E01009660",2011,658,25,633,245
"43749","E01009661",2011,793,77,716,419
"43750","E01009662",2011,569,124,445,94
"43751","E01009663",2011,633,20,613,86
"43752","E01009664",2011,578,47,531,124
"43753","E01009665",2011,475,15,460,32
"43754","E01009666",2011,503,5,498,38
"43755","E01009667",2011,575,5,570,22
"43756","E01009668",2011,630,25,605,62
"43757","E01009669",2011,462,9,453,39
"43758","E01009670",2011,673,3,670,58
"43759","E01009671",2011,410,6,404,48
"43760","E01009672",2011,822,11,811,61
"43761","E01009674",2011,674,265,409,68
"43762","E01009676",2011,600,15,585,136
"43763","E01009679",2011,614,261,353,109
"43764","E01009681",2011,535,8,527,90
"43765","E01009682",2011,601,11,590,105
"43766","E01009683",2011,560,75,485,113
"43767","E01009684",2011,680,169,511,132
"43768","E01009685",2011,714,33,681,108
"43769","E01009686",2011,692,7,685,97
"43770","E01009687",2011,600,6,594,123
"43771","E01009688",2011,601,37,564,264
"43772","E01009689",2011,717,50,667,365
"43773","E01009690",2011,660,19,641,296
"43774","E01009691",2011,631,19,612,285
"43775","E01009692",2011,531,4,527,29
"43776","E01009693",2011,692,7,685,68
"43777","E01009694",2011,623,4,619,85
"43778","E01009695",2011,754,3,751,73
"43779","E01009696",2011,640,2,638,78
"43780","E01009697",2011,644,13,631,76
"43781","E01009698",2011,624,10,614,53
"43782","E01009699",2011,624,76,548,47
"43783","E01009700",2011,831,448,383,98
"43784","E01009701",2011,729,272,457,63
"43785","E01009702",2011,729,321,408,102
"43786","E01009703",2011,1144,370,774,134
"43787","E01009704",2011,596,5,591,52
"43788","E01009705",2011,578,2,576,42
"43789","E01009706",2011,656,17,639,86
"43790","E01009707",2011,727,47,680,81
"43791","E01009708",2011,626,26,600,87
"43792","E01009709",2011,429,281,148,87
"43793","E01009710",2011,634,10,624,171
"43794","E01009711",2011,600,31,569,93
"43795","E01009712",2011,620,9,611,126
"43796","E01009713",2011,521,22,499,103
"43797","E01009714",2011,576,3,573,99
"43798","E01009715",2011,588,111,477,126
"43799","E01009716",2011,649,23,626,96
"43800","E01009717",2011,585,20,565,94
"43801","E01009718",2011,885,463,422,118
"43802","E01009719",2011,558,14,544,55
"43803","E01009720",2011,528,2,526,28
"43804","E01009721",2011,866,135,731,88
"43805","E01009722",2011,618,8,610,54
"43806","E01009723",2011,466,2,464,24
"43807","E01009724",2011,623,2,621,37
"43808","E01009725",2011,595,332,263,37
"43809","E01009726",2011,535,7,528,41
"43810","E01009727",2011,503,4,499,38
"43811","E01009728",2011,501,4,497,17
"43812","E01009729",2011,620,118,502,49
"43813","E01009730",2011,606,11,595,74
"43814","E01009731",2011,679,31,648,135
"43815","E01009732",2011,719,154,565,84
"43816","E01009733",2011,929,611,318,84
"43817","E01009734",2011,686,154,532,74
"43818","E01009735",2011,631,8,623,75
"43819","E01009736",2011,602,10,592,75
"43820","E01009737",2011,664,112,552,61
"43821","E01009738",2011,607,130,477,26
"43822","E01009739",2011,640,102,538,82
"43823","E01009740",2011,669,205,464,100
"43824","E01009741",2011,1179,701,478,188
"43825","E01009742",2011,647,281,366,42
"43826","E01009743",2011,696,349,347,31
"43827","E01009744",2011,872,285,587,161
"43828","E01009745",2011,727,56,671,77
"43829","E01009746",2011,688,182,506,159
"43830","E01009747",2011,661,142,519,145
"43831","E01009748",2011,649,322,327,53
"43832","E01009749",2011,594,15,579,51
"43833","E01009750",2011,595,147,448,34
"43834","E01009751",2011,651,138,513,102
"43835","E01009752",2011,595,233,362,53
"43836","E01009753",2011,615,325,290,43
"43837","E01009754",2011,640,199,441,52
"43838","E01009756",2011,527,235,292,45
"43839","E01009757",2011,645,141,504,86
"43840","E01009758",2011,664,224,440,47
"43841","E01009759",2011,526,14,512,27
"43842","E01009760",2011,505,95,410,37
"43843","E01009762",2011,489,334,155,17
"43844","E01009763",2011,690,287,403,47
"43845","E01009764",2011,571,33,538,43
"43846","E01009765",2011,641,57,584,55
"43847","E01009766",2011,672,174,498,46
"43848","E01009767",2011,615,160,455,29
"43849","E01009768",2011,626,140,486,66
"43850","E01009769",2011,708,365,343,64
"43851","E01009770",2011,634,187,447,24
"43852","E01009771",2011,640,36,604,30
"43853","E01009772",2011,480,224,256,26
"43854","E01009773",2011,665,172,493,77
"43855","E01009774",2011,625,76,549,46
"43856","E01009775",2011,597,157,440,42
"43857","E01009776",2011,590,39,551,30
"43858","E01009777",2011,612,215,397,30
"43859","E01009778",2011,621,56,565,60
"43860","E01009779",2011,675,135,540,69
"43861","E01009780",2011,745,31,714,44
"43862","E01009781",2011,890,309,581,74
"43863","E01009782",2011,632,253,379,38
"43864","E01009783",2011,597,195,402,44
"43865","E01009784",2011,625,3,622,30
"43866","E01009785",2011,634,34,600,19
"43867","E01009786",2011,626,333,293,43
"43868","E01009787",2011,585,11,574,23
"43869","E01009788",2011,705,281,424,73
"43870","E01009789",2011,643,61,582,43
"43871","E01009790",2011,667,231,436,47
"43872","E01009791",2011,662,164,498,35
"43873","E01009792",2011,632,144,488,53
"43874","E01009793",2011,527,7,520,61
"43875","E01009794",2011,629,6,623,41
"43876","E01009795",2011,705,103,602,174
"43877","E01009796",2011,604,55,549,49
"43878","E01009797",2011,645,134,511,56
"43879","E01009798",2011,716,67,649,85
"43880","E01009799",2011,658,26,632,69
"43881","E01009800",2011,635,57,578,44
"43882","E01009801",2011,667,29,638,31
"43883","E01009802",2011,668,135,533,25
"43884","E01009803",2011,653,3,650,19
"43885","E01009804",2011,534,13,521,26
"43886","E01009805",2011,613,68,545,57
"43887","E01009806",2011,672,53,619,70
"43888","E01009807",2011,755,3,752,37
"43889","E01009808",2011,602,9,593,21
"43890","E01009809",2011,669,262,407,59
"43891","E01009810",2011,764,90,674,70
"43892","E01009811",2011,663,102,561,39
"43893","E01009812",2011,577,29,548,23
"43894","E01009813",2011,638,158,480,74
"43895","E01009814",2011,515,2,513,15
"43896","E01009815",2011,498,2,496,18
"43897","E01009816",2011,607,5,602,23
"43898","E01009817",2011,544,6,538,17
"43899","E01009818",2011,511,137,374,41
"43900","E01009819",2011,662,12,650,53
"43901","E01009820",2011,644,44,600,53
"43902","E01009821",2011,602,5,597,20
"43903","E01009822",2011,657,40,617,58
"43904","E01009823",2011,537,10,527,18
"43905","E01009824",2011,703,217,486,49
"43906","E01009825",2011,604,122,482,39
"43907","E01009826",2011,638,7,631,32
"43908","E01009827",2011,633,8,625,17
"43909","E01009828",2011,573,51,522,38
"43910","E01009829",2011,635,8,627,32
"43911","E01009830",2011,624,24,600,32
"43912","E01009831",2011,638,272,366,38
"43913","E01009832",2011,659,313,346,47
"43914","E01009833",2011,498,60,438,123
"43915","E01009834",2011,694,201,493,57
"43916","E01009835",2011,498,17,481,90
"43917","E01009836",2011,859,439,420,161
"43918","E01009837",2011,618,83,535,113
"43919","E01009838",2011,658,149,509,79
"43920","E01009839",2011,582,119,463,77
"43921","E01009840",2011,533,72,461,125
"43922","E01009841",2011,631,289,342,60
"43923","E01009842",2011,902,471,431,115
"43924","E01009843",2011,659,99,560,59
"43925","E01009844",2011,608,197,411,124
"43926","E01009845",2011,628,32,596,26
"43927","E01009846",2011,617,55,562,35
"43928","E01009847",2011,607,81,526,17
"43929","E01009848",2011,622,99,523,59
"43930","E01009849",2011,653,164,489,33
"43931","E01009850",2011,664,55,609,63
"43932","E01009851",2011,625,80,545,40
"43933","E01009852",2011,601,2,599,27
"43934","E01009853",2011,628,7,621,21
"43935","E01009854",2011,632,3,629,47
"43936","E01009855",2011,637,5,632,26
"43937","E01009856",2011,901,225,676,144
"43938","E01009857",2011,694,251,443,66
"43939","E01009858",2011,593,42,551,127
"43940","E01009859",2011,643,9,634,64
"43941","E01009860",2011,646,16,630,20
"43942","E01009861",2011,646,97,549,99
"43943","E01009862",2011,724,202,522,76
"43944","E01009863",2011,702,151,551,58
"43945","E01009864",2011,600,148,452,42
"43946","E01009865",2011,644,219,425,41
"43947","E01009866",2011,732,90,642,158
"43948","E01009867",2011,694,123,571,48
"43949","E01009868",2011,671,144,527,96
"43950","E01009869",2011,675,15,660,97
"43951","E01009870",2011,668,2,666,124
"43952","E01009871",2011,833,221,612,90
"43953","E01009872",2011,615,244,371,70
"43954","E01009873",2011,620,75,545,54
"43955","E01009874",2011,581,213,368,29
"43956","E01009875",2011,623,148,475,43
"43957","E01009876",2011,653,153,500,52
"43958","E01009877",2011,633,303,330,35
"43959","E01009878",2011,764,45,719,62
"43960","E01009879",2011,802,167,635,108
"43961","E01009880",2011,569,15,554,60
"43962","E01009881",2011,1131,542,589,271
"43963","E01009882",2011,542,25,517,65
"43964","E01009883",2011,569,222,347,43
"43965","E01009884",2011,645,262,383,107
"43966","E01009885",2011,682,194,488,119
"43967","E01009886",2011,833,475,358,40
"43968","E01009887",2011,637,146,491,70
"43969","E01009888",2011,660,84,576,83
"43970","E01009889",2011,681,114,567,201
"43971","E01009890",2011,665,293,372,55
"43972","E01009891",2011,615,244,371,56
"43973","E01009892",2011,632,275,357,109
"43974","E01009893",2011,607,324,283,60
"43975","E01009894",2011,696,184,512,67
"43976","E01009895",2011,611,181,430,35
"43977","E01009896",2011,606,52,554,22
"43978","E01009897",2011,606,3,603,20
"43979","E01009898",2011,652,72,580,34
"43980","E01009899",2011,625,19,606,23
"43981","E01009900",2011,633,7,626,13
"43982","E01009901",2011,585,45,540,20
"43983","E01009902",2011,533,17,516,21
"43984","E01009903",2011,621,5,616,36
"43985","E01009904",2011,625,22,603,48
"43986","E01009905",2011,647,85,562,94
"43987","E01009906",2011,860,385,475,119
"43988","E01009907",2011,637,44,593,118
"43989","E01009908",2011,679,25,654,96
"43990","E01009909",2011,630,119,511,34
"43991","E01009910",2011,711,260,451,35
"43992","E01009911",2011,611,4,607,63
"43993","E01009912",2011,691,37,654,29
"43994","E01009913",2011,648,106,542,35
"43995","E01009914",2011,593,4,589,17
"43996","E01009915",2011,712,9,703,103
"43997","E01009916",2011,725,108,617,98
"43998","E01009917",2011,498,18,480,19
"43999","E01009918",2011,600,232,368,31
"44000","E01009919",2011,502,6,496,21
"44001","E01009920",2011,621,17,604,85
"44002","E01009921",2011,715,22,693,274
"44003","E01009922",2011,503,132,371,42
"44004","E01009923",2011,574,67,507,55
"44005","E01009924",2011,616,14,602,141
"44006","E01009925",2011,560,13,547,82
"44007","E01009926",2011,615,34,581,159
"44008","E01009927",2011,714,17,697,264
"44009","E01009928",2011,756,169,587,208
"44010","E01009929",2011,723,293,430,56
"44011","E01009930",2011,634,218,416,51
"44012","E01009931",2011,900,45,855,117
"44013","E01009932",2011,809,342,467,144
"44014","E01009933",2011,541,162,379,32
"44015","E01009934",2011,590,247,343,43
"44016","E01009935",2011,885,497,388,62
"44017","E01009936",2011,669,49,620,52
"44018","E01009937",2011,599,229,370,47
"44019","E01009938",2011,668,207,461,53
"44020","E01009939",2011,669,74,595,74
"44021","E01009940",2011,618,204,414,52
"44022","E01009941",2011,596,119,477,60
"44023","E01009942",2011,627,191,436,68
"44024","E01009943",2011,478,167,311,30
"44025","E01009944",2011,575,202,373,53
"44026","E01009946",2011,657,40,617,64
"44027","E01009947",2011,788,150,638,94
"44028","E01009948",2011,585,35,550,39
"44029","E01009949",2011,578,8,570,31
"44030","E01009950",2011,639,93,546,43
"44031","E01009951",2011,1004,495,509,202
"44032","E01009952",2011,885,519,366,107
"44033","E01009953",2011,790,228,562,137
"44034","E01009954",2011,718,199,519,56
"44035","E01009955",2011,812,165,647,203
"44036","E01009956",2011,678,179,499,104
"44037","E01009957",2011,634,304,330,70
"44038","E01009958",2011,641,39,602,61
"44039","E01009959",2011,591,13,578,31
"44040","E01009960",2011,649,278,371,38
"44041","E01009961",2011,534,24,510,29
"44042","E01009962",2011,499,254,245,26
"44043","E01009963",2011,497,239,258,30
"44044","E01009964",2011,564,287,277,33
"44045","E01009965",2011,471,253,218,23
"44046","E01009966",2011,467,178,289,29
"44047","E01009967",2011,770,172,598,80
"44048","E01009968",2011,646,43,603,82
"44049","E01009969",2011,774,259,515,126
"44050","E01009970",2011,629,165,464,49
"44051","E01009971",2011,670,271,399,64
"44052","E01009972",2011,723,32,691,69
"44053","E01009973",2011,761,60,701,85
"44054","E01009974",2011,608,6,602,43
"44055","E01009975",2011,658,40,618,45
"44056","E01009976",2011,980,62,918,210
"44057","E01009977",2011,711,159,552,132
"44058","E01009978",2011,625,170,455,47
"44059","E01009979",2011,797,529,268,53
"44060","E01009980",2011,825,211,614,142
"44061","E01009981",2011,716,252,464,95
"44062","E01009982",2011,528,215,313,45
"44063","E01009983",2011,570,266,304,19
"44064","E01009985",2011,674,276,398,53
"44065","E01009986",2011,453,58,395,117
"44066","E01009987",2011,471,236,235,52
"44067","E01009988",2011,734,387,347,55
"44068","E01009989",2011,642,147,495,110
"44069","E01009991",2011,797,296,501,106
"44070","E01009992",2011,615,117,498,102
"44071","E01009993",2011,715,317,398,89
"44072","E01009994",2011,620,215,405,75
"44073","E01009995",2011,612,134,478,79
"44074","E01009996",2011,654,342,312,40
"44075","E01009997",2011,627,207,420,81
"44076","E01009998",2011,772,309,463,93
"44077","E01009999",2011,527,89,438,56
"44078","E01010000",2011,674,113,561,61
"44079","E01010001",2011,705,212,493,57
"44080","E01010002",2011,817,31,786,193
"44081","E01010003",2011,712,316,396,111
"44082","E01010004",2011,773,250,523,120
"44083","E01010005",2011,572,59,513,87
"44084","E01010006",2011,640,41,599,82
"44085","E01010007",2011,507,85,422,69
"44086","E01010008",2011,627,88,539,57
"44087","E01010009",2011,541,129,412,31
"44088","E01010010",2011,598,270,328,57
"44089","E01010011",2011,688,11,677,122
"44090","E01010012",2011,564,9,555,40
"44091","E01010013",2011,513,7,506,54
"44092","E01010014",2011,713,26,687,106
"44093","E01010015",2011,619,22,597,101
"44094","E01010016",2011,578,73,505,133
"44095","E01010017",2011,841,314,527,209
"44096","E01010018",2011,862,175,687,173
"44097","E01010019",2011,621,80,541,128
"44098","E01010020",2011,668,168,500,73
"44099","E01010021",2011,654,150,504,124
"44100","E01010022",2011,620,22,598,57
"44101","E01010023",2011,767,73,694,108
"44102","E01010024",2011,618,25,593,68
"44103","E01010025",2011,677,240,437,61
"44104","E01010026",2011,704,131,573,44
"44105","E01010027",2011,587,27,560,62
"44106","E01010028",2011,606,224,382,47
"44107","E01010029",2011,536,302,234,61
"44108","E01010030",2011,654,343,311,66
"44109","E01010031",2011,720,415,305,38
"44110","E01010032",2011,467,339,128,20
"44111","E01010033",2011,767,393,374,81
"44112","E01010034",2011,507,13,494,25
"44113","E01010035",2011,589,8,581,41
"44114","E01010036",2011,615,209,406,68
"44115","E01010037",2011,407,220,187,24
"44116","E01010038",2011,669,208,461,55
"44117","E01010039",2011,499,204,295,44
"44118","E01010040",2011,572,120,452,41
"44119","E01010041",2011,744,320,424,66
"44120","E01010042",2011,775,183,592,98
"44121","E01010043",2011,592,39,553,25
"44122","E01010044",2011,582,175,407,43
"44123","E01010045",2011,625,192,433,50
"44124","E01010046",2011,581,161,420,108
"44125","E01010047",2011,564,59,505,119
"44126","E01010048",2011,514,19,495,160
"44127","E01010049",2011,568,96,472,147
"44128","E01010050",2011,496,58,438,101
"44129","E01010051",2011,465,140,325,46
"44130","E01010052",2011,475,145,330,86
"44131","E01010053",2011,576,246,330,94
"44132","E01010054",2011,868,452,416,126
"44133","E01010055",2011,643,37,606,199
"44134","E01010056",2011,629,262,367,53
"44135","E01010057",2011,658,146,512,149
"44136","E01010058",2011,681,288,393,63
"44137","E01010059",2011,612,116,496,195
"44138","E01010060",2011,689,153,536,187
"44139","E01010061",2011,523,68,455,154
"44140","E01010062",2011,659,404,255,54
"44141","E01010063",2011,775,613,162,36
"44142","E01010064",2011,683,237,446,155
"44143","E01010065",2011,845,248,597,220
"44144","E01010066",2011,651,313,338,50
"44145","E01010067",2011,641,161,480,167
"44146","E01010068",2011,620,186,434,55
"44147","E01010069",2011,627,77,550,71
"44148","E01010070",2011,719,145,574,94
"44149","E01010071",2011,682,278,404,97
"44150","E01010072",2011,931,186,745,213
"44151","E01010073",2011,593,141,452,81
"44152","E01010074",2011,953,311,642,132
"44153","E01010075",2011,446,27,419,50
"44154","E01010076",2011,578,307,271,32
"44155","E01010077",2011,651,299,352,28
"44156","E01010078",2011,517,11,506,26
"44157","E01010079",2011,612,61,551,57
"44158","E01010080",2011,695,304,391,66
"44159","E01010081",2011,626,47,579,46
"44160","E01010082",2011,852,100,752,100
"44161","E01010083",2011,674,207,467,54
"44162","E01010084",2011,546,230,316,62
"44163","E01010085",2011,606,62,544,89
"44164","E01010086",2011,690,281,409,66
"44165","E01010087",2011,615,175,440,59
"44166","E01010088",2011,557,168,389,55
"44167","E01010089",2011,697,241,456,54
"44168","E01010090",2011,708,255,453,122
"44169","E01010091",2011,634,189,445,75
"44170","E01010092",2011,781,248,533,78
"44171","E01010093",2011,477,223,254,49
"44172","E01010094",2011,485,67,418,69
"44173","E01010095",2011,488,202,286,28
"44174","E01010096",2011,714,278,436,72
"44175","E01010097",2011,731,109,622,43
"44176","E01010098",2011,748,384,364,42
"44177","E01010099",2011,655,132,523,61
"44178","E01010100",2011,666,86,580,126
"44179","E01010101",2011,872,562,310,56
"44180","E01010102",2011,683,202,481,113
"44181","E01010103",2011,782,259,523,132
"44182","E01010104",2011,827,278,549,146
"44183","E01010105",2011,517,80,437,98
"44184","E01010106",2011,486,95,391,105
"44185","E01010107",2011,663,238,425,154
"44186","E01010108",2011,857,58,799,103
"44187","E01010109",2011,550,6,544,57
"44188","E01010110",2011,574,72,502,40
"44189","E01010111",2011,668,328,340,62
"44190","E01010112",2011,675,122,553,97
"44191","E01010113",2011,555,137,418,52
"44192","E01010114",2011,730,60,670,70
"44193","E01010115",2011,667,117,550,81
"44194","E01010116",2011,522,9,513,23
"44195","E01010117",2011,533,4,529,30
"44196","E01010118",2011,508,111,397,19
"44197","E01010119",2011,604,3,601,27
"44198","E01010120",2011,656,260,396,49
"44199","E01010121",2011,605,9,596,49
"44200","E01010122",2011,600,11,589,45
"44201","E01010123",2011,583,13,570,27
"44202","E01010124",2011,619,8,611,33
"44203","E01010125",2011,711,450,261,42
"44204","E01010126",2011,661,353,308,47
"44205","E01010127",2011,749,263,486,63
"44206","E01010128",2011,586,155,431,66
"44207","E01010129",2011,695,362,333,53
"44208","E01010130",2011,820,474,346,53
"44209","E01010131",2011,632,293,339,62
"44210","E01010132",2011,623,71,552,110
"44211","E01010133",2011,696,19,677,66
"44212","E01010134",2011,585,5,580,57
"44213","E01010135",2011,655,108,547,55
"44214","E01010136",2011,522,20,502,62
"44215","E01010137",2011,647,280,367,53
"44216","E01010138",2011,601,3,598,59
"44217","E01010139",2011,400,82,318,24
"44218","E01010140",2011,645,304,341,48
"44219","E01010141",2011,656,463,193,24
"44220","E01010142",2011,641,348,293,61
"44221","E01010143",2011,658,346,312,41
"44222","E01010144",2011,740,174,566,68
"44223","E01010145",2011,648,128,520,35
"44224","E01010146",2011,649,249,400,44
"44225","E01010147",2011,641,360,281,56
"44226","E01010148",2011,732,372,360,96
"44227","E01010149",2011,572,86,486,23
"44228","E01010150",2011,647,20,627,33
"44229","E01010151",2011,802,157,645,159
"44230","E01010152",2011,502,2,500,12
"44231","E01010153",2011,618,22,596,49
"44232","E01010154",2011,677,16,661,62
"44233","E01010155",2011,659,24,635,47
"44234","E01010156",2011,630,1,629,30
"44235","E01010157",2011,597,13,584,77
"44236","E01010158",2011,637,217,420,63
"44237","E01010159",2011,531,33,498,51
"44238","E01010160",2011,636,121,515,49
"44239","E01010161",2011,616,34,582,53
"44240","E01010162",2011,623,8,615,36
"44241","E01010163",2011,551,22,529,55
"44242","E01010164",2011,654,42,612,53
"44243","E01010165",2011,712,152,560,87
"44244","E01010166",2011,550,6,544,30
"44245","E01010167",2011,637,108,529,65
"44246","E01010168",2011,793,39,754,110
"44247","E01010169",2011,669,11,658,70
"44248","E01010170",2011,554,3,551,27
"44249","E01010171",2011,535,61,474,30
"44250","E01010172",2011,585,2,583,30
"44251","E01010173",2011,549,5,544,37
"44252","E01010174",2011,655,14,641,100
"44253","E01010175",2011,710,34,676,100
"44254","E01010176",2011,473,2,471,31
"44255","E01010177",2011,577,66,511,63
"44256","E01010178",2011,894,297,597,177
"44257","E01010179",2011,773,7,766,129
"44258","E01010180",2011,520,13,507,43
"44259","E01010181",2011,749,16,733,97
"44260","E01010183",2011,531,12,519,38
"44261","E01010184",2011,615,101,514,40
"44262","E01010185",2011,611,27,584,29
"44263","E01010186",2011,799,9,790,118
"44264","E01010187",2011,510,5,505,22
"44265","E01010188",2011,685,7,678,39
"44266","E01010189",2011,634,28,606,57
"44267","E01010190",2011,669,6,663,86
"44268","E01010191",2011,771,25,746,124
"44269","E01010192",2011,683,8,675,163
"44270","E01010193",2011,477,4,473,17
"44271","E01010194",2011,653,2,651,75
"44272","E01010195",2011,585,12,573,22
"44273","E01010196",2011,624,2,622,24
"44274","E01010197",2011,638,2,636,27
"44275","E01010198",2011,742,62,680,107
"44276","E01010199",2011,701,15,686,55
"44277","E01010200",2011,663,150,513,56
"44278","E01010201",2011,616,21,595,36
"44279","E01010202",2011,612,9,603,39
"44280","E01010203",2011,747,41,706,106
"44281","E01010204",2011,653,270,383,62
"44282","E01010205",2011,543,4,539,37
"44283","E01010206",2011,632,15,617,54
"44284","E01010207",2011,600,9,591,47
"44285","E01010208",2011,643,9,634,51
"44286","E01010209",2011,696,45,651,76
"44287","E01010210",2011,639,6,633,27
"44288","E01010211",2011,663,194,469,29
"44289","E01010212",2011,486,1,485,35
"44290","E01010213",2011,648,140,508,65
"44291","E01010214",2011,505,14,491,40
"44292","E01010215",2011,675,28,647,88
"44293","E01010216",2011,603,4,599,77
"44294","E01010217",2011,630,5,625,44
"44295","E01010218",2011,634,158,476,65
"44296","E01010219",2011,698,21,677,73
"44297","E01010220",2011,659,5,654,73
"44298","E01010221",2011,695,53,642,87
"44299","E01010222",2011,618,31,587,61
"44300","E01010223",2011,486,76,410,51
"44301","E01010225",2011,580,2,578,50
"44302","E01010226",2011,844,54,790,174
"44303","E01010227",2011,799,41,758,82
"44304","E01010228",2011,671,33,638,76
"44305","E01010229",2011,553,4,549,25
"44306","E01010230",2011,759,144,615,112
"44307","E01010231",2011,661,3,658,46
"44308","E01010232",2011,954,138,816,215
"44309","E01010233",2011,763,155,608,113
"44310","E01010234",2011,539,284,255,21
"44311","E01010235",2011,564,250,314,44
"44312","E01010236",2011,665,388,277,42
"44313","E01010237",2011,760,190,570,36
"44314","E01010238",2011,666,384,282,30
"44315","E01010239",2011,630,213,417,49
"44316","E01010240",2011,582,231,351,61
"44317","E01010241",2011,1039,64,975,171
"44318","E01010242",2011,801,292,509,58
"44319","E01010243",2011,688,45,643,37
"44320","E01010244",2011,633,234,399,68
"44321","E01010245",2011,649,26,623,34
"44322","E01010246",2011,623,21,602,34
"44323","E01010247",2011,701,91,610,50
"44324","E01010248",2011,649,6,643,37
"44325","E01010249",2011,737,158,579,132
"44326","E01010250",2011,584,57,527,47
"44327","E01010251",2011,517,5,512,25
"44328","E01010252",2011,745,185,560,92
"44329","E01010253",2011,536,182,354,18
"44330","E01010254",2011,617,161,456,62
"44331","E01010255",2011,614,15,599,30
"44332","E01010256",2011,668,101,567,79
"44333","E01010257",2011,514,6,508,28
"44334","E01010258",2011,727,415,312,41
"44335","E01010259",2011,647,114,533,53
"44336","E01010260",2011,674,238,436,42
"44337","E01010261",2011,658,244,414,92
"44338","E01010262",2011,652,182,470,79
"44339","E01010263",2011,507,74,433,87
"44340","E01010264",2011,637,225,412,84
"44341","E01010265",2011,641,229,412,120
"44342","E01010266",2011,511,236,275,29
"44343","E01010267",2011,715,121,594,99
"44344","E01010268",2011,579,106,473,135
"44345","E01010269",2011,530,115,415,145
"44346","E01010270",2011,674,187,487,78
"44347","E01010271",2011,687,321,366,82
"44348","E01010272",2011,727,391,336,115
"44349","E01010273",2011,627,347,280,48
"44350","E01010274",2011,605,323,282,50
"44351","E01010275",2011,641,321,320,58
"44352","E01010277",2011,618,169,449,91
"44353","E01010279",2011,708,283,425,88
"44354","E01010282",2011,513,141,372,88
"44355","E01010283",2011,692,257,435,147
"44356","E01010284",2011,667,238,429,46
"44357","E01010285",2011,737,96,641,56
"44358","E01010286",2011,649,312,337,37
"44359","E01010287",2011,637,186,451,111
"44360","E01010288",2011,630,251,379,82
"44361","E01010289",2011,621,309,312,60
"44362","E01010290",2011,782,272,510,41
"44363","E01010291",2011,548,201,347,56
"44364","E01010292",2011,832,443,389,96
"44365","E01010293",2011,728,299,429,49
"44366","E01010294",2011,667,309,358,65
"44367","E01010295",2011,615,239,376,82
"44368","E01010296",2011,596,15,581,68
"44369","E01010297",2011,587,9,578,18
"44370","E01010298",2011,486,94,392,38
"44371","E01010299",2011,604,214,390,67
"44372","E01010300",2011,653,289,364,64
"44373","E01010301",2011,631,272,359,51
"44374","E01010302",2011,638,182,456,47
"44375","E01010303",2011,604,73,531,60
"44376","E01010304",2011,732,91,641,56
"44377","E01010305",2011,523,149,374,40
"44378","E01010306",2011,779,58,721,133
"44379","E01010307",2011,675,55,620,39
"44380","E01010308",2011,591,283,308,42
"44381","E01010309",2011,739,215,524,144
"44382","E01010310",2011,608,190,418,60
"44383","E01010311",2011,715,307,408,67
"44384","E01010312",2011,709,261,448,83
"44385","E01010313",2011,548,210,338,53
"44386","E01010314",2011,641,293,348,50
"44387","E01010315",2011,575,230,345,49
"44388","E01010316",2011,635,338,297,58
"44389","E01010317",2011,674,6,668,60
"44390","E01010318",2011,770,382,388,129
"44391","E01010319",2011,485,14,471,29
"44392","E01010320",2011,594,172,422,32
"44393","E01010321",2011,636,149,487,55
"44394","E01010322",2011,676,150,526,57
"44395","E01010323",2011,623,143,480,45
"44396","E01010324",2011,659,101,558,90
"44397","E01010325",2011,695,71,624,130
"44398","E01010326",2011,583,10,573,73
"44399","E01010327",2011,561,41,520,153
"44400","E01010328",2011,534,1,533,22
"44401","E01010329",2011,651,6,645,28
"44402","E01010330",2011,635,50,585,179
"44403","E01010331",2011,631,1,630,31
"44404","E01010332",2011,653,7,646,58
"44405","E01010333",2011,646,51,595,45
"44406","E01010334",2011,568,2,566,27
"44407","E01010335",2011,643,244,399,100
"44408","E01010336",2011,532,92,440,105
"44409","E01010337",2011,547,99,448,57
"44410","E01010338",2011,545,117,428,86
"44411","E01010339",2011,522,39,483,59
"44412","E01010340",2011,563,240,323,113
"44413","E01010341",2011,481,99,382,88
"44414","E01010342",2011,508,68,440,185
"44415","E01010343",2011,467,124,343,104
"44416","E01010344",2011,599,183,416,118
"44417","E01010345",2011,482,37,445,20
"44418","E01010346",2011,525,5,520,19
"44419","E01010347",2011,642,297,345,38
"44420","E01010348",2011,623,113,510,65
"44421","E01010349",2011,612,156,456,68
"44422","E01010350",2011,570,56,514,39
"44423","E01010351",2011,743,98,645,63
"44424","E01010352",2011,664,30,634,38
"44425","E01010353",2011,674,141,533,49
"44426","E01010354",2011,656,121,535,50
"44427","E01010355",2011,612,52,560,20
"44428","E01010356",2011,621,4,617,35
"44429","E01010357",2011,770,43,727,33
"44430","E01010358",2011,624,31,593,49
"44431","E01010359",2011,647,18,629,67
"44432","E01010360",2011,614,5,609,57
"44433","E01010361",2011,556,17,539,117
"44434","E01010362",2011,623,196,427,90
"44435","E01010363",2011,758,252,506,232
"44436","E01010364",2011,505,134,371,103
"44437","E01010365",2011,589,322,267,71
"44438","E01010366",2011,664,264,400,124
"44439","E01010367",2011,622,135,487,137
"44440","E01010368",2011,1023,513,510,324
"44441","E01010369",2011,902,458,444,177
"44442","E01010370",2011,846,428,418,158
"44443","E01010371",2011,886,500,386,193
"44444","E01010372",2011,623,207,416,127
"44445","E01010373",2011,527,67,460,54
"44446","E01010374",2011,631,220,411,131
"44447","E01010375",2011,735,202,533,229
"44448","E01010376",2011,488,7,481,40
"44449","E01010377",2011,619,115,504,53
"44450","E01010378",2011,476,25,451,44
"44451","E01010379",2011,559,8,551,45
"44452","E01010380",2011,683,7,676,43
"44453","E01010381",2011,661,218,443,77
"44454","E01010382",2011,658,142,516,57
"44455","E01010383",2011,693,331,362,45
"44456","E01010384",2011,576,6,570,29
"44457","E01010385",2011,642,1,641,50
"44458","E01010386",2011,725,7,718,49
"44459","E01010387",2011,629,4,625,44
"44460","E01010388",2011,560,13,547,24
"44461","E01010389",2011,591,48,543,35
"44462","E01010390",2011,707,1,706,66
"44463","E01010391",2011,792,2,790,69
"44464","E01010392",2011,656,10,646,50
"44465","E01010393",2011,588,48,540,40
"44466","E01010394",2011,531,12,519,73
"44467","E01010395",2011,508,9,499,33
"44468","E01010396",2011,630,105,525,41
"44469","E01010397",2011,617,233,384,47
"44470","E01010398",2011,624,9,615,22
"44471","E01010399",2011,637,107,530,36
"44472","E01010400",2011,945,485,460,66
"44473","E01010401",2011,620,245,375,45
"44474","E01010402",2011,668,95,573,86
"44475","E01010403",2011,683,192,491,153
"44476","E01010404",2011,728,172,556,146
"44477","E01010405",2011,703,99,604,140
"44478","E01010406",2011,1090,344,746,290
"44479","E01010407",2011,628,154,474,44
"44480","E01010408",2011,649,152,497,155
"44481","E01010409",2011,632,212,420,47
"44482","E01010410",2011,793,400,393,66
"44483","E01010411",2011,633,228,405,37
"44484","E01010412",2011,826,284,542,109
"44485","E01010413",2011,727,381,346,49
"44486","E01010414",2011,960,543,417,109
"44487","E01010415",2011,596,254,342,79
"44488","E01010416",2011,702,290,412,130
"44489","E01010417",2011,729,369,360,39
"44490","E01010418",2011,580,17,563,53
"44491","E01010419",2011,576,178,398,63
"44492","E01010420",2011,515,164,351,43
"44493","E01010421",2011,605,322,283,37
"44494","E01010422",2011,643,123,520,74
"44495","E01010423",2011,660,314,346,67
"44496","E01010424",2011,616,17,599,73
"44497","E01010425",2011,530,118,412,56
"44498","E01010426",2011,530,95,435,90
"44499","E01010427",2011,535,17,518,109
"44500","E01010428",2011,508,103,405,192
"44501","E01010429",2011,453,77,376,93
"44502","E01010430",2011,669,157,512,135
"44503","E01010431",2011,477,3,474,34
"44504","E01010432",2011,507,30,477,48
"44505","E01010433",2011,430,151,279,119
"44506","E01010434",2011,733,102,631,122
"44507","E01010435",2011,548,238,310,85
"44508","E01010436",2011,611,21,590,20
"44509","E01010437",2011,487,10,477,26
"44510","E01010438",2011,632,90,542,51
"44511","E01010439",2011,538,179,359,34
"44512","E01010440",2011,710,377,333,49
"44513","E01010441",2011,557,226,331,30
"44514","E01010442",2011,512,163,349,71
"44515","E01010443",2011,659,374,285,56
"44516","E01010444",2011,594,144,450,57
"44517","E01010445",2011,502,268,234,41
"44518","E01010446",2011,709,194,515,78
"44519","E01010447",2011,863,353,510,118
"44520","E01010448",2011,709,280,429,67
"44521","E01010449",2011,921,249,672,172
"44522","E01010450",2011,760,386,374,84
"44523","E01010451",2011,594,96,498,125
"44524","E01010452",2011,700,330,370,66
"44525","E01010453",2011,726,313,413,106
"44526","E01010454",2011,623,226,397,99
"44527","E01010455",2011,846,480,366,98
"44528","E01010456",2011,499,380,119,21
"44529","E01010457",2011,660,112,548,43
"44530","E01010458",2011,785,288,497,51
"44531","E01010459",2011,624,68,556,78
"44532","E01010460",2011,641,60,581,77
"44533","E01010461",2011,616,12,604,49
"44534","E01010462",2011,639,327,312,32
"44535","E01010463",2011,728,207,521,245
"44536","E01010464",2011,844,521,323,118
"44537","E01010465",2011,600,73,527,158
"44538","E01010466",2011,558,79,479,209
"44539","E01010467",2011,628,43,585,220
"44540","E01010468",2011,591,98,493,52
"44541","E01010469",2011,598,27,571,89
"44542","E01010470",2011,624,186,438,143
"44543","E01010471",2011,858,510,348,138
"44544","E01010472",2011,781,344,437,138
"44545","E01010473",2011,1193,1023,170,39
"44546","E01010474",2011,613,206,407,57
"44547","E01010475",2011,654,98,556,113
"44548","E01010476",2011,872,428,444,136
"44549","E01010477",2011,701,204,497,138
"44550","E01010478",2011,518,163,355,168
"44551","E01010479",2011,576,132,444,81
"44552","E01010480",2011,486,63,423,75
"44553","E01010481",2011,539,276,263,42
"44554","E01010482",2011,503,343,160,19
"44555","E01010483",2011,496,385,111,24
"44556","E01010484",2011,506,333,173,25
"44557","E01010485",2011,624,223,401,133
"44558","E01010486",2011,635,447,188,46
"44559","E01010487",2011,611,10,601,60
"44560","E01010488",2011,631,104,527,40
"44561","E01010489",2011,659,166,493,52
"44562","E01010490",2011,941,630,311,49
"44563","E01010491",2011,627,159,468,67
"44564","E01010492",2011,510,8,502,30
"44565","E01010493",2011,623,77,546,62
"44566","E01010494",2011,601,18,583,34
"44567","E01010495",2011,790,266,524,61
"44568","E01010496",2011,646,290,356,70
"44569","E01010497",2011,468,11,457,33
"44570","E01010498",2011,648,27,621,86
"44571","E01010499",2011,519,40,479,66
"44572","E01010500",2011,482,203,279,53
"44573","E01010501",2011,604,167,437,47
"44574","E01010502",2011,512,15,497,54
"44575","E01010503",2011,606,197,409,103
"44576","E01010504",2011,517,20,497,56
"44577","E01010505",2011,511,6,505,57
"44578","E01010506",2011,888,122,766,420
"44579","E01010507",2011,638,6,632,59
"44580","E01010508",2011,708,236,472,281
"44581","E01010509",2011,742,232,510,80
"44582","E01010510",2011,779,53,726,324
"44583","E01010511",2011,604,148,456,175
"44584","E01010512",2011,632,67,565,221
"44585","E01010513",2011,638,40,598,49
"44586","E01010514",2011,651,6,645,74
"44587","E01010515",2011,669,14,655,84
"44588","E01010516",2011,529,6,523,41
"44589","E01010517",2011,622,104,518,43
"44590","E01010518",2011,629,51,578,38
"44591","E01010519",2011,539,39,500,93
"44592","E01010520",2011,664,6,658,69
"44593","E01010521",2011,1068,368,700,453
"44594","E01010522",2011,661,272,389,123
"44595","E01010523",2011,611,67,544,175
"44596","E01010524",2011,632,305,327,80
"44597","E01010525",2011,522,124,398,142
"44598","E01010526",2011,486,136,350,153
"44599","E01010527",2011,769,448,321,114
"44600","E01010528",2011,503,309,194,114
"44601","E01010529",2011,603,203,400,206
"44602","E01010530",2011,532,191,341,143
"44603","E01010531",2011,744,291,453,61
"44604","E01010532",2011,673,247,426,44
"44605","E01010533",2011,729,264,465,80
"44606","E01010534",2011,475,16,459,52
"44607","E01010535",2011,641,252,389,63
"44608","E01010536",2011,639,30,609,35
"44609","E01010537",2011,657,6,651,43
"44610","E01010538",2011,623,130,493,44
"44611","E01010539",2011,657,67,590,99
"44612","E01010540",2011,618,23,595,101
"44613","E01010541",2011,650,407,243,41
"44614","E01010542",2011,627,104,523,54
"44615","E01010543",2011,604,336,268,42
"44616","E01010544",2011,609,19,590,38
"44617","E01010545",2011,659,22,637,74
"44618","E01010546",2011,526,5,521,23
"44619","E01010547",2011,744,67,677,101
"44620","E01010548",2011,734,153,581,60
"44621","E01010549",2011,616,81,535,62
"44622","E01010550",2011,641,10,631,20
"44623","E01010551",2011,785,81,704,111
"44624","E01010552",2011,809,160,649,59
"44625","E01010553",2011,655,54,601,53
"44626","E01010554",2011,630,85,545,22
"44627","E01010555",2011,725,341,384,44
"44628","E01010556",2011,607,150,457,27
"44629","E01010557",2011,607,63,544,26
"44630","E01010558",2011,702,97,605,37
"44631","E01010559",2011,670,281,389,37
"44632","E01010560",2011,775,277,498,37
"44633","E01010561",2011,620,24,596,36
"44634","E01010562",2011,740,254,486,34
"44635","E01010563",2011,702,300,402,42
"44636","E01010564",2011,782,119,663,244
"44637","E01010565",2011,747,9,738,58
"44638","E01010566",2011,743,223,520,68
"44639","E01010567",2011,663,240,423,33
"44640","E01010568",2011,822,102,720,85
"44641","E01010569",2011,826,238,588,73
"44642","E01010570",2011,550,2,548,14
"44643","E01010571",2011,828,118,710,177
"44644","E01010572",2011,639,19,620,42
"44645","E01010573",2011,726,29,697,37
"44646","E01010574",2011,626,63,563,54
"44647","E01010575",2011,752,71,681,91
"44648","E01010576",2011,651,22,629,65
"44649","E01010577",2011,662,13,649,51
"44650","E01010578",2011,716,30,686,169
"44651","E01010579",2011,633,16,617,36
"44652","E01010580",2011,999,6,993,85
"44653","E01010581",2011,709,39,670,118
"44654","E01010582",2011,723,21,702,192
"44655","E01010583",2011,770,266,504,84
"44656","E01010584",2011,885,234,651,272
"44657","E01010585",2011,986,168,818,228
"44658","E01010586",2011,700,9,691,79
"44659","E01010587",2011,813,49,764,118
"44660","E01010588",2011,682,45,637,58
"44661","E01010589",2011,645,5,640,74
"44662","E01010590",2011,766,24,742,118
"44663","E01010591",2011,691,171,520,87
"44664","E01010592",2011,670,126,544,56
"44665","E01010593",2011,752,71,681,80
"44666","E01010594",2011,686,64,622,56
"44667","E01010595",2011,795,125,670,164
"44668","E01010596",2011,617,2,615,46
"44669","E01010597",2011,581,94,487,80
"44670","E01010598",2011,668,5,663,79
"44671","E01010599",2011,473,6,467,93
"44672","E01010600",2011,493,4,489,100
"44673","E01010601",2011,735,5,730,139
"44674","E01010602",2011,609,4,605,96
"44675","E01010603",2011,631,24,607,66
"44676","E01010604",2011,723,16,707,80
"44677","E01010605",2011,621,195,426,74
"44678","E01010606",2011,609,237,372,162
"44679","E01010607",2011,594,108,486,175
"44680","E01010608",2011,492,109,383,108
"44681","E01010609",2011,686,122,564,130
"44682","E01010610",2011,702,509,193,81
"44683","E01010611",2011,878,250,628,188
"44684","E01010612",2011,576,332,244,81
"44685","E01010613",2011,635,111,524,191
"44686","E01010614",2011,558,117,441,137
"44687","E01010615",2011,566,10,556,102
"44688","E01010616",2011,588,129,459,93
"44689","E01010617",2011,595,380,215,77
"44690","E01010618",2011,510,124,386,95
"44691","E01010619",2011,521,12,509,101
"44692","E01010620",2011,517,64,453,155
"44693","E01010621",2011,528,16,512,112
"44694","E01010622",2011,627,56,571,198
"44695","E01010623",2011,529,181,348,107
"44696","E01010624",2011,602,95,507,149
"44697","E01010625",2011,499,203,296,56
"44698","E01010626",2011,495,73,422,84
"44699","E01010627",2011,536,35,501,125
"44700","E01010628",2011,669,50,619,107
"44701","E01010629",2011,619,19,600,123
"44702","E01010630",2011,606,135,471,77
"44703","E01010631",2011,550,203,347,86
"44704","E01010632",2011,500,161,339,107
"44705","E01010633",2011,624,37,587,110
"44706","E01010634",2011,586,12,574,53
"44707","E01010635",2011,664,316,348,86
"44708","E01010636",2011,746,31,715,132
"44709","E01010637",2011,532,14,518,129
"44710","E01010638",2011,653,38,615,62
"44711","E01010639",2011,844,48,796,178
"44712","E01010640",2011,796,7,789,242
"44713","E01010641",2011,622,76,546,35
"44714","E01010642",2011,738,11,727,43
"44715","E01010643",2011,620,7,613,157
"44716","E01010644",2011,635,57,578,92
"44717","E01010645",2011,542,3,539,35
"44718","E01010646",2011,623,31,592,50
"44719","E01010647",2011,509,100,409,35
"44720","E01010648",2011,619,12,607,58
"44721","E01010649",2011,605,105,500,106
"44722","E01010650",2011,575,261,314,80
"44723","E01010651",2011,621,2,619,71
"44724","E01010652",2011,739,104,635,123
"44725","E01010653",2011,686,245,441,129
"44726","E01010654",2011,582,252,330,65
"44727","E01010655",2011,529,156,373,81
"44728","E01010656",2011,608,34,574,45
"44729","E01010657",2011,673,10,663,155
"44730","E01010658",2011,598,47,551,181
"44731","E01010659",2011,600,236,364,78
"44732","E01010662",2011,487,11,476,66
"44733","E01010663",2011,638,75,563,235
"44734","E01010664",2011,528,38,490,63
"44735","E01010665",2011,602,33,569,126
"44736","E01010666",2011,662,217,445,199
"44737","E01010667",2011,614,46,568,162
"44738","E01010668",2011,516,4,512,42
"44739","E01010669",2011,640,6,634,112
"44740","E01010670",2011,458,4,454,110
"44741","E01010671",2011,483,28,455,57
"44742","E01010672",2011,522,4,518,73
"44743","E01010673",2011,501,11,490,132
"44744","E01010674",2011,509,128,381,90
"44745","E01010675",2011,622,52,570,105
"44746","E01010676",2011,513,18,495,100
"44747","E01010677",2011,638,184,454,103
"44748","E01010678",2011,556,66,490,74
"44749","E01010679",2011,495,140,355,145
"44750","E01010680",2011,892,490,402,100
"44751","E01010681",2011,502,2,500,27
"44752","E01010682",2011,659,232,427,88
"44753","E01010683",2011,705,37,668,142
"44754","E01010684",2011,661,53,608,68
"44755","E01010685",2011,724,45,679,110
"44756","E01010686",2011,714,48,666,92
"44757","E01010687",2011,732,13,719,66
"44758","E01010688",2011,831,22,809,150
"44759","E01010689",2011,767,34,733,137
"44760","E01010690",2011,820,116,704,105
"44761","E01010691",2011,645,5,640,46
"44762","E01010692",2011,828,32,796,122
"44763","E01010693",2011,560,6,554,26
"44764","E01010694",2011,621,5,616,52
"44765","E01010695",2011,843,75,768,233
"44766","E01010696",2011,600,3,597,47
"44767","E01010697",2011,659,16,643,65
"44768","E01010698",2011,847,74,773,174
"44769","E01010699",2011,781,197,584,71
"44770","E01010700",2011,450,15,435,121
"44771","E01010701",2011,430,61,369,119
"44772","E01010702",2011,510,75,435,107
"44773","E01010703",2011,663,64,599,105
"44774","E01010704",2011,611,63,548,129
"44775","E01010705",2011,674,16,658,64
"44776","E01010706",2011,709,11,698,82
"44777","E01010707",2011,756,2,754,82
"44778","E01010708",2011,654,5,649,107
"44779","E01010709",2011,1054,14,1040,75
"44780","E01010710",2011,884,222,662,410
"44781","E01010711",2011,803,443,360,176
"44782","E01010712",2011,487,24,463,131
"44783","E01010713",2011,572,156,416,92
"44784","E01010714",2011,599,54,545,118
"44785","E01010715",2011,467,118,349,38
"44786","E01010716",2011,854,137,717,174
"44787","E01010717",2011,671,107,564,117
"44788","E01010718",2011,665,268,397,66
"44789","E01010719",2011,495,40,455,94
"44790","E01010720",2011,618,233,385,68
"44791","E01010721",2011,622,253,369,50
"44792","E01010722",2011,625,125,500,120
"44793","E01010723",2011,489,32,457,147
"44794","E01010724",2011,611,189,422,72
"44795","E01010725",2011,696,50,646,175
"44796","E01010726",2011,623,7,616,33
"44797","E01010727",2011,743,68,675,89
"44798","E01010728",2011,528,13,515,125
"44799","E01010729",2011,483,1,482,27
"44800","E01010730",2011,801,611,190,111
"44801","E01010731",2011,702,181,521,377
"44802","E01010732",2011,692,385,307,110
"44803","E01010733",2011,701,274,427,171
"44804","E01010734",2011,516,22,494,221
"44805","E01010735",2011,507,256,251,58
"44806","E01010736",2011,715,140,575,300
"44807","E01010737",2011,522,174,348,142
"44808","E01010738",2011,556,72,484,131
"44809","E01010739",2011,614,252,362,120
"44810","E01010740",2011,538,74,464,117
"44811","E01010741",2011,656,32,624,109
"44812","E01010742",2011,608,123,485,156
"44813","E01010743",2011,676,231,445,120
"44814","E01010744",2011,480,35,445,99
"44815","E01010745",2011,618,99,519,163
"44816","E01010746",2011,684,4,680,87
"44817","E01010747",2011,644,98,546,112
"44818","E01010748",2011,670,283,387,79
"44819","E01010749",2011,614,125,489,122
"44820","E01010750",2011,693,51,642,89
"44821","E01010751",2011,676,186,490,56
"44822","E01010752",2011,818,34,784,265
"44823","E01010753",2011,597,7,590,37
"44824","E01010754",2011,662,50,612,95
"44825","E01010755",2011,671,168,503,205
"44826","E01010756",2011,604,38,566,100
"44827","E01010758",2011,477,8,469,28
"44828","E01010759",2011,660,136,524,95
"44829","E01010760",2011,605,6,599,61
"44830","E01010761",2011,683,60,623,141
"44831","E01010762",2011,601,22,579,115
"44832","E01010763",2011,621,9,612,117
"44833","E01010764",2011,673,1,672,42
"44834","E01010765",2011,1067,193,874,156
"44835","E01010766",2011,538,2,536,43
"44836","E01010767",2011,633,135,498,30
"44837","E01010768",2011,637,4,633,45
"44838","E01010769",2011,730,57,673,131
"44839","E01010770",2011,619,2,617,30
"44840","E01010771",2011,478,8,470,25
"44841","E01010772",2011,501,19,482,13
"44842","E01010773",2011,619,29,590,54
"44843","E01010774",2011,736,48,688,91
"44844","E01010775",2011,697,5,692,53
"44845","E01010776",2011,677,172,505,53
"44846","E01010777",2011,730,375,355,79
"44847","E01010778",2011,755,164,591,158
"44848","E01010779",2011,640,157,483,77
"44849","E01010781",2011,574,88,486,103
"44850","E01010782",2011,882,298,584,260
"44851","E01010783",2011,664,77,587,79
"44852","E01010784",2011,760,105,655,180
"44853","E01010785",2011,807,70,737,257
"44854","E01010786",2011,548,12,536,49
"44855","E01010787",2011,696,49,647,69
"44856","E01010788",2011,585,17,568,132
"44857","E01010789",2011,665,62,603,145
"44858","E01010790",2011,597,3,594,40
"44859","E01010791",2011,523,11,512,87
"44860","E01010792",2011,570,60,510,140
"44861","E01010793",2011,549,20,529,148
"44862","E01010794",2011,775,101,674,99
"44863","E01010795",2011,754,25,729,120
"44864","E01010796",2011,687,171,516,105
"44865","E01010797",2011,540,3,537,56
"44866","E01010798",2011,692,55,637,155
"44867","E01010799",2011,649,101,548,111
"44868","E01010800",2011,710,402,308,70
"44869","E01010801",2011,616,19,597,115
"44870","E01010802",2011,632,235,397,76
"44871","E01010803",2011,538,18,520,150
"44872","E01010804",2011,485,5,480,78
"44873","E01010805",2011,473,10,463,85
"44874","E01010806",2011,486,81,405,88
"44875","E01010807",2011,742,187,555,263
"44876","E01010808",2011,539,20,519,114
"44877","E01010809",2011,481,7,474,103
"44878","E01010810",2011,531,24,507,104
"44879","E01010811",2011,552,18,534,187
"44880","E01010812",2011,642,106,536,232
"44881","E01010813",2011,531,134,397,97
"44882","E01010814",2011,797,129,668,237
"44883","E01010815",2011,873,145,728,189
"44884","E01010816",2011,758,21,737,82
"44885","E01010817",2011,881,348,533,156
"44886","E01010818",2011,691,27,664,104
"44887","E01010819",2011,651,416,235,63
"44888","E01010820",2011,604,384,220,54
"44889","E01010821",2011,812,425,387,82
"44890","E01010822",2011,549,238,311,73
"44891","E01010824",2011,720,380,340,175
"44892","E01010825",2011,522,15,507,78
"44893","E01010826",2011,521,252,269,63
"44894","E01010827",2011,526,15,511,94
"44895","E01010828",2011,742,158,584,193
"44896","E01010829",2011,602,80,522,176
"44897","E01010830",2011,631,62,569,194
"44898","E01010831",2011,558,46,512,217
"44899","E01010832",2011,462,50,412,69
"44900","E01010833",2011,523,143,380,176
"44901","E01010834",2011,676,45,631,485
"44902","E01010835",2011,780,9,771,265
"44903","E01010836",2011,524,13,511,270
"44904","E01010837",2011,515,12,503,112
"44905","E01010838",2011,492,20,472,187
"44906","E01010839",2011,491,46,445,224
"44907","E01010840",2011,501,151,350,77
"44908","E01010841",2011,471,154,317,76
"44909","E01010842",2011,595,250,345,100
"44910","E01010843",2011,453,95,358,73
"44911","E01010845",2011,848,358,490,123
"44912","E01010846",2011,849,95,754,155
"44913","E01010847",2011,674,16,658,135
"44914","E01010848",2011,650,31,619,104
"44915","E01010849",2011,605,9,596,66
"44916","E01010850",2011,507,197,310,72
"44917","E01010851",2011,662,14,648,105
"44918","E01010852",2011,663,31,632,125
"44919","E01010853",2011,506,7,499,74
"44920","E01010854",2011,828,47,781,174
"44921","E01010855",2011,752,53,699,117
"44922","E01010856",2011,763,19,744,237
"44923","E01010857",2011,697,16,681,74
"44924","E01010858",2011,694,22,672,108
"44925","E01010859",2011,681,8,673,34
"44926","E01010860",2011,667,10,657,106
"44927","E01010861",2011,742,7,735,80
"44928","E01010862",2011,712,49,663,110
"44929","E01010863",2011,618,1,617,60
"44930","E01010864",2011,526,129,397,64
"44931","E01010865",2011,709,33,676,106
"44932","E01010866",2011,607,4,603,110
"44933","E01010867",2011,581,105,476,92
"44934","E01010868",2011,700,221,479,112
"44935","E01010869",2011,742,88,654,141
"44936","E01010870",2011,684,90,594,64
"44937","E01010871",2011,756,37,719,186
"44938","E01010872",2011,656,245,411,75
"44939","E01010873",2011,509,24,485,41
"44940","E01010874",2011,512,211,301,74
"44941","E01010875",2011,779,14,765,63
"44942","E01010876",2011,684,11,673,60
"44943","E01010877",2011,772,57,715,205
"44944","E01010878",2011,896,122,774,296
"44945","E01010879",2011,824,111,713,102
"44946","E01010880",2011,713,384,329,78
"44947","E01010881",2011,718,110,608,77
"44948","E01010882",2011,649,136,513,53
"44949","E01010883",2011,644,7,637,56
"44950","E01010884",2011,770,160,610,75
"44951","E01010885",2011,654,25,629,123
"44952","E01010886",2011,509,96,413,79
"44953","E01010887",2011,710,14,696,115
"44954","E01010888",2011,794,44,750,213
"44955","E01010889",2011,887,446,441,153
"44956","E01010890",2011,843,129,714,273
"44957","E01010891",2011,808,294,514,95
"44958","E01010892",2011,738,58,680,66
"44959","E01010893",2011,618,77,541,96
"44960","E01010894",2011,730,46,684,233
"44961","E01010895",2011,653,198,455,42
"44962","E01010896",2011,665,18,647,73
"44963","E01010897",2011,749,63,686,105
"44964","E01010898",2011,800,74,726,189
"44965","E01010899",2011,574,66,508,52
"44966","E01010900",2011,662,5,657,47
"44967","E01010901",2011,717,29,688,87
"44968","E01010902",2011,656,169,487,105
"44969","E01010903",2011,724,114,610,48
"44970","E01010904",2011,593,2,591,55
"44971","E01010905",2011,760,15,745,80
"44972","E01010906",2011,593,20,573,42
"44973","E01010907",2011,598,9,589,95
"44974","E01010908",2011,952,56,896,196
"44975","E01010909",2011,713,107,606,121
"44976","E01010910",2011,573,204,369,39
"44977","E01010911",2011,711,11,700,67
"44978","E01010912",2011,688,240,448,59
"44979","E01010913",2011,550,15,535,19
"44980","E01010914",2011,784,180,604,121
"44981","E01010915",2011,576,57,519,69
"44982","E01010916",2011,578,183,395,74
"44983","E01010917",2011,862,18,844,149
"44984","E01010918",2011,725,47,678,74
"44985","E01010919",2011,772,232,540,94
"44986","E01010920",2011,726,25,701,132
"44987","E01010921",2011,720,169,551,102
"44988","E01010922",2011,808,28,780,156
"44989","E01010923",2011,795,102,693,199
"44990","E01010924",2011,643,430,213,47
"44991","E01010925",2011,575,183,392,79
"44992","E01010926",2011,439,227,212,69
"44993","E01010927",2011,692,14,678,64
"44994","E01010928",2011,616,289,327,63
"44995","E01010929",2011,901,62,839,260
"44996","E01010930",2011,737,156,581,168
"44997","E01010931",2011,613,94,519,59
"44998","E01010932",2011,679,2,677,89
"44999","E01010933",2011,701,28,673,117
"45000","E01010934",2011,911,53,858,170
"45001","E01010935",2011,691,4,687,77
"45002","E01010936",2011,814,55,759,73
"45003","E01010937",2011,685,39,646,80
"45004","E01010938",2011,613,288,325,74
"45005","E01010939",2011,712,10,702,64
"45006","E01010940",2011,637,95,542,96
"45007","E01010941",2011,522,188,334,41
"45008","E01010942",2011,773,186,587,183
"45009","E01010943",2011,603,332,271,67
"45010","E01010944",2011,595,254,341,79
"45011","E01010945",2011,671,75,596,57
"45012","E01010946",2011,566,25,541,22
"45013","E01010947",2011,639,8,631,62
"45014","E01010948",2011,640,131,509,50
"45015","E01010949",2011,741,55,686,199
"45016","E01010950",2011,687,132,555,170
"45017","E01010951",2011,664,35,629,121
"45018","E01010952",2011,716,87,629,106
"45019","E01010953",2011,598,32,566,80
"45020","E01010954",2011,958,30,928,149
"45021","E01010955",2011,606,53,553,70
"45022","E01010956",2011,685,74,611,90
"45023","E01010957",2011,640,12,628,69
"45024","E01010958",2011,671,334,337,45
"45025","E01010959",2011,717,165,552,80
"45026","E01010960",2011,472,42,430,155
"45027","E01010961",2011,532,29,503,143
"45028","E01010964",2011,585,259,326,124
"45029","E01010965",2011,512,279,233,41
"45030","E01010966",2011,517,165,352,103
"45031","E01010967",2011,786,340,446,182
"45032","E01010968",2011,767,21,746,178
"45033","E01010969",2011,742,20,722,157
"45034","E01010970",2011,872,31,841,206
"45035","E01010971",2011,820,7,813,124
"45036","E01010972",2011,666,33,633,92
"45037","E01010973",2011,777,121,656,72
"45038","E01010974",2011,614,149,465,117
"45039","E01010975",2011,745,188,557,51
"45040","E01010976",2011,779,65,714,64
"45041","E01010977",2011,674,12,662,73
"45042","E01010978",2011,572,90,482,98
"45043","E01010979",2011,838,310,528,252
"45044","E01010980",2011,676,79,597,169
"45045","E01010981",2011,691,44,647,232
"45046","E01010982",2011,597,24,573,86
"45047","E01010983",2011,742,76,666,244
"45048","E01010984",2011,579,17,562,149
"45049","E01010985",2011,630,110,520,101
"45050","E01010986",2011,772,136,636,154
"45051","E01010987",2011,767,87,680,120
"45052","E01010988",2011,648,225,423,47
"45053","E01010989",2011,738,90,648,202
"45054","E01010990",2011,728,99,629,87
"45055","E01010991",2011,681,35,646,91
"45056","E01010992",2011,773,69,704,179
"45057","E01010993",2011,735,176,559,120
"45058","E01010994",2011,1046,329,717,507
"45059","E01010995",2011,399,64,335,135
"45060","E01010996",2011,429,11,418,117
"45061","E01010997",2011,625,5,620,45
"45062","E01010998",2011,715,120,595,116
"45063","E01010999",2011,637,14,623,64
"45064","E01011000",2011,604,36,568,131
"45065","E01011001",2011,459,29,430,101
"45066","E01011002",2011,637,25,612,147
"45067","E01011003",2011,549,67,482,176
"45068","E01011004",2011,710,396,314,41
"45069","E01011005",2011,670,26,644,54
"45070","E01011006",2011,651,79,572,90
"45071","E01011007",2011,659,37,622,221
"45072","E01011008",2011,642,9,633,204
"45073","E01011009",2011,612,76,536,83
"45074","E01011010",2011,647,182,465,108
"45075","E01011011",2011,695,21,674,65
"45076","E01011012",2011,710,103,607,163
"45077","E01011013",2011,627,5,622,52
"45078","E01011014",2011,607,93,514,152
"45079","E01011015",2011,550,232,318,74
"45080","E01011016",2011,541,49,492,129
"45081","E01011017",2011,467,103,364,53
"45082","E01011018",2011,433,77,356,60
"45083","E01011019",2011,526,19,507,64
"45084","E01011020",2011,446,188,258,57
"45085","E01011021",2011,690,5,685,69
"45086","E01011022",2011,597,4,593,91
"45087","E01011023",2011,630,9,621,134
"45088","E01011024",2011,663,166,497,92
"45089","E01011025",2011,582,186,396,96
"45090","E01011026",2011,557,65,492,129
"45091","E01011027",2011,498,77,421,80
"45092","E01011028",2011,666,119,547,132
"45093","E01011029",2011,677,391,286,62
"45094","E01011030",2011,574,205,369,81
"45095","E01011031",2011,658,12,646,68
"45096","E01011032",2011,578,204,374,80
"45097","E01011033",2011,667,25,642,113
"45098","E01011034",2011,469,103,366,49
"45099","E01011035",2011,481,104,377,49
"45100","E01011036",2011,586,193,393,68
"45101","E01011037",2011,802,50,752,205
"45102","E01011038",2011,684,315,369,113
"45103","E01011039",2011,673,47,626,109
"45104","E01011040",2011,682,11,671,243
"45105","E01011041",2011,662,37,625,219
"45106","E01011042",2011,639,8,631,93
"45107","E01011043",2011,889,84,805,329
"45108","E01011044",2011,543,10,533,97
"45109","E01011045",2011,725,189,536,217
"45110","E01011046",2011,508,1,507,23
"45111","E01011047",2011,649,6,643,67
"45112","E01011048",2011,859,243,616,173
"45113","E01011049",2011,684,116,568,72
"45114","E01011050",2011,620,32,588,34
"45115","E01011051",2011,680,29,651,81
"45116","E01011052",2011,707,192,515,66
"45117","E01011053",2011,623,20,603,62
"45118","E01011054",2011,580,13,567,42
"45119","E01011055",2011,547,12,535,64
"45120","E01011056",2011,694,30,664,74
"45121","E01011057",2011,617,61,556,116
"45122","E01011058",2011,502,61,441,51
"45123","E01011059",2011,614,334,280,23
"45124","E01011060",2011,789,261,528,51
"45125","E01011061",2011,866,254,612,237
"45126","E01011062",2011,732,28,704,140
"45127","E01011063",2011,970,97,873,202
"45128","E01011064",2011,644,169,475,80
"45129","E01011065",2011,693,20,673,155
"45130","E01011066",2011,624,11,613,61
"45131","E01011067",2011,670,82,588,71
"45132","E01011068",2011,718,8,710,69
"45133","E01011069",2011,608,48,560,58
"45134","E01011070",2011,661,37,624,60
"45135","E01011071",2011,702,27,675,76
"45136","E01011072",2011,662,69,593,79
"45137","E01011073",2011,678,88,590,153
"45138","E01011074",2011,832,41,791,152
"45139","E01011075",2011,662,65,597,112
"45140","E01011076",2011,626,95,531,50
"45141","E01011077",2011,717,34,683,159
"45142","E01011078",2011,834,34,800,193
"45143","E01011079",2011,875,75,800,238
"45144","E01011080",2011,775,45,730,265
"45145","E01011081",2011,729,140,589,211
"45146","E01011082",2011,481,40,441,125
"45147","E01011083",2011,713,20,693,78
"45148","E01011084",2011,641,282,359,105
"45149","E01011085",2011,691,138,553,57
"45150","E01011086",2011,719,17,702,39
"45151","E01011087",2011,769,217,552,83
"45152","E01011088",2011,606,4,602,39
"45153","E01011089",2011,603,103,500,56
"45154","E01011090",2011,677,137,540,92
"45155","E01011091",2011,573,8,565,43
"45156","E01011092",2011,568,6,562,39
"45157","E01011093",2011,681,333,348,74
"45158","E01011094",2011,674,397,277,41
"45159","E01011095",2011,628,72,556,58
"45160","E01011096",2011,615,34,581,72
"45161","E01011097",2011,697,112,585,83
"45162","E01011098",2011,669,51,618,224
"45163","E01011099",2011,621,98,523,44
"45164","E01011100",2011,719,216,503,83
"45165","E01011101",2011,737,439,298,47
"45166","E01011102",2011,520,10,510,48
"45167","E01011103",2011,638,215,423,73
"45168","E01011104",2011,785,284,501,62
"45169","E01011105",2011,791,347,444,139
"45170","E01011106",2011,680,284,396,123
"45171","E01011107",2011,826,270,556,352
"45172","E01011108",2011,644,23,621,117
"45173","E01011109",2011,723,15,708,109
"45174","E01011110",2011,584,18,566,94
"45175","E01011111",2011,643,26,617,69
"45176","E01011112",2011,667,74,593,84
"45177","E01011113",2011,740,10,730,92
"45178","E01011114",2011,688,165,523,66
"45179","E01011115",2011,772,18,754,123
"45180","E01011116",2011,691,57,634,60
"45181","E01011117",2011,729,22,707,58
"45182","E01011118",2011,634,47,587,60
"45183","E01011119",2011,660,118,542,55
"45184","E01011120",2011,592,1,591,41
"45185","E01011121",2011,628,210,418,83
"45186","E01011122",2011,493,269,224,33
"45187","E01011123",2011,688,131,557,142
"45188","E01011124",2011,850,143,707,109
"45189","E01011125",2011,671,150,521,51
"45190","E01011126",2011,771,281,490,86
"45191","E01011127",2011,590,9,581,60
"45192","E01011128",2011,788,143,645,283
"45193","E01011129",2011,501,86,415,37
"45194","E01011130",2011,949,372,577,288
"45195","E01011132",2011,544,5,539,26
"45196","E01011133",2011,472,109,363,68
"45197","E01011134",2011,600,189,411,117
"45198","E01011136",2011,592,190,402,71
"45199","E01011137",2011,641,171,470,87
"45200","E01011138",2011,655,300,355,68
"45201","E01011139",2011,462,58,404,51
"45202","E01011140",2011,474,215,259,51
"45203","E01011141",2011,535,64,471,91
"45204","E01011142",2011,686,13,673,111
"45205","E01011143",2011,521,108,413,141
"45206","E01011144",2011,498,129,369,133
"45207","E01011145",2011,637,32,605,80
"45208","E01011146",2011,638,3,635,60
"45209","E01011147",2011,637,35,602,87
"45210","E01011148",2011,761,387,374,57
"45211","E01011149",2011,923,176,747,311
"45212","E01011150",2011,694,37,657,162
"45213","E01011151",2011,648,4,644,59
"45214","E01011152",2011,777,9,768,215
"45215","E01011153",2011,755,40,715,155
"45216","E01011154",2011,633,102,531,85
"45217","E01011155",2011,873,8,865,173
"45218","E01011156",2011,687,144,543,51
"45219","E01011157",2011,574,58,516,81
"45220","E01011158",2011,716,29,687,161
"45221","E01011159",2011,726,26,700,100
"45222","E01011160",2011,553,9,544,57
"45223","E01011161",2011,528,6,522,61
"45224","E01011162",2011,674,9,665,73
"45225","E01011163",2011,589,203,386,40
"45226","E01011164",2011,695,79,616,53
"45227","E01011165",2011,564,8,556,99
"45228","E01011166",2011,658,101,557,135
"45229","E01011167",2011,732,172,560,145
"45230","E01011168",2011,672,20,652,49
"45231","E01011169",2011,607,10,597,50
"45232","E01011170",2011,740,11,729,63
"45233","E01011171",2011,632,32,600,114
"45234","E01011172",2011,531,213,318,63
"45235","E01011173",2011,525,18,507,37
"45236","E01011174",2011,704,7,697,42
"45237","E01011175",2011,598,170,428,64
"45238","E01011176",2011,577,40,537,56
"45239","E01011177",2011,722,24,698,101
"45240","E01011178",2011,871,171,700,184
"45241","E01011179",2011,765,15,750,114
"45242","E01011180",2011,799,33,766,106
"45243","E01011181",2011,846,17,829,175
"45244","E01011182",2011,766,43,723,99
"45245","E01011183",2011,793,8,785,102
"45246","E01011184",2011,582,160,422,46
"45247","E01011185",2011,701,67,634,60
"45248","E01011186",2011,678,9,669,82
"45249","E01011187",2011,685,51,634,84
"45250","E01011188",2011,699,92,607,61
"45251","E01011189",2011,675,6,669,47
"45252","E01011190",2011,729,2,727,119
"45253","E01011191",2011,662,38,624,51
"45254","E01011192",2011,712,167,545,76
"45255","E01011193",2011,785,88,697,59
"45256","E01011194",2011,599,4,595,25
"45257","E01011195",2011,447,20,427,49
"45258","E01011196",2011,726,12,714,64
"45259","E01011197",2011,667,110,557,82
"45260","E01011198",2011,662,13,649,70
"45261","E01011199",2011,621,43,578,61
"45262","E01011200",2011,906,19,887,189
"45263","E01011201",2011,883,144,739,213
"45264","E01011202",2011,710,129,581,69
"45265","E01011203",2011,728,47,681,69
"45266","E01011204",2011,545,7,538,47
"45267","E01011205",2011,696,6,690,110
"45268","E01011206",2011,805,143,662,176
"45269","E01011207",2011,606,13,593,46
"45270","E01011208",2011,773,67,706,270
"45271","E01011209",2011,640,4,636,43
"45272","E01011210",2011,812,27,785,178
"45273","E01011211",2011,680,29,651,50
"45274","E01011212",2011,796,256,540,97
"45275","E01011213",2011,654,17,637,47
"45276","E01011214",2011,690,62,628,116
"45277","E01011215",2011,974,94,880,291
"45278","E01011216",2011,574,12,562,44
"45279","E01011217",2011,734,57,677,56
"45280","E01011218",2011,733,116,617,90
"45281","E01011219",2011,683,42,641,72
"45282","E01011220",2011,730,247,483,102
"45283","E01011221",2011,722,15,707,86
"45284","E01011222",2011,1003,265,738,203
"45285","E01011223",2011,726,249,477,134
"45286","E01011224",2011,750,257,493,121
"45287","E01011225",2011,733,195,538,224
"45288","E01011226",2011,649,40,609,56
"45289","E01011227",2011,842,430,412,69
"45290","E01011228",2011,642,75,567,67
"45291","E01011229",2011,936,342,594,376
"45292","E01011230",2011,559,53,506,176
"45293","E01011231",2011,751,27,724,224
"45294","E01011232",2011,675,185,490,164
"45295","E01011233",2011,647,19,628,106
"45296","E01011234",2011,703,228,475,97
"45297","E01011235",2011,869,265,604,332
"45298","E01011236",2011,779,139,640,452
"45299","E01011237",2011,647,75,572,184
"45300","E01011238",2011,751,79,672,285
"45301","E01011239",2011,691,70,621,174
"45302","E01011240",2011,757,95,662,180
"45303","E01011241",2011,646,27,619,73
"45304","E01011242",2011,676,207,469,55
"45305","E01011243",2011,727,24,703,88
"45306","E01011244",2011,830,70,760,118
"45307","E01011245",2011,634,91,543,100
"45308","E01011246",2011,621,262,359,59
"45309","E01011247",2011,648,23,625,95
"45310","E01011248",2011,679,194,485,85
"45311","E01011249",2011,659,188,471,56
"45312","E01011250",2011,846,202,644,200
"45313","E01011251",2011,703,335,368,89
"45314","E01011252",2011,487,15,472,41
"45315","E01011253",2011,513,209,304,39
"45316","E01011254",2011,646,24,622,48
"45317","E01011255",2011,625,301,324,50
"45318","E01011256",2011,607,246,361,46
"45319","E01011257",2011,498,9,489,43
"45320","E01011258",2011,414,7,407,55
"45321","E01011259",2011,583,213,370,74
"45322","E01011260",2011,533,121,412,70
"45323","E01011261",2011,444,121,323,51
"45324","E01011262",2011,536,184,352,63
"45325","E01011263",2011,627,70,557,77
"45326","E01011264",2011,565,108,457,27
"45327","E01011265",2011,748,76,672,177
"45328","E01011266",2011,893,84,809,120
"45329","E01011267",2011,666,208,458,59
"45330","E01011268",2011,615,271,344,47
"45331","E01011269",2011,735,179,556,104
"45332","E01011270",2011,649,4,645,25
"45333","E01011271",2011,903,38,865,77
"45334","E01011272",2011,571,7,564,36
"45335","E01011273",2011,700,69,631,106
"45336","E01011274",2011,680,345,335,96
"45337","E01011275",2011,602,95,507,62
"45338","E01011276",2011,611,28,583,96
"45339","E01011277",2011,607,28,579,68
"45340","E01011278",2011,716,9,707,94
"45341","E01011279",2011,573,77,496,50
"45342","E01011280",2011,715,17,698,64
"45343","E01011281",2011,824,225,599,181
"45344","E01011282",2011,610,180,430,104
"45345","E01011283",2011,538,282,256,32
"45346","E01011284",2011,878,160,718,435
"45347","E01011286",2011,538,56,482,61
"45348","E01011287",2011,599,94,505,72
"45349","E01011292",2011,823,450,373,172
"45350","E01011293",2011,743,239,504,195
"45351","E01011294",2011,462,193,269,83
"45352","E01011295",2011,686,241,445,89
"45353","E01011296",2011,771,48,723,47
"45354","E01011297",2011,632,80,552,75
"45355","E01011298",2011,675,182,493,120
"45356","E01011299",2011,947,112,835,148
"45357","E01011300",2011,614,178,436,26
"45358","E01011301",2011,547,13,534,22
"45359","E01011302",2011,619,5,614,33
"45360","E01011303",2011,486,87,399,30
"45361","E01011304",2011,699,201,498,68
"45362","E01011305",2011,634,27,607,58
"45363","E01011306",2011,544,8,536,27
"45364","E01011307",2011,610,135,475,45
"45365","E01011308",2011,655,112,543,49
"45366","E01011309",2011,654,68,586,61
"45367","E01011310",2011,716,99,617,79
"45368","E01011311",2011,463,10,453,38
"45369","E01011312",2011,669,216,453,283
"45370","E01011313",2011,649,25,624,199
"45371","E01011314",2011,674,23,651,205
"45372","E01011315",2011,646,90,556,118
"45373","E01011316",2011,720,181,539,305
"45374","E01011317",2011,856,489,367,67
"45375","E01011318",2011,637,383,254,53
"45376","E01011319",2011,624,46,578,130
"45377","E01011320",2011,679,18,661,114
"45378","E01011321",2011,637,341,296,46
"45379","E01011322",2011,673,118,555,63
"45380","E01011323",2011,576,145,431,42
"45381","E01011324",2011,510,346,164,54
"45382","E01011325",2011,653,180,473,63
"45383","E01011326",2011,575,272,303,45
"45384","E01011327",2011,624,209,415,95
"45385","E01011328",2011,665,233,432,59
"45386","E01011329",2011,662,27,635,72
"45387","E01011330",2011,556,115,441,46
"45388","E01011331",2011,591,86,505,105
"45389","E01011332",2011,558,228,330,45
"45390","E01011333",2011,559,144,415,42
"45391","E01011334",2011,598,112,486,134
"45392","E01011335",2011,792,103,689,163
"45393","E01011336",2011,777,317,460,81
"45394","E01011337",2011,469,305,164,35
"45395","E01011338",2011,740,654,86,30
"45396","E01011339",2011,823,509,314,51
"45397","E01011340",2011,693,372,321,63
"45398","E01011341",2011,637,231,406,64
"45399","E01011342",2011,569,339,230,53
"45400","E01011343",2011,807,227,580,77
"45401","E01011344",2011,824,190,634,361
"45402","E01011345",2011,627,313,314,66
"45403","E01011346",2011,821,525,296,44
"45404","E01011347",2011,776,227,549,287
"45405","E01011348",2011,636,329,307,99
"45406","E01011349",2011,962,598,364,78
"45407","E01011350",2011,713,31,682,139
"45408","E01011351",2011,878,72,806,248
"45409","E01011352",2011,887,118,769,395
"45410","E01011353",2011,822,17,805,157
"45411","E01011354",2011,624,393,231,47
"45412","E01011355",2011,576,254,322,55
"45413","E01011356",2011,897,170,727,234
"45414","E01011357",2011,880,563,317,108
"45415","E01011358",2011,695,327,368,59
"45416","E01011359",2011,745,167,578,195
"45417","E01011360",2011,722,192,530,153
"45418","E01011361",2011,1090,595,495,181
"45419","E01011362",2011,974,384,590,204
"45420","E01011363",2011,735,457,278,68
"45421","E01011364",2011,785,355,430,217
"45422","E01011366",2011,757,291,466,234
"45423","E01011368",2011,611,228,383,244
"45424","E01011369",2011,727,152,575,147
"45425","E01011370",2011,698,82,616,300
"45426","E01011371",2011,728,458,270,104
"45427","E01011372",2011,521,185,336,201
"45428","E01011373",2011,574,268,306,147
"45429","E01011374",2011,595,45,550,239
"45430","E01011375",2011,689,119,570,319
"45431","E01011376",2011,623,7,616,21
"45432","E01011377",2011,607,12,595,13
"45433","E01011378",2011,685,360,325,49
"45434","E01011379",2011,768,335,433,62
"45435","E01011380",2011,679,58,621,55
"45436","E01011381",2011,509,4,505,30
"45437","E01011382",2011,662,14,648,49
"45438","E01011383",2011,742,127,615,99
"45439","E01011384",2011,660,136,524,47
"45440","E01011385",2011,525,37,488,44
"45441","E01011386",2011,621,16,605,83
"45442","E01011388",2011,643,130,513,40
"45443","E01011390",2011,612,153,459,51
"45444","E01011391",2011,726,188,538,41
"45445","E01011392",2011,643,134,509,28
"45446","E01011393",2011,693,96,597,57
"45447","E01011394",2011,497,43,454,29
"45448","E01011395",2011,464,60,404,41
"45449","E01011396",2011,800,90,710,195
"45450","E01011397",2011,602,56,546,34
"45451","E01011398",2011,498,3,495,35
"45452","E01011399",2011,623,55,568,82
"45453","E01011400",2011,597,107,490,54
"45454","E01011401",2011,601,4,597,37
"45455","E01011402",2011,813,94,719,72
"45456","E01011403",2011,613,66,547,45
"45457","E01011404",2011,522,5,517,20
"45458","E01011405",2011,627,39,588,26
"45459","E01011406",2011,590,9,581,58
"45460","E01011407",2011,653,62,591,64
"45461","E01011408",2011,735,27,708,67
"45462","E01011409",2011,635,2,633,154
"45463","E01011410",2011,616,6,610,38
"45464","E01011411",2011,665,15,650,80
"45465","E01011412",2011,624,5,619,38
"45466","E01011413",2011,584,4,580,42
"45467","E01011414",2011,623,4,619,69
"45468","E01011415",2011,718,16,702,118
"45469","E01011416",2011,606,51,555,63
"45470","E01011417",2011,724,87,637,75
"45471","E01011418",2011,612,4,608,59
"45472","E01011419",2011,496,8,488,13
"45473","E01011420",2011,624,7,617,18
"45474","E01011421",2011,607,204,403,94
"45475","E01011422",2011,495,79,416,215
"45476","E01011423",2011,607,260,347,54
"45477","E01011424",2011,516,189,327,51
"45478","E01011425",2011,606,43,563,59
"45479","E01011426",2011,493,128,365,137
"45480","E01011427",2011,563,274,289,72
"45481","E01011428",2011,601,79,522,239
"45482","E01011429",2011,693,289,404,178
"45483","E01011430",2011,451,69,382,148
"45484","E01011431",2011,769,489,280,85
"45485","E01011432",2011,571,78,493,227
"45486","E01011433",2011,668,113,555,315
"45487","E01011434",2011,612,134,478,285
"45488","E01011435",2011,562,21,541,471
"45489","E01011440",2011,611,115,496,354
"45490","E01011441",2011,649,97,552,384
"45491","E01011442",2011,543,58,485,404
"45492","E01011443",2011,479,58,421,349
"45493","E01011444",2011,586,80,506,456
"45494","E01011445",2011,436,13,423,378
"45495","E01011446",2011,465,34,431,360
"45496","E01011447",2011,405,71,334,268
"45497","E01011448",2011,460,134,326,276
"45498","E01011449",2011,566,125,441,338
"45499","E01011450",2011,523,188,335,75
"45500","E01011451",2011,466,81,385,197
"45501","E01011452",2011,616,3,613,76
"45502","E01011453",2011,661,33,628,86
"45503","E01011454",2011,669,7,662,123
"45504","E01011455",2011,481,7,474,16
"45505","E01011456",2011,728,35,693,106
"45506","E01011457",2011,591,37,554,73
"45507","E01011458",2011,556,11,545,33
"45508","E01011459",2011,743,34,709,162
"45509","E01011460",2011,655,94,561,140
"45510","E01011461",2011,611,5,606,20
"45511","E01011462",2011,699,205,494,79
"45512","E01011463",2011,749,333,416,48
"45513","E01011464",2011,821,43,778,238
"45514","E01011465",2011,785,198,587,145
"45515","E01011466",2011,654,241,413,36
"45516","E01011467",2011,647,219,428,170
"45517","E01011468",2011,743,462,281,56
"45518","E01011469",2011,641,62,579,62
"45519","E01011470",2011,607,159,448,76
"45520","E01011471",2011,636,334,302,53
"45521","E01011472",2011,700,429,271,40
"45522","E01011473",2011,632,433,199,43
"45523","E01011474",2011,641,395,246,54
"45524","E01011475",2011,690,364,326,71
"45525","E01011476",2011,497,219,278,44
"45526","E01011477",2011,866,341,525,203
"45527","E01011478",2011,752,188,564,344
"45528","E01011479",2011,543,67,476,327
"45529","E01011480",2011,624,23,601,126
"45530","E01011481",2011,639,212,427,286
"45531","E01011482",2011,820,82,738,334
"45532","E01011483",2011,665,271,394,265
"45533","E01011484",2011,671,428,243,44
"45534","E01011485",2011,746,306,440,79
"45535","E01011488",2011,666,170,496,223
"45536","E01011489",2011,823,319,504,211
"45537","E01011490",2011,1178,123,1055,182
"45538","E01011491",2011,608,341,267,34
"45539","E01011492",2011,553,342,211,46
"45540","E01011493",2011,644,313,331,59
"45541","E01011494",2011,541,202,339,80
"45542","E01011496",2011,606,8,598,75
"45543","E01011497",2011,671,403,268,28
"45544","E01011499",2011,1053,192,861,133
"45545","E01011500",2011,689,85,604,52
"45546","E01011502",2011,595,202,393,44
"45547","E01011504",2011,749,428,321,44
"45548","E01011505",2011,658,101,557,68
"45549","E01011506",2011,513,3,510,81
"45550","E01011507",2011,660,11,649,62
"45551","E01011508",2011,463,6,457,57
"45552","E01011509",2011,637,35,602,73
"45553","E01011510",2011,865,555,310,50
"45554","E01011511",2011,529,60,469,90
"45555","E01011512",2011,654,37,617,164
"45556","E01011513",2011,936,97,839,166
"45557","E01011514",2011,632,26,606,105
"45558","E01011515",2011,652,11,641,198
"45559","E01011516",2011,644,8,636,60
"45560","E01011517",2011,731,143,588,92
"45561","E01011518",2011,957,111,846,145
"45562","E01011519",2011,648,187,461,46
"45563","E01011520",2011,654,30,624,71
"45564","E01011521",2011,908,55,853,136
"45565","E01011522",2011,589,10,579,62
"45566","E01011523",2011,771,115,656,100
"45567","E01011524",2011,540,17,523,64
"45568","E01011525",2011,702,31,671,109
"45569","E01011526",2011,489,5,484,33
"45570","E01011527",2011,772,7,765,92
"45571","E01011528",2011,622,39,583,52
"45572","E01011529",2011,580,143,437,48
"45573","E01011530",2011,651,29,622,121
"45574","E01011531",2011,676,17,659,33
"45575","E01011532",2011,710,248,462,75
"45576","E01011533",2011,687,105,582,167
"45577","E01011534",2011,684,43,641,147
"45578","E01011535",2011,658,15,643,60
"45579","E01011536",2011,660,34,626,35
"45580","E01011537",2011,947,113,834,140
"45581","E01011538",2011,662,178,484,85
"45582","E01011540",2011,641,247,394,41
"45583","E01011541",2011,1010,321,689,290
"45584","E01011545",2011,651,45,606,158
"45585","E01011546",2011,743,77,666,153
"45586","E01011547",2011,834,244,590,122
"45587","E01011548",2011,639,34,605,73
"45588","E01011549",2011,512,4,508,31
"45589","E01011550",2011,552,5,547,63
"45590","E01011551",2011,647,81,566,75
"45591","E01011552",2011,575,214,361,43
"45592","E01011553",2011,615,28,587,53
"45593","E01011554",2011,603,7,596,83
"45594","E01011555",2011,561,24,537,45
"45595","E01011556",2011,759,47,712,217
"45596","E01011557",2011,646,64,582,63
"45597","E01011558",2011,722,346,376,69
"45598","E01011559",2011,568,289,279,44
"45599","E01011560",2011,883,540,343,40
"45600","E01011561",2011,533,39,494,95
"45601","E01011562",2011,628,4,624,55
"45602","E01011563",2011,618,5,613,83
"45603","E01011564",2011,605,6,599,48
"45604","E01011565",2011,592,19,573,48
"45605","E01011566",2011,569,27,542,68
"45606","E01011567",2011,562,5,557,56
"45607","E01011568",2011,861,21,840,135
"45608","E01011569",2011,804,58,746,225
"45609","E01011570",2011,959,90,869,89
"45610","E01011571",2011,758,98,660,105
"45611","E01011572",2011,816,29,787,87
"45612","E01011573",2011,536,48,488,32
"45613","E01011574",2011,711,153,558,86
"45614","E01011576",2011,594,37,557,51
"45615","E01011578",2011,625,82,543,71
"45616","E01011579",2011,493,61,432,50
"45617","E01011580",2011,603,49,554,45
"45618","E01011581",2011,626,101,525,31
"45619","E01011582",2011,752,326,426,33
"45620","E01011583",2011,601,68,533,35
"45621","E01011584",2011,555,34,521,38
"45622","E01011585",2011,650,158,492,65
"45623","E01011586",2011,597,17,580,74
"45624","E01011587",2011,757,32,725,147
"45625","E01011588",2011,691,69,622,79
"45626","E01011589",2011,699,55,644,129
"45627","E01011590",2011,639,21,618,52
"45628","E01011591",2011,810,37,773,182
"45629","E01011592",2011,719,115,604,112
"45630","E01011593",2011,789,5,784,118
"45631","E01011594",2011,605,223,382,30
"45632","E01011595",2011,639,7,632,74
"45633","E01011596",2011,759,9,750,134
"45634","E01011597",2011,557,23,534,90
"45635","E01011598",2011,734,44,690,133
"45636","E01011599",2011,647,69,578,93
"45637","E01011600",2011,671,70,601,75
"45638","E01011601",2011,624,162,462,93
"45639","E01011602",2011,743,167,576,118
"45640","E01011603",2011,658,43,615,112
"45641","E01011604",2011,601,62,539,117
"45642","E01011605",2011,636,28,608,42
"45643","E01011606",2011,642,15,627,94
"45644","E01011607",2011,685,106,579,86
"45645","E01011608",2011,583,179,404,44
"45646","E01011609",2011,668,279,389,42
"45647","E01011610",2011,616,34,582,73
"45648","E01011611",2011,603,296,307,30
"45649","E01011612",2011,687,221,466,106
"45650","E01011613",2011,549,127,422,57
"45651","E01011614",2011,807,52,755,119
"45652","E01011615",2011,639,20,619,110
"45653","E01011616",2011,680,390,290,34
"45654","E01011617",2011,679,281,398,61
"45655","E01011618",2011,725,99,626,214
"45656","E01011620",2011,490,245,245,19
"45657","E01011621",2011,588,270,318,45
"45658","E01011622",2011,657,470,187,38
"45659","E01011623",2011,703,271,432,224
"45660","E01011624",2011,714,476,238,81
"45661","E01011625",2011,698,142,556,244
"45662","E01011626",2011,949,452,497,301
"45663","E01011627",2011,592,163,429,41
"45664","E01011628",2011,597,15,582,29
"45665","E01011629",2011,605,169,436,53
"45666","E01011630",2011,886,36,850,122
"45667","E01011632",2011,605,294,311,45
"45668","E01011633",2011,622,101,521,72
"45669","E01011634",2011,664,160,504,56
"45670","E01011635",2011,705,61,644,142
"45671","E01011636",2011,722,62,660,99
"45672","E01011637",2011,735,89,646,72
"45673","E01011638",2011,617,50,567,46
"45674","E01011639",2011,645,207,438,49
"45675","E01011641",2011,618,20,598,69
"45676","E01011642",2011,487,10,477,42
"45677","E01011643",2011,594,15,579,120
"45678","E01011644",2011,542,184,358,54
"45679","E01011645",2011,608,37,571,174
"45680","E01011646",2011,644,26,618,107
"45681","E01011647",2011,498,29,469,119
"45682","E01011648",2011,566,6,560,75
"45683","E01011649",2011,647,6,641,45
"45684","E01011650",2011,594,44,550,57
"45685","E01011651",2011,637,137,500,95
"45686","E01011652",2011,501,37,464,62
"45687","E01011653",2011,606,12,594,212
"45688","E01011654",2011,530,6,524,28
"45689","E01011655",2011,703,35,668,172
"45690","E01011656",2011,597,283,314,46
"45691","E01011657",2011,602,337,265,26
"45692","E01011658",2011,631,466,165,38
"45693","E01011659",2011,648,365,283,26
"45694","E01011660",2011,588,307,281,35
"45695","E01011661",2011,852,579,273,35
"45696","E01011662",2011,496,363,133,26
"45697","E01011663",2011,430,287,143,26
"45698","E01011664",2011,477,225,252,26
"45699","E01011665",2011,626,215,411,44
"45700","E01011666",2011,594,23,571,45
"45701","E01011667",2011,511,393,118,26
"45702","E01011668",2011,517,108,409,327
"45703","E01011669",2011,518,97,421,295
"45704","E01011670",2011,916,485,431,277
"45705","E01011671",2011,644,386,258,92
"45706","E01011673",2011,810,283,527,398
"45707","E01011677",2011,786,430,356,192
"45708","E01011678",2011,663,199,464,372
"45709","E01011681",2011,673,298,375,274
"45710","E01011684",2011,638,87,551,52
"45711","E01011685",2011,777,38,739,250
"45712","E01011686",2011,810,472,338,40
"45713","E01011687",2011,574,38,536,68
"45714","E01011688",2011,608,92,516,91
"45715","E01011689",2011,765,157,608,92
"45716","E01011690",2011,661,14,647,226
"45717","E01011691",2011,645,278,367,128
"45718","E01011692",2011,666,34,632,193
"45719","E01011693",2011,725,35,690,337
"45720","E01011694",2011,615,16,599,250
"45721","E01011695",2011,704,379,325,52
"45722","E01011696",2011,656,52,604,23
"45723","E01011697",2011,558,82,476,51
"45724","E01011698",2011,634,55,579,41
"45725","E01011699",2011,583,9,574,43
"45726","E01011700",2011,500,36,464,45
"45727","E01011701",2011,529,28,501,31
"45728","E01011702",2011,483,12,471,17
"45729","E01011703",2011,556,4,552,15
"45730","E01011704",2011,985,257,728,202
"45731","E01011705",2011,636,223,413,46
"45732","E01011706",2011,616,19,597,53
"45733","E01011707",2011,616,89,527,27
"45734","E01011708",2011,612,49,563,48
"45735","E01011709",2011,660,62,598,43
"45736","E01011710",2011,638,48,590,72
"45737","E01011711",2011,656,67,589,80
"45738","E01011712",2011,586,71,515,86
"45739","E01011713",2011,737,45,692,58
"45740","E01011714",2011,605,75,530,34
"45741","E01011715",2011,527,15,512,43
"45742","E01011716",2011,607,26,581,49
"45743","E01011717",2011,655,204,451,34
"45744","E01011718",2011,601,214,387,41
"45745","E01011719",2011,628,60,568,25
"45746","E01011720",2011,691,310,381,33
"45747","E01011721",2011,621,268,353,39
"45748","E01011722",2011,812,301,511,69
"45749","E01011723",2011,617,347,270,36
"45750","E01011724",2011,830,368,462,64
"45751","E01011725",2011,699,441,258,60
"45752","E01011726",2011,634,292,342,44
"45753","E01011727",2011,674,63,611,64
"45754","E01011728",2011,626,49,577,62
"45755","E01011729",2011,741,237,504,208
"45756","E01011730",2011,657,242,415,85
"45757","E01011731",2011,609,52,557,29
"45758","E01011732",2011,777,65,712,87
"45759","E01011733",2011,691,58,633,75
"45760","E01011734",2011,1011,40,971,180
"45761","E01011735",2011,738,380,358,50
"45762","E01011736",2011,648,77,571,48
"45763","E01011737",2011,760,190,570,152
"45764","E01011738",2011,632,62,570,60
"45765","E01011739",2011,699,356,343,43
"45766","E01011740",2011,660,350,310,40
"45767","E01011741",2011,636,93,543,32
"45768","E01011742",2011,716,315,401,46
"45769","E01011743",2011,597,14,583,15
"45770","E01011744",2011,669,22,647,35
"45771","E01011745",2011,697,409,288,41
"45772","E01011746",2011,564,309,255,37
"45773","E01011747",2011,726,407,319,43
"45774","E01011748",2011,656,54,602,66
"45775","E01011749",2011,969,65,904,243
"45776","E01011750",2011,603,332,271,34
"45777","E01011751",2011,517,8,509,41
"45778","E01011752",2011,722,57,665,144
"45779","E01011753",2011,627,43,584,111
"45780","E01011754",2011,630,196,434,41
"45781","E01011755",2011,677,12,665,54
"45782","E01011756",2011,758,391,367,81
"45783","E01011757",2011,744,201,543,56
"45784","E01011758",2011,614,164,450,78
"45785","E01011759",2011,831,367,464,55
"45786","E01011760",2011,795,37,758,230
"45787","E01011761",2011,792,78,714,102
"45788","E01011762",2011,737,23,714,178
"45789","E01011763",2011,744,271,473,74
"45790","E01011764",2011,714,269,445,78
"45791","E01011765",2011,640,123,517,49
"45792","E01011766",2011,584,117,467,41
"45793","E01011767",2011,740,60,680,51
"45794","E01011768",2011,583,20,563,60
"45795","E01011769",2011,930,59,871,153
"45796","E01011770",2011,795,180,615,69
"45797","E01011771",2011,615,295,320,37
"45798","E01011772",2011,692,56,636,97
"45799","E01011773",2011,609,6,603,29
"45800","E01011774",2011,590,101,489,37
"45801","E01011775",2011,1131,161,970,104
"45802","E01011776",2011,619,198,421,55
"45803","E01011777",2011,622,90,532,68
"45804","E01011778",2011,652,93,559,76
"45805","E01011779",2011,598,172,426,35
"45806","E01011780",2011,870,579,291,38
"45807","E01011781",2011,804,273,531,99
"45808","E01011782",2011,640,94,546,56
"45809","E01011783",2011,594,32,562,158
"45810","E01011784",2011,772,189,583,70
"45811","E01011785",2011,608,108,500,88
"45812","E01011786",2011,620,92,528,103
"45813","E01011787",2011,765,53,712,116
"45814","E01011788",2011,729,63,666,61
"45815","E01011789",2011,510,167,343,74
"45816","E01011790",2011,761,251,510,140
"45817","E01011791",2011,626,217,409,64
"45818","E01011792",2011,631,381,250,44
"45819","E01011793",2011,729,126,603,55
"45820","E01011794",2011,613,179,434,60
"45821","E01011795",2011,595,216,379,45
"45822","E01011796",2011,582,69,513,45
"45823","E01011797",2011,706,8,698,66
"45824","E01011798",2011,662,55,607,170
"45825","E01011799",2011,775,318,457,57
"45826","E01011800",2011,718,62,656,104
"45827","E01011801",2011,645,135,510,71
"45828","E01011802",2011,647,78,569,71
"45829","E01011803",2011,583,263,320,44
"45830","E01011804",2011,708,186,522,49
"45831","E01011805",2011,707,310,397,80
"45832","E01011806",2011,664,153,511,76
"45833","E01011807",2011,662,183,479,118
"45834","E01011808",2011,770,120,650,74
"45835","E01011809",2011,736,338,398,42
"45836","E01011810",2011,582,122,460,42
"45837","E01011811",2011,661,343,318,70
"45838","E01011812",2011,1010,22,988,102
"45839","E01011813",2011,700,321,379,46
"45840","E01011814",2011,803,379,424,65
"45841","E01011815",2011,685,222,463,64
"45842","E01011816",2011,630,333,297,41
"45843","E01011817",2011,557,203,354,34
"45844","E01011818",2011,592,96,496,45
"45845","E01011819",2011,717,57,660,184
"45846","E01011820",2011,636,76,560,76
"45847","E01011821",2011,599,167,432,24
"45848","E01011822",2011,636,64,572,114
"45849","E01011823",2011,619,90,529,88
"45850","E01011824",2011,620,282,338,62
"45851","E01011825",2011,771,66,705,143
"45852","E01011826",2011,590,49,541,40
"45853","E01011827",2011,526,46,480,28
"45854","E01011828",2011,631,32,599,153
"45855","E01011829",2011,613,39,574,76
"45856","E01011830",2011,660,194,466,74
"45857","E01011831",2011,776,223,553,111
"45858","E01011832",2011,621,182,439,60
"45859","E01011833",2011,667,93,574,58
"45860","E01011834",2011,613,147,466,73
"45861","E01011835",2011,640,7,633,64
"45862","E01011836",2011,576,67,509,68
"45863","E01011837",2011,613,180,433,55
"45864","E01011838",2011,1102,490,612,223
"45865","E01011839",2011,642,100,542,33
"45866","E01011840",2011,685,280,405,53
"45867","E01011841",2011,706,160,546,88
"45868","E01011842",2011,689,439,250,33
"45869","E01011843",2011,643,153,490,60
"45870","E01011844",2011,729,9,720,57
"45871","E01011845",2011,626,5,621,19
"45872","E01011846",2011,594,47,547,51
"45873","E01011847",2011,615,12,603,35
"45874","E01011848",2011,624,40,584,35
"45875","E01011849",2011,730,38,692,61
"45876","E01011850",2011,628,310,318,33
"45877","E01011851",2011,690,204,486,105
"45878","E01011852",2011,651,300,351,44
"45879","E01011853",2011,588,226,362,22
"45880","E01011854",2011,513,40,473,125
"45881","E01011855",2011,686,107,579,81
"45882","E01011856",2011,622,22,600,119
"45883","E01011857",2011,721,37,684,44
"45884","E01011858",2011,638,126,512,60
"45885","E01011859",2011,688,278,410,81
"45886","E01011860",2011,642,85,557,57
"45887","E01011861",2011,815,113,702,126
"45888","E01011862",2011,606,205,401,69
"45889","E01011863",2011,609,323,286,56
"45890","E01011864",2011,662,333,329,46
"45891","E01011865",2011,754,318,436,45
"45892","E01011866",2011,641,192,449,34
"45893","E01011867",2011,684,240,444,65
"45894","E01011868",2011,814,261,553,102
"45895","E01011869",2011,683,119,564,260
"45896","E01011870",2011,641,94,547,37
"45897","E01011871",2011,661,111,550,98
"45898","E01011872",2011,629,201,428,63
"45899","E01011873",2011,679,10,669,71
"45900","E01011874",2011,665,45,620,55
"45901","E01011875",2011,676,213,463,75
"45902","E01011876",2011,653,199,454,84
"45903","E01011877",2011,544,9,535,54
"45904","E01011878",2011,668,31,637,77
"45905","E01011879",2011,637,13,624,98
"45906","E01011880",2011,660,21,639,69
"45907","E01011881",2011,660,98,562,95
"45908","E01011882",2011,641,92,549,37
"45909","E01011883",2011,642,178,464,46
"45910","E01011884",2011,961,40,921,269
"45911","E01011885",2011,597,36,561,27
"45912","E01011886",2011,649,38,611,53
"45913","E01011887",2011,498,9,489,37
"45914","E01011888",2011,598,10,588,29
"45915","E01011889",2011,502,21,481,39
"45916","E01011890",2011,489,60,429,31
"45917","E01011891",2011,716,256,460,35
"45918","E01011892",2011,779,232,547,81
"45919","E01011893",2011,574,4,570,53
"45920","E01011894",2011,543,13,530,43
"45921","E01011895",2011,587,92,495,40
"45922","E01011896",2011,627,134,493,56
"45923","E01011897",2011,698,307,391,64
"45924","E01011898",2011,717,116,601,262
"45925","E01011899",2011,542,314,228,21
"45926","E01011900",2011,752,416,336,43
"45927","E01011901",2011,584,438,146,27
"45928","E01011902",2011,674,100,574,105
"45929","E01011903",2011,617,168,449,32
"45930","E01011904",2011,500,343,157,20
"45931","E01011905",2011,684,11,673,52
"45932","E01011906",2011,672,488,184,37
"45933","E01011907",2011,875,242,633,183
"45934","E01011908",2011,934,83,851,301
"45935","E01011909",2011,595,120,475,52
"45936","E01011910",2011,730,488,242,34
"45937","E01011911",2011,629,367,262,39
"45938","E01011912",2011,687,220,467,214
"45939","E01011913",2011,546,104,442,150
"45940","E01011914",2011,667,337,330,35
"45941","E01011915",2011,631,204,427,160
"45942","E01011916",2011,1205,630,575,404
"45943","E01011917",2011,699,288,411,169
"45944","E01011918",2011,634,323,311,32
"45945","E01011919",2011,832,238,594,135
"45946","E01011920",2011,702,78,624,276
"45947","E01011921",2011,608,120,488,52
"45948","E01011922",2011,639,400,239,34
"45949","E01011923",2011,714,15,699,194
"45950","E01011924",2011,655,46,609,99
"45951","E01011925",2011,667,359,308,73
"45952","E01011926",2011,645,254,391,110
"45953","E01011927",2011,568,215,353,48
"45954","E01011928",2011,625,197,428,47
"45955","E01011929",2011,746,8,738,63
"45956","E01011930",2011,713,11,702,80
"45957","E01011931",2011,637,96,541,45
"45958","E01011932",2011,607,14,593,65
"45959","E01011933",2011,657,60,597,69
"45960","E01011934",2011,621,19,602,71
"45961","E01011935",2011,756,29,727,99
"45962","E01011936",2011,659,336,323,39
"45963","E01011937",2011,606,5,601,63
"45964","E01011938",2011,570,17,553,64
"45965","E01011939",2011,639,4,635,31
"45966","E01011940",2011,614,265,349,27
"45967","E01011941",2011,646,151,495,30
"45968","E01011942",2011,554,34,520,33
"45969","E01011943",2011,806,397,409,45
"45970","E01011944",2011,589,67,522,148
"45971","E01011945",2011,648,74,574,54
"45972","E01011946",2011,617,8,609,42
"45973","E01011947",2011,670,11,659,32
"45974","E01011948",2011,665,4,661,25
"45975","E01011949",2011,785,213,572,96
"45976","E01011950",2011,771,43,728,357
"45977","E01011951",2011,694,38,656,310
"45978","E01011952",2011,690,338,352,70
"45979","E01011953",2011,803,471,332,71
"45980","E01011954",2011,948,274,674,95
"45981","E01011955",2011,601,233,368,97
"45982","E01011957",2011,570,111,459,116
"45983","E01011959",2011,830,57,773,92
"45984","E01011960",2011,616,5,611,21
"45985","E01011961",2011,629,191,438,57
"45986","E01011962",2011,613,234,379,46
"45987","E01011963",2011,660,18,642,36
"45988","E01011964",2011,535,58,477,105
"45989","E01011965",2011,635,7,628,24
"45990","E01011966",2011,641,72,569,102
"45991","E01011967",2011,548,22,526,69
"45992","E01011968",2011,952,153,799,88
"45993","E01011969",2011,601,18,583,27
"45994","E01011970",2011,458,4,454,25
"45995","E01011971",2011,526,4,522,29
"45996","E01011973",2011,661,152,509,314
"45997","E01011974",2011,933,206,727,512
"45998","E01011975",2011,681,15,666,213
"45999","E01011976",2011,490,72,418,172
"46000","E01011977",2011,748,346,402,86
"46001","E01011978",2011,774,440,334,114
"46002","E01011979",2011,635,274,361,70
"46003","E01011980",2011,812,356,456,63
"46004","E01011981",2011,709,327,382,57
"46005","E01011982",2011,543,3,540,18
"46006","E01011983",2011,629,8,621,41
"46007","E01011984",2011,581,22,559,30
"46008","E01011985",2011,503,17,486,77
"46009","E01011986",2011,531,52,479,42
"46010","E01011987",2011,642,20,622,145
"46011","E01011988",2011,862,310,552,51
"46012","E01011989",2011,835,400,435,66
"46013","E01011990",2011,724,106,618,71
"46014","E01011991",2011,810,196,614,118
"46015","E01011992",2011,712,286,426,141
"46016","E01011993",2011,854,413,441,104
"46017","E01011994",2011,684,443,241,54
"46018","E01011995",2011,581,4,577,37
"46019","E01011996",2011,664,52,612,88
"46020","E01011997",2011,816,57,759,36
"46021","E01011998",2011,637,102,535,46
"46022","E01011999",2011,959,150,809,432
"46023","E01012000",2011,796,505,291,143
"46024","E01012001",2011,913,381,532,176
"46025","E01012002",2011,607,52,555,71
"46026","E01012003",2011,668,3,665,44
"46027","E01012005",2011,717,22,695,25
"46028","E01012007",2011,665,10,655,60
"46029","E01012008",2011,535,22,513,36
"46030","E01012009",2011,760,7,753,133
"46031","E01012010",2011,538,2,536,36
"46032","E01012011",2011,770,433,337,45
"46033","E01012012",2011,633,32,601,63
"46034","E01012013",2011,547,113,434,75
"46035","E01012014",2011,617,220,397,94
"46036","E01012015",2011,710,353,357,35
"46037","E01012016",2011,793,357,436,109
"46038","E01012017",2011,727,103,624,115
"46039","E01012018",2011,676,164,512,204
"46040","E01012019",2011,583,482,101,26
"46041","E01012020",2011,623,244,379,66
"46042","E01012021",2011,544,277,267,63
"46043","E01012022",2011,631,33,598,54
"46044","E01012023",2011,691,5,686,45
"46045","E01012024",2011,643,5,638,69
"46046","E01012025",2011,517,3,514,26
"46047","E01012026",2011,618,37,581,80
"46048","E01012027",2011,799,379,420,96
"46049","E01012030",2011,625,86,539,31
"46050","E01012031",2011,771,314,457,56
"46051","E01012032",2011,612,37,575,35
"46052","E01012033",2011,647,371,276,37
"46053","E01012034",2011,548,176,372,30
"46054","E01012035",2011,624,238,386,65
"46055","E01012036",2011,608,47,561,343
"46056","E01012037",2011,687,95,592,315
"46057","E01012038",2011,661,31,630,335
"46058","E01012039",2011,625,62,563,394
"46059","E01012040",2011,626,54,572,337
"46060","E01012041",2011,613,391,222,89
"46061","E01012042",2011,730,363,367,60
"46062","E01012043",2011,625,66,559,42
"46063","E01012044",2011,637,439,198,51
"46064","E01012045",2011,603,349,254,63
"46065","E01012046",2011,815,8,807,94
"46066","E01012047",2011,582,36,546,39
"46067","E01012048",2011,721,7,714,33
"46068","E01012049",2011,637,29,608,66
"46069","E01012050",2011,630,198,432,98
"46070","E01012051",2011,534,167,367,81
"46071","E01012052",2011,542,59,483,36
"46072","E01012053",2011,621,9,612,65
"46073","E01012054",2011,618,7,611,91
"46074","E01012055",2011,734,10,724,125
"46075","E01012056",2011,987,67,920,306
"46076","E01012057",2011,759,37,722,153
"46077","E01012058",2011,774,76,698,363
"46078","E01012059",2011,724,206,518,210
"46079","E01012060",2011,698,339,359,90
"46080","E01012061",2011,619,256,363,81
"46081","E01012062",2011,614,1,613,30
"46082","E01012063",2011,638,35,603,39
"46083","E01012064",2011,776,34,742,131
"46084","E01012065",2011,761,30,731,72
"46085","E01012066",2011,715,5,710,46
"46086","E01012067",2011,729,40,689,35
"46087","E01012068",2011,804,156,648,483
"46088","E01012071",2011,574,1,573,14
"46089","E01012073",2011,597,5,592,39
"46090","E01012074",2011,634,180,454,66
"46091","E01012075",2011,621,246,375,79
"46092","E01012076",2011,615,347,268,69
"46093","E01012077",2011,604,241,363,50
"46094","E01012078",2011,654,62,592,277
"46095","E01012079",2011,503,29,474,61
"46096","E01012080",2011,503,40,463,87
"46097","E01012081",2011,679,49,630,176
"46098","E01012082",2011,629,212,417,59
"46099","E01012083",2011,620,243,377,70
"46100","E01012084",2011,698,351,347,87
"46101","E01012085",2011,584,247,337,58
"46102","E01012088",2011,531,250,281,55
"46103","E01012089",2011,602,328,274,58
"46104","E01012090",2011,718,493,225,54
"46105","E01012091",2011,630,353,277,56
"46106","E01012092",2011,625,202,423,239
"46107","E01012093",2011,711,76,635,383
"46108","E01012094",2011,956,183,773,355
"46109","E01012095",2011,543,9,534,31
"46110","E01012096",2011,707,102,605,177
"46111","E01012097",2011,512,84,428,27
"46112","E01012098",2011,553,52,501,62
"46113","E01012099",2011,683,171,512,163
"46114","E01012100",2011,883,98,785,491
"46115","E01012101",2011,713,59,654,203
"46116","E01012102",2011,1038,26,1012,371
"46117","E01012105",2011,567,94,473,63
"46118","E01012106",2011,604,52,552,40
"46119","E01012107",2011,666,304,362,69
"46120","E01012108",2011,618,219,399,65
"46121","E01012109",2011,605,57,548,93
"46122","E01012110",2011,622,12,610,103
"46123","E01012111",2011,642,287,355,72
"46124","E01012112",2011,783,492,291,65
"46125","E01012113",2011,558,334,224,54
"46126","E01012114",2011,648,400,248,102
"46127","E01012117",2011,782,228,554,209
"46128","E01012118",2011,656,24,632,130
"46129","E01012119",2011,880,229,651,120
"46130","E01012120",2011,631,18,613,69
"46131","E01012121",2011,615,285,330,57
"46132","E01012124",2011,620,4,616,22
"46133","E01012127",2011,517,414,103,22
"46134","E01012128",2011,542,314,228,48
"46135","E01012129",2011,854,157,697,48
"46136","E01012130",2011,588,40,548,55
"46137","E01012131",2011,652,376,276,38
"46138","E01012132",2011,922,258,664,117
"46139","E01012134",2011,697,196,501,78
"46140","E01012136",2011,637,52,585,153
"46141","E01012137",2011,549,61,488,55
"46142","E01012138",2011,1026,26,1000,69
"46143","E01012139",2011,781,5,776,30
"46144","E01012140",2011,617,66,551,107
"46145","E01012141",2011,490,5,485,33
"46146","E01012142",2011,724,152,572,66
"46147","E01012143",2011,529,344,185,37
"46148","E01012144",2011,612,44,568,56
"46149","E01012145",2011,670,119,551,95
"46150","E01012146",2011,516,12,504,25
"46151","E01012147",2011,670,27,643,29
"46152","E01012148",2011,672,345,327,60
"46153","E01012149",2011,497,13,484,25
"46154","E01012150",2011,711,277,434,86
"46155","E01012151",2011,650,13,637,41
"46156","E01012152",2011,684,14,670,47
"46157","E01012154",2011,591,6,585,46
"46158","E01012155",2011,768,263,505,75
"46159","E01012156",2011,738,10,728,34
"46160","E01012157",2011,761,109,652,125
"46161","E01012158",2011,647,36,611,35
"46162","E01012159",2011,955,198,757,342
"46163","E01012160",2011,606,118,488,50
"46164","E01012161",2011,657,33,624,158
"46165","E01012162",2011,624,20,604,129
"46166","E01012163",2011,832,19,813,73
"46167","E01012164",2011,748,66,682,164
"46168","E01012165",2011,985,424,561,128
"46169","E01012167",2011,590,66,524,59
"46170","E01012168",2011,819,279,540,67
"46171","E01012170",2011,568,337,231,46
"46172","E01012171",2011,660,193,467,59
"46173","E01012172",2011,625,47,578,39
"46174","E01012173",2011,518,24,494,47
"46175","E01012174",2011,481,10,471,21
"46176","E01012175",2011,636,371,265,52
"46177","E01012176",2011,661,3,658,50
"46178","E01012177",2011,615,3,612,56
"46179","E01012178",2011,605,22,583,56
"46180","E01012179",2011,635,4,631,48
"46181","E01012180",2011,613,5,608,45
"46182","E01012181",2011,713,125,588,113
"46183","E01012182",2011,598,0,598,33
"46184","E01012183",2011,620,2,618,42
"46185","E01012184",2011,636,47,589,107
"46186","E01012185",2011,633,106,527,87
"46187","E01012186",2011,748,13,735,78
"46188","E01012187",2011,538,4,534,51
"46189","E01012188",2011,491,1,490,30
"46190","E01012189",2011,631,4,627,38
"46191","E01012190",2011,632,7,625,42
"46192","E01012191",2011,713,134,579,49
"46193","E01012192",2011,748,98,650,93
"46194","E01012193",2011,605,117,488,106
"46195","E01012194",2011,647,73,574,143
"46196","E01012195",2011,684,438,246,79
"46197","E01012196",2011,674,133,541,72
"46198","E01012197",2011,809,80,729,219
"46199","E01012198",2011,610,266,344,93
"46200","E01012199",2011,614,11,603,34
"46201","E01012200",2011,889,60,829,143
"46202","E01012201",2011,737,1,736,43
"46203","E01012202",2011,624,55,569,111
"46204","E01012203",2011,687,25,662,51
"46205","E01012204",2011,625,19,606,26
"46206","E01012205",2011,634,67,567,56
"46207","E01012206",2011,716,196,520,51
"46208","E01012207",2011,782,87,695,58
"46209","E01012208",2011,642,9,633,21
"46210","E01012209",2011,676,86,590,50
"46211","E01012210",2011,640,4,636,40
"46212","E01012211",2011,750,7,743,48
"46213","E01012212",2011,683,11,672,47
"46214","E01012213",2011,735,99,636,57
"46215","E01012214",2011,643,87,556,97
"46216","E01012215",2011,498,186,312,71
"46217","E01012216",2011,519,124,395,76
"46218","E01012217",2011,750,226,524,198
"46219","E01012218",2011,615,6,609,71
"46220","E01012219",2011,693,67,626,57
"46221","E01012223",2011,629,17,612,38
"46222","E01012224",2011,769,4,765,53
"46223","E01012225",2011,647,6,641,37
"46224","E01012226",2011,600,2,598,27
"46225","E01012227",2011,590,19,571,112
"46226","E01012228",2011,529,5,524,39
"46227","E01012230",2011,599,3,596,83
"46228","E01012231",2011,685,4,681,65
"46229","E01012232",2011,545,2,543,46
"46230","E01012233",2011,564,8,556,31
"46231","E01012234",2011,580,1,579,45
"46232","E01012235",2011,461,2,459,43
"46233","E01012236",2011,538,2,536,65
"46234","E01012237",2011,496,2,494,27
"46235","E01012238",2011,641,266,375,60
"46236","E01012239",2011,783,299,484,94
"46237","E01012240",2011,763,194,569,70
"46238","E01012241",2011,611,14,597,53
"46239","E01012242",2011,627,13,614,35
"46240","E01012243",2011,665,3,662,72
"46241","E01012244",2011,620,3,617,46
"46242","E01012245",2011,729,308,421,85
"46243","E01012246",2011,574,1,573,55
"46244","E01012247",2011,508,166,342,47
"46245","E01012248",2011,647,227,420,54
"46246","E01012249",2011,640,220,420,68
"46247","E01012250",2011,635,331,304,44
"46248","E01012251",2011,648,112,536,162
"46249","E01012252",2011,634,400,234,76
"46250","E01012253",2011,484,107,377,52
"46251","E01012254",2011,644,200,444,196
"46252","E01012255",2011,646,3,643,21
"46253","E01012256",2011,630,39,591,66
"46254","E01012257",2011,632,8,624,37
"46255","E01012258",2011,529,181,348,87
"46256","E01012259",2011,776,39,737,134
"46257","E01012260",2011,814,58,756,166
"46258","E01012261",2011,703,9,694,125
"46259","E01012262",2011,810,209,601,275
"46260","E01012264",2011,1036,161,875,259
"46261","E01012266",2011,1149,806,343,136
"46262","E01012267",2011,855,404,451,192
"46263","E01012268",2011,755,218,537,190
"46264","E01012269",2011,668,20,648,47
"46265","E01012270",2011,586,54,532,77
"46266","E01012271",2011,575,240,335,68
"46267","E01012272",2011,493,14,479,34
"46268","E01012273",2011,642,280,362,74
"46269","E01012274",2011,500,155,345,58
"46270","E01012275",2011,625,171,454,74
"46271","E01012276",2011,839,350,489,71
"46272","E01012277",2011,704,121,583,92
"46273","E01012278",2011,501,123,378,63
"46274","E01012279",2011,637,27,610,119
"46275","E01012280",2011,649,110,539,100
"46276","E01012281",2011,642,264,378,85
"46277","E01012282",2011,539,123,416,65
"46278","E01012283",2011,547,240,307,65
"46279","E01012284",2011,649,328,321,68
"46280","E01012285",2011,620,179,441,53
"46281","E01012286",2011,663,236,427,222
"46282","E01012287",2011,945,345,600,378
"46283","E01012288",2011,621,155,466,218
"46284","E01012289",2011,510,56,454,83
"46285","E01012290",2011,829,84,745,59
"46286","E01012291",2011,698,171,527,114
"46287","E01012292",2011,1058,308,750,198
"46288","E01012294",2011,481,13,468,31
"46289","E01012295",2011,495,76,419,44
"46290","E01012296",2011,598,89,509,53
"46291","E01012297",2011,978,51,927,58
"46292","E01012298",2011,544,1,543,30
"46293","E01012299",2011,736,8,728,239
"46294","E01012300",2011,747,257,490,79
"46295","E01012301",2011,564,3,561,47
"46296","E01012302",2011,487,1,486,41
"46297","E01012303",2011,606,5,601,57
"46298","E01012304",2011,649,221,428,197
"46299","E01012305",2011,622,66,556,230
"46300","E01012306",2011,601,34,567,114
"46301","E01012307",2011,878,94,784,268
"46302","E01012309",2011,760,30,730,78
"46303","E01012310",2011,864,112,752,65
"46304","E01012311",2011,633,247,386,50
"46305","E01012312",2011,625,383,242,42
"46306","E01012313",2011,664,204,460,63
"46307","E01012314",2011,591,257,334,57
"46308","E01012315",2011,688,4,684,59
"46309","E01012316",2011,1163,85,1078,285
"46310","E01012317",2011,624,40,584,78
"46311","E01012318",2011,1015,436,579,180
"46312","E01012319",2011,1119,172,947,188
"46313","E01012323",2011,657,10,647,104
"46314","E01012324",2011,627,7,620,80
"46315","E01012325",2011,657,75,582,76
"46316","E01012326",2011,502,168,334,40
"46317","E01012327",2011,625,415,210,49
"46318","E01012328",2011,768,251,517,64
"46319","E01012329",2011,776,12,764,54
"46320","E01012330",2011,458,4,454,28
"46321","E01012331",2011,505,19,486,69
"46322","E01012332",2011,592,220,372,33
"46323","E01012333",2011,592,94,498,54
"46324","E01012334",2011,962,31,931,182
"46325","E01012335",2011,620,47,573,43
"46326","E01012336",2011,725,71,654,26
"46327","E01012337",2011,709,8,701,25
"46328","E01012338",2011,848,120,728,105
"46329","E01012339",2011,756,18,738,81
"46330","E01012340",2011,1053,107,946,270
"46331","E01012341",2011,798,395,403,95
"46332","E01012342",2011,819,291,528,115
"46333","E01012343",2011,887,90,797,90
"46334","E01012344",2011,605,72,533,119
"46335","E01012345",2011,580,2,578,49
"46336","E01012346",2011,699,39,660,75
"46337","E01012347",2011,765,48,717,68
"46338","E01012348",2011,915,4,911,69
"46339","E01012349",2011,798,241,557,333
"46340","E01012350",2011,775,133,642,196
"46341","E01012351",2011,556,51,505,52
"46342","E01012352",2011,804,261,543,191
"46343","E01012353",2011,780,23,757,372
"46344","E01012354",2011,737,63,674,386
"46345","E01012355",2011,710,106,604,284
"46346","E01012356",2011,742,27,715,259
"46347","E01012357",2011,606,36,570,197
"46348","E01012358",2011,708,152,556,123
"46349","E01012359",2011,671,484,187,51
"46350","E01012360",2011,783,103,680,95
"46351","E01012361",2011,798,10,788,38
"46352","E01012362",2011,703,12,691,326
"46353","E01012363",2011,684,7,677,249
"46354","E01012364",2011,740,6,734,250
"46355","E01012365",2011,540,4,536,53
"46356","E01012366",2011,860,60,800,111
"46357","E01012367",2011,776,310,466,158
"46358","E01012368",2011,849,194,655,127
"46359","E01012369",2011,619,163,456,37
"46360","E01012370",2011,811,37,774,286
"46361","E01012371",2011,526,0,526,35
"46362","E01012372",2011,507,6,501,34
"46363","E01012373",2011,538,4,534,9
"46364","E01012374",2011,1075,9,1066,119
"46365","E01012375",2011,559,4,555,17
"46366","E01012376",2011,922,9,913,76
"46367","E01012377",2011,745,279,466,48
"46368","E01012378",2011,640,38,602,32
"46369","E01012379",2011,634,56,578,108
"46370","E01012380",2011,571,270,301,32
"46371","E01012381",2011,656,485,171,21
"46372","E01012382",2011,709,483,226,21
"46373","E01012383",2011,756,233,523,47
"46374","E01012384",2011,748,261,487,42
"46375","E01012385",2011,575,25,550,44
"46376","E01012386",2011,661,1,660,22
"46377","E01012387",2011,507,6,501,28
"46378","E01012388",2011,730,247,483,57
"46379","E01012389",2011,745,4,741,27
"46380","E01012390",2011,678,166,512,49
"46381","E01012391",2011,975,209,766,128
"46382","E01012392",2011,910,14,896,83
"46383","E01012393",2011,865,6,859,89
"46384","E01012394",2011,675,188,487,53
"46385","E01012395",2011,620,3,617,18
"46386","E01012396",2011,600,267,333,52
"46387","E01012397",2011,679,366,313,36
"46388","E01012398",2011,513,108,405,32
"46389","E01012399",2011,639,281,358,36
"46390","E01012400",2011,507,32,475,54
"46391","E01012401",2011,787,23,764,54
"46392","E01012402",2011,656,267,389,53
"46393","E01012403",2011,647,323,324,46
"46394","E01012404",2011,577,75,502,38
"46395","E01012405",2011,836,95,741,72
"46396","E01012406",2011,673,270,403,45
"46397","E01012407",2011,758,460,298,65
"46398","E01012408",2011,739,473,266,50
"46399","E01012409",2011,633,218,415,54
"46400","E01012410",2011,533,14,519,41
"46401","E01012411",2011,591,37,554,55
"46402","E01012412",2011,684,176,508,108
"46403","E01012413",2011,663,235,428,82
"46404","E01012414",2011,504,8,496,37
"46405","E01012415",2011,545,2,543,27
"46406","E01012416",2011,774,118,656,50
"46407","E01012417",2011,577,34,543,106
"46408","E01012418",2011,618,3,615,24
"46409","E01012419",2011,486,244,242,18
"46410","E01012420",2011,746,511,235,38
"46411","E01012421",2011,536,2,534,20
"46412","E01012422",2011,632,297,335,46
"46413","E01012423",2011,640,59,581,60
"46414","E01012424",2011,761,437,324,57
"46415","E01012425",2011,692,208,484,76
"46416","E01012426",2011,572,27,545,47
"46417","E01012427",2011,649,145,504,57
"46418","E01012428",2011,1024,143,881,275
"46419","E01012429",2011,627,170,457,63
"46420","E01012430",2011,884,364,520,240
"46421","E01012431",2011,1011,76,935,318
"46422","E01012432",2011,666,112,554,84
"46423","E01012433",2011,690,293,397,66
"46424","E01012434",2011,601,13,588,46
"46425","E01012435",2011,759,43,716,21
"46426","E01012436",2011,504,290,214,33
"46427","E01012437",2011,539,251,288,36
"46428","E01012438",2011,535,337,198,38
"46429","E01012439",2011,642,306,336,50
"46430","E01012440",2011,524,25,499,28
"46431","E01012441",2011,1078,379,699,265
"46432","E01012442",2011,618,329,289,38
"46433","E01012443",2011,601,63,538,87
"46434","E01012444",2011,427,322,105,14
"46435","E01012445",2011,553,400,153,27
"46436","E01012446",2011,527,6,521,9
"46437","E01012447",2011,494,1,493,8
"46438","E01012448",2011,498,5,493,29
"46439","E01012449",2011,641,2,639,13
"46440","E01012450",2011,633,29,604,40
"46441","E01012451",2011,648,185,463,42
"46442","E01012452",2011,732,0,732,37
"46443","E01012453",2011,654,330,324,53
"46444","E01012454",2011,859,162,697,179
"46445","E01012455",2011,876,442,434,126
"46446","E01012457",2011,777,124,653,251
"46447","E01012458",2011,1011,108,903,248
"46448","E01012459",2011,622,325,297,43
"46449","E01012460",2011,629,227,402,56
"46450","E01012461",2011,535,12,523,35
"46451","E01012462",2011,633,81,552,95
"46452","E01012463",2011,506,7,499,23
"46453","E01012464",2011,599,169,430,52
"46454","E01012465",2011,608,93,515,87
"46455","E01012466",2011,707,409,298,56
"46456","E01012467",2011,522,2,520,16
"46457","E01012468",2011,914,48,866,78
"46458","E01012469",2011,624,39,585,65
"46459","E01012470",2011,497,120,377,29
"46460","E01012471",2011,507,2,505,38
"46461","E01012472",2011,740,68,672,33
"46462","E01012473",2011,678,29,649,29
"46463","E01012474",2011,611,172,439,59
"46464","E01012475",2011,643,71,572,79
"46465","E01012476",2011,668,63,605,65
"46466","E01012477",2011,610,4,606,42
"46467","E01012478",2011,617,108,509,73
"46468","E01012479",2011,793,242,551,191
"46469","E01012480",2011,921,187,734,318
"46470","E01012481",2011,714,129,585,128
"46471","E01012482",2011,869,315,554,103
"46472","E01012483",2011,883,443,440,123
"46473","E01012485",2011,660,117,543,35
"46474","E01012486",2011,631,9,622,34
"46475","E01012487",2011,652,32,620,41
"46476","E01012488",2011,716,4,712,45
"46477","E01012489",2011,681,4,677,34
"46478","E01012490",2011,629,3,626,30
"46479","E01012491",2011,621,119,502,27
"46480","E01012492",2011,609,4,605,25
"46481","E01012493",2011,669,5,664,39
"46482","E01012494",2011,649,6,643,49
"46483","E01012495",2011,643,4,639,95
"46484","E01012496",2011,585,37,548,23
"46485","E01012497",2011,516,184,332,30
"46486","E01012498",2011,656,225,431,58
"46487","E01012499",2011,739,23,716,70
"46488","E01012500",2011,593,2,591,49
"46489","E01012501",2011,603,10,593,59
"46490","E01012502",2011,629,6,623,36
"46491","E01012503",2011,559,9,550,64
"46492","E01012504",2011,753,136,617,137
"46493","E01012505",2011,652,216,436,63
"46494","E01012506",2011,668,269,399,77
"46495","E01012507",2011,943,150,793,318
"46496","E01012508",2011,715,343,372,61
"46497","E01012509",2011,882,54,828,148
"46498","E01012510",2011,868,178,690,227
"46499","E01012511",2011,786,45,741,236
"46500","E01012512",2011,739,9,730,84
"46501","E01012513",2011,805,59,746,111
"46502","E01012514",2011,737,31,706,80
"46503","E01012515",2011,659,98,561,77
"46504","E01012516",2011,589,55,534,86
"46505","E01012517",2011,900,13,887,120
"46506","E01012518",2011,846,84,762,95
"46507","E01012519",2011,635,46,589,53
"46508","E01012520",2011,638,287,351,58
"46509","E01012521",2011,654,116,538,47
"46510","E01012522",2011,613,226,387,43
"46511","E01012523",2011,621,52,569,114
"46512","E01012524",2011,627,16,611,45
"46513","E01012525",2011,635,90,545,97
"46514","E01012526",2011,654,368,286,62
"46515","E01012527",2011,622,39,583,43
"46516","E01012528",2011,500,5,495,23
"46517","E01012529",2011,599,10,589,51
"46518","E01012530",2011,529,3,526,44
"46519","E01012531",2011,675,17,658,42
"46520","E01012532",2011,601,3,598,25
"46521","E01012533",2011,554,354,200,33
"46522","E01012534",2011,655,307,348,46
"46523","E01012535",2011,701,297,404,56
"46524","E01012536",2011,631,244,387,30
"46525","E01012537",2011,702,334,368,44
"46526","E01012538",2011,619,3,616,60
"46527","E01012539",2011,697,275,422,21
"46528","E01012540",2011,587,46,541,29
"46529","E01012541",2011,516,88,428,54
"46530","E01012542",2011,633,125,508,55
"46531","E01012543",2011,595,32,563,60
"46532","E01012544",2011,588,106,482,42
"46533","E01012545",2011,703,467,236,50
"46534","E01012546",2011,682,494,188,31
"46535","E01012547",2011,682,37,645,41
"46536","E01012548",2011,703,64,639,42
"46537","E01012549",2011,639,11,628,27
"46538","E01012550",2011,702,6,696,46
"46539","E01012551",2011,598,3,595,24
"46540","E01012552",2011,619,92,527,51
"46541","E01012553",2011,499,1,498,12
"46542","E01012554",2011,840,63,777,60
"46543","E01012555",2011,525,11,514,27
"46544","E01012556",2011,621,22,599,26
"46545","E01012557",2011,755,36,719,157
"46546","E01012558",2011,749,5,744,121
"46547","E01012559",2011,593,16,577,27
"46548","E01012560",2011,631,139,492,27
"46549","E01012561",2011,678,58,620,88
"46550","E01012562",2011,610,2,608,85
"46551","E01012563",2011,635,3,632,38
"46552","E01012564",2011,526,3,523,45
"46553","E01012565",2011,932,108,824,78
"46554","E01012566",2011,729,13,716,75
"46555","E01012567",2011,641,6,635,47
"46556","E01012568",2011,963,38,925,116
"46557","E01012569",2011,703,34,669,80
"46558","E01012570",2011,604,262,342,46
"46559","E01012571",2011,457,129,328,64
"46560","E01012572",2011,522,274,248,43
"46561","E01012573",2011,484,58,426,76
"46562","E01012574",2011,563,262,301,51
"46563","E01012575",2011,546,281,265,69
"46564","E01012576",2011,569,232,337,83
"46565","E01012577",2011,516,63,453,125
"46566","E01012578",2011,528,106,422,97
"46567","E01012579",2011,542,184,358,63
"46568","E01012580",2011,537,61,476,83
"46569","E01012581",2011,495,1,494,29
"46570","E01012582",2011,525,4,521,40
"46571","E01012583",2011,643,7,636,30
"46572","E01012584",2011,521,17,504,53
"46573","E01012585",2011,466,22,444,59
"46574","E01012586",2011,490,62,428,119
"46575","E01012587",2011,661,3,658,105
"46576","E01012588",2011,617,9,608,116
"46577","E01012589",2011,653,73,580,204
"46578","E01012590",2011,630,112,518,117
"46579","E01012591",2011,666,224,442,74
"46580","E01012592",2011,826,4,822,67
"46581","E01012593",2011,742,6,736,144
"46582","E01012594",2011,626,266,360,70
"46583","E01012595",2011,860,192,668,241
"46584","E01012596",2011,794,80,714,245
"46585","E01012597",2011,679,2,677,68
"46586","E01012598",2011,1050,4,1046,89
"46587","E01012599",2011,498,5,493,65
"46588","E01012600",2011,635,316,319,44
"46589","E01012601",2011,593,360,233,44
"46590","E01012602",2011,651,9,642,68
"46591","E01012603",2011,649,298,351,89
"46592","E01012604",2011,599,74,525,122
"46593","E01012605",2011,578,77,501,128
"46594","E01012606",2011,483,72,411,93
"46595","E01012607",2011,640,97,543,36
"46596","E01012608",2011,731,199,532,106
"46597","E01012609",2011,654,4,650,18
"46598","E01012610",2011,506,68,438,28
"46599","E01012611",2011,482,7,475,55
"46600","E01012612",2011,625,2,623,37
"46601","E01012613",2011,558,5,553,54
"46602","E01012614",2011,673,34,639,62
"46603","E01012615",2011,748,190,558,107
"46604","E01012616",2011,761,101,660,82
"46605","E01012617",2011,602,20,582,135
"46606","E01012618",2011,647,25,622,64
"46607","E01012619",2011,554,266,288,45
"46608","E01012620",2011,639,44,595,39
"46609","E01012621",2011,625,138,487,81
"46610","E01012622",2011,780,341,439,194
"46611","E01012623",2011,636,67,569,102
"46612","E01012624",2011,715,147,568,176
"46613","E01012625",2011,774,106,668,202
"46614","E01012628",2011,497,5,492,50
"46615","E01012629",2011,479,42,437,167
"46616","E01012630",2011,601,74,527,119
"46617","E01012631",2011,579,379,200,72
"46618","E01012632",2011,808,151,657,176
"46619","E01012633",2011,729,95,634,90
"46620","E01012634",2011,590,43,547,57
"46621","E01012635",2011,589,13,576,49
"46622","E01012636",2011,673,30,643,55
"46623","E01012637",2011,637,412,225,47
"46624","E01012638",2011,703,374,329,51
"46625","E01012639",2011,722,407,315,89
"46626","E01012640",2011,722,108,614,151
"46627","E01012641",2011,550,202,348,83
"46628","E01012642",2011,482,78,404,97
"46629","E01012643",2011,627,297,330,58
"46630","E01012644",2011,661,22,639,133
"46631","E01012645",2011,582,8,574,59
"46632","E01012646",2011,744,191,553,201
"46633","E01012647",2011,646,238,408,73
"46634","E01012648",2011,531,16,515,151
"46635","E01012649",2011,633,167,466,165
"46636","E01012650",2011,596,37,559,190
"46637","E01012651",2011,686,10,676,138
"46638","E01012652",2011,652,24,628,61
"46639","E01012653",2011,580,34,546,152
"46640","E01012654",2011,762,68,694,276
"46641","E01012655",2011,879,592,287,167
"46642","E01012656",2011,627,192,435,177
"46643","E01012657",2011,718,168,550,188
"46644","E01012658",2011,756,47,709,155
"46645","E01012659",2011,593,13,580,85
"46646","E01012660",2011,463,9,454,35
"46647","E01012661",2011,687,10,677,154
"46648","E01012662",2011,832,157,675,94
"46649","E01012663",2011,751,4,747,182
"46650","E01012664",2011,714,3,711,114
"46651","E01012665",2011,863,6,857,119
"46652","E01012666",2011,667,27,640,233
"46653","E01012667",2011,642,2,640,66
"46654","E01012668",2011,728,5,723,133
"46655","E01012669",2011,875,7,868,269
"46656","E01012670",2011,574,46,528,298
"46657","E01012671",2011,586,35,551,366
"46658","E01012672",2011,540,53,487,339
"46659","E01012673",2011,712,246,466,309
"46660","E01012674",2011,720,34,686,391
"46661","E01012675",2011,697,63,634,361
"46662","E01012676",2011,611,56,555,128
"46663","E01012677",2011,614,16,598,141
"46664","E01012678",2011,738,458,280,123
"46665","E01012679",2011,637,150,487,267
"46666","E01012680",2011,684,100,584,239
"46667","E01012681",2011,762,97,665,514
"46668","E01012682",2011,745,144,601,305
"46669","E01012683",2011,715,77,638,407
"46670","E01012684",2011,689,169,520,204
"46671","E01012685",2011,638,6,632,163
"46672","E01012686",2011,636,311,325,56
"46673","E01012687",2011,632,313,319,57
"46674","E01012688",2011,658,105,553,104
"46675","E01012689",2011,630,56,574,115
"46676","E01012690",2011,740,8,732,120
"46677","E01012691",2011,790,74,716,128
"46678","E01012692",2011,827,248,579,106
"46679","E01012693",2011,725,6,719,120
"46680","E01012694",2011,645,56,589,153
"46681","E01012695",2011,616,43,573,191
"46682","E01012696",2011,667,16,651,195
"46683","E01012697",2011,680,82,598,100
"46684","E01012698",2011,637,180,457,130
"46685","E01012699",2011,759,26,733,113
"46686","E01012700",2011,758,10,748,115
"46687","E01012701",2011,619,6,613,107
"46688","E01012702",2011,766,229,537,109
"46689","E01012703",2011,706,58,648,81
"46690","E01012704",2011,1078,585,493,109
"46691","E01012705",2011,727,147,580,107
"46692","E01012706",2011,709,10,699,95
"46693","E01012707",2011,640,159,481,139
"46694","E01012708",2011,607,2,605,152
"46695","E01012709",2011,744,4,740,280
"46696","E01012710",2011,480,2,478,78
"46697","E01012711",2011,602,47,555,133
"46698","E01012712",2011,695,2,693,101
"46699","E01012713",2011,826,7,819,172
"46700","E01012714",2011,796,44,752,123
"46701","E01012715",2011,698,8,690,147
"46702","E01012716",2011,642,3,639,95
"46703","E01012717",2011,715,13,702,70
"46704","E01012718",2011,771,18,753,69
"46705","E01012719",2011,625,6,619,70
"46706","E01012720",2011,649,332,317,63
"46707","E01012721",2011,835,648,187,33
"46708","E01012722",2011,514,5,509,124
"46709","E01012723",2011,654,37,617,96
"46710","E01012724",2011,621,332,289,50
"46711","E01012725",2011,595,1,594,88
"46712","E01012726",2011,757,47,710,145
"46713","E01012727",2011,653,8,645,70
"46714","E01012728",2011,736,15,721,290
"46715","E01012729",2011,749,3,746,81
"46716","E01012730",2011,685,2,683,92
"46717","E01012731",2011,728,11,717,132
"46718","E01012732",2011,829,187,642,123
"46719","E01012733",2011,471,25,446,193
"46720","E01012734",2011,631,12,619,195
"46721","E01012735",2011,700,9,691,407
"46722","E01012736",2011,468,15,453,308
"46723","E01012737",2011,805,30,775,554
"46724","E01012738",2011,563,46,517,230
"46725","E01012739",2011,578,102,476,150
"46726","E01012740",2011,685,16,669,179
"46727","E01012741",2011,608,3,605,114
"46728","E01012742",2011,541,26,515,143
"46729","E01012743",2011,742,15,727,270
"46730","E01012744",2011,746,145,601,211
"46731","E01012745",2011,755,14,741,192
"46732","E01012746",2011,796,27,769,234
"46733","E01012747",2011,611,1,610,42
"46734","E01012748",2011,715,12,703,383
"46735","E01012749",2011,715,6,709,339
"46736","E01012750",2011,735,3,732,147
"46737","E01012751",2011,735,5,730,566
"46738","E01012752",2011,583,2,581,257
"46739","E01012753",2011,469,1,468,101
"46740","E01012754",2011,522,7,515,231
"46741","E01012755",2011,608,4,604,132
"46742","E01012756",2011,714,12,702,197
"46743","E01012757",2011,687,19,668,271
"46744","E01012758",2011,700,35,665,203
"46745","E01012759",2011,801,27,774,311
"46746","E01012760",2011,724,12,712,314
"46747","E01012761",2011,863,238,625,463
"46748","E01012762",2011,632,16,616,221
"46749","E01012763",2011,996,77,919,616
"46750","E01012764",2011,552,8,544,60
"46751","E01012765",2011,628,3,625,97
"46752","E01012766",2011,562,6,556,74
"46753","E01012767",2011,583,64,519,194
"46754","E01012768",2011,698,7,691,112
"46755","E01012769",2011,684,3,681,64
"46756","E01012770",2011,591,14,577,44
"46757","E01012771",2011,636,57,579,49
"46758","E01012772",2011,613,16,597,104
"46759","E01012773",2011,753,11,742,148
"46760","E01012774",2011,667,169,498,96
"46761","E01012775",2011,658,215,443,84
"46762","E01012776",2011,657,17,640,126
"46763","E01012777",2011,729,351,378,54
"46764","E01012778",2011,536,310,226,49
"46765","E01012779",2011,487,273,214,71
"46766","E01012780",2011,593,306,287,58
"46767","E01012781",2011,471,276,195,35
"46768","E01012782",2011,576,374,202,38
"46769","E01012783",2011,529,317,212,64
"46770","E01012784",2011,791,195,596,132
"46771","E01012785",2011,549,389,160,32
"46772","E01012786",2011,507,213,294,36
"46773","E01012787",2011,681,400,281,62
"46774","E01012788",2011,578,332,246,41
"46775","E01012789",2011,540,260,280,35
"46776","E01012790",2011,569,251,318,41
"46777","E01012791",2011,662,9,653,41
"46778","E01012792",2011,644,49,595,69
"46779","E01012793",2011,620,90,530,63
"46780","E01012794",2011,637,13,624,110
"46781","E01012795",2011,880,334,546,78
"46782","E01012796",2011,576,28,548,66
"46783","E01012797",2011,643,156,487,90
"46784","E01012798",2011,834,494,340,49
"46785","E01012799",2011,606,10,596,189
"46786","E01012800",2011,755,77,678,179
"46787","E01012801",2011,664,93,571,113
"46788","E01012802",2011,650,38,612,139
"46789","E01012803",2011,664,44,620,185
"46790","E01012804",2011,683,9,674,124
"46791","E01012805",2011,671,120,551,245
"46792","E01012806",2011,743,70,673,297
"46793","E01012807",2011,599,55,544,107
"46794","E01012808",2011,874,378,496,181
"46795","E01012809",2011,924,104,820,434
"46796","E01012810",2011,949,230,719,222
"46797","E01012811",2011,855,51,804,345
"46798","E01012812",2011,521,1,520,36
"46799","E01012813",2011,681,15,666,54
"46800","E01012814",2011,623,15,608,34
"46801","E01012815",2011,675,19,656,68
"46802","E01012816",2011,573,65,508,88
"46803","E01012817",2011,648,11,637,198
"46804","E01012818",2011,507,13,494,45
"46805","E01012819",2011,622,25,597,127
"46806","E01012820",2011,561,15,546,133
"46807","E01012821",2011,609,320,289,22
"46808","E01012822",2011,651,79,572,92
"46809","E01012823",2011,602,273,329,46
"46810","E01012824",2011,682,154,528,38
"46811","E01012825",2011,679,99,580,43
"46812","E01012826",2011,710,265,445,58
"46813","E01012827",2011,755,300,455,53
"46814","E01012828",2011,679,187,492,43
"46815","E01012829",2011,692,37,655,61
"46816","E01012830",2011,612,5,607,57
"46817","E01012832",2011,548,111,437,87
"46818","E01012833",2011,645,335,310,42
"46819","E01012834",2011,664,308,356,63
"46820","E01012835",2011,525,12,513,30
"46821","E01012836",2011,785,443,342,40
"46822","E01012837",2011,741,367,374,40
"46823","E01012838",2011,607,322,285,47
"46824","E01012839",2011,551,113,438,40
"46825","E01012840",2011,648,290,358,68
"46826","E01012841",2011,655,515,140,32
"46827","E01012842",2011,602,296,306,59
"46828","E01012843",2011,633,351,282,68
"46829","E01012844",2011,609,455,154,26
"46830","E01012845",2011,623,303,320,72
"46831","E01012846",2011,624,297,327,64
"46832","E01012847",2011,521,272,249,59
"46833","E01012848",2011,631,141,490,179
"46834","E01012849",2011,712,326,386,57
"46835","E01012850",2011,984,304,680,500
"46836","E01012851",2011,1383,639,744,551
"46837","E01012852",2011,799,344,455,226
"46838","E01012854",2011,1243,758,485,243
"46839","E01012855",2011,945,663,282,112
"46840","E01012856",2011,819,531,288,109
"46841","E01012857",2011,769,384,385,173
"46842","E01012858",2011,729,386,343,79
"46843","E01012859",2011,651,48,603,367
"46844","E01012860",2011,641,166,475,79
"46845","E01012862",2011,597,178,419,140
"46846","E01012863",2011,602,18,584,175
"46847","E01012864",2011,732,47,685,349
"46848","E01012865",2011,605,34,571,235
"46849","E01012866",2011,701,21,680,367
"46850","E01012867",2011,734,179,555,372
"46851","E01012868",2011,695,84,611,408
"46852","E01012869",2011,675,94,581,398
"46853","E01012870",2011,670,26,644,404
"46854","E01012871",2011,742,70,672,416
"46855","E01012872",2011,678,71,607,434
"46856","E01012873",2011,643,448,195,49
"46857","E01012874",2011,645,372,273,41
"46858","E01012875",2011,645,498,147,40
"46859","E01012876",2011,680,410,270,36
"46860","E01012877",2011,499,331,168,25
"46861","E01012878",2011,650,399,251,52
"46862","E01012879",2011,649,454,195,47
"46863","E01012880",2011,704,483,221,60
"46864","E01012881",2011,639,405,234,49
"46865","E01012882",2011,685,25,660,88
"46866","E01012883",2011,809,210,599,87
"46867","E01012884",2011,822,344,478,58
"46868","E01012886",2011,691,284,407,56
"46869","E01012887",2011,703,408,295,36
"46870","E01012888",2011,725,77,648,339
"46871","E01012889",2011,648,260,388,201
"46872","E01012891",2011,1078,224,854,587
"46873","E01012892",2011,827,47,780,398
"46874","E01012893",2011,701,273,428,217
"46875","E01012894",2011,629,285,344,46
"46876","E01012895",2011,588,442,146,42
"46877","E01012896",2011,802,130,672,105
"46878","E01012897",2011,695,585,110,30
"46879","E01012898",2011,669,372,297,58
"46880","E01012899",2011,669,14,655,136
"46881","E01012900",2011,756,87,669,345
"46882","E01012901",2011,611,51,560,84
"46883","E01012902",2011,616,14,602,65
"46884","E01012903",2011,829,93,736,310
"46885","E01012904",2011,655,107,548,99
"46886","E01012905",2011,580,239,341,34
"46887","E01012906",2011,679,364,315,62
"46888","E01012907",2011,595,120,475,54
"46889","E01012908",2011,490,222,268,32
"46890","E01012909",2011,591,28,563,74
"46891","E01012910",2011,466,13,453,39
"46892","E01012911",2011,500,11,489,38
"46893","E01012912",2011,756,6,750,81
"46894","E01012913",2011,821,202,619,206
"46895","E01012914",2011,627,89,538,403
"46896","E01012915",2011,640,312,328,63
"46897","E01012916",2011,685,47,638,156
"46898","E01012917",2011,785,433,352,100
"46899","E01012918",2011,609,303,306,82
"46900","E01012919",2011,531,26,505,59
"46901","E01012920",2011,622,31,591,61
"46902","E01012921",2011,486,27,459,46
"46903","E01012922",2011,642,39,603,86
"46904","E01012923",2011,603,34,569,217
"46905","E01012924",2011,703,14,689,52
"46906","E01012925",2011,534,22,512,78
"46907","E01012926",2011,1059,28,1031,102
"46908","E01012927",2011,648,4,644,39
"46909","E01012928",2011,719,350,369,68
"46910","E01012929",2011,794,109,685,161
"46911","E01012930",2011,637,11,626,88
"46912","E01012931",2011,810,360,450,128
"46913","E01012932",2011,713,175,538,162
"46914","E01012933",2011,476,6,470,26
"46915","E01012934",2011,711,49,662,116
"46916","E01012935",2011,610,5,605,30
"46917","E01012936",2011,688,40,648,202
"46918","E01012937",2011,1045,51,994,132
"46919","E01012938",2011,1095,50,1045,157
"46920","E01012939",2011,802,13,789,68
"46921","E01012940",2011,837,6,831,115
"46922","E01012941",2011,707,35,672,67
"46923","E01012942",2011,653,3,650,61
"46924","E01012943",2011,701,64,637,190
"46925","E01012944",2011,719,35,684,436
"46926","E01012945",2011,717,70,647,284
"46927","E01012946",2011,696,362,334,65
"46928","E01012947",2011,578,23,555,107
"46929","E01012948",2011,652,65,587,346
"46930","E01012949",2011,633,183,450,101
"46931","E01012950",2011,592,5,587,71
"46932","E01012951",2011,574,5,569,232
"46933","E01012952",2011,653,15,638,281
"46934","E01012953",2011,485,9,476,59
"46935","E01012954",2011,543,14,529,61
"46936","E01012955",2011,666,13,653,77
"46937","E01012956",2011,477,55,422,25
"46938","E01012957",2011,780,74,706,153
"46939","E01012958",2011,486,7,479,15
"46940","E01012959",2011,642,3,639,60
"46941","E01012960",2011,703,25,678,96
"46942","E01012961",2011,683,82,601,39
"46943","E01012962",2011,471,7,464,43
"46944","E01012963",2011,756,326,430,68
"46945","E01012964",2011,746,185,561,60
"46946","E01012965",2011,422,15,407,39
"46947","E01012966",2011,576,37,539,30
"46948","E01012967",2011,660,12,648,47
"46949","E01012968",2011,701,5,696,57
"46950","E01012969",2011,476,60,416,40
"46951","E01012970",2011,634,42,592,74
"46952","E01012972",2011,601,11,590,27
"46953","E01012973",2011,1135,4,1131,199
"46954","E01012974",2011,661,53,608,62
"46955","E01012975",2011,650,7,643,71
"46956","E01012976",2011,613,159,454,64
"46957","E01012977",2011,1019,37,982,152
"46958","E01012978",2011,649,6,643,49
"46959","E01012979",2011,731,9,722,158
"46960","E01012980",2011,837,153,684,223
"46961","E01012981",2011,611,61,550,161
"46962","E01012982",2011,775,16,759,194
"46963","E01012983",2011,740,7,733,95
"46964","E01012984",2011,706,31,675,63
"46965","E01012985",2011,739,66,673,85
"46966","E01012986",2011,738,72,666,108
"46967","E01012987",2011,704,25,679,72
"46968","E01012988",2011,646,43,603,92
"46969","E01012989",2011,751,50,701,82
"46970","E01012990",2011,600,46,554,108
"46971","E01012991",2011,663,68,595,73
"46972","E01012992",2011,656,77,579,172
"46973","E01012993",2011,596,52,544,43
"46974","E01012994",2011,781,221,560,67
"46975","E01012995",2011,771,229,542,91
"46976","E01012996",2011,638,13,625,48
"46977","E01012997",2011,850,95,755,330
"46978","E01012998",2011,884,19,865,61
"46979","E01012999",2011,681,36,645,317
"46980","E01013000",2011,915,225,690,348
"46981","E01013001",2011,756,72,684,104
"46982","E01013002",2011,686,193,493,120
"46983","E01013003",2011,658,153,505,50
"46984","E01013004",2011,658,96,562,155
"46985","E01013005",2011,528,3,525,48
"46986","E01013006",2011,629,40,589,106
"46987","E01013007",2011,663,51,612,95
"46988","E01013008",2011,650,11,639,151
"46989","E01013009",2011,753,216,537,138
"46990","E01013010",2011,631,87,544,101
"46991","E01013011",2011,652,91,561,88
"46992","E01013012",2011,520,1,519,21
"46993","E01013013",2011,672,10,662,157
"46994","E01013014",2011,608,92,516,71
"46995","E01013015",2011,674,10,664,169
"46996","E01013016",2011,704,6,698,52
"46997","E01013017",2011,731,146,585,93
"46998","E01013018",2011,769,81,688,75
"46999","E01013019",2011,496,37,459,36
"47000","E01013020",2011,720,30,690,85
"47001","E01013021",2011,655,9,646,94
"47002","E01013022",2011,754,58,696,59
"47003","E01013023",2011,754,11,743,79
"47004","E01013024",2011,751,76,675,71
"47005","E01013025",2011,589,74,515,68
"47006","E01013026",2011,694,60,634,59
"47007","E01013027",2011,736,89,647,93
"47008","E01013028",2011,650,44,606,62
"47009","E01013029",2011,632,70,562,86
"47010","E01013030",2011,654,58,596,67
"47011","E01013031",2011,630,9,621,37
"47012","E01013032",2011,622,7,615,42
"47013","E01013033",2011,643,43,600,55
"47014","E01013034",2011,734,25,709,93
"47015","E01013035",2011,551,6,545,31
"47016","E01013036",2011,791,161,630,211
"47017","E01013037",2011,656,13,643,148
"47018","E01013038",2011,612,323,289,43
"47019","E01013039",2011,784,70,714,71
"47020","E01013040",2011,881,51,830,254
"47021","E01013041",2011,883,185,698,161
"47022","E01013042",2011,655,14,641,43
"47023","E01013043",2011,548,42,506,54
"47024","E01013044",2011,659,4,655,58
"47025","E01013045",2011,642,270,372,53
"47026","E01013046",2011,767,5,762,101
"47027","E01013047",2011,701,121,580,111
"47028","E01013048",2011,866,84,782,99
"47029","E01013049",2011,754,126,628,136
"47030","E01013050",2011,734,14,720,77
"47031","E01013051",2011,670,109,561,93
"47032","E01013052",2011,637,25,612,49
"47033","E01013053",2011,654,7,647,45
"47034","E01013054",2011,801,5,796,180
"47035","E01013055",2011,671,95,576,92
"47036","E01013056",2011,747,184,563,168
"47037","E01013057",2011,614,14,600,69
"47038","E01013058",2011,599,104,495,65
"47039","E01013059",2011,679,42,637,45
"47040","E01013060",2011,795,5,790,58
"47041","E01013061",2011,697,100,597,40
"47042","E01013062",2011,903,99,804,249
"47043","E01013063",2011,684,54,630,76
"47044","E01013064",2011,526,3,523,32
"47045","E01013065",2011,742,44,698,40
"47046","E01013066",2011,691,2,689,36
"47047","E01013067",2011,701,2,699,75
"47048","E01013068",2011,630,22,608,43
"47049","E01013069",2011,702,83,619,80
"47050","E01013070",2011,687,10,677,49
"47051","E01013071",2011,802,369,433,112
"47052","E01013072",2011,701,139,562,68
"47053","E01013073",2011,673,55,618,83
"47054","E01013074",2011,676,27,649,75
"47055","E01013075",2011,547,28,519,31
"47056","E01013076",2011,630,81,549,94
"47057","E01013077",2011,819,74,745,68
"47058","E01013078",2011,594,54,540,39
"47059","E01013079",2011,686,11,675,88
"47060","E01013080",2011,580,91,489,160
"47061","E01013081",2011,651,33,618,117
"47062","E01013082",2011,665,8,657,110
"47063","E01013083",2011,616,55,561,196
"47064","E01013084",2011,678,285,393,89
"47065","E01013085",2011,704,58,646,69
"47066","E01013086",2011,634,163,471,74
"47067","E01013087",2011,572,76,496,63
"47068","E01013088",2011,688,7,681,29
"47069","E01013089",2011,707,8,699,63
"47070","E01013090",2011,587,39,548,40
"47071","E01013091",2011,671,45,626,53
"47072","E01013092",2011,844,67,777,74
"47073","E01013093",2011,630,7,623,53
"47074","E01013094",2011,566,71,495,42
"47075","E01013095",2011,669,18,651,129
"47076","E01013096",2011,700,50,650,92
"47077","E01013097",2011,662,6,656,125
"47078","E01013098",2011,920,21,899,138
"47079","E01013099",2011,638,162,476,55
"47080","E01013100",2011,686,9,677,44
"47081","E01013101",2011,717,58,659,61
"47082","E01013102",2011,660,27,633,55
"47083","E01013103",2011,611,4,607,45
"47084","E01013104",2011,567,4,563,51
"47085","E01013105",2011,611,118,493,35
"47086","E01013106",2011,480,125,355,28
"47087","E01013107",2011,777,217,560,99
"47088","E01013108",2011,627,3,624,39
"47089","E01013110",2011,660,48,612,67
"47090","E01013111",2011,606,6,600,55
"47091","E01013112",2011,647,11,636,20
"47092","E01013113",2011,663,5,658,41
"47093","E01013114",2011,633,2,631,25
"47094","E01013115",2011,639,8,631,68
"47095","E01013116",2011,611,0,611,34
"47096","E01013117",2011,590,3,587,38
"47097","E01013118",2011,638,15,623,25
"47098","E01013119",2011,628,32,596,201
"47099","E01013120",2011,834,30,804,91
"47100","E01013121",2011,769,43,726,89
"47101","E01013122",2011,589,21,568,53
"47102","E01013123",2011,663,30,633,89
"47103","E01013124",2011,987,212,775,155
"47104","E01013125",2011,734,87,647,96
"47105","E01013126",2011,599,15,584,62
"47106","E01013127",2011,608,28,580,59
"47107","E01013128",2011,616,26,590,236
"47108","E01013129",2011,728,37,691,374
"47109","E01013130",2011,627,230,397,51
"47110","E01013131",2011,778,161,617,247
"47111","E01013132",2011,635,60,575,87
"47112","E01013133",2011,772,44,728,257
"47113","E01013134",2011,691,142,549,72
"47114","E01013135",2011,758,213,545,47
"47115","E01013136",2011,885,619,266,162
"47116","E01013137",2011,989,837,152,70
"47117","E01013138",2011,619,178,441,256
"47118","E01013139",2011,656,365,291,126
"47119","E01013140",2011,652,64,588,294
"47120","E01013141",2011,647,65,582,195
"47121","E01013142",2011,767,169,598,312
"47122","E01013143",2011,579,21,558,188
"47123","E01013144",2011,792,492,300,76
"47124","E01013145",2011,503,4,499,25
"47125","E01013146",2011,708,69,639,99
"47126","E01013147",2011,607,168,439,84
"47127","E01013148",2011,575,5,570,35
"47128","E01013149",2011,485,1,484,34
"47129","E01013150",2011,522,7,515,31
"47130","E01013151",2011,520,0,520,32
"47131","E01013152",2011,620,5,615,43
"47132","E01013153",2011,643,3,640,45
"47133","E01013154",2011,619,8,611,33
"47134","E01013155",2011,626,1,625,40
"47135","E01013156",2011,661,243,418,83
"47136","E01013157",2011,735,4,731,87
"47137","E01013158",2011,599,53,546,79
"47138","E01013159",2011,613,36,577,287
"47139","E01013160",2011,655,4,651,77
"47140","E01013161",2011,566,36,530,223
"47141","E01013162",2011,670,32,638,270
"47142","E01013163",2011,605,13,592,39
"47143","E01013164",2011,715,101,614,119
"47144","E01013165",2011,602,94,508,223
"47145","E01013166",2011,692,5,687,49
"47146","E01013167",2011,808,3,805,51
"47147","E01013168",2011,709,7,702,34
"47148","E01013169",2011,528,92,436,29
"47149","E01013170",2011,665,50,615,66
"47150","E01013171",2011,625,10,615,41
"47151","E01013172",2011,682,36,646,64
"47152","E01013173",2011,534,38,496,40
"47153","E01013174",2011,532,260,272,70
"47154","E01013175",2011,601,40,561,63
"47155","E01013176",2011,600,10,590,99
"47156","E01013177",2011,804,422,382,88
"47157","E01013178",2011,637,18,619,72
"47158","E01013179",2011,632,126,506,63
"47159","E01013180",2011,621,43,578,71
"47160","E01013181",2011,616,29,587,268
"47161","E01013182",2011,636,2,634,69
"47162","E01013183",2011,639,36,603,82
"47163","E01013184",2011,643,16,627,185
"47164","E01013185",2011,657,52,605,116
"47165","E01013186",2011,502,2,500,36
"47166","E01013187",2011,792,251,541,223
"47167","E01013188",2011,684,9,675,84
"47168","E01013189",2011,641,5,636,51
"47169","E01013190",2011,1075,8,1067,129
"47170","E01013191",2011,642,8,634,36
"47171","E01013192",2011,744,282,462,67
"47172","E01013193",2011,728,5,723,30
"47173","E01013194",2011,677,9,668,58
"47174","E01013195",2011,616,36,580,197
"47175","E01013196",2011,565,16,549,251
"47176","E01013197",2011,524,13,511,84
"47177","E01013198",2011,613,31,582,156
"47178","E01013199",2011,541,20,521,241
"47179","E01013200",2011,511,4,507,48
"47180","E01013201",2011,673,52,621,303
"47181","E01013202",2011,621,6,615,223
"47182","E01013203",2011,728,59,669,368
"47183","E01013204",2011,586,196,390,60
"47184","E01013205",2011,519,272,247,72
"47185","E01013206",2011,593,183,410,56
"47186","E01013207",2011,604,67,537,67
"47187","E01013208",2011,520,343,177,46
"47188","E01013209",2011,676,362,314,59
"47189","E01013210",2011,536,269,267,55
"47190","E01013211",2011,642,21,621,108
"47191","E01013212",2011,599,416,183,38
"47192","E01013213",2011,625,176,449,80
"47193","E01013214",2011,637,23,614,38
"47194","E01013215",2011,620,3,617,45
"47195","E01013216",2011,511,1,510,35
"47196","E01013217",2011,623,27,596,49
"47197","E01013218",2011,624,62,562,221
"47198","E01013219",2011,641,54,587,214
"47199","E01013220",2011,761,93,668,306
"47200","E01013221",2011,953,258,695,360
"47201","E01013222",2011,702,24,678,295
"47202","E01013223",2011,1149,25,1124,97
"47203","E01013224",2011,778,86,692,63
"47204","E01013225",2011,429,8,421,73
"47205","E01013226",2011,632,11,621,62
"47206","E01013227",2011,751,96,655,72
"47207","E01013228",2011,691,17,674,92
"47208","E01013229",2011,575,154,421,89
"47209","E01013231",2011,708,26,682,224
"47210","E01013233",2011,618,7,611,171
"47211","E01013234",2011,656,27,629,117
"47212","E01013236",2011,728,87,641,80
"47213","E01013237",2011,647,263,384,70
"47214","E01013238",2011,769,209,560,135
"47215","E01013239",2011,714,30,684,184
"47216","E01013240",2011,987,310,677,120
"47217","E01013241",2011,725,31,694,93
"47218","E01013242",2011,709,17,692,43
"47219","E01013243",2011,871,38,833,94
"47220","E01013244",2011,790,206,584,58
"47221","E01013245",2011,609,129,480,88
"47222","E01013246",2011,638,89,549,65
"47223","E01013247",2011,711,38,673,74
"47224","E01013248",2011,760,22,738,91
"47225","E01013249",2011,747,179,568,86
"47226","E01013250",2011,703,113,590,30
"47227","E01013251",2011,768,19,749,41
"47228","E01013252",2011,695,17,678,51
"47229","E01013253",2011,801,104,697,78
"47230","E01013254",2011,814,193,621,153
"47231","E01013255",2011,832,35,797,198
"47232","E01013256",2011,1029,26,1003,153
"47233","E01013257",2011,746,20,726,53
"47234","E01013258",2011,712,183,529,85
"47235","E01013259",2011,683,212,471,55
"47236","E01013260",2011,660,10,650,32
"47237","E01013261",2011,640,6,634,28
"47238","E01013262",2011,598,19,579,35
"47239","E01013263",2011,666,41,625,35
"47240","E01013264",2011,746,42,704,71
"47241","E01013265",2011,726,4,722,46
"47242","E01013266",2011,835,3,832,111
"47243","E01013267",2011,507,55,452,66
"47244","E01013268",2011,567,66,501,99
"47245","E01013269",2011,720,78,642,58
"47246","E01013270",2011,829,91,738,113
"47247","E01013271",2011,768,165,603,115
"47248","E01013272",2011,832,194,638,194
"47249","E01013273",2011,757,21,736,70
"47250","E01013274",2011,818,29,789,207
"47251","E01013275",2011,650,30,620,43
"47252","E01013276",2011,730,142,588,89
"47253","E01013277",2011,636,14,622,59
"47254","E01013278",2011,641,413,228,47
"47255","E01013279",2011,716,446,270,52
"47256","E01013280",2011,601,59,542,53
"47257","E01013281",2011,517,196,321,55
"47258","E01013282",2011,624,166,458,73
"47259","E01013283",2011,530,226,304,44
"47260","E01013284",2011,645,262,383,55
"47261","E01013285",2011,524,36,488,29
"47262","E01013286",2011,1159,224,935,185
"47263","E01013287",2011,698,36,662,94
"47264","E01013288",2011,647,20,627,63
"47265","E01013289",2011,704,13,691,141
"47266","E01013290",2011,728,44,684,86
"47267","E01013291",2011,604,232,372,78
"47268","E01013292",2011,750,13,737,87
"47269","E01013293",2011,667,30,637,47
"47270","E01013294",2011,666,77,589,67
"47271","E01013295",2011,596,21,575,45
"47272","E01013296",2011,648,124,524,299
"47273","E01013297",2011,876,111,765,136
"47274","E01013298",2011,534,219,315,84
"47275","E01013299",2011,657,412,245,63
"47276","E01013300",2011,629,120,509,236
"47277","E01013301",2011,654,47,607,99
"47278","E01013302",2011,557,43,514,60
"47279","E01013303",2011,579,82,497,77
"47280","E01013304",2011,659,28,631,65
"47281","E01013305",2011,651,13,638,68
"47282","E01013306",2011,658,88,570,70
"47283","E01013307",2011,747,87,660,101
"47284","E01013308",2011,746,114,632,84
"47285","E01013309",2011,702,57,645,141
"47286","E01013310",2011,614,117,497,75
"47287","E01013311",2011,772,425,347,60
"47288","E01013312",2011,800,328,472,173
"47289","E01013313",2011,670,56,614,118
"47290","E01013314",2011,631,107,524,70
"47291","E01013315",2011,776,351,425,83
"47292","E01013316",2011,588,3,585,38
"47293","E01013317",2011,558,65,493,36
"47294","E01013318",2011,625,70,555,79
"47295","E01013319",2011,920,287,633,163
"47296","E01013320",2011,636,134,502,82
"47297","E01013321",2011,665,26,639,66
"47298","E01013322",2011,806,78,728,132
"47299","E01013323",2011,670,84,586,147
"47300","E01013324",2011,627,22,605,68
"47301","E01013325",2011,650,13,637,67
"47302","E01013326",2011,696,73,623,61
"47303","E01013327",2011,697,65,632,72
"47304","E01013328",2011,519,25,494,35
"47305","E01013329",2011,773,133,640,97
"47306","E01013330",2011,778,155,623,365
"47307","E01013331",2011,845,421,424,136
"47308","E01013332",2011,660,101,559,231
"47309","E01013333",2011,620,32,588,140
"47310","E01013334",2011,648,48,600,104
"47311","E01013335",2011,639,270,369,36
"47312","E01013336",2011,638,106,532,51
"47313","E01013337",2011,697,33,664,63
"47314","E01013338",2011,902,90,812,111
"47315","E01013339",2011,644,16,628,25
"47316","E01013340",2011,521,5,516,35
"47317","E01013341",2011,616,57,559,37
"47318","E01013342",2011,599,10,589,47
"47319","E01013343",2011,839,47,792,335
"47320","E01013344",2011,677,24,653,232
"47321","E01013345",2011,786,91,695,232
"47322","E01013346",2011,810,104,706,162
"47323","E01013347",2011,667,320,347,80
"47324","E01013348",2011,672,54,618,308
"47325","E01013349",2011,523,267,256,56
"47326","E01013350",2011,678,273,405,99
"47327","E01013351",2011,761,20,741,48
"47328","E01013352",2011,758,69,689,58
"47329","E01013353",2011,727,224,503,53
"47330","E01013354",2011,613,8,605,37
"47331","E01013355",2011,710,8,702,57
"47332","E01013356",2011,654,47,607,45
"47333","E01013357",2011,808,20,788,57
"47334","E01013358",2011,671,12,659,94
"47335","E01013359",2011,660,160,500,55
"47336","E01013360",2011,648,30,618,242
"47337","E01013361",2011,799,35,764,270
"47338","E01013362",2011,772,52,720,187
"47339","E01013363",2011,861,141,720,407
"47340","E01013364",2011,865,128,737,451
"47341","E01013365",2011,1181,116,1065,218
"47342","E01013366",2011,975,289,686,403
"47343","E01013368",2011,937,46,891,407
"47344","E01013369",2011,982,198,784,420
"47345","E01013370",2011,756,82,674,67
"47346","E01013371",2011,588,2,586,34
"47347","E01013372",2011,805,5,800,49
"47348","E01013373",2011,635,101,534,31
"47349","E01013374",2011,594,4,590,42
"47350","E01013375",2011,598,3,595,37
"47351","E01013376",2011,635,25,610,17
"47352","E01013377",2011,659,16,643,40
"47353","E01013378",2011,480,54,426,129
"47354","E01013379",2011,614,42,572,58
"47355","E01013380",2011,716,73,643,211
"47356","E01013381",2011,615,27,588,76
"47357","E01013382",2011,760,189,571,133
"47358","E01013383",2011,1031,237,794,435
"47359","E01013384",2011,653,224,429,126
"47360","E01013385",2011,635,231,404,47
"47361","E01013386",2011,761,307,454,130
"47362","E01013387",2011,679,2,677,40
"47363","E01013388",2011,503,4,499,38
"47364","E01013389",2011,505,8,497,19
"47365","E01013390",2011,796,64,732,316
"47366","E01013391",2011,1049,76,973,434
"47367","E01013392",2011,632,29,603,90
"47368","E01013393",2011,730,100,630,130
"47369","E01013394",2011,663,303,360,42
"47370","E01013395",2011,650,29,621,113
"47371","E01013396",2011,767,77,690,132
"47372","E01013397",2011,643,41,602,90
"47373","E01013398",2011,556,147,409,133
"47374","E01013399",2011,682,404,278,98
"47375","E01013400",2011,862,77,785,503
"47376","E01013401",2011,593,57,536,201
"47377","E01013402",2011,641,3,638,131
"47378","E01013403",2011,650,73,577,233
"47379","E01013404",2011,647,270,377,34
"47380","E01013405",2011,611,5,606,29
"47381","E01013406",2011,835,156,679,123
"47382","E01013407",2011,672,84,588,35
"47383","E01013408",2011,626,10,616,27
"47384","E01013409",2011,705,93,612,48
"47385","E01013410",2011,620,452,168,26
"47386","E01013411",2011,713,6,707,41
"47387","E01013412",2011,881,62,819,332
"47388","E01013413",2011,727,9,718,142
"47389","E01013414",2011,770,32,738,244
"47390","E01013416",2011,791,325,466,190
"47391","E01013417",2011,838,54,784,251
"47392","E01013418",2011,798,143,655,229
"47393","E01013419",2011,652,69,583,65
"47394","E01013420",2011,854,26,828,110
"47395","E01013421",2011,524,30,494,63
"47396","E01013422",2011,644,33,611,51
"47397","E01013423",2011,533,4,529,21
"47398","E01013424",2011,506,16,490,21
"47399","E01013425",2011,688,44,644,64
"47400","E01013426",2011,718,55,663,42
"47401","E01013427",2011,605,7,598,22
"47402","E01013428",2011,701,117,584,66
"47403","E01013429",2011,808,49,759,111
"47404","E01013430",2011,656,93,563,45
"47405","E01013431",2011,656,53,603,94
"47406","E01013432",2011,865,33,832,101
"47407","E01013433",2011,651,6,645,35
"47408","E01013434",2011,616,12,604,49
"47409","E01013435",2011,630,48,582,32
"47410","E01013436",2011,626,28,598,168
"47411","E01013437",2011,525,41,484,72
"47412","E01013438",2011,733,133,600,70
"47413","E01013439",2011,527,1,526,33
"47414","E01013440",2011,787,2,785,67
"47415","E01013441",2011,697,29,668,139
"47416","E01013442",2011,615,133,482,34
"47417","E01013443",2011,709,398,311,54
"47418","E01013444",2011,585,252,333,35
"47419","E01013445",2011,769,257,512,93
"47420","E01013446",2011,700,189,511,54
"47421","E01013447",2011,617,243,374,46
"47422","E01013448",2011,604,281,323,59
"47423","E01013449",2011,708,131,577,50
"47424","E01013450",2011,512,26,486,52
"47425","E01013451",2011,468,16,452,46
"47426","E01013452",2011,640,31,609,38
"47427","E01013453",2011,1121,284,837,468
"47428","E01013454",2011,543,160,383,142
"47429","E01013455",2011,812,188,624,115
"47430","E01013456",2011,1053,431,622,396
"47431","E01013457",2011,822,119,703,322
"47432","E01013458",2011,569,79,490,89
"47433","E01013459",2011,595,44,551,95
"47434","E01013460",2011,909,109,800,553
"47435","E01013461",2011,711,6,705,68
"47436","E01013462",2011,633,52,581,46
"47437","E01013463",2011,607,4,603,43
"47438","E01013464",2011,634,26,608,32
"47439","E01013465",2011,694,13,681,34
"47440","E01013466",2011,648,1,647,26
"47441","E01013467",2011,609,4,605,34
"47442","E01013468",2011,698,4,694,41
"47443","E01013469",2011,722,6,716,137
"47444","E01013470",2011,625,111,514,48
"47445","E01013471",2011,806,114,692,229
"47446","E01013472",2011,965,505,460,132
"47447","E01013473",2011,670,198,472,142
"47448","E01013474",2011,719,214,505,84
"47449","E01013475",2011,573,242,331,80
"47450","E01013476",2011,723,64,659,110
"47451","E01013477",2011,765,107,658,175
"47452","E01013479",2011,1142,498,644,516
"47453","E01013480",2011,1085,404,681,472
"47454","E01013481",2011,585,137,448,172
"47455","E01013483",2011,699,74,625,231
"47456","E01013484",2011,695,192,503,237
"47457","E01013485",2011,639,134,505,196
"47458","E01013486",2011,573,97,476,179
"47459","E01013487",2011,761,186,575,252
"47460","E01013488",2011,572,7,565,45
"47461","E01013489",2011,618,5,613,60
"47462","E01013490",2011,587,83,504,34
"47463","E01013491",2011,600,35,565,59
"47464","E01013492",2011,594,24,570,45
"47465","E01013493",2011,647,132,515,79
"47466","E01013494",2011,795,267,528,74
"47467","E01013495",2011,712,117,595,75
"47468","E01013496",2011,661,324,337,68
"47469","E01013497",2011,617,218,399,80
"47470","E01013498",2011,585,69,516,42
"47471","E01013499",2011,646,211,435,45
"47472","E01013500",2011,724,123,601,51
"47473","E01013501",2011,620,70,550,40
"47474","E01013502",2011,614,178,436,57
"47475","E01013503",2011,615,36,579,71
"47476","E01013504",2011,714,243,471,134
"47477","E01013505",2011,608,25,583,43
"47478","E01013506",2011,696,116,580,55
"47479","E01013507",2011,643,53,590,39
"47480","E01013508",2011,488,173,315,32
"47481","E01013509",2011,713,63,650,77
"47482","E01013510",2011,624,204,420,41
"47483","E01013511",2011,637,13,624,40
"47484","E01013512",2011,632,204,428,75
"47485","E01013513",2011,500,129,371,30
"47486","E01013514",2011,684,53,631,75
"47487","E01013515",2011,730,233,497,54
"47488","E01013517",2011,667,139,528,48
"47489","E01013518",2011,581,39,542,59
"47490","E01013519",2011,587,140,447,56
"47491","E01013520",2011,645,8,637,65
"47492","E01013521",2011,691,271,420,60
"47493","E01013522",2011,918,338,580,278
"47494","E01013523",2011,836,316,520,287
"47495","E01013524",2011,676,233,443,249
"47496","E01013525",2011,1062,178,884,312
"47497","E01013526",2011,735,59,676,108
"47498","E01013527",2011,638,12,626,66
"47499","E01013528",2011,731,125,606,152
"47500","E01013529",2011,1032,188,844,260
"47501","E01013530",2011,622,106,516,137
"47502","E01013531",2011,601,147,454,56
"47503","E01013532",2011,618,173,445,48
"47504","E01013533",2011,705,474,231,33
"47505","E01013534",2011,662,104,558,65
"47506","E01013535",2011,521,357,164,27
"47507","E01013536",2011,680,389,291,66
"47508","E01013537",2011,725,108,617,84
"47509","E01013538",2011,625,94,531,125
"47510","E01013539",2011,718,22,696,46
"47511","E01013540",2011,645,37,608,49
"47512","E01013541",2011,651,140,511,123
"47513","E01013542",2011,696,143,553,107
"47514","E01013543",2011,624,11,613,61
"47515","E01013544",2011,670,18,652,65
"47516","E01013545",2011,714,149,565,99
"47517","E01013546",2011,645,16,629,76
"47518","E01013547",2011,809,80,729,394
"47519","E01013548",2011,639,164,475,47
"47520","E01013549",2011,622,186,436,39
"47521","E01013550",2011,538,211,327,84
"47522","E01013551",2011,687,90,597,354
"47523","E01013552",2011,738,318,420,47
"47524","E01013553",2011,646,183,463,39
"47525","E01013554",2011,805,293,512,277
"47526","E01013555",2011,598,129,469,38
"47527","E01013556",2011,611,3,608,61
"47528","E01013557",2011,605,4,601,27
"47529","E01013558",2011,853,84,769,63
"47530","E01013559",2011,579,8,571,49
"47531","E01013560",2011,595,5,590,41
"47532","E01013561",2011,687,9,678,57
"47533","E01013562",2011,719,159,560,79
"47534","E01013563",2011,627,4,623,70
"47535","E01013564",2011,809,17,792,76
"47536","E01013565",2011,541,37,504,171
"47537","E01013566",2011,720,166,554,249
"47538","E01013567",2011,633,100,533,226
"47539","E01013568",2011,751,126,625,212
"47540","E01013569",2011,541,28,513,149
"47541","E01013570",2011,681,177,504,183
"47542","E01013571",2011,670,174,496,153
"47543","E01013572",2011,688,168,520,69
"47544","E01013573",2011,813,479,334,59
"47545","E01013574",2011,536,5,531,26
"47546","E01013575",2011,602,7,595,83
"47547","E01013576",2011,566,19,547,65
"47548","E01013577",2011,596,3,593,50
"47549","E01013578",2011,555,4,551,79
"47550","E01013579",2011,631,10,621,102
"47551","E01013580",2011,701,2,699,167
"47552","E01013581",2011,610,242,368,64
"47553","E01013582",2011,694,112,582,97
"47554","E01013583",2011,582,256,326,104
"47555","E01013584",2011,635,387,248,49
"47556","E01013585",2011,660,277,383,71
"47557","E01013586",2011,618,350,268,79
"47558","E01013587",2011,590,36,554,74
"47559","E01013588",2011,662,237,425,69
"47560","E01013589",2011,551,45,506,49
"47561","E01013590",2011,643,380,263,88
"47562","E01013591",2011,819,264,555,238
"47563","E01013592",2011,635,16,619,80
"47564","E01013593",2011,591,10,581,40
"47565","E01013594",2011,630,31,599,25
"47566","E01013595",2011,957,151,806,129
"47567","E01013596",2011,692,44,648,53
"47568","E01013597",2011,650,230,420,45
"47569","E01013598",2011,632,149,483,69
"47570","E01013599",2011,618,2,616,31
"47571","E01013600",2011,755,419,336,48
"47572","E01013601",2011,644,275,369,50
"47573","E01013602",2011,797,360,437,120
"47574","E01013603",2011,798,505,293,59
"47575","E01013604",2011,648,301,347,64
"47576","E01013605",2011,698,115,583,174
"47577","E01013606",2011,693,21,672,78
"47578","E01013607",2011,1136,158,978,379
"47579","E01013608",2011,627,13,614,86
"47580","E01013609",2011,741,102,639,81
"47581","E01013610",2011,747,242,505,79
"47582","E01013611",2011,604,144,460,54
"47583","E01013612",2011,631,29,602,110
"47584","E01013613",2011,775,59,716,270
"47585","E01013614",2011,714,55,659,186
"47586","E01013615",2011,543,30,513,57
"47587","E01013616",2011,683,159,524,103
"47588","E01013617",2011,936,164,772,221
"47589","E01013618",2011,685,160,525,72
"47590","E01013619",2011,639,388,251,47
"47591","E01013620",2011,694,513,181,47
"47592","E01013621",2011,743,531,212,55
"47593","E01013622",2011,729,449,280,53
"47594","E01013623",2011,807,101,706,99
"47595","E01013624",2011,511,240,271,64
"47596","E01013625",2011,668,196,472,180
"47597","E01013626",2011,574,171,403,133
"47598","E01013627",2011,421,14,407,73
"47599","E01013628",2011,645,287,358,118
"47600","E01013629",2011,527,101,426,112
"47601","E01013630",2011,576,107,469,173
"47602","E01013631",2011,544,250,294,30
"47603","E01013632",2011,740,565,175,20
"47604","E01013633",2011,681,358,323,52
"47605","E01013634",2011,622,332,290,34
"47606","E01013635",2011,595,22,573,143
"47607","E01013636",2011,492,5,487,51
"47608","E01013637",2011,764,388,376,48
"47609","E01013638",2011,664,479,185,27
"47610","E01013639",2011,538,191,347,63
"47611","E01013640",2011,636,486,150,29
"47612","E01013641",2011,617,63,554,252
"47613","E01013642",2011,837,27,810,451
"47614","E01013643",2011,738,17,721,356
"47615","E01013646",2011,1099,230,869,644
"47616","E01013647",2011,947,623,324,250
"47617","E01013648",2011,746,203,543,440
"47618","E01013649",2011,684,48,636,343
"47619","E01013650",2011,742,13,729,400
"47620","E01013651",2011,648,276,372,83
"47621","E01013652",2011,576,265,311,75
"47622","E01013653",2011,683,325,358,110
"47623","E01013654",2011,835,384,451,217
"47624","E01013655",2011,717,187,530,228
"47625","E01013656",2011,502,70,432,185
"47626","E01013657",2011,529,162,367,128
"47627","E01013658",2011,561,70,491,224
"47628","E01013659",2011,565,101,464,237
"47629","E01013660",2011,647,135,512,148
"47630","E01013661",2011,633,325,308,71
"47631","E01013662",2011,517,16,501,156
"47632","E01013663",2011,512,34,478,84
"47633","E01013664",2011,777,402,375,80
"47634","E01013665",2011,620,123,497,127
"47635","E01013666",2011,597,6,591,40
"47636","E01013667",2011,678,310,368,50
"47637","E01013668",2011,578,61,517,170
"47638","E01013669",2011,457,4,453,34
"47639","E01013670",2011,707,79,628,81
"47640","E01013671",2011,589,70,519,61
"47641","E01013672",2011,511,23,488,28
"47642","E01013673",2011,611,260,351,32
"47643","E01013674",2011,774,428,346,37
"47644","E01013675",2011,667,240,427,53
"47645","E01013676",2011,823,350,473,77
"47646","E01013677",2011,672,311,361,47
"47647","E01013678",2011,644,156,488,64
"47648","E01013679",2011,520,283,237,39
"47649","E01013680",2011,822,43,779,203
"47650","E01013681",2011,772,109,663,388
"47651","E01013682",2011,772,99,673,300
"47652","E01013683",2011,980,119,861,468
"47653","E01013684",2011,894,197,697,431
"47654","E01013685",2011,616,6,610,55
"47655","E01013686",2011,708,11,697,123
"47656","E01013687",2011,737,65,672,350
"47657","E01013688",2011,699,153,546,248
"47658","E01013689",2011,519,62,457,236
"47659","E01013690",2011,656,161,495,134
"47660","E01013691",2011,606,430,176,23
"47661","E01013692",2011,483,371,112,13
"47662","E01013693",2011,522,398,124,18
"47663","E01013694",2011,650,266,384,83
"47664","E01013695",2011,609,269,340,45
"47665","E01013696",2011,818,130,688,128
"47666","E01013697",2011,921,136,785,147
"47667","E01013698",2011,587,157,430,46
"47668","E01013699",2011,644,79,565,97
"47669","E01013700",2011,615,124,491,49
"47670","E01013702",2011,623,12,611,121
"47671","E01013703",2011,513,8,505,80
"47672","E01013704",2011,597,7,590,126
"47673","E01013705",2011,667,163,504,64
"47674","E01013706",2011,646,17,629,87
"47675","E01013707",2011,602,12,590,62
"47676","E01013709",2011,552,3,549,67
"47677","E01013710",2011,714,31,683,258
"47678","E01013711",2011,728,101,627,276
"47679","E01013712",2011,570,21,549,113
"47680","E01013713",2011,489,76,413,133
"47681","E01013714",2011,503,40,463,108
"47682","E01013715",2011,439,48,391,117
"47683","E01013716",2011,560,90,470,179
"47684","E01013717",2011,495,94,401,109
"47685","E01013718",2011,558,129,429,120
"47686","E01013719",2011,480,77,403,144
"47687","E01013720",2011,606,372,234,51
"47688","E01013721",2011,658,174,484,68
"47689","E01013722",2011,598,279,319,32
"47690","E01013723",2011,480,233,247,39
"47691","E01013725",2011,528,337,191,43
"47692","E01013726",2011,885,662,223,49
"47693","E01013727",2011,649,260,389,56
"47694","E01013728",2011,542,273,269,43
"47695","E01013729",2011,545,80,465,62
"47696","E01013730",2011,758,479,279,48
"47697","E01013731",2011,648,264,384,66
"47698","E01013732",2011,742,34,708,166
"47699","E01013733",2011,619,15,604,105
"47700","E01013734",2011,531,47,484,87
"47701","E01013735",2011,469,7,462,56
"47702","E01013736",2011,720,22,698,102
"47703","E01013737",2011,465,4,461,89
"47704","E01013738",2011,491,3,488,57
"47705","E01013739",2011,570,120,450,75
"47706","E01013740",2011,499,22,477,81
"47707","E01013741",2011,529,8,521,107
"47708","E01013742",2011,462,123,339,110
"47709","E01013743",2011,428,73,355,112
"47710","E01013744",2011,482,46,436,107
"47711","E01013745",2011,423,51,372,103
"47712","E01013746",2011,724,562,162,65
"47713","E01013747",2011,532,22,510,154
"47714","E01013748",2011,682,491,191,82
"47715","E01013749",2011,449,40,409,74
"47716","E01013750",2011,416,16,400,99
"47717","E01013751",2011,524,51,473,156
"47718","E01013752",2011,444,43,401,114
"47719","E01013753",2011,517,135,382,157
"47720","E01013754",2011,705,569,136,55
"47721","E01013755",2011,720,633,87,29
"47722","E01013756",2011,675,73,602,224
"47723","E01013757",2011,489,7,482,82
"47724","E01013758",2011,428,8,420,100
"47725","E01013759",2011,531,8,523,61
"47726","E01013760",2011,698,172,526,335
"47727","E01013761",2011,619,279,340,175
"47728","E01013762",2011,542,103,439,193
"47729","E01013763",2011,828,218,610,439
"47730","E01013764",2011,458,5,453,55
"47731","E01013765",2011,548,75,473,250
"47732","E01013766",2011,500,37,463,75
"47733","E01013767",2011,567,89,478,41
"47734","E01013768",2011,705,286,419,49
"47735","E01013770",2011,551,98,453,55
"47736","E01013771",2011,519,13,506,51
"47737","E01013772",2011,616,213,403,47
"47738","E01013773",2011,576,190,386,34
"47739","E01013774",2011,704,47,657,436
"47740","E01013775",2011,968,50,918,577
"47741","E01013776",2011,754,57,697,476
"47742","E01013777",2011,731,19,712,342
"47743","E01013778",2011,939,360,579,424
"47744","E01013779",2011,893,51,842,594
"47745","E01013780",2011,622,8,614,88
"47746","E01013781",2011,768,95,673,428
"47747","E01013782",2011,673,80,593,230
"47748","E01013783",2011,619,7,612,76
"47749","E01013784",2011,525,12,513,234
"47750","E01013785",2011,542,5,537,40
"47751","E01013786",2011,700,34,666,171
"47752","E01013787",2011,540,38,502,80
"47753","E01013788",2011,1014,109,905,305
"47754","E01013789",2011,596,50,546,112
"47755","E01013790",2011,501,36,465,62
"47756","E01013791",2011,483,84,399,65
"47757","E01013792",2011,684,27,657,81
"47758","E01013793",2011,610,30,580,84
"47759","E01013794",2011,561,30,531,62
"47760","E01013795",2011,488,43,445,83
"47761","E01013796",2011,565,70,495,161
"47762","E01013797",2011,724,45,679,141
"47763","E01013798",2011,579,16,563,70
"47764","E01013799",2011,651,150,501,178
"47765","E01013800",2011,659,81,578,50
"47766","E01013801",2011,725,142,583,129
"47767","E01013802",2011,1178,146,1032,170
"47768","E01013803",2011,982,116,866,79
"47769","E01013804",2011,661,31,630,63
"47770","E01013805",2011,536,98,438,59
"47771","E01013806",2011,498,41,457,88
"47772","E01013807",2011,622,86,536,93
"47773","E01013808",2011,620,155,465,76
"47774","E01013809",2011,525,61,464,42
"47775","E01013810",2011,617,199,418,194
"47776","E01013811",2011,588,250,338,237
"47777","E01013812",2011,570,199,371,238
"47778","E01013813",2011,758,590,168,128
"47779","E01013814",2011,841,290,551,414
"47780","E01013815",2011,627,238,389,305
"47781","E01013816",2011,914,332,582,470
"47782","E01013817",2011,642,348,294,91
"47783","E01013818",2011,579,379,200,51
"47784","E01013819",2011,735,346,389,88
"47785","E01013820",2011,669,308,361,105
"47786","E01013821",2011,627,266,361,100
"47787","E01013822",2011,641,369,272,69
"47788","E01013823",2011,666,244,422,88
"47789","E01013824",2011,599,254,345,89
"47790","E01013825",2011,690,259,431,88
"47791","E01013826",2011,706,391,315,93
"47792","E01013827",2011,608,225,383,89
"47793","E01013828",2011,790,117,673,202
"47794","E01013829",2011,797,209,588,168
"47795","E01013830",2011,696,101,595,106
"47796","E01013831",2011,672,42,630,61
"47797","E01013832",2011,745,240,505,168
"47798","E01013833",2011,561,224,337,53
"47799","E01013834",2011,642,296,346,66
"47800","E01013835",2011,715,297,418,89
"47801","E01013836",2011,872,257,615,227
"47802","E01013837",2011,736,33,703,150
"47803","E01013838",2011,664,28,636,123
"47804","E01013839",2011,862,325,537,253
"47805","E01013840",2011,982,33,949,351
"47806","E01013841",2011,692,179,513,247
"47807","E01013842",2011,648,155,493,280
"47808","E01013843",2011,663,48,615,376
"47809","E01013844",2011,621,137,484,284
"47810","E01013845",2011,606,89,517,225
"47811","E01013846",2011,684,166,518,336
"47812","E01013847",2011,433,59,374,166
"47813","E01013849",2011,693,344,349,51
"47814","E01013850",2011,715,312,403,53
"47815","E01013851",2011,786,466,320,78
"47816","E01013852",2011,763,311,452,53
"47817","E01013853",2011,653,170,483,41
"47818","E01013854",2011,639,256,383,47
"47819","E01013855",2011,642,340,302,76
"47820","E01013856",2011,638,205,433,68
"47821","E01013858",2011,592,181,411,44
"47822","E01013859",2011,732,305,427,51
"47823","E01013860",2011,713,289,424,52
"47824","E01013861",2011,722,436,286,34
"47825","E01013862",2011,640,360,280,39
"47826","E01013863",2011,620,99,521,71
"47827","E01013864",2011,710,430,280,73
"47828","E01013865",2011,752,275,477,54
"47829","E01013866",2011,609,239,370,56
"47830","E01013867",2011,598,265,333,67
"47831","E01013868",2011,627,345,282,41
"47832","E01013870",2011,1026,432,594,293
"47833","E01013871",2011,858,498,360,76
"47834","E01013872",2011,821,325,496,176
"47835","E01013873",2011,619,111,508,213
"47836","E01013874",2011,684,67,617,236
"47837","E01013875",2011,521,20,501,33
"47838","E01013876",2011,757,274,483,214
"47839","E01013877",2011,680,442,238,62
"47840","E01013878",2011,538,273,265,33
"47841","E01013879",2011,573,284,289,60
"47842","E01013880",2011,678,301,377,81
"47843","E01013881",2011,649,296,353,68
"47844","E01013882",2011,628,157,471,115
"47845","E01013883",2011,681,262,419,52
"47846","E01013884",2011,639,287,352,61
"47847","E01013885",2011,769,278,491,191
"47848","E01013886",2011,660,182,478,82
"47849","E01013887",2011,637,26,611,37
"47850","E01013888",2011,696,92,604,120
"47851","E01013889",2011,721,76,645,95
"47852","E01013890",2011,661,27,634,130
"47853","E01013891",2011,731,255,476,110
"47854","E01013892",2011,600,13,587,40
"47855","E01013893",2011,583,258,325,51
"47856","E01013894",2011,638,25,613,30
"47857","E01013895",2011,636,8,628,40
"47858","E01013896",2011,588,274,314,58
"47859","E01013897",2011,641,190,451,67
"47860","E01013898",2011,436,123,313,63
"47861","E01013899",2011,492,124,368,40
"47862","E01013900",2011,672,204,468,56
"47863","E01013901",2011,639,11,628,93
"47864","E01013902",2011,677,30,647,84
"47865","E01013903",2011,491,63,428,51
"47866","E01013904",2011,626,148,478,54
"47867","E01013905",2011,633,233,400,67
"47868","E01013906",2011,689,173,516,67
"47869","E01013907",2011,756,340,416,75
"47870","E01013908",2011,774,249,525,61
"47871","E01013909",2011,786,388,398,54
"47872","E01013910",2011,628,141,487,79
"47873","E01013911",2011,690,213,477,47
"47874","E01013912",2011,666,78,588,60
"47875","E01013913",2011,688,70,618,68
"47876","E01013914",2011,627,12,615,74
"47877","E01013915",2011,656,70,586,81
"47878","E01013916",2011,622,236,386,59
"47879","E01013917",2011,783,233,550,127
"47880","E01013918",2011,781,109,672,349
"47881","E01013919",2011,836,147,689,363
"47882","E01013920",2011,1219,701,518,287
"47883","E01013921",2011,882,319,563,332
"47884","E01013924",2011,723,467,256,212
"47885","E01013926",2011,633,167,466,307
"47886","E01013928",2011,548,65,483,369
"47887","E01013929",2011,751,105,646,97
"47888","E01013930",2011,731,133,598,163
"47889","E01013931",2011,622,51,571,49
"47890","E01013932",2011,658,66,592,108
"47891","E01013933",2011,780,336,444,125
"47892","E01013934",2011,647,147,500,99
"47893","E01013935",2011,744,23,721,149
"47894","E01013936",2011,1057,141,916,321
"47895","E01013937",2011,748,64,684,239
"47896","E01013938",2011,704,41,663,219
"47897","E01013939",2011,769,73,696,164
"47898","E01013940",2011,753,420,333,115
"47899","E01013941",2011,827,34,793,407
"47900","E01013942",2011,958,503,455,153
"47901","E01013943",2011,812,173,639,404
"47902","E01013944",2011,651,52,599,209
"47903","E01013945",2011,610,194,416,284
"47904","E01013947",2011,759,281,478,338
"47905","E01013948",2011,754,617,137,66
"47906","E01013953",2011,513,28,485,394
"47907","E01013954",2011,594,218,376,110
"47908","E01013957",2011,654,207,447,164
"47909","E01013958",2011,838,490,348,143
"47910","E01013959",2011,841,479,362,94
"47911","E01013960",2011,770,517,253,61
"47912","E01013961",2011,853,308,545,403
"47913","E01013962",2011,859,308,551,138
"47914","E01013963",2011,718,262,456,53
"47915","E01013964",2011,671,159,512,79
"47916","E01013965",2011,617,150,467,73
"47917","E01013966",2011,568,160,408,66
"47918","E01013967",2011,478,53,425,91
"47919","E01013968",2011,669,161,508,68
"47920","E01013969",2011,798,45,753,325
"47921","E01013970",2011,670,35,635,191
"47922","E01013971",2011,769,83,686,287
"47923","E01013972",2011,693,102,591,251
"47924","E01013973",2011,401,184,217,117
"47925","E01013974",2011,667,128,539,159
"47926","E01013975",2011,425,60,365,86
"47927","E01013976",2011,679,247,432,186
"47928","E01013977",2011,766,76,690,98
"47929","E01013978",2011,669,114,555,111
"47930","E01013979",2011,601,11,590,86
"47931","E01013980",2011,666,10,656,65
"47932","E01013981",2011,653,21,632,79
"47933","E01013982",2011,625,27,598,42
"47934","E01013983",2011,733,367,366,74
"47935","E01013984",2011,643,6,637,32
"47936","E01013985",2011,739,33,706,77
"47937","E01013986",2011,729,285,444,122
"47938","E01013987",2011,671,57,614,67
"47939","E01013988",2011,912,92,820,134
"47940","E01013989",2011,582,208,374,74
"47941","E01013990",2011,751,54,697,99
"47942","E01013991",2011,536,77,459,79
"47943","E01013992",2011,594,204,390,79
"47944","E01013993",2011,606,224,382,44
"47945","E01013994",2011,632,308,324,39
"47946","E01013995",2011,734,502,232,36
"47947","E01013996",2011,680,15,665,135
"47948","E01013997",2011,822,44,778,146
"47949","E01013998",2011,612,26,586,53
"47950","E01013999",2011,614,38,576,81
"47951","E01014000",2011,567,33,534,65
"47952","E01014001",2011,623,46,577,85
"47953","E01014002",2011,616,17,599,57
"47954","E01014003",2011,595,97,498,76
"47955","E01014004",2011,589,49,540,86
"47956","E01014005",2011,798,281,517,180
"47957","E01014006",2011,652,60,592,67
"47958","E01014007",2011,668,12,656,51
"47959","E01014008",2011,705,67,638,97
"47960","E01014009",2011,646,70,576,59
"47961","E01014010",2011,849,144,705,419
"47962","E01014011",2011,648,122,526,188
"47963","E01014012",2011,699,39,660,92
"47964","E01014013",2011,670,130,540,139
"47965","E01014014",2011,729,51,678,101
"47966","E01014015",2011,656,53,603,104
"47967","E01014016",2011,665,136,529,114
"47968","E01014017",2011,632,24,608,104
"47969","E01014018",2011,628,29,599,109
"47970","E01014019",2011,671,76,595,76
"47971","E01014020",2011,636,20,616,72
"47972","E01014021",2011,638,73,565,98
"47973","E01014022",2011,791,22,769,92
"47974","E01014023",2011,680,74,606,105
"47975","E01014024",2011,545,34,511,87
"47976","E01014025",2011,596,68,528,57
"47977","E01014026",2011,896,74,822,172
"47978","E01014027",2011,532,58,474,64
"47979","E01014028",2011,624,28,596,73
"47980","E01014029",2011,656,123,533,83
"47981","E01014030",2011,587,65,522,34
"47982","E01014031",2011,631,41,590,71
"47983","E01014032",2011,689,35,654,100
"47984","E01014033",2011,776,83,693,146
"47985","E01014034",2011,683,162,521,157
"47986","E01014035",2011,790,249,541,159
"47987","E01014036",2011,690,27,663,160
"47988","E01014037",2011,733,52,681,67
"47989","E01014038",2011,624,128,496,76
"47990","E01014039",2011,721,40,681,134
"47991","E01014040",2011,757,93,664,112
"47992","E01014041",2011,721,55,666,137
"47993","E01014042",2011,665,298,367,111
"47994","E01014043",2011,513,15,498,58
"47995","E01014044",2011,598,96,502,81
"47996","E01014045",2011,683,33,650,149
"47997","E01014046",2011,616,53,563,47
"47998","E01014047",2011,612,186,426,81
"47999","E01014048",2011,776,218,558,259
"48000","E01014049",2011,666,28,638,121
"48001","E01014050",2011,706,34,672,98
"48002","E01014051",2011,737,82,655,138
"48003","E01014052",2011,652,14,638,157
"48004","E01014053",2011,719,48,671,150
"48005","E01014054",2011,585,56,529,90
"48006","E01014055",2011,672,89,583,100
"48007","E01014056",2011,610,23,587,104
"48008","E01014057",2011,726,122,604,77
"48009","E01014058",2011,699,8,691,67
"48010","E01014059",2011,780,25,755,116
"48011","E01014060",2011,646,35,611,95
"48012","E01014061",2011,683,51,632,41
"48013","E01014062",2011,819,90,729,230
"48014","E01014063",2011,734,154,580,53
"48015","E01014064",2011,779,306,473,112
"48016","E01014065",2011,634,63,571,112
"48017","E01014066",2011,541,93,448,123
"48018","E01014067",2011,594,6,588,53
"48019","E01014068",2011,609,106,503,50
"48020","E01014069",2011,793,125,668,146
"48021","E01014070",2011,897,90,807,116
"48022","E01014071",2011,610,278,332,56
"48023","E01014072",2011,826,211,615,105
"48024","E01014073",2011,801,324,477,171
"48025","E01014074",2011,722,335,387,120
"48026","E01014075",2011,693,35,658,110
"48027","E01014076",2011,1030,78,952,320
"48028","E01014077",2011,710,33,677,76
"48029","E01014078",2011,599,118,481,61
"48030","E01014079",2011,641,102,539,63
"48031","E01014080",2011,598,85,513,53
"48032","E01014081",2011,598,45,553,69
"48033","E01014082",2011,694,80,614,62
"48034","E01014083",2011,710,12,698,88
"48035","E01014084",2011,735,155,580,129
"48036","E01014085",2011,578,136,442,79
"48037","E01014086",2011,713,234,479,198
"48038","E01014087",2011,712,14,698,203
"48039","E01014088",2011,696,56,640,197
"48040","E01014089",2011,579,91,488,62
"48041","E01014090",2011,601,6,595,41
"48042","E01014091",2011,634,11,623,39
"48043","E01014092",2011,903,77,826,229
"48044","E01014093",2011,598,110,488,44
"48045","E01014094",2011,589,25,564,41
"48046","E01014095",2011,581,92,489,90
"48047","E01014096",2011,649,30,619,77
"48048","E01014097",2011,576,52,524,81
"48049","E01014098",2011,583,154,429,69
"48050","E01014099",2011,735,33,702,137
"48051","E01014100",2011,650,48,602,85
"48052","E01014101",2011,454,22,432,144
"48053","E01014102",2011,674,13,661,83
"48054","E01014103",2011,473,45,428,44
"48055","E01014104",2011,641,126,515,77
"48056","E01014105",2011,698,242,456,122
"48057","E01014106",2011,618,115,503,106
"48058","E01014107",2011,475,9,466,34
"48059","E01014108",2011,645,241,404,193
"48060","E01014109",2011,463,67,396,73
"48061","E01014110",2011,470,141,329,149
"48062","E01014111",2011,625,61,564,73
"48063","E01014112",2011,624,29,595,62
"48064","E01014113",2011,645,204,441,148
"48065","E01014114",2011,647,86,561,107
"48066","E01014115",2011,549,117,432,124
"48067","E01014116",2011,776,287,489,126
"48068","E01014117",2011,485,17,468,42
"48069","E01014118",2011,447,83,364,144
"48070","E01014119",2011,678,96,582,51
"48071","E01014120",2011,767,421,346,59
"48072","E01014121",2011,614,111,503,50
"48073","E01014122",2011,731,58,673,246
"48074","E01014123",2011,617,11,606,84
"48075","E01014124",2011,755,283,472,140
"48076","E01014125",2011,659,256,403,66
"48077","E01014126",2011,597,136,461,63
"48078","E01014127",2011,644,314,330,80
"48079","E01014128",2011,814,238,576,140
"48080","E01014129",2011,534,178,356,48
"48081","E01014130",2011,579,27,552,74
"48082","E01014131",2011,584,44,540,68
"48083","E01014132",2011,450,31,419,33
"48084","E01014133",2011,773,93,680,90
"48085","E01014134",2011,590,15,575,39
"48086","E01014135",2011,477,34,443,65
"48087","E01014136",2011,693,96,597,96
"48088","E01014137",2011,519,29,490,61
"48089","E01014138",2011,603,156,447,64
"48090","E01014139",2011,517,120,397,87
"48091","E01014140",2011,615,159,456,135
"48092","E01014141",2011,1086,282,804,241
"48093","E01014142",2011,450,185,265,87
"48094","E01014143",2011,602,202,400,102
"48095","E01014144",2011,656,232,424,67
"48096","E01014145",2011,874,275,599,208
"48097","E01014146",2011,776,162,614,81
"48098","E01014147",2011,783,50,733,108
"48099","E01014148",2011,700,37,663,133
"48100","E01014149",2011,435,43,392,65
"48101","E01014150",2011,686,35,651,93
"48102","E01014151",2011,639,240,399,78
"48103","E01014152",2011,587,187,400,43
"48104","E01014153",2011,793,187,606,126
"48105","E01014154",2011,682,128,554,92
"48106","E01014155",2011,676,174,502,77
"48107","E01014156",2011,796,206,590,134
"48108","E01014157",2011,530,9,521,63
"48109","E01014158",2011,643,132,511,82
"48110","E01014159",2011,594,169,425,70
"48111","E01014160",2011,526,50,476,61
"48112","E01014161",2011,499,116,383,52
"48113","E01014162",2011,810,328,482,132
"48114","E01014163",2011,516,238,278,86
"48115","E01014164",2011,691,450,241,56
"48116","E01014165",2011,586,237,349,117
"48117","E01014166",2011,641,113,528,98
"48118","E01014167",2011,688,89,599,70
"48119","E01014168",2011,501,6,495,45
"48120","E01014169",2011,703,202,501,154
"48121","E01014170",2011,658,16,642,39
"48122","E01014171",2011,591,141,450,87
"48123","E01014172",2011,518,6,512,55
"48124","E01014173",2011,663,133,530,123
"48125","E01014174",2011,593,17,576,39
"48126","E01014175",2011,507,91,416,52
"48127","E01014176",2011,632,25,607,88
"48128","E01014177",2011,584,46,538,63
"48129","E01014178",2011,665,135,530,211
"48130","E01014179",2011,487,6,481,36
"48131","E01014180",2011,586,90,496,47
"48132","E01014181",2011,667,7,660,93
"48133","E01014182",2011,469,7,462,48
"48134","E01014183",2011,602,29,573,46
"48135","E01014184",2011,529,81,448,132
"48136","E01014185",2011,790,358,432,110
"48137","E01014186",2011,627,91,536,113
"48138","E01014187",2011,669,110,559,113
"48139","E01014188",2011,607,20,587,92
"48140","E01014189",2011,589,77,512,84
"48141","E01014190",2011,607,9,598,43
"48142","E01014191",2011,731,200,531,214
"48143","E01014192",2011,480,80,400,110
"48144","E01014193",2011,610,145,465,81
"48145","E01014194",2011,595,145,450,78
"48146","E01014195",2011,523,20,503,49
"48147","E01014196",2011,649,266,383,78
"48148","E01014197",2011,552,130,422,139
"48149","E01014198",2011,412,211,201,72
"48150","E01014199",2011,604,106,498,168
"48151","E01014200",2011,452,155,297,134
"48152","E01014201",2011,455,99,356,140
"48153","E01014202",2011,899,55,844,120
"48154","E01014203",2011,618,25,593,56
"48155","E01014204",2011,750,44,706,106
"48156","E01014205",2011,596,8,588,54
"48157","E01014206",2011,511,84,427,76
"48158","E01014207",2011,492,9,483,93
"48159","E01014208",2011,534,187,347,44
"48160","E01014209",2011,591,89,502,86
"48161","E01014210",2011,612,258,354,36
"48162","E01014211",2011,622,420,202,31
"48163","E01014212",2011,610,331,279,22
"48164","E01014213",2011,521,179,342,50
"48165","E01014214",2011,628,5,623,28
"48166","E01014215",2011,610,27,583,54
"48167","E01014216",2011,634,48,586,38
"48168","E01014217",2011,639,384,255,38
"48169","E01014218",2011,612,317,295,49
"48170","E01014219",2011,584,83,501,59
"48171","E01014220",2011,717,414,303,57
"48172","E01014221",2011,657,372,285,62
"48173","E01014222",2011,647,385,262,48
"48174","E01014223",2011,749,482,267,62
"48175","E01014224",2011,671,377,294,49
"48176","E01014225",2011,668,9,659,53
"48177","E01014226",2011,723,287,436,52
"48178","E01014228",2011,573,6,567,24
"48179","E01014229",2011,771,476,295,41
"48180","E01014230",2011,686,141,545,74
"48181","E01014231",2011,947,459,488,137
"48182","E01014233",2011,629,68,561,30
"48183","E01014234",2011,564,282,282,41
"48184","E01014235",2011,765,320,445,68
"48185","E01014236",2011,986,370,616,129
"48186","E01014237",2011,777,443,334,40
"48187","E01014238",2011,666,396,270,42
"48188","E01014239",2011,601,61,540,26
"48189","E01014240",2011,626,139,487,45
"48190","E01014241",2011,656,120,536,93
"48191","E01014242",2011,628,274,354,36
"48192","E01014243",2011,599,38,561,40
"48193","E01014244",2011,606,367,239,42
"48194","E01014245",2011,706,49,657,115
"48195","E01014246",2011,728,229,499,96
"48196","E01014247",2011,776,123,653,223
"48197","E01014248",2011,660,87,573,180
"48198","E01014249",2011,782,165,617,252
"48199","E01014250",2011,537,203,334,120
"48200","E01014251",2011,912,309,603,250
"48201","E01014252",2011,748,107,641,250
"48202","E01014253",2011,657,96,561,49
"48203","E01014254",2011,643,87,556,261
"48204","E01014255",2011,692,276,416,152
"48205","E01014256",2011,775,280,495,136
"48206","E01014257",2011,640,134,506,49
"48207","E01014258",2011,541,14,527,36
"48208","E01014259",2011,647,81,566,34
"48209","E01014260",2011,604,225,379,21
"48210","E01014261",2011,577,363,214,39
"48211","E01014262",2011,528,206,322,20
"48212","E01014263",2011,624,268,356,38
"48213","E01014264",2011,772,76,696,61
"48214","E01014265",2011,681,10,671,61
"48215","E01014266",2011,577,129,448,113
"48216","E01014267",2011,1060,121,939,183
"48217","E01014268",2011,998,361,637,111
"48218","E01014269",2011,668,334,334,54
"48219","E01014270",2011,650,46,604,32
"48220","E01014271",2011,615,66,549,54
"48221","E01014272",2011,661,6,655,76
"48222","E01014273",2011,577,58,519,214
"48223","E01014274",2011,858,278,580,147
"48224","E01014275",2011,754,353,401,135
"48225","E01014276",2011,735,106,629,190
"48226","E01014277",2011,711,78,633,120
"48227","E01014278",2011,588,96,492,75
"48228","E01014279",2011,803,82,721,248
"48229","E01014280",2011,610,38,572,51
"48230","E01014281",2011,622,161,461,224
"48231","E01014282",2011,493,242,251,115
"48232","E01014283",2011,806,68,738,418
"48233","E01014284",2011,468,28,440,351
"48234","E01014285",2011,918,169,749,258
"48235","E01014286",2011,544,147,397,145
"48236","E01014287",2011,635,268,367,150
"48237","E01014288",2011,728,44,684,196
"48238","E01014289",2011,666,44,622,128
"48239","E01014290",2011,673,98,575,185
"48240","E01014291",2011,624,145,479,112
"48241","E01014292",2011,692,26,666,176
"48242","E01014293",2011,772,94,678,323
"48243","E01014294",2011,597,152,445,122
"48244","E01014295",2011,794,134,660,143
"48245","E01014296",2011,608,113,495,49
"48246","E01014297",2011,487,17,470,28
"48247","E01014298",2011,687,315,372,42
"48248","E01014299",2011,598,20,578,35
"48249","E01014300",2011,623,212,411,78
"48250","E01014301",2011,651,42,609,30
"48251","E01014302",2011,926,344,582,135
"48252","E01014303",2011,656,25,631,42
"48253","E01014304",2011,645,16,629,62
"48254","E01014305",2011,481,48,433,113
"48255","E01014306",2011,539,101,438,124
"48256","E01014307",2011,462,77,385,89
"48257","E01014308",2011,768,80,688,50
"48258","E01014309",2011,599,196,403,82
"48259","E01014310",2011,751,25,726,66
"48260","E01014311",2011,617,118,499,83
"48261","E01014312",2011,593,55,538,93
"48262","E01014313",2011,830,388,442,72
"48263","E01014314",2011,523,14,509,29
"48264","E01014315",2011,598,4,594,22
"48265","E01014316",2011,616,377,239,43
"48266","E01014317",2011,692,419,273,40
"48267","E01014318",2011,597,4,593,32
"48268","E01014319",2011,597,116,481,33
"48269","E01014320",2011,477,4,473,38
"48270","E01014321",2011,642,21,621,136
"48271","E01014322",2011,656,166,490,93
"48272","E01014323",2011,609,50,559,170
"48273","E01014324",2011,684,23,661,76
"48274","E01014325",2011,518,16,502,22
"48275","E01014326",2011,589,16,573,26
"48276","E01014327",2011,675,38,637,153
"48277","E01014328",2011,640,79,561,187
"48278","E01014329",2011,723,138,585,124
"48279","E01014330",2011,912,513,399,169
"48280","E01014331",2011,639,281,358,62
"48281","E01014332",2011,790,147,643,30
"48282","E01014333",2011,605,40,565,34
"48283","E01014334",2011,756,274,482,26
"48284","E01014335",2011,751,77,674,82
"48285","E01014336",2011,717,347,370,62
"48286","E01014337",2011,722,234,488,71
"48287","E01014338",2011,676,107,569,84
"48288","E01014339",2011,803,69,734,283
"48289","E01014340",2011,863,180,683,222
"48290","E01014341",2011,764,224,540,136
"48291","E01014342",2011,598,310,288,36
"48292","E01014343",2011,843,133,710,249
"48293","E01014344",2011,615,193,422,54
"48294","E01014345",2011,893,312,581,226
"48295","E01014346",2011,729,26,703,41
"48296","E01014347",2011,583,4,579,25
"48297","E01014348",2011,615,15,600,33
"48298","E01014349",2011,642,8,634,47
"48299","E01014350",2011,553,6,547,29
"48300","E01014351",2011,566,2,564,55
"48301","E01014352",2011,579,25,554,23
"48302","E01014353",2011,706,233,473,51
"48303","E01014354",2011,846,344,502,174
"48304","E01014355",2011,753,64,689,192
"48305","E01014356",2011,746,47,699,202
"48306","E01014357",2011,705,207,498,89
"48307","E01014358",2011,590,278,312,65
"48308","E01014359",2011,758,187,571,86
"48309","E01014360",2011,784,36,748,109
"48310","E01014361",2011,667,101,566,259
"48311","E01014362",2011,586,6,580,12
"48312","E01014363",2011,624,58,566,15
"48313","E01014364",2011,597,95,502,33
"48314","E01014365",2011,638,80,558,33
"48315","E01014366",2011,809,440,369,49
"48316","E01014367",2011,666,402,264,49
"48317","E01014368",2011,676,233,443,113
"48318","E01014369",2011,556,97,459,39
"48319","E01014370",2011,1044,359,685,409
"48320","E01014371",2011,1084,147,937,521
"48321","E01014372",2011,1164,206,958,601
"48322","E01014373",2011,656,107,549,89
"48323","E01014374",2011,642,130,512,42
"48324","E01014375",2011,515,9,506,64
"48325","E01014376",2011,633,7,626,55
"48326","E01014377",2011,656,13,643,52
"48327","E01014379",2011,841,66,775,146
"48328","E01014380",2011,517,6,511,57
"48329","E01014381",2011,660,12,648,143
"48330","E01014382",2011,944,75,869,91
"48331","E01014383",2011,424,33,391,40
"48332","E01014384",2011,546,45,501,44
"48333","E01014385",2011,508,37,471,46
"48334","E01014386",2011,454,41,413,30
"48335","E01014387",2011,505,88,417,70
"48336","E01014388",2011,546,17,529,69
"48337","E01014389",2011,620,125,495,83
"48338","E01014390",2011,665,400,265,45
"48339","E01014391",2011,611,67,544,62
"48340","E01014392",2011,426,41,385,36
"48341","E01014393",2011,511,7,504,39
"48342","E01014394",2011,675,72,603,56
"48343","E01014395",2011,519,1,518,18
"48344","E01014396",2011,656,26,630,114
"48345","E01014397",2011,510,3,507,12
"48346","E01014398",2011,639,67,572,58
"48347","E01014399",2011,660,84,576,50
"48348","E01014400",2011,865,89,776,148
"48349","E01014401",2011,651,214,437,38
"48350","E01014402",2011,731,85,646,73
"48351","E01014403",2011,833,239,594,76
"48352","E01014404",2011,743,272,471,53
"48353","E01014405",2011,836,36,800,202
"48354","E01014407",2011,643,279,364,230
"48355","E01014409",2011,747,233,514,87
"48356","E01014410",2011,733,21,712,84
"48357","E01014411",2011,932,38,894,239
"48358","E01014412",2011,679,25,654,191
"48359","E01014413",2011,653,11,642,107
"48360","E01014414",2011,848,248,600,312
"48361","E01014415",2011,771,19,752,172
"48362","E01014416",2011,726,118,608,72
"48363","E01014417",2011,743,25,718,80
"48364","E01014418",2011,565,46,519,51
"48365","E01014419",2011,483,76,407,44
"48366","E01014420",2011,691,63,628,127
"48367","E01014421",2011,528,18,510,29
"48368","E01014422",2011,622,18,604,47
"48369","E01014423",2011,614,15,599,144
"48370","E01014424",2011,664,19,645,56
"48371","E01014425",2011,829,86,743,76
"48372","E01014426",2011,637,191,446,45
"48373","E01014427",2011,582,88,494,192
"48374","E01014428",2011,558,76,482,122
"48375","E01014429",2011,634,65,569,81
"48376","E01014430",2011,709,159,550,68
"48377","E01014431",2011,511,96,415,76
"48378","E01014432",2011,543,109,434,95
"48379","E01014433",2011,553,152,401,87
"48380","E01014434",2011,757,61,696,83
"48381","E01014435",2011,525,13,512,245
"48382","E01014436",2011,616,112,504,169
"48383","E01014437",2011,637,219,418,69
"48384","E01014438",2011,499,146,353,71
"48385","E01014439",2011,713,181,532,53
"48386","E01014440",2011,761,41,720,100
"48387","E01014441",2011,711,3,708,75
"48388","E01014442",2011,705,42,663,98
"48389","E01014443",2011,658,17,641,73
"48390","E01014444",2011,588,9,579,71
"48391","E01014445",2011,681,208,473,87
"48392","E01014446",2011,448,37,411,54
"48393","E01014447",2011,499,47,452,35
"48394","E01014448",2011,679,184,495,74
"48395","E01014449",2011,568,37,531,74
"48396","E01014450",2011,533,201,332,45
"48397","E01014451",2011,520,54,466,74
"48398","E01014452",2011,658,140,518,40
"48399","E01014453",2011,503,9,494,18
"48400","E01014454",2011,519,6,513,15
"48401","E01014455",2011,567,158,409,60
"48402","E01014456",2011,625,96,529,69
"48403","E01014457",2011,613,22,591,59
"48404","E01014458",2011,522,257,265,49
"48405","E01014459",2011,612,131,481,60
"48406","E01014460",2011,501,12,489,29
"48407","E01014461",2011,461,143,318,59
"48408","E01014462",2011,617,332,285,37
"48409","E01014463",2011,589,297,292,42
"48410","E01014464",2011,606,326,280,71
"48411","E01014465",2011,669,44,625,117
"48412","E01014466",2011,576,226,350,80
"48413","E01014467",2011,827,51,776,306
"48414","E01014468",2011,756,37,719,324
"48415","E01014469",2011,490,111,379,32
"48416","E01014470",2011,618,29,589,47
"48417","E01014471",2011,645,59,586,99
"48418","E01014472",2011,546,28,518,52
"48419","E01014473",2011,577,8,569,215
"48420","E01014474",2011,492,93,399,119
"48421","E01014475",2011,623,72,551,229
"48422","E01014476",2011,524,12,512,181
"48423","E01014477",2011,636,15,621,48
"48424","E01014478",2011,469,182,287,33
"48425","E01014479",2011,650,52,598,112
"48426","E01014480",2011,551,102,449,105
"48427","E01014481",2011,562,17,545,255
"48428","E01014482",2011,510,4,506,79
"48429","E01014483",2011,640,91,549,194
"48430","E01014484",2011,611,24,587,285
"48431","E01014485",2011,828,127,701,203
"48432","E01014486",2011,1084,376,708,350
"48433","E01014487",2011,819,38,781,437
"48434","E01014488",2011,797,173,624,240
"48435","E01014489",2011,1140,338,802,392
"48436","E01014491",2011,764,26,738,245
"48437","E01014492",2011,741,299,442,71
"48438","E01014493",2011,609,164,445,73
"48439","E01014494",2011,623,41,582,75
"48440","E01014495",2011,733,138,595,96
"48441","E01014496",2011,680,95,585,169
"48442","E01014497",2011,670,278,392,48
"48443","E01014498",2011,658,305,353,44
"48444","E01014499",2011,609,153,456,74
"48445","E01014500",2011,686,40,646,163
"48446","E01014501",2011,756,159,597,77
"48447","E01014502",2011,750,189,561,113
"48448","E01014504",2011,656,32,624,160
"48449","E01014505",2011,824,50,774,242
"48450","E01014506",2011,599,17,582,37
"48451","E01014507",2011,673,23,650,219
"48452","E01014508",2011,510,22,488,156
"48453","E01014509",2011,855,29,826,272
"48454","E01014510",2011,740,27,713,224
"48455","E01014511",2011,517,7,510,121
"48456","E01014512",2011,587,51,536,114
"48457","E01014513",2011,619,7,612,86
"48458","E01014514",2011,817,18,799,298
"48459","E01014515",2011,618,194,424,52
"48460","E01014516",2011,636,370,266,28
"48461","E01014517",2011,495,216,279,45
"48462","E01014518",2011,720,87,633,128
"48463","E01014519",2011,552,107,445,61
"48464","E01014520",2011,652,36,616,54
"48465","E01014521",2011,510,62,448,52
"48466","E01014522",2011,732,273,459,71
"48467","E01014523",2011,548,44,504,50
"48468","E01014524",2011,591,44,547,65
"48469","E01014525",2011,651,29,622,120
"48470","E01014526",2011,672,261,411,50
"48471","E01014527",2011,660,170,490,119
"48472","E01014528",2011,686,10,676,168
"48473","E01014529",2011,596,192,404,79
"48474","E01014530",2011,684,60,624,184
"48475","E01014531",2011,754,25,729,236
"48476","E01014532",2011,631,89,542,107
"48477","E01014533",2011,619,10,609,142
"48478","E01014534",2011,650,54,596,126
"48479","E01014535",2011,757,51,706,96
"48480","E01014536",2011,672,248,424,46
"48481","E01014537",2011,756,160,596,125
"48482","E01014538",2011,676,67,609,423
"48483","E01014539",2011,784,70,714,356
"48484","E01014540",2011,1164,289,875,631
"48485","E01014542",2011,865,105,760,595
"48486","E01014544",2011,577,8,569,247
"48487","E01014545",2011,809,69,740,369
"48488","E01014546",2011,736,16,720,459
"48489","E01014547",2011,857,13,844,405
"48490","E01014548",2011,832,131,701,350
"48491","E01014549",2011,550,157,393,160
"48492","E01014550",2011,895,52,843,333
"48493","E01014551",2011,813,31,782,535
"48494","E01014552",2011,775,33,742,410
"48495","E01014553",2011,759,16,743,462
"48496","E01014554",2011,832,23,809,469
"48497","E01014555",2011,711,129,582,375
"48498","E01014556",2011,859,17,842,350
"48499","E01014557",2011,589,24,565,253
"48500","E01014558",2011,775,51,724,519
"48501","E01014559",2011,816,32,784,369
"48502","E01014560",2011,778,51,727,406
"48503","E01014561",2011,774,52,722,378
"48504","E01014562",2011,655,17,638,401
"48505","E01014563",2011,802,77,725,462
"48506","E01014564",2011,736,140,596,209
"48507","E01014565",2011,778,144,634,254
"48508","E01014566",2011,819,46,773,365
"48509","E01014567",2011,894,36,858,371
"48510","E01014568",2011,1007,208,799,347
"48511","E01014569",2011,846,106,740,275
"48512","E01014570",2011,779,62,717,213
"48513","E01014571",2011,663,193,470,103
"48514","E01014572",2011,796,53,743,327
"48515","E01014573",2011,803,26,777,251
"48516","E01014574",2011,989,202,787,394
"48517","E01014575",2011,656,130,526,159
"48518","E01014576",2011,833,99,734,168
"48519","E01014577",2011,640,17,623,121
"48520","E01014578",2011,645,169,476,58
"48521","E01014579",2011,546,101,445,72
"48522","E01014580",2011,666,352,314,49
"48523","E01014581",2011,641,341,300,56
"48524","E01014582",2011,520,187,333,71
"48525","E01014583",2011,529,254,275,41
"48526","E01014584",2011,468,194,274,33
"48527","E01014585",2011,711,442,269,77
"48528","E01014586",2011,719,132,587,85
"48529","E01014587",2011,608,162,446,77
"48530","E01014588",2011,747,149,598,154
"48531","E01014589",2011,630,381,249,48
"48532","E01014590",2011,728,106,622,201
"48533","E01014591",2011,800,43,757,114
"48534","E01014592",2011,694,104,590,136
"48535","E01014593",2011,572,321,251,44
"48536","E01014594",2011,640,371,269,39
"48537","E01014595",2011,642,271,371,46
"48538","E01014596",2011,603,257,346,36
"48539","E01014597",2011,618,274,344,35
"48540","E01014598",2011,616,13,603,37
"48541","E01014599",2011,533,17,516,73
"48542","E01014600",2011,585,135,450,63
"48543","E01014601",2011,687,167,520,54
"48544","E01014602",2011,825,398,427,66
"48545","E01014603",2011,960,202,758,144
"48546","E01014605",2011,810,487,323,88
"48547","E01014607",2011,541,10,531,67
"48548","E01014608",2011,719,256,463,71
"48549","E01014609",2011,704,174,530,87
"48550","E01014610",2011,715,287,428,137
"48551","E01014611",2011,560,19,541,26
"48552","E01014612",2011,625,65,560,62
"48553","E01014613",2011,659,47,612,105
"48554","E01014614",2011,498,20,478,42
"48555","E01014615",2011,609,6,603,37
"48556","E01014616",2011,684,52,632,118
"48557","E01014617",2011,522,4,518,34
"48558","E01014618",2011,624,2,622,36
"48559","E01014619",2011,602,25,577,146
"48560","E01014620",2011,634,12,622,45
"48561","E01014621",2011,581,76,505,115
"48562","E01014622",2011,625,42,583,147
"48563","E01014623",2011,642,93,549,126
"48564","E01014624",2011,667,150,517,99
"48565","E01014626",2011,913,223,690,202
"48566","E01014627",2011,903,57,846,211
"48567","E01014629",2011,544,157,387,79
"48568","E01014630",2011,885,420,465,178
"48569","E01014631",2011,520,116,404,61
"48570","E01014632",2011,618,94,524,144
"48571","E01014633",2011,663,91,572,103
"48572","E01014634",2011,694,31,663,290
"48573","E01014635",2011,769,43,726,233
"48574","E01014636",2011,635,295,340,60
"48575","E01014637",2011,530,13,517,165
"48576","E01014638",2011,788,482,306,62
"48577","E01014639",2011,625,442,183,36
"48578","E01014640",2011,590,238,352,37
"48579","E01014641",2011,625,110,515,46
"48580","E01014642",2011,608,137,471,69
"48581","E01014643",2011,547,243,304,39
"48582","E01014644",2011,613,179,434,47
"48583","E01014645",2011,688,157,531,80
"48584","E01014646",2011,633,101,532,65
"48585","E01014647",2011,613,249,364,53
"48586","E01014648",2011,675,40,635,144
"48587","E01014649",2011,670,22,648,127
"48588","E01014650",2011,620,103,517,52
"48589","E01014651",2011,676,10,666,117
"48590","E01014653",2011,1058,598,460,222
"48591","E01014654",2011,879,391,488,222
"48592","E01014655",2011,1063,270,793,447
"48593","E01014658",2011,842,674,168,73
"48594","E01014659",2011,880,348,532,190
"48595","E01014660",2011,667,290,377,93
"48596","E01014661",2011,600,187,413,89
"48597","E01014662",2011,631,89,542,159
"48598","E01014663",2011,616,252,364,70
"48599","E01014664",2011,664,174,490,112
"48600","E01014665",2011,779,42,737,157
"48601","E01014666",2011,660,48,612,96
"48602","E01014667",2011,625,10,615,169
"48603","E01014668",2011,620,7,613,203
"48604","E01014669",2011,621,19,602,266
"48605","E01014670",2011,596,13,583,236
"48606","E01014671",2011,663,67,596,304
"48607","E01014672",2011,962,57,905,389
"48608","E01014673",2011,817,58,759,270
"48609","E01014674",2011,647,83,564,118
"48610","E01014675",2011,662,44,618,155
"48611","E01014676",2011,669,154,515,73
"48612","E01014677",2011,662,29,633,173
"48613","E01014678",2011,674,38,636,133
"48614","E01014679",2011,662,34,628,126
"48615","E01014680",2011,515,4,511,46
"48616","E01014681",2011,1061,180,881,324
"48617","E01014682",2011,647,35,612,158
"48618","E01014683",2011,840,228,612,225
"48619","E01014684",2011,840,34,806,380
"48620","E01014685",2011,623,190,433,98
"48621","E01014686",2011,704,115,589,125
"48622","E01014687",2011,704,103,601,163
"48623","E01014688",2011,644,289,355,96
"48624","E01014689",2011,637,411,226,58
"48625","E01014690",2011,792,281,511,86
"48626","E01014691",2011,853,286,567,73
"48627","E01014692",2011,606,212,394,104
"48628","E01014693",2011,651,15,636,104
"48629","E01014694",2011,667,168,499,111
"48630","E01014695",2011,852,348,504,158
"48631","E01014696",2011,695,34,661,208
"48632","E01014698",2011,857,79,778,283
"48633","E01014699",2011,706,196,510,212
"48634","E01014700",2011,652,15,637,141
"48635","E01014701",2011,712,53,659,244
"48636","E01014702",2011,599,40,559,37
"48637","E01014703",2011,676,252,424,56
"48638","E01014704",2011,742,158,584,89
"48639","E01014705",2011,616,99,517,28
"48640","E01014706",2011,624,257,367,65
"48641","E01014707",2011,626,45,581,45
"48642","E01014708",2011,708,79,629,58
"48643","E01014709",2011,596,5,591,101
"48644","E01014710",2011,529,12,517,103
"48645","E01014711",2011,527,8,519,37
"48646","E01014712",2011,500,75,425,50
"48647","E01014713",2011,565,8,557,69
"48648","E01014714",2011,524,2,522,44
"48649","E01014715",2011,616,15,601,38
"48650","E01014716",2011,614,5,609,38
"48651","E01014717",2011,637,130,507,28
"48652","E01014718",2011,637,7,630,80
"48653","E01014719",2011,628,37,591,138
"48654","E01014720",2011,777,185,592,93
"48655","E01014721",2011,647,87,560,49
"48656","E01014722",2011,622,3,619,41
"48657","E01014723",2011,533,5,528,45
"48658","E01014725",2011,607,6,601,33
"48659","E01014726",2011,675,488,187,20
"48660","E01014727",2011,631,350,281,30
"48661","E01014729",2011,585,198,387,100
"48662","E01014730",2011,883,163,720,342
"48663","E01014731",2011,775,116,659,259
"48664","E01014732",2011,799,91,708,314
"48665","E01014733",2011,741,114,627,191
"48666","E01014734",2011,678,80,598,170
"48667","E01014735",2011,755,58,697,159
"48668","E01014736",2011,827,208,619,182
"48669","E01014737",2011,603,6,597,25
"48670","E01014738",2011,566,55,511,56
"48671","E01014739",2011,589,43,546,38
"48672","E01014740",2011,530,24,506,60
"48673","E01014741",2011,646,66,580,98
"48674","E01014742",2011,613,14,599,60
"48675","E01014744",2011,606,7,599,53
"48676","E01014745",2011,657,57,600,40
"48677","E01014746",2011,597,80,517,61
"48678","E01014747",2011,587,36,551,92
"48679","E01014748",2011,441,50,391,82
"48680","E01014749",2011,507,9,498,41
"48681","E01014750",2011,742,98,644,164
"48682","E01014751",2011,716,169,547,87
"48683","E01014752",2011,646,5,641,80
"48684","E01014753",2011,810,163,647,118
"48685","E01014754",2011,636,23,613,181
"48686","E01014755",2011,627,61,566,144
"48687","E01014756",2011,768,37,731,140
"48688","E01014757",2011,620,22,598,70
"48689","E01014758",2011,512,11,501,56
"48690","E01014759",2011,596,0,596,28
"48691","E01014760",2011,626,62,564,47
"48692","E01014761",2011,729,3,726,107
"48693","E01014762",2011,612,4,608,69
"48694","E01014763",2011,719,70,649,141
"48695","E01014764",2011,687,122,565,59
"48696","E01014765",2011,735,26,709,86
"48697","E01014766",2011,564,9,555,65
"48698","E01014767",2011,572,7,565,38
"48699","E01014769",2011,943,62,881,142
"48700","E01014770",2011,632,11,621,42
"48701","E01014771",2011,637,31,606,43
"48702","E01014772",2011,614,21,593,50
"48703","E01014773",2011,640,13,627,109
"48704","E01014774",2011,694,33,661,88
"48705","E01014775",2011,496,4,492,37
"48706","E01014776",2011,498,1,497,29
"48707","E01014777",2011,628,21,607,74
"48708","E01014778",2011,536,5,531,7
"48709","E01014779",2011,493,59,434,50
"48710","E01014780",2011,715,101,614,109
"48711","E01014781",2011,789,145,644,64
"48712","E01014782",2011,605,2,603,37
"48713","E01014783",2011,729,115,614,93
"48714","E01014784",2011,702,23,679,69
"48715","E01014785",2011,587,13,574,24
"48716","E01014786",2011,721,214,507,74
"48717","E01014787",2011,814,78,736,64
"48718","E01014789",2011,615,1,614,69
"48719","E01014790",2011,624,63,561,36
"48720","E01014792",2011,891,75,816,87
"48721","E01014793",2011,666,0,666,61
"48722","E01014794",2011,745,56,689,19
"48723","E01014795",2011,605,160,445,59
"48724","E01014796",2011,732,30,702,52
"48725","E01014797",2011,740,148,592,70
"48726","E01014798",2011,587,7,580,23
"48727","E01014799",2011,801,60,741,381
"48728","E01014800",2011,799,93,706,433
"48729","E01014801",2011,793,56,737,353
"48730","E01014802",2011,758,66,692,369
"48731","E01014803",2011,644,15,629,78
"48732","E01014804",2011,624,74,550,107
"48733","E01014805",2011,688,7,681,35
"48734","E01014806",2011,780,80,700,299
"48735","E01014807",2011,818,46,772,337
"48736","E01014808",2011,588,14,574,85
"48737","E01014809",2011,772,59,713,243
"48738","E01014810",2011,693,149,544,189
"48739","E01014811",2011,742,170,572,126
"48740","E01014812",2011,675,24,651,85
"48741","E01014813",2011,734,36,698,98
"48742","E01014815",2011,587,116,471,75
"48743","E01014816",2011,648,9,639,63
"48744","E01014817",2011,695,19,676,72
"48745","E01014818",2011,750,3,747,50
"48746","E01014819",2011,732,18,714,56
"48747","E01014820",2011,719,137,582,80
"48748","E01014821",2011,500,4,496,118
"48749","E01014822",2011,542,1,541,39
"48750","E01014823",2011,504,2,502,52
"48751","E01014824",2011,644,51,593,62
"48752","E01014825",2011,487,2,485,58
"48753","E01014826",2011,630,4,626,153
"48754","E01014827",2011,598,130,468,110
"48755","E01014828",2011,579,163,416,98
"48756","E01014829",2011,793,343,450,160
"48757","E01014830",2011,657,59,598,201
"48758","E01014831",2011,582,424,158,26
"48759","E01014832",2011,630,407,223,32
"48760","E01014833",2011,645,393,252,42
"48761","E01014834",2011,621,207,414,79
"48762","E01014835",2011,650,156,494,70
"48763","E01014836",2011,644,48,596,106
"48764","E01014838",2011,594,16,578,77
"48765","E01014839",2011,631,40,591,114
"48766","E01014840",2011,615,45,570,98
"48767","E01014841",2011,978,25,953,465
"48768","E01014842",2011,822,11,811,400
"48769","E01014843",2011,670,15,655,198
"48770","E01014844",2011,769,80,689,397
"48771","E01014845",2011,577,18,559,62
"48772","E01014846",2011,637,30,607,125
"48773","E01014847",2011,681,10,671,79
"48774","E01014848",2011,522,41,481,52
"48775","E01014849",2011,682,19,663,41
"48776","E01014850",2011,822,75,747,71
"48777","E01014851",2011,1080,117,963,129
"48778","E01014852",2011,613,52,561,52
"48779","E01014853",2011,739,69,670,114
"48780","E01014854",2011,549,4,545,64
"48781","E01014855",2011,581,7,574,42
"48782","E01014856",2011,590,72,518,60
"48783","E01014857",2011,616,71,545,52
"48784","E01014858",2011,714,15,699,123
"48785","E01014859",2011,636,35,601,58
"48786","E01014860",2011,624,114,510,44
"48787","E01014861",2011,747,58,689,88
"48788","E01014862",2011,1065,104,961,91
"48789","E01014863",2011,660,88,572,31
"48790","E01014864",2011,632,15,617,61
"48791","E01014865",2011,784,156,628,88
"48792","E01014866",2011,646,30,616,39
"48793","E01014867",2011,523,81,442,29
"48794","E01014868",2011,630,24,606,52
"48795","E01014869",2011,719,64,655,107
"48796","E01014870",2011,635,50,585,98
"48797","E01014871",2011,518,68,450,43
"48798","E01014872",2011,723,15,708,306
"48799","E01014873",2011,558,7,551,59
"48800","E01014874",2011,601,0,601,159
"48801","E01014875",2011,794,14,780,361
"48802","E01014876",2011,746,12,734,268
"48803","E01014877",2011,601,3,598,129
"48804","E01014878",2011,853,9,844,259
"48805","E01014879",2011,757,1,756,148
"48806","E01014880",2011,715,42,673,174
"48807","E01014881",2011,717,4,713,190
"48808","E01014882",2011,834,221,613,203
"48809","E01014883",2011,535,19,516,126
"48810","E01014884",2011,589,88,501,86
"48811","E01014885",2011,717,12,705,49
"48812","E01014886",2011,836,202,634,104
"48813","E01014887",2011,614,8,606,66
"48814","E01014888",2011,618,25,593,46
"48815","E01014889",2011,613,6,607,51
"48816","E01014890",2011,817,64,753,115
"48817","E01014891",2011,688,42,646,164
"48818","E01014892",2011,679,56,623,147
"48819","E01014893",2011,620,8,612,90
"48820","E01014894",2011,490,2,488,63
"48821","E01014895",2011,526,4,522,83
"48822","E01014896",2011,478,3,475,75
"48823","E01014897",2011,594,2,592,35
"48824","E01014898",2011,720,47,673,55
"48825","E01014899",2011,744,77,667,99
"48826","E01014900",2011,631,75,556,89
"48827","E01014901",2011,660,11,649,52
"48828","E01014902",2011,537,1,536,26
"48829","E01014903",2011,641,25,616,34
"48830","E01014904",2011,648,126,522,98
"48831","E01014905",2011,663,8,655,110
"48832","E01014906",2011,742,308,434,123
"48833","E01014907",2011,685,55,630,172
"48834","E01014908",2011,559,8,551,92
"48835","E01014909",2011,595,17,578,195
"48836","E01014910",2011,622,89,533,119
"48837","E01014911",2011,548,19,529,33
"48838","E01014912",2011,735,11,724,63
"48839","E01014913",2011,655,12,643,35
"48840","E01014914",2011,639,194,445,35
"48841","E01014915",2011,651,98,553,85
"48842","E01014916",2011,685,91,594,106
"48843","E01014917",2011,616,66,550,64
"48844","E01014918",2011,644,18,626,55
"48845","E01014919",2011,501,4,497,19
"48846","E01014920",2011,532,43,489,28
"48847","E01014921",2011,553,39,514,22
"48848","E01014922",2011,547,11,536,65
"48849","E01014923",2011,651,108,543,77
"48850","E01014924",2011,792,52,740,235
"48851","E01014925",2011,625,91,534,55
"48852","E01014926",2011,686,271,415,68
"48853","E01014927",2011,826,175,651,174
"48854","E01014928",2011,644,190,454,57
"48855","E01014929",2011,786,71,715,72
"48856","E01014930",2011,709,82,627,42
"48857","E01014931",2011,613,22,591,59
"48858","E01014932",2011,728,18,710,67
"48859","E01014933",2011,623,2,621,85
"48860","E01014934",2011,502,0,502,20
"48861","E01014935",2011,664,8,656,73
"48862","E01014936",2011,554,74,480,56
"48863","E01014937",2011,524,5,519,30
"48864","E01014938",2011,624,89,535,58
"48865","E01014939",2011,498,53,445,53
"48866","E01014940",2011,501,30,471,29
"48867","E01014941",2011,645,290,355,38
"48868","E01014942",2011,654,188,466,49
"48869","E01014943",2011,815,48,767,176
"48870","E01014944",2011,710,11,699,88
"48871","E01014945",2011,687,101,586,48
"48872","E01014946",2011,639,147,492,51
"48873","E01014947",2011,632,29,603,27
"48874","E01014948",2011,804,377,427,80
"48875","E01014949",2011,544,31,513,51
"48876","E01014950",2011,601,30,571,117
"48877","E01014951",2011,586,130,456,66
"48878","E01014952",2011,708,60,648,73
"48879","E01014953",2011,807,25,782,88
"48880","E01014954",2011,700,52,648,120
"48881","E01014955",2011,557,11,546,33
"48882","E01014956",2011,658,30,628,46
"48883","E01014957",2011,509,9,500,38
"48884","E01014958",2011,483,126,357,35
"48885","E01014959",2011,535,85,450,48
"48886","E01014960",2011,685,134,551,99
"48887","E01014961",2011,668,209,459,49
"48888","E01014962",2011,666,16,650,109
"48889","E01014963",2011,768,27,741,78
"48890","E01014964",2011,667,10,657,74
"48891","E01014965",2011,607,21,586,25
"48892","E01014966",2011,640,10,630,164
"48893","E01014967",2011,811,8,803,150
"48894","E01014968",2011,747,282,465,57
"48895","E01014969",2011,634,6,628,62
"48896","E01014972",2011,701,69,632,48
"48897","E01014973",2011,638,147,491,73
"48898","E01014974",2011,713,62,651,79
"48899","E01014975",2011,706,38,668,176
"48900","E01014976",2011,660,124,536,118
"48901","E01014977",2011,696,308,388,163
"48902","E01014978",2011,589,36,553,63
"48903","E01014979",2011,667,8,659,110
"48904","E01014980",2011,641,8,633,66
"48905","E01014981",2011,1168,130,1038,313
"48906","E01014982",2011,632,67,565,78
"48907","E01014983",2011,648,189,459,63
"48908","E01014984",2011,608,105,503,59
"48909","E01014985",2011,641,5,636,87
"48910","E01014986",2011,663,156,507,76
"48911","E01014987",2011,514,5,509,41
"48912","E01014988",2011,543,5,538,46
"48913","E01014989",2011,441,11,430,51
"48914","E01014990",2011,640,5,635,31
"48915","E01014991",2011,983,350,633,96
"48916","E01014992",2011,582,20,562,43
"48917","E01014993",2011,551,23,528,52
"48918","E01014994",2011,734,67,667,51
"48919","E01014995",2011,689,7,682,36
"48920","E01014996",2011,699,7,692,124
"48921","E01014998",2011,643,107,536,36
"48922","E01014999",2011,629,6,623,36
"48923","E01015000",2011,654,127,527,81
"48924","E01015001",2011,628,38,590,28
"48925","E01015002",2011,643,70,573,92
"48926","E01015003",2011,657,21,636,56
"48927","E01015004",2011,716,63,653,83
"48928","E01015005",2011,850,64,786,210
"48929","E01015006",2011,665,128,537,51
"48930","E01015007",2011,794,172,622,160
"48931","E01015008",2011,663,90,573,72
"48932","E01015009",2011,616,51,565,54
"48933","E01015010",2011,527,6,521,68
"48934","E01015011",2011,659,131,528,84
"48935","E01015012",2011,526,9,517,24
"48936","E01015013",2011,514,10,504,80
"48937","E01015014",2011,537,1,536,44
"48938","E01015015",2011,575,7,568,142
"48939","E01015016",2011,455,2,453,14
"48940","E01015017",2011,585,51,534,55
"48941","E01015018",2011,571,74,497,34
"48942","E01015019",2011,758,117,641,131
"48943","E01015020",2011,650,107,543,126
"48944","E01015021",2011,636,12,624,60
"48945","E01015022",2011,675,15,660,136
"48946","E01015023",2011,686,236,450,57
"48947","E01015024",2011,648,64,584,102
"48948","E01015025",2011,655,5,650,40
"48949","E01015026",2011,769,289,480,97
"48950","E01015027",2011,647,98,549,45
"48951","E01015028",2011,642,335,307,54
"48952","E01015029",2011,716,153,563,187
"48953","E01015030",2011,757,431,326,49
"48954","E01015031",2011,673,5,668,351
"48955","E01015032",2011,804,8,796,579
"48956","E01015033",2011,626,12,614,48
"48957","E01015034",2011,516,12,504,67
"48958","E01015035",2011,634,14,620,65
"48959","E01015036",2011,655,108,547,88
"48960","E01015037",2011,601,113,488,56
"48961","E01015038",2011,712,23,689,104
"48962","E01015039",2011,461,59,402,116
"48963","E01015040",2011,589,227,362,68
"48964","E01015041",2011,642,65,577,158
"48965","E01015042",2011,650,40,610,180
"48966","E01015043",2011,675,287,388,189
"48967","E01015044",2011,734,32,702,339
"48968","E01015045",2011,748,291,457,231
"48969","E01015046",2011,931,703,228,74
"48970","E01015047",2011,633,351,282,126
"48971","E01015048",2011,592,331,261,110
"48972","E01015049",2011,594,8,586,308
"48973","E01015050",2011,665,7,658,532
"48974","E01015051",2011,521,8,513,304
"48975","E01015052",2011,806,157,649,476
"48976","E01015053",2011,581,155,426,299
"48977","E01015054",2011,528,121,407,323
"48978","E01015055",2011,603,213,390,66
"48979","E01015056",2011,746,126,620,117
"48980","E01015057",2011,657,288,369,70
"48981","E01015058",2011,559,274,285,56
"48982","E01015059",2011,639,87,552,113
"48983","E01015060",2011,644,133,511,92
"48984","E01015061",2011,614,61,553,238
"48985","E01015062",2011,711,30,681,398
"48986","E01015063",2011,634,160,474,91
"48987","E01015064",2011,713,16,697,36
"48988","E01015065",2011,635,179,456,120
"48989","E01015066",2011,605,12,593,54
"48990","E01015067",2011,613,7,606,20
"48991","E01015068",2011,628,13,615,54
"48992","E01015069",2011,674,182,492,84
"48993","E01015070",2011,1078,223,855,208
"48994","E01015071",2011,696,153,543,104
"48995","E01015072",2011,607,194,413,55
"48996","E01015073",2011,642,233,409,57
"48997","E01015074",2011,667,278,389,52
"48998","E01015075",2011,648,228,420,78
"48999","E01015076",2011,628,23,605,75
"49000","E01015077",2011,748,173,575,71
"49001","E01015078",2011,484,263,221,18
"49002","E01015079",2011,628,64,564,34
"49003","E01015080",2011,471,334,137,29
"49004","E01015081",2011,626,244,382,58
"49005","E01015082",2011,693,341,352,50
"49006","E01015083",2011,687,305,382,50
"49007","E01015084",2011,620,145,475,45
"49008","E01015085",2011,716,100,616,58
"49009","E01015086",2011,621,281,340,54
"49010","E01015087",2011,560,258,302,31
"49011","E01015088",2011,620,382,238,50
"49012","E01015089",2011,741,126,615,120
"49013","E01015090",2011,567,17,550,71
"49014","E01015091",2011,629,116,513,30
"49015","E01015092",2011,483,104,379,98
"49016","E01015093",2011,634,227,407,49
"49017","E01015094",2011,596,211,385,43
"49018","E01015095",2011,645,148,497,48
"49019","E01015096",2011,612,291,321,34
"49020","E01015097",2011,830,5,825,40
"49021","E01015098",2011,647,6,641,177
"49022","E01015099",2011,634,3,631,152
"49023","E01015100",2011,612,27,585,187
"49024","E01015101",2011,616,8,608,34
"49025","E01015102",2011,763,51,712,179
"49026","E01015103",2011,624,7,617,127
"49027","E01015104",2011,592,9,583,36
"49028","E01015105",2011,621,6,615,99
"49029","E01015106",2011,531,83,448,57
"49030","E01015107",2011,593,51,542,67
"49031","E01015108",2011,762,41,721,193
"49032","E01015109",2011,641,16,625,117
"49033","E01015110",2011,609,7,602,54
"49034","E01015111",2011,703,25,678,169
"49035","E01015112",2011,559,16,543,61
"49036","E01015113",2011,627,2,625,49
"49037","E01015114",2011,622,36,586,65
"49038","E01015115",2011,697,284,413,41
"49039","E01015116",2011,603,54,549,54
"49040","E01015117",2011,592,85,507,47
"49041","E01015118",2011,676,13,663,41
"49042","E01015119",2011,639,18,621,64
"49043","E01015120",2011,608,55,553,47
"49044","E01015121",2011,645,8,637,32
"49045","E01015122",2011,642,15,627,61
"49046","E01015123",2011,721,26,695,122
"49047","E01015124",2011,692,22,670,53
"49048","E01015125",2011,620,51,569,38
"49049","E01015126",2011,637,11,626,34
"49050","E01015127",2011,616,53,563,69
"49051","E01015128",2011,758,40,718,101
"49052","E01015129",2011,674,32,642,173
"49053","E01015130",2011,616,14,602,140
"49054","E01015131",2011,643,4,639,36
"49055","E01015132",2011,668,97,571,89
"49056","E01015133",2011,649,10,639,32
"49057","E01015134",2011,678,36,642,119
"49058","E01015135",2011,630,54,576,67
"49059","E01015136",2011,628,9,619,96
"49060","E01015137",2011,655,40,615,89
"49061","E01015138",2011,699,9,690,96
"49062","E01015139",2011,613,67,546,88
"49063","E01015140",2011,653,13,640,123
"49064","E01015141",2011,746,30,716,67
"49065","E01015142",2011,602,22,580,98
"49066","E01015143",2011,612,112,500,79
"49067","E01015144",2011,613,172,441,95
"49068","E01015145",2011,668,520,148,46
"49069","E01015146",2011,676,321,355,90
"49070","E01015147",2011,503,57,446,32
"49071","E01015148",2011,661,171,490,84
"49072","E01015149",2011,623,412,211,37
"49073","E01015150",2011,638,106,532,56
"49074","E01015151",2011,914,313,601,393
"49075","E01015152",2011,947,577,370,223
"49076","E01015153",2011,903,407,496,347
"49077","E01015155",2011,934,632,302,185
"49078","E01015156",2011,758,246,512,309
"49079","E01015157",2011,1193,228,965,534
"49080","E01015158",2011,1334,212,1122,717
"49081","E01015159",2011,767,230,537,58
"49082","E01015160",2011,624,8,616,49
"49083","E01015161",2011,640,182,458,74
"49084","E01015162",2011,633,252,381,57
"49085","E01015163",2011,593,125,468,56
"49086","E01015164",2011,734,107,627,168
"49087","E01015165",2011,643,29,614,109
"49088","E01015166",2011,821,330,491,84
"49089","E01015167",2011,683,60,623,178
"49090","E01015168",2011,814,99,715,237
"49091","E01015169",2011,860,84,776,386
"49092","E01015170",2011,748,233,515,189
"49093","E01015171",2011,809,90,719,340
"49094","E01015172",2011,822,39,783,355
"49095","E01015173",2011,760,38,722,227
"49096","E01015174",2011,681,15,666,92
"49097","E01015175",2011,660,35,625,265
"49098","E01015176",2011,588,159,429,93
"49099","E01015177",2011,727,4,723,255
"49100","E01015178",2011,810,20,790,420
"49101","E01015179",2011,659,19,640,326
"49102","E01015180",2011,871,247,624,278
"49103","E01015181",2011,985,55,930,520
"49104","E01015182",2011,837,182,655,222
"49105","E01015183",2011,582,81,501,67
"49106","E01015184",2011,620,8,612,45
"49107","E01015185",2011,681,77,604,147
"49108","E01015186",2011,681,32,649,272
"49109","E01015187",2011,705,16,689,126
"49110","E01015188",2011,667,35,632,110
"49111","E01015189",2011,564,15,549,190
"49112","E01015190",2011,708,70,638,119
"49113","E01015191",2011,662,31,631,158
"49114","E01015192",2011,589,142,447,92
"49115","E01015193",2011,552,64,488,79
"49116","E01015194",2011,606,129,477,55
"49117","E01015195",2011,639,130,509,61
"49118","E01015196",2011,593,278,315,57
"49119","E01015197",2011,637,2,635,37
"49120","E01015198",2011,740,5,735,55
"49121","E01015199",2011,628,5,623,36
"49122","E01015200",2011,442,41,401,62
"49123","E01015201",2011,580,47,533,75
"49124","E01015202",2011,601,22,579,56
"49125","E01015203",2011,547,7,540,47
"49126","E01015204",2011,622,5,617,191
"49127","E01015205",2011,639,11,628,79
"49128","E01015206",2011,629,21,608,121
"49129","E01015207",2011,649,22,627,124
"49130","E01015208",2011,847,7,840,65
"49131","E01015209",2011,625,7,618,222
"49132","E01015210",2011,639,129,510,142
"49133","E01015211",2011,586,9,577,70
"49134","E01015212",2011,586,8,578,169
"49135","E01015213",2011,569,42,527,73
"49136","E01015214",2011,630,27,603,241
"49137","E01015215",2011,608,6,602,143
"49138","E01015216",2011,625,14,611,230
"49139","E01015217",2011,778,73,705,378
"49140","E01015218",2011,586,37,549,133
"49141","E01015219",2011,688,115,573,139
"49142","E01015220",2011,618,14,604,67
"49143","E01015221",2011,634,55,579,102
"49144","E01015222",2011,631,10,621,97
"49145","E01015223",2011,510,6,504,48
"49146","E01015224",2011,623,4,619,122
"49147","E01015225",2011,597,62,535,70
"49148","E01015226",2011,603,0,603,59
"49149","E01015227",2011,622,4,618,55
"49150","E01015228",2011,737,4,733,209
"49151","E01015229",2011,609,55,554,169
"49152","E01015230",2011,639,2,637,34
"49153","E01015231",2011,856,188,668,452
"49154","E01015232",2011,842,11,831,422
"49155","E01015233",2011,701,16,685,321
"49156","E01015234",2011,595,76,519,174
"49157","E01015235",2011,845,15,830,300
"49158","E01015236",2011,647,34,613,121
"49159","E01015237",2011,519,19,500,117
"49160","E01015238",2011,611,14,597,177
"49161","E01015239",2011,791,38,753,316
"49162","E01015240",2011,790,39,751,247
"49163","E01015241",2011,627,30,597,131
"49164","E01015242",2011,518,93,425,119
"49165","E01015243",2011,594,15,579,82
"49166","E01015244",2011,641,18,623,62
"49167","E01015245",2011,603,97,506,69
"49168","E01015246",2011,600,17,583,96
"49169","E01015247",2011,735,76,659,114
"49170","E01015248",2011,657,74,583,167
"49171","E01015249",2011,619,180,439,57
"49172","E01015250",2011,608,5,603,148
"49173","E01015251",2011,461,34,427,49
"49174","E01015252",2011,1001,82,919,287
"49175","E01015253",2011,645,37,608,199
"49176","E01015254",2011,610,37,573,43
"49177","E01015255",2011,823,87,736,542
"49178","E01015256",2011,1034,52,982,612
"49179","E01015257",2011,566,188,378,91
"49180","E01015258",2011,885,180,705,183
"49181","E01015259",2011,585,29,556,165
"49182","E01015260",2011,783,52,731,368
"49183","E01015261",2011,918,112,806,319
"49184","E01015262",2011,525,97,428,66
"49185","E01015263",2011,624,234,390,85
"49186","E01015264",2011,618,14,604,46
"49187","E01015265",2011,653,73,580,64
"49188","E01015266",2011,618,274,344,79
"49189","E01015267",2011,852,5,847,386
"49190","E01015268",2011,875,55,820,278
"49191","E01015269",2011,796,31,765,252
"49192","E01015270",2011,882,48,834,309
"49193","E01015271",2011,704,0,704,83
"49194","E01015272",2011,833,20,813,225
"49195","E01015273",2011,938,97,841,415
"49196","E01015274",2011,873,62,811,275
"49197","E01015275",2011,739,51,688,286
"49198","E01015276",2011,658,34,624,186
"49199","E01015277",2011,847,79,768,321
"49200","E01015279",2011,991,86,905,623
"49201","E01015280",2011,998,92,906,611
"49202","E01015281",2011,884,189,695,473
"49203","E01015282",2011,1174,90,1084,891
"49204","E01015283",2011,992,52,940,657
"49205","E01015285",2011,1091,41,1050,630
"49206","E01015286",2011,1086,153,933,337
"49207","E01015287",2011,1183,326,857,443
"49208","E01015288",2011,911,180,731,519
"49209","E01015289",2011,1018,112,906,498
"49210","E01015290",2011,887,129,758,493
"49211","E01015291",2011,1101,67,1034,411
"49212","E01015292",2011,737,92,645,304
"49213","E01015293",2011,644,97,547,225
"49214","E01015294",2011,831,98,733,364
"49215","E01015295",2011,650,3,647,60
"49216","E01015296",2011,985,93,892,343
"49217","E01015297",2011,698,16,682,185
"49218","E01015298",2011,794,48,746,87
"49219","E01015299",2011,732,5,727,145
"49220","E01015300",2011,679,6,673,100
"49221","E01015301",2011,671,63,608,72
"49222","E01015302",2011,842,96,746,112
"49223","E01015303",2011,661,62,599,102
"49224","E01015304",2011,782,314,468,60
"49225","E01015305",2011,624,195,429,44
"49226","E01015306",2011,732,232,500,57
"49227","E01015307",2011,598,293,305,45
"49228","E01015308",2011,718,202,516,102
"49229","E01015309",2011,585,302,283,49
"49230","E01015310",2011,606,171,435,79
"49231","E01015311",2011,685,15,670,35
"49232","E01015312",2011,519,221,298,32
"49233","E01015313",2011,518,326,192,26
"49234","E01015314",2011,615,35,580,59
"49235","E01015315",2011,733,4,729,58
"49236","E01015316",2011,674,9,665,69
"49237","E01015317",2011,683,87,596,84
"49238","E01015318",2011,715,28,687,210
"49239","E01015319",2011,626,24,602,182
"49240","E01015320",2011,671,8,663,93
"49241","E01015321",2011,747,173,574,186
"49242","E01015322",2011,670,25,645,108
"49243","E01015323",2011,593,1,592,88
"49244","E01015324",2011,659,36,623,176
"49245","E01015325",2011,648,7,641,81
"49246","E01015326",2011,815,16,799,345
"49247","E01015327",2011,783,98,685,273
"49248","E01015328",2011,958,160,798,437
"49249","E01015329",2011,689,12,677,278
"49250","E01015330",2011,771,68,703,179
"49251","E01015331",2011,1015,74,941,476
"49252","E01015332",2011,701,9,692,105
"49253","E01015333",2011,677,12,665,48
"49254","E01015334",2011,678,110,568,59
"49255","E01015335",2011,703,16,687,91
"49256","E01015336",2011,674,24,650,100
"49257","E01015337",2011,727,23,704,138
"49258","E01015338",2011,828,479,349,53
"49259","E01015339",2011,674,156,518,94
"49260","E01015340",2011,723,67,656,51
"49261","E01015341",2011,541,252,289,59
"49262","E01015342",2011,615,3,612,70
"49263","E01015343",2011,639,128,511,68
"49264","E01015344",2011,719,6,713,132
"49265","E01015345",2011,728,15,713,353
"49266","E01015346",2011,678,101,577,241
"49267","E01015348",2011,767,21,746,166
"49268","E01015349",2011,656,49,607,97
"49269","E01015350",2011,617,5,612,45
"49270","E01015351",2011,606,9,597,102
"49271","E01015352",2011,643,22,621,100
"49272","E01015353",2011,494,42,452,85
"49273","E01015354",2011,712,41,671,130
"49274","E01015355",2011,707,41,666,127
"49275","E01015356",2011,684,46,638,177
"49276","E01015357",2011,697,223,474,97
"49277","E01015358",2011,733,74,659,171
"49278","E01015359",2011,756,223,533,122
"49279","E01015360",2011,601,10,591,212
"49280","E01015361",2011,545,39,506,110
"49281","E01015362",2011,464,186,278,35
"49282","E01015363",2011,669,31,638,161
"49283","E01015364",2011,684,20,664,109
"49284","E01015365",2011,792,72,720,364
"49285","E01015366",2011,888,125,763,302
"49286","E01015367",2011,1110,54,1056,629
"49287","E01015368",2011,1019,6,1013,319
"49288","E01015369",2011,958,31,927,305
"49289","E01015370",2011,811,6,805,331
"49290","E01015371",2011,867,99,768,482
"49291","E01015372",2011,1111,178,933,392
"49292","E01015373",2011,673,21,652,261
"49293","E01015374",2011,875,69,806,488
"49294","E01015375",2011,703,54,649,337
"49295","E01015376",2011,613,11,602,255
"49296","E01015377",2011,608,62,546,178
"49297","E01015378",2011,612,17,595,151
"49298","E01015379",2011,480,149,331,56
"49299","E01015380",2011,753,52,701,64
"49300","E01015381",2011,652,220,432,54
"49301","E01015382",2011,768,102,666,183
"49302","E01015383",2011,685,18,667,98
"49303","E01015384",2011,493,247,246,42
"49304","E01015385",2011,788,233,555,107
"49305","E01015386",2011,843,267,576,257
"49306","E01015387",2011,666,73,593,99
"49307","E01015388",2011,487,48,439,74
"49308","E01015389",2011,675,19,656,141
"49309","E01015390",2011,753,114,639,191
"49310","E01015391",2011,619,10,609,62
"49311","E01015392",2011,647,10,637,129
"49312","E01015393",2011,520,59,461,95
"49313","E01015394",2011,634,12,622,103
"49314","E01015395",2011,625,66,559,59
"49315","E01015396",2011,643,3,640,25
"49316","E01015397",2011,528,1,527,19
"49317","E01015398",2011,508,3,505,22
"49318","E01015399",2011,628,2,626,40
"49319","E01015400",2011,621,2,619,19
"49320","E01015401",2011,644,1,643,23
"49321","E01015402",2011,795,19,776,187
"49322","E01015403",2011,1095,7,1088,200
"49323","E01015404",2011,855,10,845,146
"49324","E01015405",2011,766,3,763,145
"49325","E01015406",2011,902,53,849,211
"49326","E01015407",2011,622,5,617,74
"49327","E01015408",2011,503,47,456,37
"49328","E01015409",2011,589,166,423,112
"49329","E01015410",2011,655,38,617,158
"49330","E01015411",2011,529,20,509,56
"49331","E01015412",2011,486,2,484,20
"49332","E01015413",2011,635,114,521,78
"49333","E01015414",2011,625,67,558,78
"49334","E01015415",2011,541,225,316,105
"49335","E01015416",2011,522,51,471,46
"49336","E01015417",2011,621,137,484,65
"49337","E01015418",2011,694,47,647,92
"49338","E01015419",2011,782,11,771,81
"49339","E01015420",2011,646,214,432,41
"49340","E01015421",2011,629,69,560,37
"49341","E01015422",2011,614,18,596,94
"49342","E01015423",2011,975,267,708,214
"49343","E01015424",2011,610,20,590,106
"49344","E01015425",2011,551,36,515,51
"49345","E01015426",2011,550,172,378,61
"49346","E01015427",2011,647,94,553,200
"49347","E01015428",2011,965,93,872,186
"49348","E01015429",2011,675,177,498,93
"49349","E01015430",2011,574,283,291,84
"49350","E01015431",2011,441,1,440,51
"49351","E01015432",2011,745,72,673,80
"49352","E01015433",2011,603,2,601,33
"49353","E01015434",2011,651,3,648,20
"49354","E01015435",2011,659,94,565,94
"49355","E01015436",2011,532,33,499,49
"49356","E01015437",2011,505,13,492,25
"49357","E01015438",2011,622,9,613,87
"49358","E01015439",2011,755,174,581,113
"49359","E01015440",2011,842,16,826,159
"49360","E01015441",2011,836,150,686,194
"49361","E01015442",2011,799,328,471,71
"49362","E01015443",2011,759,70,689,133
"49363","E01015444",2011,687,53,634,110
"49364","E01015445",2011,779,3,776,67
"49365","E01015446",2011,646,134,512,67
"49366","E01015447",2011,647,8,639,53
"49367","E01015448",2011,627,57,570,67
"49368","E01015449",2011,707,172,535,119
"49369","E01015450",2011,669,56,613,65
"49370","E01015451",2011,633,7,626,42
"49371","E01015452",2011,826,28,798,67
"49372","E01015453",2011,980,46,934,338
"49373","E01015454",2011,874,59,815,290
"49374","E01015455",2011,906,33,873,140
"49375","E01015456",2011,780,235,545,158
"49376","E01015457",2011,805,75,730,182
"49377","E01015458",2011,651,2,649,55
"49378","E01015459",2011,800,4,796,111
"49379","E01015460",2011,720,26,694,198
"49380","E01015461",2011,642,41,601,184
"49381","E01015462",2011,682,60,622,189
"49382","E01015463",2011,733,36,697,182
"49383","E01015464",2011,649,1,648,67
"49384","E01015465",2011,770,180,590,167
"49385","E01015466",2011,734,90,644,155
"49386","E01015468",2011,933,110,823,282
"49387","E01015471",2011,675,7,668,124
"49388","E01015472",2011,1088,110,978,215
"49389","E01015473",2011,674,58,616,68
"49390","E01015474",2011,649,92,557,66
"49391","E01015475",2011,683,61,622,263
"49392","E01015476",2011,1198,426,772,468
"49393","E01015477",2011,713,106,607,261
"49394","E01015478",2011,657,59,598,162
"49395","E01015479",2011,661,26,635,176
"49396","E01015480",2011,751,17,734,349
"49397","E01015481",2011,758,71,687,69
"49398","E01015482",2011,512,3,509,25
"49399","E01015483",2011,648,7,641,28
"49400","E01015484",2011,621,8,613,43
"49401","E01015485",2011,654,19,635,103
"49402","E01015486",2011,621,65,556,61
"49403","E01015487",2011,608,15,593,52
"49404","E01015488",2011,654,267,387,48
"49405","E01015489",2011,549,17,532,42
"49406","E01015490",2011,543,50,493,67
"49407","E01015491",2011,721,331,390,48
"49408","E01015492",2011,540,124,416,41
"49409","E01015493",2011,712,19,693,207
"49410","E01015494",2011,811,15,796,385
"49411","E01015496",2011,816,24,792,336
"49412","E01015497",2011,711,33,678,216
"49413","E01015498",2011,783,18,765,182
"49414","E01015499",2011,463,3,460,37
"49415","E01015500",2011,653,25,628,104
"49416","E01015501",2011,523,10,513,50
"49417","E01015502",2011,640,228,412,80
"49418","E01015503",2011,613,261,352,73
"49419","E01015504",2011,516,38,478,39
"49420","E01015505",2011,668,108,560,138
"49421","E01015506",2011,633,239,394,45
"49422","E01015507",2011,644,415,229,24
"49423","E01015508",2011,614,251,363,71
"49424","E01015509",2011,705,60,645,150
"49425","E01015510",2011,844,162,682,245
"49426","E01015511",2011,709,40,669,168
"49427","E01015512",2011,612,4,608,97
"49428","E01015513",2011,672,9,663,132
"49429","E01015514",2011,523,14,509,23
"49430","E01015515",2011,580,1,579,47
"49431","E01015516",2011,624,184,440,46
"49432","E01015517",2011,669,11,658,39
"49433","E01015518",2011,537,9,528,85
"49434","E01015519",2011,691,306,385,55
"49435","E01015520",2011,549,51,498,71
"49436","E01015521",2011,604,11,593,36
"49437","E01015522",2011,643,59,584,88
"49438","E01015523",2011,655,38,617,94
"49439","E01015524",2011,465,70,395,42
"49440","E01015525",2011,664,11,653,91
"49441","E01015526",2011,607,50,557,90
"49442","E01015527",2011,682,193,489,64
"49443","E01015528",2011,794,398,396,61
"49444","E01015529",2011,676,82,594,77
"49445","E01015530",2011,698,289,409,37
"49446","E01015532",2011,636,18,618,165
"49447","E01015533",2011,673,9,664,39
"49448","E01015534",2011,1046,143,903,269
"49449","E01015535",2011,618,9,609,54
"49450","E01015536",2011,1012,141,871,70
"49451","E01015537",2011,707,306,401,39
"49452","E01015538",2011,841,470,371,46
"49453","E01015539",2011,630,175,455,47
"49454","E01015540",2011,736,353,383,63
"49455","E01015541",2011,749,369,380,72
"49456","E01015542",2011,623,335,288,46
"49457","E01015543",2011,605,175,430,31
"49458","E01015544",2011,743,460,283,30
"49459","E01015545",2011,698,480,218,30
"49460","E01015546",2011,699,476,223,36
"49461","E01015547",2011,594,54,540,79
"49462","E01015548",2011,619,29,590,75
"49463","E01015549",2011,702,16,686,80
"49464","E01015550",2011,876,38,838,90
"49465","E01015551",2011,619,24,595,38
"49466","E01015552",2011,814,58,756,120
"49467","E01015553",2011,670,12,658,118
"49468","E01015554",2011,640,162,478,22
"49469","E01015555",2011,668,134,534,51
"49470","E01015556",2011,669,34,635,85
"49471","E01015557",2011,627,15,612,72
"49472","E01015558",2011,640,406,234,37
"49473","E01015559",2011,638,91,547,60
"49474","E01015560",2011,669,19,650,64
"49475","E01015561",2011,650,5,645,167
"49476","E01015562",2011,599,80,519,88
"49477","E01015563",2011,601,6,595,79
"49478","E01015564",2011,607,6,601,85
"49479","E01015565",2011,646,115,531,109
"49480","E01015566",2011,679,9,670,142
"49481","E01015567",2011,673,5,668,162
"49482","E01015568",2011,622,24,598,154
"49483","E01015569",2011,643,256,387,41
"49484","E01015570",2011,771,371,400,87
"49485","E01015571",2011,648,47,601,78
"49486","E01015572",2011,523,306,217,40
"49487","E01015573",2011,936,532,404,65
"49488","E01015574",2011,644,55,589,70
"49489","E01015575",2011,489,279,210,40
"49490","E01015576",2011,681,61,620,32
"49491","E01015578",2011,748,87,661,197
"49492","E01015579",2011,696,27,669,150
"49493","E01015580",2011,637,173,464,35
"49494","E01015581",2011,617,10,607,58
"49495","E01015582",2011,832,39,793,200
"49496","E01015583",2011,860,94,766,123
"49497","E01015584",2011,646,78,568,26
"49498","E01015585",2011,661,51,610,68
"49499","E01015586",2011,631,18,613,22
"49500","E01015587",2011,865,268,597,73
"49501","E01015588",2011,740,147,593,59
"49502","E01015589",2011,668,39,629,66
"49503","E01015590",2011,531,89,442,74
"49504","E01015591",2011,587,66,521,57
"49505","E01015592",2011,644,133,511,135
"49506","E01015593",2011,571,209,362,116
"49507","E01015594",2011,752,152,600,154
"49508","E01015595",2011,677,266,411,87
"49509","E01015596",2011,594,166,428,149
"49510","E01015597",2011,612,315,297,83
"49511","E01015598",2011,633,69,564,68
"49512","E01015599",2011,729,222,507,287
"49513","E01015600",2011,547,63,484,186
"49514","E01015601",2011,514,25,489,155
"49515","E01015602",2011,892,109,783,469
"49516","E01015603",2011,772,121,651,339
"49517","E01015604",2011,506,71,435,149
"49518","E01015605",2011,641,228,413,74
"49519","E01015606",2011,721,143,578,98
"49520","E01015607",2011,633,337,296,67
"49521","E01015608",2011,633,186,447,79
"49522","E01015609",2011,664,398,266,79
"49523","E01015610",2011,664,285,379,67
"49524","E01015611",2011,914,335,579,191
"49525","E01015612",2011,859,134,725,330
"49526","E01015613",2011,666,193,473,166
"49527","E01015614",2011,737,73,664,258
"49528","E01015615",2011,678,168,510,93
"49529","E01015616",2011,652,310,342,127
"49530","E01015617",2011,560,20,540,114
"49531","E01015618",2011,451,82,369,44
"49532","E01015619",2011,871,224,647,118
"49533","E01015620",2011,685,11,674,69
"49534","E01015621",2011,929,113,816,340
"49535","E01015622",2011,1093,175,918,360
"49536","E01015623",2011,744,103,641,130
"49537","E01015624",2011,729,65,664,199
"49538","E01015626",2011,535,65,470,308
"49539","E01015627",2011,749,56,693,115
"49540","E01015628",2011,746,45,701,214
"49541","E01015629",2011,671,52,619,35
"49542","E01015630",2011,612,66,546,57
"49543","E01015631",2011,524,28,496,39
"49544","E01015632",2011,731,159,572,238
"49545","E01015633",2011,982,367,615,109
"49546","E01015634",2011,765,339,426,80
"49547","E01015635",2011,632,6,626,34
"49548","E01015636",2011,474,32,442,38
"49549","E01015637",2011,562,164,398,130
"49550","E01015638",2011,609,86,523,42
"49551","E01015639",2011,678,325,353,141
"49552","E01015640",2011,590,95,495,107
"49553","E01015641",2011,497,89,408,88
"49554","E01015642",2011,576,254,322,115
"49555","E01015643",2011,583,106,477,83
"49556","E01015644",2011,787,95,692,144
"49557","E01015645",2011,708,55,653,104
"49558","E01015646",2011,881,8,873,72
"49559","E01015647",2011,629,327,302,99
"49560","E01015648",2011,607,58,549,14
"49561","E01015650",2011,863,52,811,175
"49562","E01015651",2011,658,13,645,127
"49563","E01015652",2011,596,21,575,201
"49564","E01015653",2011,650,30,620,117
"49565","E01015654",2011,866,202,664,263
"49566","E01015655",2011,808,35,773,351
"49567","E01015656",2011,666,310,356,53
"49568","E01015657",2011,735,250,485,135
"49569","E01015658",2011,633,355,278,73
"49570","E01015659",2011,839,37,802,152
"49571","E01015660",2011,740,270,470,85
"49572","E01015661",2011,611,154,457,101
"49573","E01015662",2011,485,87,398,130
"49574","E01015663",2011,649,376,273,71
"49575","E01015664",2011,668,361,307,87
"49576","E01015665",2011,574,89,485,166
"49577","E01015666",2011,622,226,396,101
"49578","E01015667",2011,550,83,467,92
"49579","E01015668",2011,817,220,597,208
"49580","E01015669",2011,602,67,535,69
"49581","E01015670",2011,601,62,539,47
"49582","E01015671",2011,719,40,679,74
"49583","E01015672",2011,657,49,608,75
"49584","E01015673",2011,648,284,364,60
"49585","E01015674",2011,669,204,465,78
"49586","E01015675",2011,665,78,587,76
"49587","E01015676",2011,690,105,585,130
"49588","E01015677",2011,474,33,441,135
"49589","E01015678",2011,568,26,542,82
"49590","E01015679",2011,823,75,748,152
"49591","E01015680",2011,640,258,382,126
"49592","E01015681",2011,594,43,551,54
"49593","E01015682",2011,664,72,592,125
"49594","E01015683",2011,849,74,775,71
"49595","E01015684",2011,607,5,602,13
"49596","E01015685",2011,693,11,682,57
"49597","E01015686",2011,711,10,701,66
"49598","E01015687",2011,640,5,635,52
"49599","E01015688",2011,658,67,591,195
"49600","E01015689",2011,617,26,591,57
"49601","E01015690",2011,462,8,454,45
"49602","E01015691",2011,500,28,472,54
"49603","E01015692",2011,469,36,433,122
"49604","E01015693",2011,514,1,513,27
"49605","E01015694",2011,497,1,496,49
"49606","E01015695",2011,494,3,491,48
"49607","E01015696",2011,505,26,479,82
"49608","E01015697",2011,659,8,651,92
"49609","E01015698",2011,532,46,486,253
"49610","E01015699",2011,617,155,462,276
"49611","E01015700",2011,773,74,699,251
"49612","E01015701",2011,509,40,469,125
"49613","E01015702",2011,472,60,412,141
"49614","E01015703",2011,490,23,467,105
"49615","E01015704",2011,570,47,523,205
"49616","E01015705",2011,561,102,459,276
"49617","E01015706",2011,604,61,543,60
"49618","E01015707",2011,585,3,582,66
"49619","E01015708",2011,510,4,506,35
"49620","E01015709",2011,629,22,607,111
"49621","E01015710",2011,643,7,636,110
"49622","E01015711",2011,514,13,501,106
"49623","E01015712",2011,631,19,612,131
"49624","E01015713",2011,517,15,502,108
"49625","E01015714",2011,631,32,599,142
"49626","E01015715",2011,496,86,410,93
"49627","E01015716",2011,616,211,405,140
"49628","E01015717",2011,512,38,474,129
"49629","E01015718",2011,680,108,572,144
"49630","E01015719",2011,552,11,541,62
"49631","E01015720",2011,554,207,347,92
"49632","E01015721",2011,656,45,611,103
"49633","E01015722",2011,522,55,467,102
"49634","E01015723",2011,494,74,420,78
"49635","E01015724",2011,658,61,597,194
"49636","E01015725",2011,496,114,382,174
"49637","E01015726",2011,574,83,491,151
"49638","E01015727",2011,450,31,419,181
"49639","E01015728",2011,515,23,492,145
"49640","E01015729",2011,595,99,496,308
"49641","E01015730",2011,743,96,647,330
"49642","E01015731",2011,553,19,534,183
"49643","E01015732",2011,514,226,288,47
"49644","E01015733",2011,608,242,366,49
"49645","E01015734",2011,716,100,616,114
"49646","E01015735",2011,690,133,557,339
"49647","E01015736",2011,689,346,343,81
"49648","E01015737",2011,503,122,381,78
"49649","E01015738",2011,788,78,710,378
"49650","E01015739",2011,963,24,939,521
"49651","E01015740",2011,568,18,550,146
"49652","E01015741",2011,1022,268,754,489
"49653","E01015742",2011,739,33,706,339
"49654","E01015743",2011,687,121,566,328
"49655","E01015744",2011,643,197,446,90
"49656","E01015745",2011,557,6,551,34
"49657","E01015746",2011,621,59,562,54
"49658","E01015747",2011,486,9,477,24
"49659","E01015748",2011,720,65,655,60
"49660","E01015749",2011,700,390,310,66
"49661","E01015750",2011,718,32,686,203
"49662","E01015751",2011,624,170,454,80
"49663","E01015752",2011,478,64,414,57
"49664","E01015753",2011,615,78,537,103
"49665","E01015754",2011,768,398,370,78
"49666","E01015755",2011,687,114,573,81
"49667","E01015756",2011,647,116,531,93
"49668","E01015757",2011,613,245,368,57
"49669","E01015758",2011,524,139,385,87
"49670","E01015759",2011,617,296,321,77
"49671","E01015760",2011,611,296,315,51
"49672","E01015761",2011,606,168,438,59
"49673","E01015762",2011,670,34,636,145
"49674","E01015763",2011,639,80,559,56
"49675","E01015764",2011,593,12,581,45
"49676","E01015765",2011,658,130,528,160
"49677","E01015766",2011,555,21,534,107
"49678","E01015767",2011,595,28,567,117
"49679","E01015768",2011,580,54,526,38
"49680","E01015769",2011,496,109,387,71
"49681","E01015770",2011,491,3,488,26
"49682","E01015771",2011,577,333,244,53
"49683","E01015772",2011,534,205,329,92
"49684","E01015773",2011,461,230,231,30
"49685","E01015774",2011,518,161,357,109
"49686","E01015775",2011,704,27,677,219
"49687","E01015776",2011,736,128,608,87
"49688","E01015777",2011,683,22,661,179
"49689","E01015778",2011,682,8,674,139
"49690","E01015779",2011,494,239,255,52
"49691","E01015780",2011,630,53,577,97
"49692","E01015781",2011,533,113,420,74
"49693","E01015782",2011,636,30,606,111
"49694","E01015783",2011,524,120,404,92
"49695","E01015784",2011,532,17,515,118
"49696","E01015785",2011,820,56,764,270
"49697","E01015786",2011,564,33,531,152
"49698","E01015787",2011,570,36,534,157
"49699","E01015788",2011,456,60,396,81
"49700","E01015789",2011,832,477,355,250
"49701","E01015790",2011,613,53,560,188
"49702","E01015791",2011,1115,338,777,557
"49703","E01015792",2011,691,69,622,335
"49704","E01015793",2011,644,63,581,164
"49705","E01015794",2011,1054,170,884,739
"49706","E01015795",2011,985,179,806,649
"49707","E01015796",2011,667,53,614,93
"49708","E01015797",2011,506,11,495,21
"49709","E01015798",2011,539,116,423,62
"49710","E01015799",2011,574,12,562,53
"49711","E01015800",2011,627,11,616,104
"49712","E01015801",2011,746,223,523,112
"49713","E01015802",2011,608,255,353,51
"49714","E01015803",2011,592,17,575,37
"49715","E01015804",2011,713,118,595,100
"49716","E01015805",2011,491,10,481,26
"49717","E01015806",2011,554,20,534,124
"49718","E01015807",2011,532,137,395,39
"49719","E01015808",2011,626,45,581,162
"49720","E01015809",2011,502,6,496,25
"49721","E01015810",2011,514,119,395,82
"49722","E01015811",2011,580,4,576,101
"49723","E01015812",2011,524,5,519,45
"49724","E01015813",2011,688,186,502,149
"49725","E01015814",2011,624,115,509,52
"49726","E01015815",2011,625,9,616,68
"49727","E01015816",2011,770,86,684,100
"49728","E01015817",2011,730,7,723,48
"49729","E01015818",2011,797,72,725,89
"49730","E01015819",2011,627,151,476,80
"49731","E01015820",2011,613,274,339,61
"49732","E01015821",2011,720,51,669,98
"49733","E01015822",2011,485,21,464,62
"49734","E01015823",2011,673,16,657,101
"49735","E01015824",2011,615,225,390,55
"49736","E01015825",2011,600,132,468,42
"49737","E01015826",2011,573,45,528,52
"49738","E01015827",2011,662,8,654,157
"49739","E01015828",2011,826,100,726,416
"49740","E01015829",2011,643,4,639,154
"49741","E01015830",2011,625,2,623,85
"49742","E01015831",2011,840,14,826,405
"49743","E01015832",2011,773,61,712,191
"49744","E01015833",2011,623,3,620,56
"49745","E01015834",2011,622,4,618,50
"49746","E01015835",2011,723,79,644,119
"49747","E01015836",2011,635,4,631,48
"49748","E01015837",2011,730,47,683,64
"49749","E01015838",2011,649,4,645,36
"49750","E01015839",2011,761,130,631,277
"49751","E01015840",2011,714,71,643,276
"49752","E01015841",2011,1071,62,1009,640
"49753","E01015842",2011,905,647,258,153
"49754","E01015843",2011,714,60,654,285
"49755","E01015844",2011,922,260,662,320
"49756","E01015845",2011,683,2,681,138
"49757","E01015846",2011,797,8,789,233
"49758","E01015847",2011,797,10,787,286
"49759","E01015848",2011,902,5,897,273
"49760","E01015849",2011,754,15,739,235
"49761","E01015850",2011,675,4,671,123
"49762","E01015851",2011,1016,13,1003,484
"49763","E01015852",2011,860,28,832,497
"49764","E01015853",2011,907,7,900,418
"49765","E01015854",2011,748,37,711,409
"49766","E01015855",2011,888,36,852,473
"49767","E01015856",2011,780,23,757,334
"49768","E01015857",2011,663,6,657,34
"49769","E01015858",2011,714,17,697,105
"49770","E01015859",2011,800,105,695,129
"49771","E01015860",2011,626,13,613,73
"49772","E01015861",2011,753,229,524,126
"49773","E01015862",2011,652,35,617,219
"49774","E01015863",2011,999,150,849,80
"49775","E01015864",2011,596,52,544,44
"49776","E01015865",2011,649,22,627,52
"49777","E01015866",2011,669,10,659,61
"49778","E01015867",2011,640,211,429,91
"49779","E01015868",2011,652,114,538,100
"49780","E01015869",2011,634,52,582,150
"49781","E01015870",2011,663,18,645,166
"49782","E01015871",2011,657,57,600,79
"49783","E01015872",2011,685,17,668,200
"49784","E01015873",2011,540,11,529,157
"49785","E01015874",2011,716,59,657,154
"49786","E01015875",2011,751,273,478,121
"49787","E01015876",2011,884,27,857,129
"49788","E01015877",2011,819,196,623,173
"49789","E01015878",2011,581,48,533,133
"49790","E01015879",2011,587,212,375,120
"49791","E01015880",2011,660,331,329,109
"49792","E01015881",2011,566,121,445,44
"49793","E01015882",2011,685,171,514,166
"49794","E01015883",2011,566,8,558,29
"49795","E01015884",2011,923,103,820,234
"49796","E01015885",2011,711,6,705,32
"49797","E01015886",2011,638,366,272,51
"49798","E01015887",2011,583,236,347,68
"49799","E01015888",2011,644,74,570,37
"49800","E01015889",2011,610,3,607,45
"49801","E01015890",2011,626,5,621,76
"49802","E01015891",2011,658,12,646,205
"49803","E01015892",2011,636,2,634,104
"49804","E01015893",2011,793,1,792,37
"49805","E01015894",2011,598,5,593,40
"49806","E01015895",2011,1053,591,462,256
"49807","E01015896",2011,853,258,595,284
"49808","E01015897",2011,884,405,479,141
"49809","E01015898",2011,757,95,662,250
"49810","E01015899",2011,800,60,740,281
"49811","E01015900",2011,618,44,574,257
"49812","E01015901",2011,589,3,586,211
"49813","E01015902",2011,647,6,641,274
"49814","E01015903",2011,675,7,668,213
"49815","E01015904",2011,695,12,683,205
"49816","E01015905",2011,583,4,579,188
"49817","E01015906",2011,605,25,580,211
"49818","E01015907",2011,592,9,583,196
"49819","E01015908",2011,647,1,646,52
"49820","E01015909",2011,627,18,609,135
"49821","E01015910",2011,623,2,621,62
"49822","E01015911",2011,511,9,502,19
"49823","E01015912",2011,639,18,621,39
"49824","E01015913",2011,793,13,780,202
"49825","E01015914",2011,502,6,496,19
"49826","E01015915",2011,621,21,600,53
"49827","E01015916",2011,544,329,215,39
"49828","E01015917",2011,622,243,379,123
"49829","E01015918",2011,531,10,521,129
"49830","E01015919",2011,505,69,436,39
"49831","E01015920",2011,638,9,629,45
"49832","E01015921",2011,548,44,504,142
"49833","E01015922",2011,591,273,318,33
"49834","E01015923",2011,653,149,504,90
"49835","E01015924",2011,600,150,450,38
"49836","E01015925",2011,624,55,569,22
"49837","E01015926",2011,658,127,531,67
"49838","E01015927",2011,663,225,438,47
"49839","E01015928",2011,653,136,517,38
"49840","E01015929",2011,654,342,312,47
"49841","E01015930",2011,664,160,504,56
"49842","E01015931",2011,663,328,335,82
"49843","E01015932",2011,569,130,439,46
"49844","E01015933",2011,635,165,470,45
"49845","E01015934",2011,523,215,308,40
"49846","E01015935",2011,607,224,383,37
"49847","E01015936",2011,686,268,418,21
"49848","E01015937",2011,688,135,553,19
"49849","E01015938",2011,796,452,344,30
"49850","E01015939",2011,557,5,552,83
"49851","E01015941",2011,513,20,493,76
"49852","E01015942",2011,563,25,538,92
"49853","E01015943",2011,601,5,596,51
"49854","E01015944",2011,525,4,521,20
"49855","E01015945",2011,490,62,428,26
"49856","E01015946",2011,624,12,612,52
"49857","E01015947",2011,548,56,492,106
"49858","E01015948",2011,605,22,583,156
"49859","E01015949",2011,612,74,538,43
"49860","E01015950",2011,682,17,665,85
"49861","E01015951",2011,657,109,548,228
"49862","E01015952",2011,818,130,688,293
"49863","E01015953",2011,1002,107,895,406
"49864","E01015954",2011,989,439,550,300
"49865","E01015955",2011,641,18,623,150
"49866","E01015956",2011,807,50,757,307
"49867","E01015957",2011,593,233,360,46
"49868","E01015958",2011,480,135,345,42
"49869","E01015959",2011,634,123,511,128
"49870","E01015960",2011,544,85,459,32
"49871","E01015961",2011,617,22,595,124
"49872","E01015962",2011,621,62,559,208
"49873","E01015963",2011,494,215,279,29
"49874","E01015964",2011,598,34,564,37
"49875","E01015965",2011,597,9,588,33
"49876","E01015966",2011,630,10,620,27
"49877","E01015967",2011,591,18,573,65
"49878","E01015968",2011,607,14,593,84
"49879","E01015969",2011,766,94,672,83
"49880","E01015970",2011,491,11,480,50
"49881","E01015971",2011,681,192,489,105
"49882","E01015972",2011,697,206,491,47
"49883","E01015973",2011,696,250,446,54
"49884","E01015974",2011,557,59,498,33
"49885","E01015975",2011,627,86,541,49
"49886","E01015976",2011,785,387,398,51
"49887","E01015977",2011,728,81,647,60
"49888","E01015978",2011,491,6,485,53
"49889","E01015979",2011,528,6,522,51
"49890","E01015980",2011,623,38,585,53
"49891","E01015982",2011,895,4,891,185
"49892","E01015983",2011,624,34,590,78
"49893","E01015984",2011,488,22,466,28
"49894","E01015985",2011,636,65,571,34
"49895","E01015986",2011,620,230,390,55
"49896","E01015987",2011,576,154,422,59
"49897","E01015988",2011,610,264,346,52
"49898","E01015989",2011,672,66,606,187
"49899","E01015990",2011,581,145,436,42
"49900","E01015991",2011,585,31,554,48
"49901","E01015992",2011,784,77,707,136
"49902","E01015993",2011,646,169,477,35
"49903","E01015994",2011,643,190,453,30
"49904","E01015995",2011,615,14,601,24
"49905","E01015996",2011,622,216,406,23
"49906","E01015997",2011,503,3,500,23
"49907","E01015998",2011,595,42,553,36
"49908","E01015999",2011,490,6,484,36
"49909","E01016000",2011,600,19,581,79
"49910","E01016001",2011,513,13,500,32
"49911","E01016002",2011,521,10,511,21
"49912","E01016003",2011,774,85,689,235
"49913","E01016004",2011,677,327,350,64
"49914","E01016005",2011,553,149,404,70
"49915","E01016006",2011,648,436,212,49
"49916","E01016007",2011,522,257,265,45
"49917","E01016008",2011,592,50,542,112
"49918","E01016009",2011,652,261,391,82
"49919","E01016010",2011,503,266,237,45
"49920","E01016011",2011,677,51,626,266
"49921","E01016012",2011,928,225,703,237
"49922","E01016013",2011,1015,47,968,392
"49923","E01016014",2011,1009,357,652,218
"49924","E01016015",2011,606,68,538,95
"49925","E01016016",2011,650,175,475,149
"49926","E01016017",2011,750,214,536,267
"49927","E01016018",2011,754,47,707,287
"49928","E01016019",2011,657,59,598,270
"49929","E01016020",2011,506,90,416,125
"49930","E01016021",2011,595,23,572,199
"49931","E01016022",2011,507,54,453,160
"49932","E01016023",2011,603,301,302,82
"49933","E01016024",2011,768,34,734,309
"49934","E01016025",2011,629,219,410,49
"49935","E01016026",2011,506,22,484,41
"49936","E01016027",2011,572,6,566,30
"49937","E01016028",2011,598,48,550,46
"49938","E01016029",2011,535,77,458,82
"49939","E01016030",2011,696,248,448,58
"49940","E01016031",2011,859,255,604,324
"49941","E01016032",2011,466,263,203,56
"49942","E01016033",2011,474,213,261,80
"49943","E01016034",2011,1035,49,986,240
"49944","E01016035",2011,737,162,575,258
"49945","E01016036",2011,715,59,656,270
"49946","E01016037",2011,665,48,617,238
"49947","E01016038",2011,586,59,527,145
"49948","E01016039",2011,692,25,667,286
"49949","E01016040",2011,681,51,630,197
"49950","E01016041",2011,714,54,660,267
"49951","E01016042",2011,570,28,542,188
"49952","E01016043",2011,561,66,495,61
"49953","E01016044",2011,673,11,662,252
"49954","E01016045",2011,630,19,611,226
"49955","E01016046",2011,632,17,615,239
"49956","E01016047",2011,649,16,633,242
"49957","E01016048",2011,683,3,680,259
"49958","E01016049",2011,876,182,694,329
"49959","E01016050",2011,666,5,661,48
"49960","E01016051",2011,592,1,591,51
"49961","E01016052",2011,648,5,643,25
"49962","E01016053",2011,637,8,629,47
"49963","E01016054",2011,596,2,594,50
"49964","E01016055",2011,651,110,541,60
"49965","E01016056",2011,630,54,576,117
"49966","E01016057",2011,642,38,604,73
"49967","E01016058",2011,622,24,598,76
"49968","E01016059",2011,532,165,367,65
"49969","E01016060",2011,628,5,623,31
"49970","E01016061",2011,694,31,663,280
"49971","E01016062",2011,594,119,475,105
"49972","E01016063",2011,741,205,536,235
"49973","E01016064",2011,701,168,533,167
"49974","E01016065",2011,635,85,550,57
"49975","E01016066",2011,608,162,446,65
"49976","E01016067",2011,651,144,507,68
"49977","E01016068",2011,667,287,380,67
"49978","E01016069",2011,764,70,694,373
"49979","E01016070",2011,731,43,688,60
"49980","E01016071",2011,630,68,562,74
"49981","E01016072",2011,525,102,423,52
"49982","E01016073",2011,794,44,750,31
"49983","E01016074",2011,838,55,783,62
"49984","E01016075",2011,576,76,500,22
"49985","E01016076",2011,920,102,818,85
"49986","E01016077",2011,634,124,510,61
"49987","E01016078",2011,658,9,649,157
"49988","E01016079",2011,488,44,444,38
"49989","E01016080",2011,620,62,558,75
"49990","E01016081",2011,567,10,557,68
"49991","E01016082",2011,580,4,576,64
"49992","E01016083",2011,570,256,314,46
"49993","E01016084",2011,513,162,351,41
"49994","E01016085",2011,646,1,645,34
"49995","E01016086",2011,499,5,494,13
"49996","E01016087",2011,694,5,689,108
"49997","E01016088",2011,597,89,508,40
"49998","E01016089",2011,667,74,593,66
"49999","E01016090",2011,609,4,605,43
"50000","E01016091",2011,614,40,574,19
"50001","E01016092",2011,630,3,627,52
"50002","E01016093",2011,665,4,661,31
"50003","E01016094",2011,616,24,592,77
"50004","E01016095",2011,523,30,493,53
"50005","E01016096",2011,633,11,622,52
"50006","E01016097",2011,637,96,541,111
"50007","E01016098",2011,682,115,567,228
"50008","E01016099",2011,621,11,610,95
"50009","E01016100",2011,657,110,547,75
"50010","E01016101",2011,565,7,558,77
"50011","E01016102",2011,620,205,415,96
"50012","E01016103",2011,575,3,572,56
"50013","E01016104",2011,566,2,564,61
"50014","E01016105",2011,592,7,585,64
"50015","E01016106",2011,591,30,561,70
"50016","E01016107",2011,602,4,598,74
"50017","E01016110",2011,955,195,760,471
"50018","E01016111",2011,568,220,348,198
"50019","E01016112",2011,1162,65,1097,279
"50020","E01016113",2011,598,35,563,80
"50021","E01016114",2011,656,116,540,157
"50022","E01016115",2011,765,198,567,71
"50023","E01016116",2011,757,237,520,61
"50024","E01016117",2011,867,319,548,274
"50025","E01016118",2011,752,21,731,210
"50026","E01016119",2011,532,30,502,33
"50027","E01016120",2011,596,165,431,58
"50028","E01016121",2011,640,16,624,53
"50029","E01016122",2011,617,7,610,48
"50030","E01016123",2011,635,55,580,78
"50031","E01016124",2011,673,34,639,98
"50032","E01016125",2011,646,11,635,151
"50033","E01016126",2011,613,27,586,46
"50034","E01016127",2011,705,91,614,125
"50035","E01016128",2011,545,91,454,45
"50036","E01016129",2011,948,247,701,270
"50037","E01016130",2011,920,122,798,327
"50038","E01016131",2011,783,134,649,154
"50039","E01016132",2011,640,13,627,64
"50040","E01016133",2011,539,3,536,24
"50041","E01016134",2011,526,61,465,35
"50042","E01016135",2011,624,34,590,98
"50043","E01016136",2011,624,151,473,118
"50044","E01016137",2011,614,38,576,189
"50045","E01016138",2011,592,2,590,42
"50046","E01016139",2011,616,24,592,58
"50047","E01016140",2011,596,80,516,182
"50048","E01016141",2011,723,22,701,231
"50049","E01016142",2011,491,10,481,53
"50050","E01016143",2011,949,154,795,116
"50051","E01016144",2011,575,39,536,50
"50052","E01016145",2011,485,23,462,24
"50053","E01016146",2011,852,244,608,69
"50054","E01016147",2011,738,11,727,78
"50055","E01016148",2011,731,17,714,57
"50056","E01016149",2011,586,118,468,69
"50057","E01016150",2011,607,166,441,71
"50058","E01016151",2011,623,63,560,83
"50059","E01016152",2011,632,233,399,50
"50060","E01016153",2011,607,252,355,64
"50061","E01016154",2011,648,45,603,134
"50062","E01016155",2011,619,151,468,41
"50063","E01016156",2011,659,61,598,85
"50064","E01016157",2011,778,98,680,96
"50065","E01016158",2011,880,150,730,64
"50066","E01016159",2011,512,226,286,40
"50067","E01016160",2011,612,217,395,45
"50068","E01016161",2011,743,370,373,57
"50069","E01016162",2011,648,28,620,76
"50070","E01016163",2011,505,103,402,28
"50071","E01016164",2011,646,185,461,51
"50072","E01016165",2011,520,44,476,43
"50073","E01016166",2011,580,38,542,35
"50074","E01016167",2011,576,73,503,39
"50075","E01016168",2011,658,159,499,44
"50076","E01016169",2011,638,14,624,53
"50077","E01016170",2011,634,19,615,108
"50078","E01016171",2011,638,211,427,47
"50079","E01016172",2011,587,5,582,37
"50080","E01016173",2011,648,165,483,57
"50081","E01016174",2011,514,12,502,125
"50082","E01016175",2011,707,26,681,65
"50083","E01016176",2011,575,4,571,42
"50084","E01016177",2011,625,53,572,129
"50085","E01016178",2011,555,10,545,108
"50086","E01016179",2011,505,18,487,27
"50087","E01016180",2011,558,84,474,66
"50088","E01016181",2011,540,5,535,109
"50089","E01016182",2011,614,40,574,80
"50090","E01016183",2011,516,6,510,52
"50091","E01016184",2011,868,51,817,143
"50092","E01016185",2011,607,6,601,177
"50093","E01016186",2011,731,83,648,88
"50094","E01016187",2011,667,35,632,61
"50095","E01016188",2011,661,54,607,84
"50096","E01016190",2011,609,126,483,43
"50097","E01016191",2011,651,150,501,42
"50098","E01016192",2011,612,111,501,113
"50099","E01016193",2011,528,51,477,87
"50100","E01016194",2011,511,6,505,27
"50101","E01016195",2011,473,56,417,49
"50102","E01016196",2011,557,28,529,219
"50103","E01016197",2011,511,81,430,34
"50104","E01016198",2011,517,5,512,55
"50105","E01016199",2011,470,8,462,57
"50106","E01016200",2011,562,46,516,103
"50107","E01016201",2011,565,47,518,116
"50108","E01016202",2011,635,13,622,189
"50109","E01016203",2011,591,243,348,69
"50110","E01016204",2011,482,125,357,60
"50111","E01016205",2011,546,143,403,60
"50112","E01016206",2011,747,33,714,103
"50113","E01016207",2011,512,92,420,49
"50114","E01016208",2011,836,82,754,152
"50115","E01016209",2011,553,100,453,39
"50116","E01016210",2011,483,176,307,45
"50117","E01016212",2011,493,115,378,45
"50118","E01016213",2011,428,49,379,25
"50119","E01016214",2011,509,18,491,16
"50120","E01016215",2011,480,163,317,50
"50121","E01016216",2011,561,118,443,65
"50122","E01016217",2011,578,106,472,73
"50123","E01016218",2011,634,200,434,58
"50124","E01016219",2011,545,94,451,43
"50125","E01016220",2011,578,138,440,75
"50126","E01016221",2011,580,71,509,77
"50127","E01016222",2011,503,3,500,70
"50128","E01016223",2011,648,195,453,113
"50129","E01016224",2011,756,261,495,84
"50130","E01016225",2011,888,238,650,89
"50131","E01016226",2011,625,185,440,75
"50132","E01016227",2011,482,36,446,27
"50133","E01016228",2011,574,21,553,42
"50134","E01016229",2011,491,4,487,34
"50135","E01016230",2011,459,6,453,94
"50136","E01016231",2011,764,186,578,92
"50137","E01016232",2011,611,103,508,84
"50138","E01016233",2011,1027,405,622,146
"50139","E01016234",2011,459,6,453,46
"50140","E01016235",2011,487,13,474,27
"50141","E01016236",2011,578,146,432,38
"50142","E01016237",2011,473,14,459,50
"50143","E01016238",2011,483,84,399,48
"50144","E01016239",2011,610,176,434,40
"50145","E01016240",2011,646,237,409,50
"50146","E01016241",2011,647,256,391,54
"50147","E01016242",2011,805,333,472,102
"50148","E01016243",2011,592,67,525,86
"50149","E01016245",2011,889,34,855,93
"50150","E01016246",2011,607,6,601,76
"50151","E01016247",2011,692,40,652,80
"50152","E01016248",2011,568,156,412,51
"50153","E01016249",2011,797,389,408,133
"50154","E01016250",2011,708,126,582,103
"50155","E01016252",2011,658,19,639,88
"50156","E01016253",2011,521,12,509,54
"50157","E01016254",2011,611,37,574,57
"50158","E01016255",2011,581,59,522,99
"50159","E01016256",2011,666,50,616,62
"50160","E01016257",2011,534,25,509,71
"50161","E01016258",2011,669,4,665,30
"50162","E01016259",2011,584,15,569,40
"50163","E01016260",2011,617,13,604,38
"50164","E01016261",2011,550,3,547,31
"50165","E01016262",2011,531,7,524,21
"50166","E01016263",2011,849,80,769,132
"50167","E01016264",2011,430,22,408,111
"50168","E01016265",2011,578,71,507,40
"50169","E01016266",2011,530,78,452,36
"50170","E01016267",2011,550,22,528,46
"50171","E01016268",2011,624,179,445,52
"50172","E01016269",2011,565,24,541,82
"50173","E01016270",2011,533,31,502,165
"50174","E01016271",2011,597,211,386,29
"50175","E01016272",2011,590,22,568,45
"50176","E01016273",2011,627,251,376,43
"50177","E01016274",2011,512,57,455,44
"50178","E01016275",2011,647,41,606,109
"50179","E01016276",2011,578,14,564,75
"50180","E01016277",2011,527,42,485,57
"50181","E01016278",2011,411,11,400,132
"50182","E01016279",2011,914,210,704,195
"50183","E01016280",2011,700,199,501,115
"50184","E01016281",2011,556,62,494,60
"50185","E01016282",2011,615,47,568,115
"50186","E01016283",2011,575,22,553,53
"50187","E01016284",2011,515,39,476,36
"50188","E01016285",2011,622,94,528,158
"50189","E01016286",2011,602,134,468,68
"50190","E01016287",2011,573,83,490,125
"50191","E01016288",2011,666,125,541,82
"50192","E01016289",2011,579,44,535,20
"50193","E01016290",2011,629,14,615,79
"50194","E01016291",2011,688,28,660,71
"50195","E01016292",2011,615,104,511,49
"50196","E01016293",2011,1005,171,834,106
"50197","E01016294",2011,650,16,634,92
"50198","E01016295",2011,616,353,263,57
"50199","E01016296",2011,766,127,639,130
"50200","E01016297",2011,628,178,450,50
"50201","E01016298",2011,564,34,530,161
"50202","E01016299",2011,642,28,614,141
"50203","E01016300",2011,642,104,538,86
"50204","E01016301",2011,771,69,702,162
"50205","E01016302",2011,633,105,528,67
"50206","E01016303",2011,633,76,557,105
"50207","E01016304",2011,672,139,533,107
"50208","E01016305",2011,581,95,486,117
"50209","E01016306",2011,530,156,374,37
"50210","E01016307",2011,679,192,487,69
"50211","E01016308",2011,759,55,704,98
"50212","E01016309",2011,888,108,780,124
"50213","E01016310",2011,826,258,568,107
"50214","E01016311",2011,819,78,741,221
"50215","E01016312",2011,825,172,653,142
"50216","E01016313",2011,706,92,614,85
"50217","E01016314",2011,521,9,512,102
"50218","E01016315",2011,713,6,707,89
"50219","E01016316",2011,793,31,762,58
"50220","E01016317",2011,510,60,450,35
"50221","E01016318",2011,626,10,616,48
"50222","E01016319",2011,737,199,538,108
"50223","E01016320",2011,637,98,539,117
"50224","E01016321",2011,609,85,524,99
"50225","E01016322",2011,491,10,481,26
"50226","E01016323",2011,595,86,509,67
"50227","E01016324",2011,577,104,473,66
"50228","E01016325",2011,649,246,403,66
"50229","E01016326",2011,541,48,493,117
"50230","E01016327",2011,471,58,413,52
"50231","E01016328",2011,717,153,564,138
"50232","E01016329",2011,606,15,591,73
"50233","E01016330",2011,665,108,557,94
"50234","E01016331",2011,593,159,434,66
"50235","E01016332",2011,755,196,559,91
"50236","E01016333",2011,492,8,484,63
"50237","E01016334",2011,637,130,507,99
"50238","E01016335",2011,586,27,559,69
"50239","E01016336",2011,479,233,246,27
"50240","E01016337",2011,887,163,724,95
"50241","E01016338",2011,743,33,710,80
"50242","E01016339",2011,1124,97,1027,160
"50243","E01016340",2011,631,119,512,51
"50244","E01016341",2011,512,84,428,41
"50245","E01016342",2011,783,42,741,121
"50246","E01016343",2011,578,25,553,30
"50247","E01016344",2011,714,234,480,105
"50248","E01016345",2011,538,36,502,87
"50249","E01016346",2011,729,214,515,221
"50250","E01016347",2011,880,202,678,317
"50251","E01016348",2011,978,114,864,294
"50252","E01016349",2011,472,2,470,15
"50253","E01016350",2011,596,4,592,31
"50254","E01016353",2011,817,141,676,440
"50255","E01016355",2011,790,37,753,336
"50256","E01016356",2011,673,130,543,244
"50257","E01016357",2011,736,25,711,304
"50258","E01016358",2011,740,72,668,396
"50259","E01016359",2011,820,69,751,276
"50260","E01016360",2011,772,83,689,364
"50261","E01016361",2011,739,31,708,290
"50262","E01016362",2011,819,64,755,274
"50263","E01016363",2011,709,320,389,114
"50264","E01016364",2011,578,7,571,86
"50265","E01016365",2011,765,20,745,246
"50266","E01016366",2011,667,97,570,104
"50267","E01016367",2011,687,117,570,124
"50268","E01016368",2011,531,289,242,43
"50269","E01016369",2011,639,89,550,61
"50270","E01016370",2011,498,83,415,139
"50271","E01016371",2011,606,91,515,113
"50272","E01016372",2011,478,229,249,50
"50273","E01016373",2011,535,214,321,95
"50274","E01016374",2011,693,46,647,299
"50275","E01016375",2011,507,132,375,207
"50276","E01016376",2011,665,54,611,342
"50277","E01016377",2011,635,200,435,156
"50278","E01016378",2011,966,144,822,502
"50279","E01016379",2011,764,49,715,403
"50280","E01016380",2011,674,15,659,89
"50281","E01016381",2011,520,118,402,60
"50282","E01016382",2011,697,197,500,152
"50283","E01016383",2011,649,44,605,87
"50284","E01016384",2011,604,5,599,53
"50285","E01016385",2011,602,33,569,84
"50286","E01016386",2011,594,7,587,40
"50287","E01016387",2011,585,1,584,23
"50288","E01016388",2011,602,99,503,76
"50289","E01016389",2011,702,412,290,83
"50290","E01016390",2011,758,17,741,332
"50291","E01016391",2011,850,237,613,297
"50292","E01016392",2011,968,52,916,422
"50293","E01016393",2011,652,78,574,123
"50294","E01016394",2011,566,280,286,32
"50295","E01016395",2011,639,133,506,81
"50296","E01016396",2011,543,258,285,25
"50297","E01016397",2011,565,266,299,43
"50298","E01016398",2011,743,60,683,281
"50299","E01016399",2011,562,33,529,108
"50300","E01016400",2011,642,43,599,212
"50301","E01016401",2011,590,14,576,232
"50302","E01016402",2011,643,22,621,371
"50303","E01016403",2011,678,14,664,187
"50304","E01016404",2011,801,141,660,265
"50305","E01016405",2011,650,30,620,266
"50306","E01016406",2011,480,8,472,234
"50307","E01016407",2011,653,30,623,67
"50308","E01016408",2011,577,10,567,84
"50309","E01016409",2011,728,102,626,52
"50310","E01016410",2011,659,21,638,74
"50311","E01016411",2011,641,39,602,30
"50312","E01016412",2011,585,9,576,65
"50313","E01016413",2011,453,25,428,161
"50314","E01016414",2011,643,80,563,304
"50315","E01016415",2011,687,333,354,89
"50316","E01016416",2011,625,21,604,406
"50317","E01016417",2011,568,19,549,328
"50318","E01016418",2011,591,14,577,326
"50319","E01016419",2011,762,149,613,155
"50320","E01016420",2011,567,350,217,39
"50321","E01016421",2011,521,57,464,33
"50322","E01016422",2011,650,264,386,49
"50323","E01016423",2011,602,204,398,45
"50324","E01016424",2011,480,20,460,34
"50325","E01016425",2011,658,15,643,48
"50326","E01016426",2011,502,3,499,25
"50327","E01016427",2011,642,55,587,113
"50328","E01016428",2011,723,78,645,70
"50329","E01016429",2011,615,8,607,44
"50330","E01016430",2011,507,6,501,26
"50331","E01016431",2011,625,17,608,70
"50332","E01016432",2011,634,9,625,64
"50333","E01016433",2011,601,90,511,79
"50334","E01016434",2011,680,35,645,96
"50335","E01016435",2011,567,169,398,36
"50336","E01016436",2011,608,131,477,52
"50337","E01016437",2011,518,109,409,63
"50338","E01016438",2011,521,249,272,66
"50339","E01016439",2011,584,147,437,66
"50340","E01016440",2011,555,154,401,58
"50341","E01016441",2011,574,313,261,38
"50342","E01016442",2011,1106,324,782,248
"50343","E01016443",2011,545,277,268,46
"50344","E01016444",2011,473,122,351,86
"50345","E01016445",2011,524,199,325,77
"50346","E01016446",2011,453,69,384,97
"50347","E01016447",2011,506,18,488,183
"50348","E01016448",2011,753,95,658,266
"50349","E01016449",2011,625,200,425,114
"50350","E01016450",2011,593,322,271,40
"50351","E01016451",2011,607,407,200,58
"50352","E01016452",2011,643,211,432,62
"50353","E01016453",2011,660,202,458,47
"50354","E01016454",2011,611,215,396,54
"50355","E01016455",2011,534,144,390,71
"50356","E01016456",2011,639,164,475,186
"50357","E01016457",2011,511,19,492,164
"50358","E01016458",2011,557,239,318,97
"50359","E01016459",2011,695,117,578,224
"50360","E01016460",2011,545,29,516,157
"50361","E01016461",2011,933,85,848,428
"50362","E01016462",2011,830,79,751,414
"50363","E01016463",2011,613,175,438,158
"50364","E01016464",2011,608,69,539,249
"50365","E01016465",2011,967,150,817,400
"50366","E01016467",2011,576,98,478,113
"50367","E01016468",2011,627,39,588,110
"50368","E01016469",2011,674,100,574,150
"50369","E01016470",2011,678,20,658,188
"50370","E01016471",2011,494,69,425,66
"50371","E01016472",2011,592,161,431,58
"50372","E01016473",2011,746,85,661,160
"50373","E01016474",2011,831,262,569,151
"50374","E01016475",2011,622,110,512,153
"50375","E01016476",2011,673,158,515,128
"50376","E01016477",2011,1023,107,916,309
"50377","E01016478",2011,694,65,629,197
"50378","E01016479",2011,579,38,541,222
"50379","E01016480",2011,519,161,358,96
"50380","E01016481",2011,715,144,571,281
"50381","E01016482",2011,720,21,699,295
"50382","E01016483",2011,561,18,543,205
"50383","E01016484",2011,547,62,485,163
"50384","E01016485",2011,539,44,495,141
"50385","E01016486",2011,640,257,383,117
"50386","E01016487",2011,470,43,427,108
"50387","E01016488",2011,705,37,668,214
"50388","E01016490",2011,843,514,329,97
"50389","E01016491",2011,665,79,586,93
"50390","E01016492",2011,601,115,486,81
"50391","E01016493",2011,484,34,450,78
"50392","E01016494",2011,825,90,735,284
"50393","E01016495",2011,682,74,608,206
"50394","E01016496",2011,574,217,357,73
"50395","E01016497",2011,484,24,460,41
"50396","E01016498",2011,647,169,478,122
"50397","E01016499",2011,502,290,212,63
"50398","E01016500",2011,606,85,521,96
"50399","E01016501",2011,603,309,294,51
"50400","E01016502",2011,502,115,387,60
"50401","E01016503",2011,601,198,403,65
"50402","E01016504",2011,473,31,442,81
"50403","E01016505",2011,660,249,411,82
"50404","E01016506",2011,811,82,729,310
"50405","E01016507",2011,614,138,476,68
"50406","E01016508",2011,605,53,552,116
"50407","E01016509",2011,619,54,565,135
"50408","E01016510",2011,457,5,452,46
"50409","E01016511",2011,775,175,600,262
"50410","E01016512",2011,842,111,731,457
"50411","E01016513",2011,592,8,584,93
"50412","E01016514",2011,821,120,701,363
"50413","E01016515",2011,624,6,618,139
"50414","E01016516",2011,456,84,372,92
"50415","E01016517",2011,458,105,353,93
"50416","E01016518",2011,600,29,571,206
"50417","E01016519",2011,1038,400,638,212
"50418","E01016520",2011,573,283,290,72
"50419","E01016521",2011,634,209,425,97
"50420","E01016522",2011,698,20,678,79
"50421","E01016523",2011,584,29,555,118
"50422","E01016524",2011,864,162,702,114
"50423","E01016525",2011,635,13,622,102
"50424","E01016526",2011,713,21,692,153
"50425","E01016527",2011,656,58,598,137
"50426","E01016528",2011,631,19,612,132
"50427","E01016529",2011,654,268,386,137
"50428","E01016530",2011,647,177,470,39
"50429","E01016531",2011,607,8,599,93
"50430","E01016532",2011,840,18,822,115
"50431","E01016533",2011,770,26,744,67
"50432","E01016534",2011,587,6,581,64
"50433","E01016535",2011,491,9,482,94
"50434","E01016536",2011,848,131,717,272
"50435","E01016537",2011,470,55,415,89
"50436","E01016538",2011,625,21,604,117
"50437","E01016539",2011,641,43,598,65
"50438","E01016540",2011,652,40,612,77
"50439","E01016541",2011,512,7,505,51
"50440","E01016542",2011,491,90,401,37
"50441","E01016543",2011,670,14,656,98
"50442","E01016544",2011,800,93,707,308
"50443","E01016545",2011,1069,217,852,374
"50444","E01016546",2011,750,4,746,253
"50445","E01016547",2011,756,34,722,208
"50446","E01016548",2011,830,63,767,184
"50447","E01016549",2011,858,224,634,135
"50448","E01016550",2011,510,99,411,105
"50449","E01016551",2011,623,18,605,54
"50450","E01016552",2011,686,65,621,122
"50451","E01016553",2011,676,35,641,56
"50452","E01016554",2011,650,270,380,57
"50453","E01016555",2011,588,291,297,50
"50454","E01016556",2011,762,245,517,64
"50455","E01016557",2011,832,136,696,93
"50456","E01016558",2011,613,148,465,285
"50457","E01016559",2011,562,6,556,37
"50458","E01016560",2011,646,291,355,37
"50459","E01016561",2011,674,49,625,57
"50460","E01016562",2011,513,6,507,34
"50461","E01016563",2011,507,10,497,31
"50462","E01016564",2011,644,102,542,78
"50463","E01016565",2011,624,9,615,99
"50464","E01016566",2011,764,177,587,148
"50465","E01016567",2011,817,91,726,257
"50466","E01016568",2011,499,91,408,41
"50467","E01016569",2011,493,91,402,75
"50468","E01016570",2011,640,10,630,65
"50469","E01016571",2011,562,60,502,47
"50470","E01016572",2011,559,50,509,40
"50471","E01016573",2011,523,264,259,34
"50472","E01016574",2011,604,112,492,81
"50473","E01016575",2011,637,6,631,45
"50474","E01016576",2011,661,26,635,90
"50475","E01016577",2011,698,116,582,106
"50476","E01016578",2011,589,22,567,112
"50477","E01016579",2011,693,100,593,105
"50478","E01016580",2011,643,287,356,33
"50479","E01016581",2011,572,38,534,60
"50480","E01016582",2011,501,17,484,90
"50481","E01016583",2011,680,2,678,105
"50482","E01016584",2011,669,145,524,142
"50483","E01016585",2011,781,30,751,232
"50484","E01016586",2011,542,2,540,54
"50485","E01016587",2011,638,51,587,43
"50486","E01016588",2011,777,144,633,254
"50487","E01016589",2011,642,10,632,62
"50488","E01016591",2011,629,4,625,65
"50489","E01016592",2011,798,58,740,197
"50490","E01016593",2011,665,255,410,55
"50491","E01016594",2011,582,233,349,63
"50492","E01016595",2011,680,86,594,131
"50493","E01016596",2011,797,61,736,236
"50494","E01016597",2011,617,12,605,76
"50495","E01016598",2011,513,5,508,31
"50496","E01016599",2011,600,272,328,40
"50497","E01016600",2011,448,2,446,42
"50498","E01016601",2011,616,93,523,77
"50499","E01016602",2011,636,9,627,49
"50500","E01016603",2011,744,21,723,165
"50501","E01016604",2011,778,33,745,146
"50502","E01016605",2011,613,107,506,92
"50503","E01016606",2011,646,18,628,91
"50504","E01016607",2011,529,5,524,42
"50505","E01016608",2011,808,200,608,154
"50506","E01016609",2011,740,230,510,89
"50507","E01016610",2011,1094,105,989,205
"50508","E01016611",2011,438,41,397,169
"50509","E01016612",2011,788,10,778,37
"50510","E01016613",2011,479,44,435,64
"50511","E01016614",2011,477,9,468,57
"50512","E01016615",2011,605,176,429,44
"50513","E01016616",2011,622,88,534,51
"50514","E01016617",2011,502,34,468,23
"50515","E01016618",2011,486,55,431,55
"50516","E01016619",2011,571,30,541,30
"50517","E01016620",2011,526,66,460,39
"50518","E01016621",2011,582,25,557,75
"50519","E01016622",2011,462,3,459,29
"50520","E01016623",2011,605,17,588,50
"50521","E01016624",2011,527,2,525,18
"50522","E01016625",2011,658,9,649,67
"50523","E01016626",2011,800,119,681,156
"50524","E01016627",2011,716,33,683,76
"50525","E01016628",2011,619,8,611,29
"50526","E01016629",2011,523,1,522,22
"50527","E01016630",2011,569,3,566,45
"50528","E01016631",2011,558,73,485,51
"50529","E01016632",2011,588,8,580,47
"50530","E01016633",2011,497,7,490,32
"50531","E01016634",2011,606,20,586,51
"50532","E01016635",2011,507,3,504,47
"50533","E01016636",2011,562,2,560,19
"50534","E01016637",2011,408,2,406,17
"50535","E01016638",2011,493,3,490,28
"50536","E01016639",2011,609,66,543,43
"50537","E01016640",2011,611,24,587,42
"50538","E01016641",2011,548,8,540,36
"50539","E01016642",2011,455,189,266,36
"50540","E01016643",2011,499,4,495,30
"50541","E01016644",2011,529,5,524,72
"50542","E01016645",2011,745,4,741,203
"50543","E01016646",2011,610,2,608,70
"50544","E01016647",2011,626,67,559,79
"50545","E01016648",2011,638,27,611,133
"50546","E01016649",2011,622,7,615,104
"50547","E01016651",2011,587,26,561,110
"50548","E01016652",2011,470,0,470,41
"50549","E01016653",2011,450,42,408,37
"50550","E01016654",2011,590,12,578,63
"50551","E01016655",2011,503,5,498,53
"50552","E01016656",2011,560,39,521,90
"50553","E01016657",2011,547,12,535,51
"50554","E01016658",2011,484,13,471,52
"50555","E01016659",2011,643,5,638,137
"50556","E01016660",2011,624,5,619,61
"50557","E01016661",2011,493,2,491,26
"50558","E01016662",2011,700,277,423,74
"50559","E01016663",2011,598,8,590,56
"50560","E01016664",2011,476,2,474,29
"50561","E01016665",2011,642,5,637,84
"50562","E01016666",2011,503,6,497,47
"50563","E01016668",2011,602,36,566,79
"50564","E01016669",2011,703,10,693,81
"50565","E01016670",2011,821,27,794,92
"50566","E01016671",2011,869,92,777,127
"50567","E01016672",2011,702,5,697,45
"50568","E01016673",2011,740,343,397,83
"50569","E01016674",2011,580,128,452,55
"50570","E01016675",2011,469,23,446,82
"50571","E01016676",2011,621,10,611,46
"50572","E01016677",2011,619,137,482,60
"50573","E01016678",2011,563,87,476,56
"50574","E01016679",2011,842,135,707,154
"50575","E01016680",2011,496,105,391,94
"50576","E01016682",2011,748,29,719,124
"50577","E01016683",2011,728,36,692,61
"50578","E01016684",2011,619,18,601,55
"50579","E01016685",2011,621,81,540,68
"50580","E01016686",2011,486,8,478,62
"50581","E01016687",2011,500,5,495,32
"50582","E01016688",2011,454,5,449,44
"50583","E01016689",2011,579,4,575,28
"50584","E01016690",2011,747,113,634,89
"50585","E01016691",2011,446,25,421,55
"50586","E01016692",2011,653,92,561,74
"50587","E01016693",2011,604,5,599,134
"50588","E01016694",2011,683,46,637,144
"50589","E01016695",2011,597,7,590,36
"50590","E01016696",2011,736,114,622,218
"50591","E01016699",2011,635,50,585,101
"50592","E01016700",2011,722,12,710,79
"50593","E01016701",2011,643,9,634,43
"50594","E01016702",2011,697,54,643,70
"50595","E01016703",2011,691,64,627,84
"50596","E01016704",2011,796,213,583,106
"50597","E01016705",2011,501,38,463,101
"50598","E01016706",2011,636,2,634,38
"50599","E01016707",2011,629,17,612,38
"50600","E01016708",2011,653,1,652,48
"50601","E01016709",2011,608,4,604,19
"50602","E01016710",2011,743,215,528,52
"50603","E01016711",2011,955,61,894,124
"50604","E01016713",2011,714,24,690,100
"50605","E01016714",2011,750,65,685,201
"50606","E01016715",2011,640,167,473,57
"50607","E01016716",2011,772,113,659,124
"50608","E01016717",2011,632,116,516,111
"50609","E01016718",2011,610,260,350,201
"50610","E01016719",2011,646,79,567,86
"50611","E01016720",2011,650,341,309,94
"50612","E01016721",2011,619,137,482,178
"50613","E01016722",2011,621,58,563,71
"50614","E01016723",2011,618,37,581,92
"50615","E01016724",2011,643,170,473,176
"50616","E01016725",2011,574,192,382,185
"50617","E01016726",2011,581,254,327,162
"50618","E01016727",2011,653,182,471,138
"50619","E01016728",2011,707,62,645,314
"50620","E01016729",2011,784,256,528,254
"50621","E01016731",2011,644,121,523,97
"50622","E01016732",2011,522,52,470,72
"50623","E01016733",2011,589,219,370,166
"50624","E01016734",2011,517,60,457,60
"50625","E01016735",2011,869,59,810,172
"50626","E01016736",2011,591,50,541,70
"50627","E01016737",2011,615,88,527,48
"50628","E01016738",2011,763,319,444,66
"50629","E01016739",2011,594,33,561,98
"50630","E01016740",2011,559,16,543,59
"50631","E01016741",2011,712,293,419,73
"50632","E01016742",2011,577,366,211,53
"50633","E01016743",2011,787,309,478,125
"50634","E01016744",2011,545,240,305,69
"50635","E01016745",2011,616,21,595,66
"50636","E01016746",2011,681,175,506,79
"50637","E01016748",2011,815,81,734,164
"50638","E01016750",2011,634,49,585,90
"50639","E01016751",2011,629,70,559,85
"50640","E01016752",2011,609,132,477,85
"50641","E01016753",2011,881,205,676,195
"50642","E01016754",2011,728,110,618,125
"50643","E01016755",2011,719,94,625,143
"50644","E01016756",2011,933,330,603,117
"50645","E01016757",2011,593,40,553,86
"50646","E01016758",2011,660,74,586,127
"50647","E01016759",2011,582,128,454,54
"50648","E01016760",2011,975,137,838,75
"50649","E01016761",2011,568,2,566,65
"50650","E01016762",2011,517,105,412,58
"50651","E01016763",2011,632,66,566,71
"50652","E01016764",2011,604,51,553,69
"50653","E01016765",2011,651,217,434,64
"50654","E01016766",2011,536,128,408,54
"50655","E01016767",2011,521,10,511,40
"50656","E01016768",2011,869,176,693,292
"50657","E01016769",2011,581,23,558,73
"50658","E01016770",2011,675,69,606,104
"50659","E01016771",2011,491,101,390,86
"50660","E01016772",2011,501,149,352,83
"50661","E01016773",2011,797,95,702,70
"50662","E01016774",2011,675,86,589,91
"50663","E01016775",2011,685,99,586,145
"50664","E01016776",2011,539,5,534,70
"50665","E01016777",2011,641,67,574,104
"50666","E01016778",2011,683,87,596,133
"50667","E01016780",2011,651,29,622,128
"50668","E01016781",2011,553,56,497,36
"50669","E01016783",2011,744,96,648,173
"50670","E01016784",2011,665,157,508,152
"50671","E01016786",2011,625,14,611,66
"50672","E01016787",2011,660,169,491,76
"50673","E01016788",2011,611,6,605,69
"50674","E01016789",2011,502,31,471,91
"50675","E01016790",2011,527,11,516,30
"50676","E01016791",2011,595,20,575,62
"50677","E01016792",2011,525,6,519,71
"50678","E01016793",2011,792,77,715,116
"50679","E01016794",2011,691,17,674,175
"50680","E01016795",2011,686,50,636,152
"50681","E01016796",2011,657,18,639,146
"50682","E01016797",2011,810,58,752,188
"50683","E01016798",2011,731,10,721,106
"50684","E01016799",2011,778,117,661,107
"50685","E01016800",2011,694,50,644,103
"50686","E01016801",2011,565,91,474,55
"50687","E01016802",2011,569,46,523,62
"50688","E01016803",2011,547,49,498,89
"50689","E01016804",2011,719,261,458,168
"50690","E01016805",2011,606,7,599,107
"50691","E01016806",2011,697,281,416,92
"50692","E01016807",2011,678,106,572,88
"50693","E01016808",2011,533,15,518,72
"50694","E01016809",2011,517,54,463,90
"50695","E01016810",2011,580,276,304,78
"50696","E01016811",2011,490,271,219,65
"50697","E01016812",2011,642,43,599,85
"50698","E01016813",2011,664,6,658,316
"50699","E01016814",2011,738,55,683,64
"50700","E01016815",2011,531,43,488,86
"50701","E01016816",2011,601,12,589,59
"50702","E01016817",2011,657,107,550,90
"50703","E01016818",2011,840,93,747,193
"50704","E01016819",2011,451,216,235,54
"50705","E01016820",2011,629,134,495,112
"50706","E01016821",2011,489,42,447,94
"50707","E01016822",2011,662,231,431,152
"50708","E01016823",2011,788,19,769,367
"50709","E01016824",2011,658,154,504,78
"50710","E01016825",2011,635,85,550,150
"50711","E01016826",2011,531,11,520,50
"50712","E01016827",2011,715,109,606,166
"50713","E01016828",2011,732,28,704,105
"50714","E01016829",2011,664,202,462,70
"50715","E01016830",2011,515,8,507,80
"50716","E01016831",2011,611,46,565,80
"50717","E01016832",2011,498,73,425,44
"50718","E01016833",2011,506,29,477,23
"50719","E01016834",2011,651,221,430,66
"50720","E01016835",2011,677,291,386,96
"50721","E01016836",2011,619,29,590,132
"50722","E01016837",2011,698,51,647,185
"50723","E01016838",2011,604,115,489,66
"50724","E01016839",2011,613,264,349,80
"50725","E01016840",2011,1052,68,984,187
"50726","E01016841",2011,984,180,804,275
"50727","E01016842",2011,601,432,169,63
"50728","E01016843",2011,528,286,242,97
"50729","E01016844",2011,636,365,271,51
"50730","E01016845",2011,709,425,284,127
"50731","E01016846",2011,626,123,503,159
"50732","E01016847",2011,844,432,412,79
"50733","E01016848",2011,575,170,405,109
"50734","E01016849",2011,893,28,865,484
"50735","E01016850",2011,912,47,865,504
"50736","E01016851",2011,992,19,973,579
"50737","E01016852",2011,964,30,934,651
"50738","E01016853",2011,1113,44,1069,626
"50739","E01016854",2011,1001,166,835,538
"50740","E01016855",2011,1021,30,991,592
"50741","E01016856",2011,981,37,944,522
"50742","E01016857",2011,811,34,777,407
"50743","E01016858",2011,878,7,871,541
"50744","E01016859",2011,891,35,856,301
"50745","E01016860",2011,795,66,729,429
"50746","E01016861",2011,907,47,860,414
"50747","E01016862",2011,845,65,780,338
"50748","E01016863",2011,928,377,551,234
"50749","E01016864",2011,584,287,297,39
"50750","E01016865",2011,578,481,97,19
"50751","E01016866",2011,542,379,163,28
"50752","E01016867",2011,661,396,265,49
"50753","E01016868",2011,707,565,142,33
"50754","E01016869",2011,809,181,628,208
"50755","E01016870",2011,688,11,677,241
"50756","E01016871",2011,1059,95,964,594
"50757","E01016872",2011,963,46,917,481
"50758","E01016873",2011,1002,231,771,404
"50759","E01016874",2011,1032,28,1004,406
"50760","E01016875",2011,600,14,586,182
"50761","E01016876",2011,816,43,773,335
"50762","E01016877",2011,919,55,864,347
"50763","E01016878",2011,876,54,822,290
"50764","E01016879",2011,558,191,367,55
"50765","E01016880",2011,495,298,197,40
"50766","E01016881",2011,605,181,424,91
"50767","E01016882",2011,627,194,433,59
"50768","E01016883",2011,661,48,613,39
"50769","E01016884",2011,616,137,479,62
"50770","E01016885",2011,619,331,288,86
"50771","E01016886",2011,623,95,528,48
"50772","E01016887",2011,619,31,588,64
"50773","E01016888",2011,587,13,574,46
"50774","E01016889",2011,761,69,692,333
"50775","E01016890",2011,777,51,726,423
"50776","E01016891",2011,805,134,671,312
"50777","E01016892",2011,628,31,597,211
"50778","E01016893",2011,773,9,764,232
"50779","E01016894",2011,709,140,569,237
"50780","E01016895",2011,587,298,289,62
"50781","E01016896",2011,700,29,671,255
"50782","E01016897",2011,761,67,694,219
"50783","E01016898",2011,757,202,555,98
"50784","E01016899",2011,404,98,306,67
"50785","E01016900",2011,764,498,266,82
"50786","E01016901",2011,611,13,598,113
"50787","E01016902",2011,577,159,418,57
"50788","E01016903",2011,690,31,659,204
"50789","E01016904",2011,684,400,284,120
"50790","E01016905",2011,803,369,434,146
"50791","E01016906",2011,603,316,287,44
"50792","E01016907",2011,579,164,415,159
"50793","E01016908",2011,577,348,229,54
"50794","E01016909",2011,647,171,476,186
"50795","E01016910",2011,541,306,235,85
"50796","E01016911",2011,543,135,408,85
"50797","E01016912",2011,785,76,709,339
"50798","E01016913",2011,612,26,586,241
"50799","E01016914",2011,506,280,226,79
"50800","E01016915",2011,499,334,165,77
"50801","E01016916",2011,611,24,587,63
"50802","E01016917",2011,578,19,559,48
"50803","E01016918",2011,592,255,337,38
"50804","E01016919",2011,551,173,378,56
"50805","E01016920",2011,638,19,619,76
"50806","E01016921",2011,640,158,482,59
"50807","E01016922",2011,523,103,420,50
"50808","E01016923",2011,675,101,574,105
"50809","E01016924",2011,582,12,570,44
"50810","E01016925",2011,612,119,493,53
"50811","E01016926",2011,606,228,378,31
"50812","E01016927",2011,626,56,570,61
"50813","E01016928",2011,662,14,648,100
"50814","E01016929",2011,639,76,563,65
"50815","E01016930",2011,760,24,736,70
"50816","E01016931",2011,635,11,624,48
"50817","E01016932",2011,687,49,638,159
"50818","E01016933",2011,635,51,584,182
"50819","E01016934",2011,528,18,510,82
"50820","E01016935",2011,813,114,699,243
"50821","E01016936",2011,684,20,664,226
"50822","E01016937",2011,1019,75,944,502
"50823","E01016938",2011,911,17,894,459
"50824","E01016939",2011,604,5,599,95
"50825","E01016940",2011,616,9,607,144
"50826","E01016941",2011,1118,232,886,562
"50827","E01016942",2011,1114,777,337,67
"50828","E01016943",2011,696,42,654,268
"50829","E01016944",2011,862,55,807,469
"50830","E01016945",2011,981,49,932,657
"50831","E01016946",2011,620,4,616,145
"50832","E01016947",2011,900,505,395,244
"50833","E01016948",2011,780,172,608,224
"50834","E01016949",2011,911,396,515,235
"50835","E01016950",2011,1029,10,1019,553
"50836","E01016951",2011,883,147,736,430
"50837","E01016952",2011,805,34,771,548
"50838","E01016953",2011,866,23,843,426
"50839","E01016954",2011,1110,59,1051,719
"50840","E01016955",2011,1037,57,980,645
"50841","E01016956",2011,717,14,703,73
"50842","E01016957",2011,889,13,876,398
"50843","E01016958",2011,821,14,807,99
"50844","E01016959",2011,619,9,610,51
"50845","E01016960",2011,829,25,804,187
"50846","E01016961",2011,792,52,740,103
"50847","E01016962",2011,734,19,715,68
"50848","E01016963",2011,958,65,893,385
"50849","E01016964",2011,1015,283,732,486
"50850","E01016966",2011,753,129,624,341
"50851","E01016967",2011,1109,50,1059,638
"50852","E01016968",2011,924,38,886,579
"50853","E01016969",2011,1037,180,857,491
"50854","E01016970",2011,696,66,630,235
"50855","E01016971",2011,756,56,700,427
"50856","E01016972",2011,804,17,787,341
"50857","E01016973",2011,648,73,575,92
"50858","E01016974",2011,706,47,659,174
"50859","E01016975",2011,592,171,421,84
"50860","E01016976",2011,623,24,599,63
"50861","E01016977",2011,618,131,487,50
"50862","E01016978",2011,716,154,562,149
"50863","E01016979",2011,625,11,614,133
"50864","E01016980",2011,570,26,544,91
"50865","E01016981",2011,657,4,653,91
"50866","E01016982",2011,498,4,494,40
"50867","E01016983",2011,535,2,533,52
"50868","E01016984",2011,575,4,571,38
"50869","E01016985",2011,626,9,617,155
"50870","E01016986",2011,841,64,777,305
"50871","E01016987",2011,761,43,718,224
"50872","E01016988",2011,737,59,678,285
"50873","E01016989",2011,744,68,676,217
"50874","E01016990",2011,749,117,632,192
"50875","E01016991",2011,794,54,740,268
"50876","E01016992",2011,659,12,647,98
"50877","E01016993",2011,754,352,402,119
"50878","E01016994",2011,730,49,681,242
"50879","E01016995",2011,648,10,638,120
"50880","E01016996",2011,703,27,676,202
"50881","E01016997",2011,631,20,611,127
"50882","E01016998",2011,591,4,587,32
"50883","E01016999",2011,569,7,562,37
"50884","E01017000",2011,851,73,778,165
"50885","E01017001",2011,598,30,568,43
"50886","E01017002",2011,774,13,761,202
"50887","E01017003",2011,671,33,638,133
"50888","E01017004",2011,776,53,723,265
"50889","E01017005",2011,715,7,708,220
"50890","E01017006",2011,763,15,748,248
"50891","E01017007",2011,652,210,442,85
"50892","E01017008",2011,694,16,678,60
"50893","E01017009",2011,631,90,541,44
"50894","E01017010",2011,695,35,660,61
"50895","E01017011",2011,531,236,295,25
"50896","E01017012",2011,721,77,644,68
"50897","E01017013",2011,649,26,623,155
"50898","E01017014",2011,634,9,625,96
"50899","E01017015",2011,627,88,539,79
"50900","E01017016",2011,634,15,619,133
"50901","E01017017",2011,602,17,585,53
"50902","E01017018",2011,620,26,594,49
"50903","E01017019",2011,746,122,624,108
"50904","E01017020",2011,953,225,728,116
"50905","E01017021",2011,637,74,563,43
"50906","E01017022",2011,661,79,582,299
"50907","E01017023",2011,669,13,656,228
"50908","E01017024",2011,725,24,701,345
"50909","E01017025",2011,818,23,795,381
"50910","E01017026",2011,771,107,664,249
"50911","E01017027",2011,626,29,597,293
"50912","E01017028",2011,690,27,663,393
"50913","E01017029",2011,706,35,671,239
"50914","E01017030",2011,705,18,687,330
"50915","E01017031",2011,970,673,297,111
"50916","E01017032",2011,612,416,196,132
"50917","E01017034",2011,582,422,160,95
"50918","E01017035",2011,765,631,134,32
"50919","E01017036",2011,593,306,287,70
"50920","E01017037",2011,649,543,106,28
"50921","E01017038",2011,820,628,192,73
"50922","E01017039",2011,746,411,335,116
"50923","E01017040",2011,644,542,102,39
"50924","E01017041",2011,517,6,511,78
"50925","E01017042",2011,528,54,474,88
"50926","E01017043",2011,524,9,515,109
"50927","E01017044",2011,617,18,599,159
"50928","E01017045",2011,510,19,491,103
"50929","E01017046",2011,780,8,772,137
"50930","E01017047",2011,636,6,630,90
"50931","E01017048",2011,593,7,586,70
"50932","E01017049",2011,594,8,586,57
"50933","E01017050",2011,690,72,618,60
"50934","E01017051",2011,789,287,502,187
"50935","E01017052",2011,572,189,383,49
"50936","E01017053",2011,535,279,256,37
"50937","E01017054",2011,624,127,497,77
"50938","E01017055",2011,676,61,615,82
"50939","E01017056",2011,497,8,489,49
"50940","E01017057",2011,570,7,563,48
"50941","E01017058",2011,651,176,475,47
"50942","E01017059",2011,648,29,619,60
"50943","E01017060",2011,633,10,623,58
"50944","E01017061",2011,664,4,660,50
"50945","E01017062",2011,619,11,608,143
"50946","E01017063",2011,626,4,622,22
"50947","E01017064",2011,707,22,685,81
"50948","E01017066",2011,758,65,693,100
"50949","E01017067",2011,653,78,575,118
"50950","E01017068",2011,908,21,887,271
"50951","E01017069",2011,745,16,729,208
"50952","E01017070",2011,726,66,660,240
"50953","E01017071",2011,656,29,627,309
"50954","E01017072",2011,627,17,610,189
"50955","E01017073",2011,953,116,837,457
"50956","E01017074",2011,793,15,778,466
"50957","E01017075",2011,672,48,624,241
"50958","E01017076",2011,742,48,694,219
"50959","E01017077",2011,886,309,577,252
"50960","E01017078",2011,638,26,612,197
"50961","E01017079",2011,627,62,565,195
"50962","E01017080",2011,827,136,691,332
"50963","E01017081",2011,666,36,630,203
"50964","E01017082",2011,728,39,689,288
"50965","E01017083",2011,723,26,697,200
"50966","E01017084",2011,565,11,554,133
"50967","E01017085",2011,671,67,604,87
"50968","E01017086",2011,500,8,492,33
"50969","E01017087",2011,596,19,577,168
"50970","E01017088",2011,687,48,639,155
"50971","E01017089",2011,629,200,429,106
"50972","E01017090",2011,607,107,500,108
"50973","E01017091",2011,723,326,397,157
"50974","E01017092",2011,642,31,611,126
"50975","E01017093",2011,495,102,393,57
"50976","E01017094",2011,611,19,592,123
"50977","E01017095",2011,869,63,806,250
"50978","E01017096",2011,670,38,632,118
"50979","E01017097",2011,725,26,699,239
"50980","E01017098",2011,646,103,543,221
"50981","E01017099",2011,706,127,579,144
"50982","E01017100",2011,521,11,510,67
"50983","E01017101",2011,656,32,624,154
"50984","E01017102",2011,713,340,373,121
"50985","E01017103",2011,502,362,140,39
"50986","E01017104",2011,473,44,429,90
"50987","E01017105",2011,639,97,542,145
"50988","E01017106",2011,627,122,505,117
"50989","E01017107",2011,662,23,639,218
"50990","E01017108",2011,709,128,581,172
"50991","E01017109",2011,599,103,496,151
"50992","E01017110",2011,605,21,584,174
"50993","E01017111",2011,612,45,567,198
"50994","E01017112",2011,664,304,360,41
"50995","E01017113",2011,621,56,565,81
"50996","E01017114",2011,702,20,682,173
"50997","E01017115",2011,485,156,329,32
"50998","E01017116",2011,624,240,384,118
"50999","E01017117",2011,600,202,398,65
"51000","E01017118",2011,563,270,293,56
"51001","E01017119",2011,648,231,417,49
"51002","E01017120",2011,679,366,313,40
"51003","E01017121",2011,763,21,742,344
"51004","E01017122",2011,854,70,784,449
"51005","E01017123",2011,1129,31,1098,579
"51006","E01017124",2011,801,60,741,338
"51007","E01017125",2011,866,227,639,229
"51008","E01017126",2011,820,22,798,362
"51009","E01017127",2011,999,73,926,588
"51010","E01017128",2011,653,45,608,396
"51011","E01017129",2011,664,79,585,371
"51012","E01017130",2011,777,593,184,88
"51013","E01017131",2011,735,95,640,304
"51014","E01017132",2011,925,620,305,159
"51015","E01017133",2011,847,257,590,272
"51016","E01017135",2011,836,158,678,346
"51017","E01017136",2011,622,58,564,375
"51018","E01017137",2011,647,32,615,540
"51019","E01017138",2011,940,138,802,541
"51020","E01017139",2011,904,448,456,293
"51021","E01017140",2011,831,387,444,276
"51022","E01017142",2011,1021,53,968,594
"51023","E01017144",2011,427,45,382,107
"51024","E01017145",2011,651,45,606,126
"51025","E01017146",2011,707,36,671,145
"51026","E01017147",2011,637,20,617,162
"51027","E01017148",2011,604,63,541,169
"51028","E01017149",2011,460,131,329,167
"51029","E01017150",2011,615,59,556,107
"51030","E01017151",2011,733,204,529,92
"51031","E01017152",2011,661,102,559,196
"51032","E01017153",2011,466,96,370,218
"51033","E01017154",2011,888,545,343,183
"51034","E01017155",2011,538,81,457,261
"51035","E01017156",2011,492,97,395,204
"51036","E01017157",2011,571,37,534,410
"51037","E01017158",2011,796,147,649,389
"51038","E01017159",2011,527,52,475,347
"51039","E01017160",2011,669,62,607,321
"51040","E01017162",2011,625,115,510,49
"51041","E01017163",2011,651,469,182,32
"51042","E01017164",2011,670,98,572,51
"51043","E01017165",2011,622,259,363,31
"51044","E01017166",2011,668,468,200,35
"51045","E01017167",2011,673,492,181,35
"51046","E01017168",2011,824,428,396,68
"51047","E01017169",2011,641,324,317,46
"51048","E01017170",2011,670,192,478,82
"51049","E01017171",2011,872,137,735,293
"51050","E01017172",2011,809,65,744,303
"51051","E01017173",2011,617,82,535,94
"51052","E01017174",2011,553,27,526,50
"51053","E01017175",2011,623,22,601,99
"51054","E01017176",2011,677,54,623,152
"51055","E01017177",2011,749,40,709,252
"51056","E01017178",2011,589,8,581,121
"51057","E01017179",2011,618,206,412,98
"51058","E01017180",2011,581,23,558,54
"51059","E01017181",2011,559,217,342,36
"51060","E01017182",2011,725,424,301,27
"51061","E01017183",2011,664,67,597,56
"51062","E01017184",2011,603,194,409,46
"51063","E01017185",2011,730,230,500,87
"51064","E01017186",2011,695,327,368,96
"51065","E01017187",2011,682,140,542,122
"51066","E01017188",2011,623,311,312,76
"51067","E01017189",2011,734,28,706,502
"51068","E01017190",2011,730,31,699,326
"51069","E01017191",2011,791,45,746,490
"51070","E01017192",2011,911,147,764,308
"51071","E01017193",2011,848,133,715,282
"51072","E01017194",2011,827,163,664,366
"51073","E01017195",2011,941,86,855,394
"51074","E01017196",2011,1012,47,965,508
"51075","E01017197",2011,553,22,531,119
"51076","E01017198",2011,673,175,498,45
"51077","E01017199",2011,771,184,587,86
"51078","E01017200",2011,840,59,781,111
"51079","E01017201",2011,630,249,381,89
"51080","E01017202",2011,747,346,401,89
"51081","E01017203",2011,632,86,546,81
"51082","E01017204",2011,625,43,582,50
"51083","E01017205",2011,515,295,220,27
"51084","E01017206",2011,648,124,524,60
"51085","E01017207",2011,697,459,238,45
"51086","E01017208",2011,561,278,283,56
"51087","E01017209",2011,584,30,554,181
"51088","E01017210",2011,603,354,249,48
"51089","E01017211",2011,934,191,743,264
"51090","E01017212",2011,555,45,510,106
"51091","E01017213",2011,713,34,679,246
"51092","E01017214",2011,552,30,522,131
"51093","E01017215",2011,696,15,681,77
"51094","E01017216",2011,579,139,440,110
"51095","E01017217",2011,663,71,592,101
"51096","E01017218",2011,495,174,321,53
"51097","E01017219",2011,857,328,529,190
"51098","E01017220",2011,800,206,594,144
"51099","E01017221",2011,662,27,635,135
"51100","E01017222",2011,620,49,571,116
"51101","E01017223",2011,662,8,654,110
"51102","E01017224",2011,550,12,538,90
"51103","E01017225",2011,609,111,498,83
"51104","E01017226",2011,830,115,715,272
"51105","E01017227",2011,410,40,370,281
"51106","E01017228",2011,712,181,531,229
"51107","E01017231",2011,640,44,596,335
"51108","E01017232",2011,495,34,461,172
"51109","E01017233",2011,723,183,540,194
"51110","E01017234",2011,735,158,577,333
"51111","E01017235",2011,601,64,537,386
"51112","E01017236",2011,599,302,297,35
"51113","E01017237",2011,590,331,259,47
"51114","E01017238",2011,582,228,354,64
"51115","E01017239",2011,641,210,431,115
"51116","E01017240",2011,599,342,257,48
"51117","E01017241",2011,657,328,329,41
"51118","E01017242",2011,730,178,552,146
"51119","E01017243",2011,660,87,573,63
"51120","E01017244",2011,511,151,360,36
"51121","E01017245",2011,611,442,169,21
"51122","E01017246",2011,879,116,763,348
"51123","E01017247",2011,622,12,610,102
"51124","E01017248",2011,600,23,577,76
"51125","E01017249",2011,508,6,502,46
"51126","E01017250",2011,728,428,300,81
"51127","E01017251",2011,661,236,425,202
"51128","E01017252",2011,663,24,639,108
"51129","E01017253",2011,656,165,491,124
"51130","E01017254",2011,672,118,554,132
"51131","E01017255",2011,686,14,672,134
"51132","E01017256",2011,863,31,832,93
"51133","E01017257",2011,767,80,687,192
"51134","E01017258",2011,640,117,523,87
"51135","E01017259",2011,601,30,571,66
"51136","E01017260",2011,653,131,522,67
"51137","E01017261",2011,717,25,692,123
"51138","E01017262",2011,528,130,398,48
"51139","E01017263",2011,598,125,473,70
"51140","E01017264",2011,483,268,215,99
"51141","E01017265",2011,751,359,392,72
"51142","E01017266",2011,483,175,308,135
"51143","E01017267",2011,442,88,354,187
"51144","E01017270",2011,556,220,336,73
"51145","E01017271",2011,466,32,434,101
"51146","E01017272",2011,506,187,319,84
"51147","E01017273",2011,594,30,564,105
"51148","E01017274",2011,613,348,265,35
"51149","E01017275",2011,691,78,613,129
"51150","E01017276",2011,742,172,570,235
"51151","E01017277",2011,582,103,479,49
"51152","E01017278",2011,600,21,579,173
"51153","E01017279",2011,730,87,643,157
"51154","E01017280",2011,604,307,297,56
"51155","E01017281",2011,818,694,124,34
"51156","E01017282",2011,590,73,517,83
"51157","E01017283",2011,667,30,637,92
"51158","E01017284",2011,783,10,773,101
"51159","E01017285",2011,920,87,833,88
"51160","E01017286",2011,694,27,667,80
"51161","E01017287",2011,746,6,740,67
"51162","E01017288",2011,590,27,563,91
"51163","E01017289",2011,910,121,789,92
"51164","E01017290",2011,588,27,561,68
"51165","E01017291",2011,563,33,530,36
"51166","E01017292",2011,665,47,618,108
"51167","E01017293",2011,771,26,745,83
"51168","E01017294",2011,657,18,639,90
"51169","E01017295",2011,539,93,446,103
"51170","E01017296",2011,527,21,506,54
"51171","E01017297",2011,606,63,543,65
"51172","E01017298",2011,681,27,654,65
"51173","E01017299",2011,546,89,457,64
"51174","E01017300",2011,1200,67,1133,350
"51175","E01017301",2011,488,3,485,42
"51176","E01017302",2011,671,30,641,68
"51177","E01017303",2011,550,14,536,145
"51178","E01017304",2011,560,67,493,71
"51179","E01017305",2011,652,70,582,216
"51180","E01017306",2011,553,92,461,95
"51181","E01017307",2011,902,29,873,136
"51182","E01017308",2011,739,138,601,128
"51183","E01017309",2011,714,50,664,185
"51184","E01017310",2011,520,11,509,43
"51185","E01017311",2011,713,81,632,148
"51186","E01017312",2011,767,111,656,154
"51187","E01017315",2011,685,186,499,55
"51188","E01017316",2011,819,27,792,116
"51189","E01017317",2011,672,67,605,87
"51190","E01017318",2011,522,134,388,75
"51191","E01017319",2011,670,111,559,96
"51192","E01017320",2011,557,19,538,41
"51193","E01017321",2011,494,32,462,44
"51194","E01017322",2011,609,227,382,99
"51195","E01017323",2011,510,17,493,29
"51196","E01017324",2011,622,37,585,66
"51197","E01017325",2011,612,147,465,118
"51198","E01017326",2011,843,169,674,338
"51199","E01017327",2011,684,69,615,108
"51200","E01017328",2011,667,86,581,257
"51201","E01017329",2011,978,54,924,72
"51202","E01017331",2011,671,205,466,76
"51203","E01017332",2011,535,232,303,43
"51204","E01017333",2011,659,37,622,111
"51205","E01017334",2011,478,63,415,50
"51206","E01017335",2011,765,70,695,271
"51207","E01017336",2011,847,48,799,460
"51208","E01017337",2011,797,30,767,347
"51209","E01017338",2011,625,35,590,92
"51210","E01017339",2011,671,46,625,125
"51211","E01017340",2011,799,97,702,235
"51212","E01017341",2011,660,169,491,70
"51213","E01017342",2011,726,84,642,135
"51214","E01017343",2011,575,141,434,95
"51215","E01017344",2011,729,22,707,103
"51216","E01017345",2011,836,333,503,168
"51217","E01017346",2011,740,54,686,269
"51218","E01017347",2011,724,88,636,111
"51219","E01017348",2011,538,39,499,160
"51220","E01017349",2011,936,15,921,321
"51221","E01017350",2011,802,162,640,119
"51222","E01017351",2011,679,23,656,99
"51223","E01017352",2011,577,4,573,34
"51224","E01017353",2011,542,46,496,25
"51225","E01017354",2011,590,65,525,110
"51226","E01017355",2011,663,39,624,80
"51227","E01017356",2011,686,71,615,226
"51228","E01017357",2011,645,147,498,83
"51229","E01017358",2011,589,59,530,33
"51230","E01017359",2011,685,21,664,138
"51231","E01017360",2011,812,34,778,316
"51232","E01017361",2011,637,32,605,70
"51233","E01017362",2011,661,64,597,139
"51234","E01017363",2011,813,141,672,257
"51235","E01017364",2011,699,27,672,131
"51236","E01017365",2011,711,38,673,95
"51237","E01017366",2011,623,142,481,90
"51238","E01017367",2011,861,4,857,93
"51239","E01017368",2011,717,95,622,103
"51240","E01017369",2011,631,69,562,73
"51241","E01017370",2011,794,128,666,53
"51242","E01017371",2011,547,16,531,37
"51243","E01017372",2011,647,129,518,69
"51244","E01017373",2011,560,39,521,45
"51245","E01017374",2011,573,9,564,88
"51246","E01017375",2011,639,95,544,104
"51247","E01017376",2011,811,43,768,137
"51248","E01017377",2011,760,99,661,69
"51249","E01017378",2011,773,286,487,78
"51250","E01017379",2011,520,109,411,90
"51251","E01017380",2011,517,16,501,64
"51252","E01017381",2011,616,16,600,58
"51253","E01017382",2011,573,134,439,28
"51254","E01017383",2011,848,53,795,197
"51255","E01017384",2011,670,199,471,87
"51256","E01017385",2011,849,59,790,217
"51257","E01017386",2011,756,110,646,129
"51258","E01017387",2011,508,67,441,23
"51259","E01017388",2011,555,98,457,61
"51260","E01017389",2011,739,92,647,54
"51261","E01017390",2011,801,244,557,63
"51262","E01017391",2011,538,147,391,36
"51263","E01017392",2011,623,8,615,49
"51264","E01017393",2011,680,63,617,47
"51265","E01017394",2011,584,75,509,74
"51266","E01017397",2011,670,39,631,116
"51267","E01017398",2011,932,74,858,63
"51268","E01017399",2011,570,44,526,97
"51269","E01017400",2011,641,365,276,29
"51270","E01017401",2011,522,49,473,104
"51271","E01017402",2011,654,11,643,57
"51272","E01017403",2011,604,49,555,53
"51273","E01017404",2011,493,4,489,19
"51274","E01017405",2011,611,6,605,92
"51275","E01017406",2011,631,15,616,107
"51276","E01017407",2011,681,27,654,124
"51277","E01017408",2011,416,2,414,41
"51278","E01017409",2011,505,69,436,33
"51279","E01017410",2011,485,62,423,27
"51280","E01017411",2011,624,65,559,68
"51281","E01017412",2011,611,101,510,197
"51282","E01017413",2011,722,36,686,48
"51283","E01017414",2011,720,113,607,51
"51284","E01017415",2011,776,154,622,57
"51285","E01017416",2011,781,66,715,99
"51286","E01017417",2011,905,59,846,120
"51287","E01017418",2011,650,180,470,51
"51288","E01017419",2011,604,11,593,40
"51289","E01017420",2011,649,154,495,60
"51290","E01017421",2011,706,108,598,36
"51291","E01017422",2011,626,88,538,32
"51292","E01017423",2011,639,118,521,61
"51293","E01017424",2011,568,70,498,38
"51294","E01017425",2011,430,64,366,47
"51295","E01017426",2011,574,43,531,51
"51296","E01017427",2011,719,137,582,99
"51297","E01017428",2011,681,103,578,69
"51298","E01017429",2011,625,25,600,116
"51299","E01017430",2011,600,131,469,60
"51300","E01017431",2011,678,67,611,116
"51301","E01017432",2011,565,39,526,32
"51302","E01017433",2011,648,347,301,32
"51303","E01017434",2011,694,90,604,104
"51304","E01017435",2011,713,161,552,99
"51305","E01017436",2011,894,20,874,89
"51306","E01017437",2011,665,157,508,118
"51307","E01017438",2011,670,36,634,79
"51308","E01017439",2011,632,48,584,93
"51309","E01017440",2011,622,244,378,63
"51310","E01017441",2011,620,59,561,156
"51311","E01017442",2011,814,67,747,71
"51312","E01017443",2011,698,41,657,279
"51313","E01017444",2011,792,129,663,88
"51314","E01017445",2011,732,66,666,71
"51315","E01017446",2011,726,163,563,63
"51316","E01017447",2011,843,44,799,74
"51317","E01017449",2011,625,49,576,54
"51318","E01017450",2011,866,92,774,60
"51319","E01017451",2011,582,62,520,173
"51320","E01017452",2011,581,68,513,120
"51321","E01017453",2011,623,250,373,46
"51322","E01017454",2011,588,35,553,40
"51323","E01017455",2011,651,24,627,73
"51324","E01017456",2011,634,46,588,36
"51325","E01017457",2011,487,106,381,34
"51326","E01017458",2011,514,43,471,48
"51327","E01017459",2011,687,6,681,53
"51328","E01017460",2011,650,13,637,70
"51329","E01017461",2011,734,81,653,64
"51330","E01017462",2011,613,5,608,32
"51331","E01017463",2011,601,74,527,22
"51332","E01017464",2011,620,31,589,42
"51333","E01017465",2011,616,41,575,50
"51334","E01017466",2011,754,120,634,399
"51335","E01017467",2011,613,53,560,173
"51336","E01017468",2011,596,12,584,160
"51337","E01017469",2011,842,135,707,373
"51338","E01017470",2011,503,8,495,91
"51339","E01017471",2011,772,362,410,289
"51340","E01017472",2011,510,218,292,93
"51341","E01017473",2011,929,149,780,372
"51342","E01017474",2011,628,136,492,199
"51343","E01017475",2011,553,40,513,128
"51344","E01017476",2011,543,46,497,86
"51345","E01017477",2011,518,340,178,32
"51346","E01017478",2011,718,93,625,84
"51347","E01017479",2011,624,47,577,78
"51348","E01017480",2011,746,53,693,100
"51349","E01017481",2011,485,72,413,40
"51350","E01017482",2011,621,125,496,176
"51351","E01017483",2011,600,12,588,93
"51352","E01017484",2011,503,42,461,234
"51353","E01017485",2011,622,27,595,243
"51354","E01017486",2011,685,106,579,110
"51355","E01017487",2011,672,181,491,67
"51356","E01017488",2011,637,28,609,39
"51357","E01017489",2011,614,291,323,51
"51358","E01017490",2011,611,318,293,55
"51359","E01017491",2011,641,81,560,67
"51360","E01017492",2011,606,241,365,73
"51361","E01017493",2011,653,203,450,78
"51362","E01017495",2011,829,69,760,94
"51363","E01017496",2011,642,71,571,46
"51364","E01017497",2011,581,48,533,228
"51365","E01017498",2011,505,11,494,91
"51366","E01017499",2011,599,75,524,247
"51367","E01017500",2011,591,135,456,242
"51368","E01017501",2011,619,132,487,214
"51369","E01017502",2011,842,487,355,225
"51370","E01017503",2011,507,52,455,62
"51371","E01017504",2011,833,79,754,128
"51372","E01017505",2011,645,93,552,114
"51373","E01017506",2011,664,119,545,143
"51374","E01017507",2011,519,36,483,73
"51375","E01017508",2011,663,27,636,115
"51376","E01017509",2011,501,303,198,22
"51377","E01017510",2011,657,73,584,86
"51378","E01017511",2011,485,61,424,59
"51379","E01017512",2011,537,151,386,66
"51380","E01017513",2011,549,23,526,74
"51381","E01017514",2011,650,269,381,78
"51382","E01017515",2011,626,231,395,39
"51383","E01017516",2011,559,24,535,58
"51384","E01017517",2011,598,38,560,63
"51385","E01017518",2011,604,162,442,100
"51386","E01017519",2011,642,278,364,66
"51387","E01017520",2011,625,73,552,102
"51388","E01017521",2011,622,88,534,70
"51389","E01017522",2011,858,221,637,270
"51390","E01017523",2011,589,343,246,46
"51391","E01017524",2011,632,60,572,81
"51392","E01017525",2011,493,118,375,49
"51393","E01017526",2011,604,22,582,123
"51394","E01017527",2011,530,19,511,126
"51395","E01017528",2011,948,52,896,69
"51396","E01017529",2011,509,14,495,37
"51397","E01017530",2011,578,9,569,22
"51398","E01017531",2011,583,263,320,46
"51399","E01017532",2011,505,4,501,27
"51400","E01017533",2011,485,10,475,17
"51401","E01017534",2011,644,5,639,42
"51402","E01017535",2011,475,48,427,64
"51403","E01017536",2011,820,130,690,339
"51404","E01017537",2011,480,169,311,60
"51405","E01017538",2011,524,46,478,138
"51406","E01017539",2011,502,52,450,129
"51407","E01017540",2011,591,31,560,53
"51408","E01017541",2011,520,66,454,34
"51409","E01017542",2011,589,77,512,74
"51410","E01017543",2011,590,44,546,71
"51411","E01017544",2011,577,56,521,49
"51412","E01017545",2011,587,34,553,86
"51413","E01017546",2011,505,61,444,85
"51414","E01017547",2011,633,39,594,50
"51415","E01017548",2011,750,168,582,37
"51416","E01017549",2011,652,31,621,31
"51417","E01017550",2011,988,148,840,122
"51418","E01017551",2011,532,31,501,38
"51419","E01017552",2011,499,24,475,44
"51420","E01017553",2011,482,17,465,23
"51421","E01017554",2011,640,142,498,36
"51422","E01017555",2011,955,189,766,252
"51423","E01017556",2011,672,23,649,131
"51424","E01017557",2011,919,269,650,113
"51425","E01017558",2011,737,34,703,95
"51426","E01017559",2011,666,78,588,48
"51427","E01017560",2011,619,6,613,30
"51428","E01017561",2011,591,30,561,24
"51429","E01017562",2011,697,131,566,70
"51430","E01017563",2011,672,13,659,47
"51431","E01017564",2011,604,26,578,110
"51432","E01017565",2011,618,36,582,26
"51433","E01017566",2011,605,10,595,24
"51434","E01017567",2011,695,157,538,91
"51435","E01017568",2011,874,159,715,255
"51436","E01017569",2011,750,111,639,168
"51437","E01017570",2011,925,93,832,285
"51438","E01017571",2011,527,108,419,24
"51439","E01017572",2011,569,23,546,62
"51440","E01017573",2011,586,6,580,45
"51441","E01017575",2011,1076,139,937,199
"51442","E01017576",2011,547,101,446,25
"51443","E01017577",2011,928,105,823,79
"51444","E01017578",2011,684,28,656,73
"51445","E01017579",2011,597,148,449,41
"51446","E01017580",2011,885,219,666,138
"51447","E01017581",2011,798,211,587,106
"51448","E01017582",2011,601,8,593,56
"51449","E01017583",2011,720,23,697,84
"51450","E01017584",2011,787,44,743,101
"51451","E01017585",2011,540,4,536,20
"51452","E01017586",2011,614,120,494,38
"51453","E01017587",2011,666,32,634,50
"51454","E01017588",2011,538,63,475,42
"51455","E01017589",2011,787,107,680,224
"51456","E01017590",2011,655,22,633,70
"51457","E01017591",2011,733,92,641,99
"51458","E01017592",2011,699,115,584,84
"51459","E01017593",2011,643,85,558,49
"51460","E01017594",2011,864,494,370,46
"51461","E01017595",2011,464,158,306,18
"51462","E01017596",2011,605,239,366,44
"51463","E01017597",2011,612,138,474,32
"51464","E01017598",2011,408,14,394,23
"51465","E01017599",2011,863,186,677,161
"51466","E01017600",2011,817,28,789,175
"51467","E01017601",2011,490,176,314,52
"51468","E01017602",2011,620,254,366,44
"51469","E01017603",2011,641,10,631,71
"51470","E01017604",2011,641,26,615,52
"51471","E01017605",2011,500,180,320,27
"51472","E01017606",2011,644,8,636,23
"51473","E01017607",2011,507,8,499,25
"51474","E01017608",2011,719,126,593,98
"51475","E01017609",2011,683,333,350,54
"51476","E01017610",2011,446,9,437,21
"51477","E01017611",2011,510,0,510,64
"51478","E01017612",2011,531,4,527,51
"51479","E01017613",2011,604,33,571,72
"51480","E01017614",2011,588,33,555,59
"51481","E01017615",2011,878,76,802,59
"51482","E01017616",2011,952,77,875,156
"51483","E01017617",2011,509,65,444,46
"51484","E01017618",2011,611,225,386,62
"51485","E01017619",2011,787,294,493,59
"51486","E01017620",2011,740,35,705,111
"51487","E01017621",2011,651,14,637,28
"51488","E01017622",2011,681,163,518,87
"51489","E01017623",2011,751,80,671,181
"51490","E01017624",2011,723,19,704,106
"51491","E01017625",2011,647,2,645,17
"51492","E01017626",2011,665,10,655,62
"51493","E01017627",2011,676,97,579,82
"51494","E01017628",2011,633,25,608,45
"51495","E01017629",2011,649,16,633,58
"51496","E01017630",2011,617,62,555,31
"51497","E01017631",2011,644,70,574,63
"51498","E01017632",2011,618,5,613,53
"51499","E01017634",2011,634,40,594,215
"51500","E01017635",2011,609,2,607,101
"51501","E01017636",2011,637,9,628,45
"51502","E01017637",2011,492,34,458,60
"51503","E01017638",2011,499,5,494,53
"51504","E01017639",2011,611,2,609,42
"51505","E01017640",2011,624,44,580,22
"51506","E01017641",2011,708,45,663,55
"51507","E01017642",2011,539,49,490,70
"51508","E01017643",2011,529,53,476,93
"51509","E01017644",2011,633,27,606,122
"51510","E01017645",2011,574,110,464,213
"51511","E01017646",2011,790,239,551,67
"51512","E01017647",2011,619,9,610,31
"51513","E01017648",2011,683,16,667,76
"51514","E01017649",2011,833,118,715,124
"51515","E01017650",2011,609,2,607,78
"51516","E01017651",2011,602,35,567,31
"51517","E01017652",2011,625,76,549,66
"51518","E01017653",2011,608,47,561,90
"51519","E01017654",2011,542,220,322,73
"51520","E01017655",2011,813,44,769,149
"51521","E01017657",2011,584,31,553,30
"51522","E01017658",2011,594,30,564,65
"51523","E01017659",2011,607,170,437,79
"51524","E01017660",2011,740,56,684,209
"51525","E01017661",2011,618,182,436,90
"51526","E01017662",2011,515,89,426,120
"51527","E01017663",2011,600,140,460,150
"51528","E01017664",2011,627,7,620,140
"51529","E01017665",2011,584,180,404,52
"51530","E01017666",2011,733,63,670,156
"51531","E01017667",2011,506,160,346,38
"51532","E01017668",2011,617,70,547,63
"51533","E01017669",2011,605,77,528,40
"51534","E01017670",2011,633,71,562,73
"51535","E01017671",2011,609,48,561,49
"51536","E01017672",2011,578,39,539,63
"51537","E01017673",2011,486,38,448,46
"51538","E01017674",2011,512,22,490,52
"51539","E01017675",2011,605,16,589,67
"51540","E01017676",2011,568,11,557,43
"51541","E01017677",2011,602,19,583,49
"51542","E01017678",2011,547,21,526,96
"51543","E01017679",2011,616,96,520,39
"51544","E01017680",2011,449,148,301,31
"51545","E01017681",2011,523,154,369,33
"51546","E01017682",2011,481,7,474,36
"51547","E01017683",2011,671,80,591,59
"51548","E01017684",2011,462,39,423,26
"51549","E01017687",2011,886,322,564,144
"51550","E01017688",2011,513,36,477,95
"51551","E01017689",2011,568,27,541,73
"51552","E01017690",2011,483,31,452,64
"51553","E01017691",2011,517,9,508,35
"51554","E01017692",2011,683,17,666,176
"51555","E01017693",2011,438,58,380,56
"51556","E01017694",2011,826,70,756,66
"51557","E01017695",2011,511,61,450,18
"51558","E01017696",2011,510,42,468,38
"51559","E01017697",2011,621,25,596,116
"51560","E01017698",2011,534,105,429,66
"51561","E01017699",2011,435,32,403,109
"51562","E01017700",2011,619,4,615,71
"51563","E01017701",2011,810,74,736,66
"51564","E01017702",2011,608,126,482,48
"51565","E01017703",2011,523,63,460,72
"51566","E01017704",2011,486,36,450,29
"51567","E01017705",2011,483,22,461,46
"51568","E01017706",2011,498,159,339,34
"51569","E01017707",2011,468,255,213,38
"51570","E01017708",2011,595,177,418,92
"51571","E01017709",2011,569,261,308,58
"51572","E01017710",2011,517,131,386,32
"51573","E01017711",2011,622,295,327,56
"51574","E01017712",2011,798,280,518,175
"51575","E01017713",2011,589,101,488,65
"51576","E01017714",2011,521,20,501,72
"51577","E01017715",2011,460,35,425,99
"51578","E01017716",2011,713,88,625,52
"51579","E01017717",2011,692,82,610,86
"51580","E01017718",2011,640,45,595,90
"51581","E01017719",2011,501,114,387,54
"51582","E01017720",2011,512,31,481,128
"51583","E01017721",2011,773,71,702,159
"51584","E01017722",2011,624,38,586,81
"51585","E01017723",2011,500,207,293,46
"51586","E01017724",2011,498,177,321,56
"51587","E01017726",2011,527,73,454,87
"51588","E01017727",2011,661,8,653,49
"51589","E01017728",2011,740,117,623,290
"51590","E01017729",2011,679,51,628,38
"51591","E01017730",2011,734,233,501,70
"51592","E01017731",2011,550,139,411,43
"51593","E01017732",2011,549,18,531,62
"51594","E01017733",2011,509,91,418,46
"51595","E01017734",2011,553,12,541,55
"51596","E01017735",2011,545,57,488,65
"51597","E01017736",2011,662,182,480,68
"51598","E01017737",2011,593,4,589,45
"51599","E01017738",2011,685,42,643,141
"51600","E01017739",2011,493,12,481,47
"51601","E01017740",2011,532,56,476,91
"51602","E01017741",2011,665,168,497,43
"51603","E01017742",2011,701,30,671,138
"51604","E01017743",2011,638,253,385,79
"51605","E01017744",2011,569,64,505,57
"51606","E01017745",2011,813,122,691,137
"51607","E01017746",2011,593,54,539,63
"51608","E01017747",2011,533,91,442,52
"51609","E01017748",2011,727,345,382,31
"51610","E01017749",2011,659,19,640,26
"51611","E01017750",2011,883,65,818,76
"51612","E01017751",2011,787,11,776,47
"51613","E01017752",2011,887,46,841,59
"51614","E01017753",2011,516,158,358,34
"51615","E01017754",2011,551,16,535,29
"51616","E01017755",2011,662,32,630,124
"51617","E01017756",2011,584,4,580,28
"51618","E01017757",2011,479,64,415,17
"51619","E01017758",2011,426,12,414,34
"51620","E01017759",2011,776,136,640,93
"51621","E01017760",2011,658,36,622,38
"51622","E01017761",2011,862,46,816,60
"51623","E01017762",2011,527,8,519,33
"51624","E01017763",2011,750,19,731,126
"51625","E01017764",2011,609,12,597,24
"51626","E01017765",2011,619,10,609,31
"51627","E01017766",2011,904,38,866,66
"51628","E01017767",2011,879,146,733,60
"51629","E01017768",2011,960,103,857,106
"51630","E01017769",2011,627,15,612,70
"51631","E01017770",2011,642,123,519,148
"51632","E01017771",2011,623,6,617,32
"51633","E01017773",2011,609,33,576,31
"51634","E01017774",2011,505,12,493,15
"51635","E01017775",2011,677,186,491,57
"51636","E01017776",2011,661,204,457,65
"51637","E01017777",2011,644,15,629,32
"51638","E01017778",2011,516,60,456,33
"51639","E01017779",2011,425,28,397,18
"51640","E01017780",2011,490,11,479,53
"51641","E01017781",2011,455,120,335,68
"51642","E01017782",2011,544,5,539,25
"51643","E01017783",2011,601,49,552,57
"51644","E01017784",2011,645,40,605,54
"51645","E01017785",2011,666,7,659,49
"51646","E01017786",2011,603,31,572,38
"51647","E01017787",2011,615,14,601,40
"51648","E01017788",2011,763,209,554,65
"51649","E01017789",2011,508,143,365,27
"51650","E01017790",2011,495,241,254,24
"51651","E01017791",2011,621,163,458,54
"51652","E01017792",2011,923,212,711,187
"51653","E01017793",2011,610,146,464,42
"51654","E01017794",2011,889,58,831,66
"51655","E01017795",2011,829,162,667,75
"51656","E01017796",2011,776,158,618,180
"51657","E01017797",2011,533,9,524,31
"51658","E01017798",2011,714,33,681,77
"51659","E01017799",2011,791,72,719,148
"51660","E01017800",2011,684,169,515,167
"51661","E01017801",2011,580,20,560,54
"51662","E01017802",2011,655,194,461,43
"51663","E01017803",2011,486,13,473,49
"51664","E01017804",2011,683,116,567,100
"51665","E01017805",2011,774,311,463,57
"51666","E01017806",2011,648,24,624,42
"51667","E01017807",2011,608,32,576,72
"51668","E01017808",2011,642,118,524,86
"51669","E01017809",2011,587,157,430,47
"51670","E01017810",2011,902,294,608,119
"51671","E01017811",2011,498,42,456,40
"51672","E01017812",2011,651,111,540,88
"51673","E01017813",2011,755,12,743,68
"51674","E01017814",2011,595,40,555,65
"51675","E01017815",2011,679,30,649,61
"51676","E01017816",2011,723,90,633,94
"51677","E01017817",2011,724,103,621,50
"51678","E01017818",2011,715,66,649,87
"51679","E01017819",2011,552,4,548,60
"51680","E01017820",2011,703,46,657,163
"51681","E01017821",2011,561,7,554,69
"51682","E01017822",2011,629,4,625,47
"51683","E01017823",2011,572,77,495,71
"51684","E01017824",2011,685,84,601,55
"51685","E01017825",2011,651,21,630,56
"51686","E01017826",2011,623,173,450,32
"51687","E01017827",2011,664,94,570,86
"51688","E01017828",2011,659,181,478,49
"51689","E01017829",2011,667,10,657,75
"51690","E01017830",2011,779,128,651,71
"51691","E01017831",2011,648,14,634,60
"51692","E01017832",2011,601,81,520,56
"51693","E01017833",2011,791,28,763,139
"51694","E01017834",2011,552,69,483,42
"51695","E01017835",2011,774,31,743,55
"51696","E01017836",2011,551,23,528,98
"51697","E01017837",2011,779,196,583,339
"51698","E01017838",2011,510,11,499,125
"51699","E01017839",2011,496,35,461,172
"51700","E01017840",2011,666,36,630,103
"51701","E01017841",2011,518,12,506,99
"51702","E01017842",2011,1053,56,997,189
"51703","E01017843",2011,654,55,599,34
"51704","E01017844",2011,731,218,513,62
"51705","E01017845",2011,706,145,561,85
"51706","E01017846",2011,639,183,456,84
"51707","E01017847",2011,682,46,636,108
"51708","E01017848",2011,474,1,473,27
"51709","E01017849",2011,665,9,656,122
"51710","E01017850",2011,474,146,328,84
"51711","E01017851",2011,678,129,549,155
"51712","E01017852",2011,709,27,682,135
"51713","E01017853",2011,575,45,530,107
"51714","E01017854",2011,505,28,477,56
"51715","E01017855",2011,617,78,539,69
"51716","E01017856",2011,538,178,360,35
"51717","E01017857",2011,598,285,313,61
"51718","E01017858",2011,601,132,469,142
"51719","E01017859",2011,503,18,485,58
"51720","E01017860",2011,493,100,393,67
"51721","E01017861",2011,607,22,585,54
"51722","E01017862",2011,706,57,649,65
"51723","E01017863",2011,641,10,631,36
"51724","E01017864",2011,520,5,515,25
"51725","E01017865",2011,611,4,607,22
"51726","E01017866",2011,603,5,598,73
"51727","E01017867",2011,610,167,443,39
"51728","E01017868",2011,649,12,637,68
"51729","E01017869",2011,511,4,507,23
"51730","E01017870",2011,478,3,475,29
"51731","E01017871",2011,609,8,601,33
"51732","E01017872",2011,673,9,664,40
"51733","E01017873",2011,517,12,505,29
"51734","E01017874",2011,459,35,424,163
"51735","E01017875",2011,544,11,533,215
"51736","E01017876",2011,775,8,767,34
"51737","E01017877",2011,641,93,548,37
"51738","E01017878",2011,1074,42,1032,211
"51739","E01017880",2011,519,2,517,18
"51740","E01017881",2011,701,30,671,37
"51741","E01017882",2011,635,29,606,56
"51742","E01017883",2011,626,31,595,47
"51743","E01017884",2011,627,105,522,49
"51744","E01017885",2011,672,48,624,75
"51745","E01017886",2011,614,31,583,67
"51746","E01017887",2011,468,25,443,36
"51747","E01017888",2011,630,37,593,204
"51748","E01017889",2011,530,128,402,63
"51749","E01017890",2011,500,11,489,18
"51750","E01017891",2011,635,19,616,82
"51751","E01017892",2011,607,9,598,44
"51752","E01017893",2011,799,233,566,161
"51753","E01017894",2011,658,21,637,93
"51754","E01017895",2011,606,125,481,105
"51755","E01017896",2011,629,11,618,117
"51756","E01017897",2011,643,51,592,112
"51757","E01017898",2011,499,110,389,81
"51758","E01017899",2011,688,252,436,59
"51759","E01017900",2011,528,164,364,76
"51760","E01017901",2011,462,192,270,29
"51761","E01017902",2011,637,236,401,83
"51762","E01017903",2011,508,83,425,136
"51763","E01017904",2011,607,88,519,182
"51764","E01017905",2011,838,126,712,352
"51765","E01017906",2011,501,143,358,73
"51766","E01017907",2011,621,183,438,99
"51767","E01017908",2011,1167,350,817,223
"51768","E01017909",2011,938,106,832,242
"51769","E01017910",2011,1072,139,933,320
"51770","E01017911",2011,670,203,467,78
"51771","E01017912",2011,523,14,509,113
"51772","E01017913",2011,745,96,649,273
"51773","E01017914",2011,507,28,479,36
"51774","E01017915",2011,530,52,478,52
"51775","E01017916",2011,480,20,460,49
"51776","E01017917",2011,578,19,559,91
"51777","E01017918",2011,702,166,536,88
"51778","E01017919",2011,630,115,515,216
"51779","E01017920",2011,476,33,443,34
"51780","E01017921",2011,674,22,652,205
"51781","E01017922",2011,676,72,604,148
"51782","E01017923",2011,666,91,575,305
"51783","E01017924",2011,557,11,546,85
"51784","E01017925",2011,785,140,645,154
"51785","E01017926",2011,669,327,342,60
"51786","E01017927",2011,589,73,516,39
"51787","E01017928",2011,614,165,449,52
"51788","E01017929",2011,785,267,518,128
"51789","E01017930",2011,731,13,718,76
"51790","E01017931",2011,600,114,486,41
"51791","E01017932",2011,680,57,623,45
"51792","E01017933",2011,704,118,586,39
"51793","E01017934",2011,750,217,533,90
"51794","E01017935",2011,872,78,794,158
"51795","E01017936",2011,649,32,617,78
"51796","E01017937",2011,567,16,551,35
"51797","E01017938",2011,503,4,499,36
"51798","E01017939",2011,558,50,508,83
"51799","E01017940",2011,673,15,658,93
"51800","E01017941",2011,671,113,558,121
"51801","E01017942",2011,587,62,525,15
"51802","E01017943",2011,740,121,619,271
"51803","E01017944",2011,575,230,345,68
"51804","E01017945",2011,768,173,595,259
"51805","E01017946",2011,643,260,383,101
"51806","E01017947",2011,682,253,429,83
"51807","E01017948",2011,698,410,288,79
"51808","E01017949",2011,683,117,566,277
"51809","E01017950",2011,568,36,532,199
"51810","E01017951",2011,660,188,472,109
"51811","E01017952",2011,684,347,337,72
"51812","E01017953",2011,690,218,472,120
"51813","E01017954",2011,601,208,393,69
"51814","E01017955",2011,647,12,635,170
"51815","E01017956",2011,536,39,497,137
"51816","E01017957",2011,507,12,495,205
"51817","E01017958",2011,392,183,209,107
"51818","E01017959",2011,686,53,633,164
"51819","E01017960",2011,555,240,315,64
"51820","E01017961",2011,583,210,373,102
"51821","E01017962",2011,662,189,473,71
"51822","E01017963",2011,678,215,463,79
"51823","E01017964",2011,512,21,491,68
"51824","E01017965",2011,745,243,502,154
"51825","E01017966",2011,1107,181,926,488
"51826","E01017967",2011,650,241,409,122
"51827","E01017968",2011,668,104,564,158
"51828","E01017969",2011,618,146,472,127
"51829","E01017971",2011,666,316,350,113
"51830","E01017972",2011,676,204,472,126
"51831","E01017973",2011,729,403,326,132
"51832","E01017974",2011,694,267,427,138
"51833","E01017975",2011,687,349,338,68
"51834","E01017976",2011,636,107,529,153
"51835","E01017977",2011,769,301,468,145
"51836","E01017978",2011,657,327,330,95
"51837","E01017979",2011,671,361,310,86
"51838","E01017980",2011,498,90,408,99
"51839","E01017983",2011,906,100,806,384
"51840","E01017984",2011,701,47,654,241
"51841","E01017985",2011,706,64,642,213
"51842","E01017986",2011,304,41,263,106
"51843","E01017987",2011,678,88,590,264
"51844","E01017988",2011,557,40,517,245
"51845","E01017989",2011,933,157,776,375
"51846","E01017990",2011,598,35,563,282
"51847","E01017991",2011,600,211,389,178
"51848","E01017992",2011,727,189,538,124
"51849","E01017993",2011,967,315,652,180
"51850","E01017994",2011,640,192,448,75
"51851","E01017995",2011,563,25,538,49
"51852","E01017996",2011,527,6,521,138
"51853","E01017997",2011,957,165,792,275
"51854","E01017998",2011,720,50,670,322
"51855","E01017999",2011,696,199,497,201
"51856","E01018000",2011,725,68,657,318
"51857","E01018001",2011,759,56,703,310
"51858","E01018002",2011,754,148,606,202
"51859","E01018003",2011,621,113,508,94
"51860","E01018005",2011,772,191,581,276
"51861","E01018006",2011,773,60,713,289
"51862","E01018007",2011,585,15,570,89
"51863","E01018008",2011,654,80,574,172
"51864","E01018009",2011,833,207,626,310
"51865","E01018010",2011,884,111,773,356
"51866","E01018011",2011,1003,107,896,137
"51867","E01018012",2011,563,128,435,53
"51868","E01018013",2011,739,36,703,43
"51869","E01018014",2011,747,63,684,80
"51870","E01018015",2011,563,18,545,55
"51871","E01018016",2011,582,189,393,29
"51872","E01018017",2011,599,154,445,68
"51873","E01018019",2011,444,9,435,51
"51874","E01018020",2011,586,32,554,52
"51875","E01018021",2011,595,108,487,46
"51876","E01018022",2011,592,81,511,28
"51877","E01018023",2011,919,140,779,116
"51878","E01018024",2011,515,117,398,66
"51879","E01018025",2011,722,140,582,275
"51880","E01018026",2011,662,20,642,160
"51881","E01018027",2011,736,39,697,118
"51882","E01018029",2011,1105,105,1000,207
"51883","E01018030",2011,416,100,316,32
"51884","E01018032",2011,1034,97,937,156
"51885","E01018033",2011,911,249,662,123
"51886","E01018034",2011,616,31,585,88
"51887","E01018035",2011,965,216,749,161
"51888","E01018036",2011,714,123,591,63
"51889","E01018037",2011,542,29,513,25
"51890","E01018038",2011,616,16,600,63
"51891","E01018039",2011,533,60,473,39
"51892","E01018040",2011,502,12,490,68
"51893","E01018041",2011,451,100,351,49
"51894","E01018042",2011,643,165,478,75
"51895","E01018043",2011,836,95,741,160
"51896","E01018044",2011,744,63,681,195
"51897","E01018045",2011,526,71,455,78
"51898","E01018046",2011,835,329,506,65
"51899","E01018047",2011,768,158,610,79
"51900","E01018049",2011,677,103,574,105
"51901","E01018050",2011,549,76,473,72
"51902","E01018051",2011,687,128,559,66
"51903","E01018052",2011,808,159,649,230
"51904","E01018053",2011,697,130,567,66
"51905","E01018054",2011,922,87,835,103
"51906","E01018055",2011,849,27,822,73
"51907","E01018056",2011,792,163,629,75
"51908","E01018057",2011,827,142,685,97
"51909","E01018058",2011,700,7,693,79
"51910","E01018059",2011,550,22,528,58
"51911","E01018060",2011,753,56,697,112
"51912","E01018061",2011,506,42,464,59
"51913","E01018062",2011,1056,138,918,137
"51914","E01018063",2011,950,173,777,280
"51915","E01018064",2011,836,84,752,89
"51916","E01018065",2011,920,39,881,91
"51917","E01018066",2011,636,93,543,51
"51918","E01018067",2011,764,64,700,99
"51919","E01018068",2011,594,78,516,75
"51920","E01018069",2011,744,23,721,95
"51921","E01018070",2011,748,214,534,194
"51922","E01018071",2011,787,165,622,133
"51923","E01018072",2011,669,123,546,74
"51924","E01018073",2011,926,118,808,144
"51925","E01018074",2011,522,42,480,53
"51926","E01018075",2011,525,175,350,73
"51927","E01018076",2011,866,49,817,93
"51928","E01018077",2011,873,107,766,290
"51929","E01018078",2011,805,292,513,116
"51930","E01018079",2011,789,119,670,99
"51931","E01018080",2011,977,55,922,167
"51932","E01018081",2011,579,56,523,78
"51933","E01018082",2011,811,45,766,100
"51934","E01018083",2011,772,85,687,175
"51935","E01018084",2011,904,51,853,127
"51936","E01018085",2011,701,9,692,98
"51937","E01018086",2011,723,76,647,129
"51938","E01018087",2011,941,152,789,177
"51939","E01018088",2011,703,27,676,67
"51940","E01018090",2011,740,88,652,53
"51941","E01018091",2011,588,84,504,74
"51942","E01018092",2011,728,76,652,90
"51943","E01018093",2011,1008,149,859,177
"51944","E01018094",2011,778,136,642,74
"51945","E01018095",2011,656,41,615,54
"51946","E01018096",2011,730,15,715,85
"51947","E01018097",2011,611,62,549,51
"51948","E01018098",2011,593,25,568,63
"51949","E01018099",2011,524,7,517,53
"51950","E01018100",2011,600,64,536,188
"51951","E01018101",2011,592,22,570,146
"51952","E01018102",2011,1148,120,1028,251
"51953","E01018103",2011,469,179,290,77
"51954","E01018104",2011,511,76,435,42
"51955","E01018105",2011,544,79,465,94
"51956","E01018106",2011,693,21,672,123
"51957","E01018107",2011,641,245,396,98
"51958","E01018108",2011,776,274,502,168
"51959","E01018109",2011,773,60,713,170
"51960","E01018110",2011,1096,92,1004,162
"51961","E01018111",2011,941,88,853,80
"51962","E01018113",2011,583,45,538,60
"51963","E01018115",2011,567,16,551,62
"51964","E01018116",2011,492,10,482,151
"51965","E01018117",2011,761,150,611,84
"51966","E01018118",2011,787,25,762,152
"51967","E01018119",2011,638,48,590,92
"51968","E01018120",2011,757,105,652,84
"51969","E01018121",2011,513,11,502,33
"51970","E01018122",2011,494,47,447,38
"51971","E01018123",2011,641,37,604,63
"51972","E01018124",2011,766,68,698,50
"51973","E01018125",2011,605,65,540,53
"51974","E01018126",2011,631,47,584,105
"51975","E01018127",2011,633,40,593,104
"51976","E01018128",2011,511,73,438,97
"51977","E01018129",2011,649,78,571,101
"51978","E01018130",2011,698,45,653,66
"51979","E01018131",2011,634,168,466,54
"51980","E01018132",2011,809,105,704,194
"51981","E01018133",2011,662,124,538,51
"51982","E01018134",2011,774,70,704,123
"51983","E01018135",2011,1151,284,867,91
"51984","E01018136",2011,690,43,647,64
"51985","E01018137",2011,695,61,634,73
"51986","E01018138",2011,924,177,747,229
"51987","E01018139",2011,571,147,424,51
"51988","E01018140",2011,507,22,485,49
"51989","E01018141",2011,682,12,670,79
"51990","E01018142",2011,626,97,529,51
"51991","E01018143",2011,692,322,370,56
"51992","E01018144",2011,565,238,327,56
"51993","E01018145",2011,481,175,306,62
"51994","E01018146",2011,764,223,541,139
"51995","E01018147",2011,579,218,361,80
"51996","E01018148",2011,896,96,800,175
"51997","E01018149",2011,539,11,528,93
"51998","E01018150",2011,665,141,524,129
"51999","E01018151",2011,905,95,810,404
"52000","E01018152",2011,598,37,561,82
"52001","E01018153",2011,757,66,691,109
"52002","E01018154",2011,720,58,662,68
"52003","E01018155",2011,641,9,632,78
"52004","E01018156",2011,678,46,632,73
"52005","E01018157",2011,795,86,709,69
"52006","E01018158",2011,844,143,701,280
"52007","E01018159",2011,553,11,542,79
"52008","E01018160",2011,689,240,449,65
"52009","E01018161",2011,578,18,560,77
"52010","E01018162",2011,619,39,580,65
"52011","E01018163",2011,597,113,484,145
"52012","E01018164",2011,534,23,511,110
"52013","E01018165",2011,557,46,511,98
"52014","E01018166",2011,652,47,605,83
"52015","E01018167",2011,584,9,575,47
"52016","E01018168",2011,1081,257,824,343
"52017","E01018169",2011,621,114,507,76
"52018","E01018170",2011,601,57,544,68
"52019","E01018171",2011,586,26,560,53
"52020","E01018172",2011,625,57,568,68
"52021","E01018173",2011,509,11,498,125
"52022","E01018174",2011,689,41,648,106
"52023","E01018175",2011,549,10,539,57
"52024","E01018176",2011,484,2,482,18
"52025","E01018177",2011,647,43,604,61
"52026","E01018178",2011,629,67,562,55
"52027","E01018179",2011,598,175,423,83
"52028","E01018180",2011,573,266,307,60
"52029","E01018181",2011,1167,99,1068,226
"52030","E01018182",2011,583,58,525,78
"52031","E01018183",2011,618,208,410,74
"52032","E01018184",2011,508,175,333,54
"52033","E01018185",2011,724,89,635,95
"52034","E01018186",2011,734,150,584,71
"52035","E01018187",2011,1022,205,817,330
"52036","E01018188",2011,634,116,518,68
"52037","E01018189",2011,502,7,495,25
"52038","E01018190",2011,627,104,523,64
"52039","E01018191",2011,473,7,466,57
"52040","E01018192",2011,556,37,519,62
"52041","E01018193",2011,492,6,486,71
"52042","E01018194",2011,581,45,536,101
"52043","E01018195",2011,539,174,365,59
"52044","E01018196",2011,510,33,477,45
"52045","E01018197",2011,656,108,548,83
"52046","E01018198",2011,674,31,643,92
"52047","E01018199",2011,604,23,581,32
"52048","E01018200",2011,637,52,585,56
"52049","E01018201",2011,600,67,533,84
"52050","E01018202",2011,639,26,613,60
"52051","E01018203",2011,621,63,558,78
"52052","E01018204",2011,541,32,509,34
"52053","E01018205",2011,826,28,798,123
"52054","E01018206",2011,714,69,645,292
"52055","E01018207",2011,617,74,543,70
"52056","E01018208",2011,674,107,567,83
"52057","E01018209",2011,598,42,556,69
"52058","E01018210",2011,592,115,477,59
"52059","E01018211",2011,689,58,631,73
"52060","E01018212",2011,679,122,557,67
"52061","E01018213",2011,741,78,663,122
"52062","E01018214",2011,798,188,610,71
"52063","E01018215",2011,559,5,554,78
"52064","E01018216",2011,934,65,869,108
"52065","E01018217",2011,737,118,619,52
"52066","E01018218",2011,718,58,660,63
"52067","E01018219",2011,563,124,439,45
"52068","E01018220",2011,596,88,508,61
"52069","E01018221",2011,749,19,730,128
"52070","E01018222",2011,591,6,585,43
"52071","E01018223",2011,799,88,711,101
"52072","E01018224",2011,591,96,495,64
"52073","E01018225",2011,494,97,397,60
"52074","E01018226",2011,474,29,445,164
"52075","E01018227",2011,747,182,565,58
"52076","E01018228",2011,663,76,587,42
"52077","E01018231",2011,972,69,903,94
"52078","E01018232",2011,948,99,849,77
"52079","E01018233",2011,658,26,632,87
"52080","E01018234",2011,655,8,647,102
"52081","E01018235",2011,702,96,606,72
"52082","E01018236",2011,643,186,457,35
"52083","E01018237",2011,624,83,541,68
"52084","E01018238",2011,578,123,455,65
"52085","E01018239",2011,546,87,459,46
"52086","E01018240",2011,483,63,420,27
"52087","E01018241",2011,485,50,435,33
"52088","E01018242",2011,564,131,433,41
"52089","E01018243",2011,659,101,558,167
"52090","E01018244",2011,662,35,627,78
"52091","E01018245",2011,694,30,664,75
"52092","E01018246",2011,714,148,566,63
"52093","E01018247",2011,637,103,534,75
"52094","E01018248",2011,712,43,669,94
"52095","E01018249",2011,453,62,391,47
"52096","E01018250",2011,522,107,415,46
"52097","E01018251",2011,484,21,463,46
"52098","E01018252",2011,533,60,473,40
"52099","E01018253",2011,428,14,414,48
"52100","E01018254",2011,563,113,450,42
"52101","E01018255",2011,458,57,401,26
"52102","E01018256",2011,626,46,580,62
"52103","E01018257",2011,585,210,375,27
"52104","E01018258",2011,683,87,596,54
"52105","E01018259",2011,534,50,484,72
"52106","E01018260",2011,772,65,707,101
"52107","E01018262",2011,549,15,534,47
"52108","E01018263",2011,598,47,551,67
"52109","E01018264",2011,653,249,404,35
"52110","E01018265",2011,703,16,687,71
"52111","E01018266",2011,1095,94,1001,152
"52112","E01018267",2011,1003,109,894,86
"52113","E01018268",2011,733,105,628,60
"52114","E01018269",2011,597,182,415,43
"52115","E01018270",2011,445,77,368,28
"52116","E01018271",2011,566,136,430,50
"52117","E01018272",2011,503,5,498,49
"52118","E01018273",2011,683,86,597,137
"52119","E01018274",2011,703,27,676,249
"52120","E01018275",2011,974,147,827,66
"52121","E01018276",2011,583,208,375,73
"52122","E01018277",2011,709,88,621,70
"52123","E01018278",2011,664,136,528,48
"52124","E01018279",2011,673,197,476,33
"52125","E01018280",2011,611,92,519,64
"52126","E01018281",2011,692,248,444,48
"52127","E01018282",2011,522,55,467,52
"52128","E01018283",2011,494,14,480,42
"52129","E01018284",2011,522,17,505,69
"52130","E01018285",2011,474,66,408,50
"52131","E01018286",2011,667,164,503,122
"52132","E01018287",2011,586,31,555,246
"52133","E01018288",2011,494,86,408,29
"52134","E01018289",2011,472,56,416,108
"52135","E01018290",2011,987,122,865,80
"52136","E01018291",2011,492,71,421,57
"52137","E01018292",2011,556,23,533,71
"52138","E01018293",2011,628,10,618,71
"52139","E01018294",2011,844,264,580,134
"52140","E01018295",2011,645,73,572,46
"52141","E01018296",2011,464,73,391,57
"52142","E01018297",2011,737,122,615,131
"52143","E01018298",2011,493,62,431,237
"52144","E01018299",2011,731,139,592,81
"52145","E01018300",2011,501,90,411,64
"52146","E01018301",2011,565,41,524,90
"52147","E01018302",2011,614,61,553,85
"52148","E01018303",2011,511,104,407,36
"52149","E01018304",2011,781,177,604,82
"52150","E01018305",2011,539,62,477,29
"52151","E01018306",2011,583,22,561,46
"52152","E01018307",2011,847,63,784,66
"52153","E01018308",2011,782,88,694,93
"52154","E01018309",2011,657,132,525,48
"52155","E01018310",2011,598,315,283,34
"52156","E01018311",2011,649,399,250,55
"52157","E01018312",2011,584,179,405,42
"52158","E01018313",2011,581,77,504,30
"52159","E01018314",2011,699,305,394,51
"52160","E01018315",2011,490,55,435,43
"52161","E01018316",2011,589,308,281,32
"52162","E01018317",2011,744,479,265,42
"52163","E01018319",2011,993,125,868,266
"52164","E01018320",2011,616,5,611,34
"52165","E01018321",2011,531,38,493,67
"52166","E01018322",2011,506,8,498,25
"52167","E01018323",2011,562,52,510,66
"52168","E01018324",2011,532,4,528,59
"52169","E01018325",2011,586,42,544,23
"52170","E01018326",2011,1175,243,932,454
"52171","E01018327",2011,1176,453,723,348
"52172","E01018328",2011,466,22,444,253
"52173","E01018329",2011,1055,196,859,495
"52174","E01018330",2011,459,7,452,133
"52175","E01018331",2011,714,13,701,390
"52176","E01018332",2011,476,61,415,41
"52177","E01018333",2011,663,6,657,93
"52178","E01018334",2011,651,11,640,35
"52179","E01018335",2011,874,45,829,222
"52180","E01018336",2011,525,11,514,27
"52181","E01018337",2011,555,34,521,52
"52182","E01018338",2011,779,40,739,92
"52183","E01018339",2011,893,87,806,92
"52184","E01018340",2011,659,98,561,87
"52185","E01018341",2011,517,28,489,50
"52186","E01018342",2011,866,38,828,306
"52187","E01018343",2011,786,151,635,319
"52188","E01018344",2011,919,28,891,287
"52189","E01018345",2011,512,42,470,40
"52190","E01018346",2011,542,16,526,43
"52191","E01018347",2011,612,179,433,49
"52192","E01018348",2011,894,10,884,116
"52193","E01018349",2011,677,58,619,58
"52194","E01018350",2011,790,8,782,35
"52195","E01018351",2011,656,445,211,26
"52196","E01018352",2011,844,51,793,171
"52197","E01018353",2011,628,65,563,62
"52198","E01018354",2011,648,213,435,68
"52199","E01018355",2011,571,130,441,93
"52200","E01018356",2011,599,32,567,110
"52201","E01018357",2011,539,21,518,82
"52202","E01018358",2011,475,26,449,46
"52203","E01018359",2011,415,9,406,17
"52204","E01018360",2011,771,38,733,194
"52205","E01018361",2011,609,22,587,182
"52206","E01018362",2011,635,19,616,52
"52207","E01018363",2011,479,2,477,38
"52208","E01018364",2011,755,376,379,64
"52209","E01018365",2011,857,70,787,63
"52210","E01018366",2011,647,11,636,38
"52211","E01018367",2011,793,116,677,63
"52212","E01018368",2011,602,65,537,76
"52213","E01018369",2011,606,31,575,84
"52214","E01018370",2011,534,7,527,36
"52215","E01018371",2011,760,133,627,119
"52216","E01018372",2011,821,20,801,199
"52217","E01018373",2011,843,37,806,117
"52218","E01018374",2011,785,39,746,194
"52219","E01018375",2011,802,10,792,309
"52220","E01018376",2011,630,33,597,64
"52221","E01018377",2011,659,45,614,27
"52222","E01018378",2011,524,180,344,35
"52223","E01018379",2011,605,62,543,29
"52224","E01018380",2011,513,59,454,29
"52225","E01018381",2011,517,8,509,77
"52226","E01018382",2011,788,180,608,119
"52227","E01018383",2011,601,19,582,51
"52228","E01018384",2011,621,9,612,52
"52229","E01018385",2011,855,24,831,79
"52230","E01018386",2011,629,64,565,75
"52231","E01018387",2011,736,4,732,22
"52232","E01018388",2011,745,296,449,92
"52233","E01018389",2011,729,41,688,77
"52234","E01018390",2011,757,22,735,51
"52235","E01018391",2011,812,144,668,110
"52236","E01018392",2011,775,13,762,57
"52237","E01018393",2011,839,55,784,81
"52238","E01018394",2011,815,32,783,72
"52239","E01018395",2011,701,33,668,72
"52240","E01018396",2011,609,178,431,28
"52241","E01018397",2011,726,19,707,78
"52242","E01018398",2011,735,182,553,132
"52243","E01018399",2011,690,94,596,124
"52244","E01018400",2011,977,452,525,99
"52245","E01018401",2011,610,196,414,34
"52246","E01018402",2011,942,162,780,257
"52247","E01018403",2011,825,25,800,50
"52248","E01018404",2011,611,3,608,33
"52249","E01018405",2011,600,3,597,68
"52250","E01018406",2011,613,5,608,69
"52251","E01018407",2011,643,2,641,37
"52252","E01018408",2011,756,31,725,37
"52253","E01018409",2011,870,116,754,66
"52254","E01018410",2011,653,8,645,25
"52255","E01018411",2011,934,17,917,33
"52256","E01018412",2011,660,93,567,45
"52257","E01018413",2011,503,10,493,38
"52258","E01018414",2011,624,20,604,64
"52259","E01018415",2011,774,103,671,72
"52260","E01018416",2011,518,13,505,31
"52261","E01018417",2011,734,63,671,34
"52262","E01018418",2011,661,51,610,67
"52263","E01018419",2011,535,12,523,49
"52264","E01018420",2011,716,37,679,85
"52265","E01018421",2011,539,18,521,54
"52266","E01018422",2011,542,68,474,60
"52267","E01018423",2011,629,200,429,47
"52268","E01018424",2011,731,48,683,89
"52269","E01018425",2011,748,78,670,109
"52270","E01018426",2011,727,152,575,61
"52271","E01018427",2011,504,9,495,28
"52272","E01018428",2011,625,70,555,53
"52273","E01018429",2011,660,101,559,47
"52274","E01018430",2011,577,35,542,42
"52275","E01018431",2011,512,3,509,86
"52276","E01018432",2011,648,118,530,55
"52277","E01018433",2011,586,42,544,40
"52278","E01018434",2011,623,40,583,65
"52279","E01018435",2011,673,266,407,87
"52280","E01018436",2011,611,10,601,39
"52281","E01018437",2011,753,151,602,138
"52282","E01018438",2011,619,2,617,23
"52283","E01018439",2011,557,5,552,35
"52284","E01018440",2011,724,44,680,135
"52285","E01018441",2011,654,21,633,92
"52286","E01018442",2011,753,29,724,76
"52287","E01018443",2011,639,5,634,71
"52288","E01018444",2011,866,63,803,124
"52289","E01018445",2011,828,296,532,166
"52290","E01018446",2011,502,134,368,36
"52291","E01018447",2011,727,46,681,284
"52292","E01018448",2011,729,16,713,153
"52293","E01018449",2011,746,51,695,44
"52294","E01018450",2011,912,34,878,143
"52295","E01018451",2011,758,258,500,86
"52296","E01018452",2011,511,110,401,29
"52297","E01018454",2011,708,199,509,137
"52298","E01018455",2011,607,55,552,30
"52299","E01018456",2011,587,5,582,27
"52300","E01018457",2011,759,33,726,190
"52301","E01018458",2011,869,85,784,81
"52302","E01018459",2011,510,224,286,44
"52303","E01018460",2011,622,33,589,89
"52304","E01018461",2011,628,150,478,63
"52305","E01018462",2011,715,172,543,294
"52306","E01018463",2011,627,107,520,130
"52307","E01018464",2011,650,29,621,178
"52308","E01018465",2011,1172,50,1122,203
"52309","E01018466",2011,1126,438,688,258
"52310","E01018467",2011,996,126,870,440
"52311","E01018468",2011,640,4,636,50
"52312","E01018469",2011,646,81,565,55
"52313","E01018470",2011,576,9,567,31
"52314","E01018471",2011,626,2,624,44
"52315","E01018472",2011,659,24,635,82
"52316","E01018473",2011,657,18,639,64
"52317","E01018474",2011,670,14,656,51
"52318","E01018475",2011,632,5,627,35
"52319","E01018476",2011,513,249,264,50
"52320","E01018477",2011,627,198,429,44
"52321","E01018478",2011,527,151,376,66
"52322","E01018479",2011,704,60,644,77
"52323","E01018480",2011,821,37,784,136
"52324","E01018481",2011,803,61,742,160
"52325","E01018482",2011,639,198,441,47
"52326","E01018483",2011,631,46,585,66
"52327","E01018484",2011,901,406,495,136
"52328","E01018485",2011,633,249,384,90
"52329","E01018486",2011,702,180,522,289
"52330","E01018487",2011,653,22,631,267
"52331","E01018488",2011,599,5,594,80
"52332","E01018489",2011,534,18,516,194
"52333","E01018490",2011,637,8,629,18
"52334","E01018491",2011,625,4,621,61
"52335","E01018492",2011,513,3,510,21
"52336","E01018493",2011,622,37,585,45
"52337","E01018494",2011,597,3,594,67
"52338","E01018495",2011,538,4,534,44
"52339","E01018496",2011,681,75,606,104
"52340","E01018497",2011,526,25,501,180
"52341","E01018498",2011,641,212,429,117
"52342","E01018499",2011,711,65,646,78
"52343","E01018500",2011,529,1,528,29
"52344","E01018501",2011,766,90,676,99
"52345","E01018502",2011,543,4,539,45
"52346","E01018503",2011,689,7,682,37
"52347","E01018504",2011,855,118,737,172
"52348","E01018505",2011,436,1,435,28
"52349","E01018506",2011,533,1,532,13
"52350","E01018507",2011,559,1,558,16
"52351","E01018508",2011,493,4,489,27
"52352","E01018509",2011,514,43,471,65
"52353","E01018510",2011,623,41,582,28
"52354","E01018511",2011,644,192,452,47
"52355","E01018512",2011,713,140,573,67
"52356","E01018513",2011,660,11,649,48
"52357","E01018514",2011,810,73,737,94
"52358","E01018515",2011,897,33,864,105
"52359","E01018516",2011,608,25,583,36
"52360","E01018518",2011,671,6,665,49
"52361","E01018519",2011,670,75,595,217
"52362","E01018520",2011,492,98,394,150
"52363","E01018521",2011,501,223,278,26
"52364","E01018522",2011,591,211,380,35
"52365","E01018523",2011,600,266,334,35
"52366","E01018524",2011,604,394,210,31
"52367","E01018525",2011,525,234,291,46
"52368","E01018526",2011,666,2,664,53
"52369","E01018527",2011,654,3,651,46
"52370","E01018528",2011,496,3,493,27
"52371","E01018529",2011,648,2,646,24
"52372","E01018530",2011,563,11,552,34
"52373","E01018531",2011,667,1,666,69
"52374","E01018532",2011,853,197,656,82
"52375","E01018533",2011,623,4,619,26
"52376","E01018534",2011,1195,480,715,164
"52377","E01018535",2011,628,133,495,48
"52378","E01018536",2011,743,18,725,90
"52379","E01018537",2011,896,41,855,65
"52380","E01018538",2011,451,190,261,23
"52381","E01018539",2011,482,170,312,30
"52382","E01018540",2011,611,50,561,52
"52383","E01018541",2011,626,69,557,68
"52384","E01018542",2011,494,310,184,40
"52385","E01018543",2011,604,145,459,95
"52386","E01018544",2011,645,10,635,53
"52387","E01018545",2011,827,14,813,67
"52388","E01018546",2011,646,150,496,92
"52389","E01018547",2011,608,72,536,39
"52390","E01018548",2011,702,193,509,42
"52391","E01018549",2011,656,89,567,57
"52392","E01018550",2011,481,304,177,36
"52393","E01018551",2011,694,395,299,49
"52394","E01018552",2011,641,186,455,64
"52395","E01018553",2011,686,212,474,73
"52396","E01018554",2011,993,2,991,49
"52397","E01018555",2011,479,3,476,24
"52398","E01018556",2011,635,46,589,29
"52399","E01018557",2011,662,235,427,36
"52400","E01018558",2011,500,7,493,36
"52401","E01018559",2011,468,4,464,15
"52402","E01018560",2011,471,2,469,23
"52403","E01018561",2011,475,0,475,18
"52404","E01018562",2011,524,2,522,40
"52405","E01018563",2011,1040,566,474,153
"52406","E01018564",2011,1119,249,870,286
"52407","E01018565",2011,618,25,593,27
"52408","E01018566",2011,592,0,592,25
"52409","E01018567",2011,590,9,581,28
"52410","E01018568",2011,575,5,570,57
"52411","E01018569",2011,545,17,528,17
"52412","E01018570",2011,521,25,496,62
"52413","E01018571",2011,630,44,586,76
"52414","E01018572",2011,746,16,730,68
"52415","E01018573",2011,674,6,668,86
"52416","E01018574",2011,988,145,843,206
"52417","E01018575",2011,473,7,466,94
"52418","E01018576",2011,872,25,847,253
"52419","E01018577",2011,1118,97,1021,156
"52420","E01018578",2011,486,12,474,54
"52421","E01018579",2011,488,156,332,30
"52422","E01018580",2011,658,27,631,81
"52423","E01018581",2011,558,56,502,48
"52424","E01018582",2011,806,45,761,152
"52425","E01018583",2011,793,22,771,129
"52426","E01018584",2011,716,9,707,71
"52427","E01018585",2011,617,77,540,43
"52428","E01018586",2011,686,27,659,87
"52429","E01018587",2011,653,10,643,56
"52430","E01018588",2011,633,3,630,71
"52431","E01018589",2011,622,3,619,24
"52432","E01018590",2011,746,35,711,54
"52433","E01018591",2011,1029,83,946,81
"52434","E01018592",2011,731,86,645,68
"52435","E01018593",2011,767,60,707,83
"52436","E01018594",2011,829,367,462,66
"52437","E01018595",2011,729,150,579,101
"52438","E01018596",2011,916,474,442,123
"52439","E01018597",2011,1026,74,952,158
"52440","E01018598",2011,649,21,628,99
"52441","E01018599",2011,488,24,464,45
"52442","E01018600",2011,639,2,637,51
"52443","E01018601",2011,836,75,761,152
"52444","E01018602",2011,833,51,782,192
"52445","E01018603",2011,512,5,507,31
"52446","E01018604",2011,617,97,520,69
"52447","E01018605",2011,494,11,483,45
"52448","E01018606",2011,818,127,691,186
"52449","E01018607",2011,516,3,513,42
"52450","E01018608",2011,551,8,543,44
"52451","E01018609",2011,754,96,658,59
"52452","E01018610",2011,899,194,705,116
"52453","E01018611",2011,749,347,402,85
"52454","E01018612",2011,520,93,427,47
"52455","E01018613",2011,706,179,527,90
"52456","E01018614",2011,829,8,821,154
"52457","E01018615",2011,515,9,506,87
"52458","E01018616",2011,508,45,463,44
"52459","E01018617",2011,692,89,603,61
"52460","E01018618",2011,601,157,444,64
"52461","E01018619",2011,570,18,552,34
"52462","E01018620",2011,580,161,419,52
"52463","E01018621",2011,560,21,539,37
"52464","E01018622",2011,732,121,611,228
"52465","E01018623",2011,699,34,665,144
"52466","E01018624",2011,996,29,967,466
"52467","E01018625",2011,657,4,653,201
"52468","E01018626",2011,1064,180,884,181
"52469","E01018627",2011,817,77,740,228
"52470","E01018628",2011,652,43,609,36
"52471","E01018629",2011,842,233,609,133
"52472","E01018630",2011,629,82,547,85
"52473","E01018631",2011,714,351,363,53
"52474","E01018632",2011,661,7,654,70
"52475","E01018633",2011,616,2,614,20
"52476","E01018634",2011,766,32,734,46
"52477","E01018635",2011,589,40,549,159
"52478","E01018636",2011,589,72,517,45
"52479","E01018637",2011,693,288,405,50
"52480","E01018638",2011,674,234,440,45
"52481","E01018639",2011,674,89,585,168
"52482","E01018640",2011,624,328,296,45
"52483","E01018641",2011,499,2,497,17
"52484","E01018642",2011,535,1,534,35
"52485","E01018643",2011,721,34,687,31
"52486","E01018644",2011,647,2,645,79
"52487","E01018645",2011,887,448,439,63
"52488","E01018646",2011,733,236,497,44
"52489","E01018647",2011,672,155,517,44
"52490","E01018648",2011,929,85,844,267
"52491","E01018649",2011,586,8,578,38
"52492","E01018650",2011,738,42,696,99
"52493","E01018651",2011,501,44,457,82
"52494","E01018652",2011,603,8,595,61
"52495","E01018653",2011,888,4,884,65
"52496","E01018654",2011,910,49,861,127
"52497","E01018655",2011,748,23,725,94
"52498","E01018656",2011,647,4,643,48
"52499","E01018657",2011,487,160,327,22
"52500","E01018658",2011,489,6,483,25
"52501","E01018659",2011,521,2,519,9
"52502","E01018660",2011,406,24,382,20
"52503","E01018661",2011,516,4,512,38
"52504","E01018662",2011,477,13,464,19
"52505","E01018663",2011,660,11,649,50
"52506","E01018664",2011,589,9,580,26
"52507","E01018665",2011,484,89,395,24
"52508","E01018666",2011,715,8,707,42
"52509","E01018667",2011,727,55,672,62
"52510","E01018668",2011,651,10,641,60
"52511","E01018669",2011,1104,48,1056,98
"52512","E01018670",2011,1029,96,933,88
"52513","E01018671",2011,513,5,508,29
"52514","E01018672",2011,667,193,474,62
"52515","E01018673",2011,522,28,494,37
"52516","E01018674",2011,691,57,634,110
"52517","E01018675",2011,871,45,826,32
"52518","E01018676",2011,642,14,628,48
"52519","E01018677",2011,648,22,626,49
"52520","E01018678",2011,510,7,503,18
"52521","E01018679",2011,725,151,574,70
"52522","E01018680",2011,647,8,639,80
"52523","E01018681",2011,627,39,588,53
"52524","E01018682",2011,491,128,363,30
"52525","E01018683",2011,643,9,634,47
"52526","E01018684",2011,927,24,903,64
"52527","E01018685",2011,601,296,305,29
"52528","E01018686",2011,603,40,563,104
"52529","E01018687",2011,585,19,566,18
"52530","E01018688",2011,692,1,691,125
"52531","E01018689",2011,676,37,639,81
"52532","E01018690",2011,868,19,849,66
"52533","E01018691",2011,700,57,643,78
"52534","E01018692",2011,793,12,781,68
"52535","E01018693",2011,626,3,623,31
"52536","E01018694",2011,635,4,631,40
"52537","E01018695",2011,738,21,717,114
"52538","E01018696",2011,626,7,619,59
"52539","E01018697",2011,779,114,665,58
"52540","E01018698",2011,814,30,784,47
"52541","E01018699",2011,653,90,563,53
"52542","E01018700",2011,761,9,752,96
"52543","E01018701",2011,622,265,357,30
"52544","E01018702",2011,481,19,462,34
"52545","E01018703",2011,828,15,813,158
"52546","E01018704",2011,541,92,449,31
"52547","E01018705",2011,620,18,602,45
"52548","E01018706",2011,526,76,450,61
"52549","E01018707",2011,736,64,672,66
"52550","E01018708",2011,889,49,840,82
"52551","E01018709",2011,669,50,619,162
"52552","E01018710",2011,579,182,397,57
"52553","E01018711",2011,730,36,694,149
"52554","E01018712",2011,752,124,628,158
"52555","E01018713",2011,1144,75,1069,199
"52556","E01018714",2011,890,248,642,230
"52557","E01018715",2011,766,102,664,201
"52558","E01018716",2011,641,256,385,50
"52559","E01018717",2011,766,59,707,146
"52560","E01018718",2011,671,45,626,46
"52561","E01018719",2011,639,119,520,58
"52562","E01018720",2011,668,230,438,40
"52563","E01018721",2011,921,76,845,59
"52564","E01018722",2011,941,53,888,77
"52565","E01018723",2011,510,74,436,54
"52566","E01018724",2011,666,13,653,72
"52567","E01018725",2011,543,45,498,88
"52568","E01018726",2011,613,150,463,45
"52569","E01018727",2011,749,22,727,71
"52570","E01018728",2011,636,107,529,37
"52571","E01018729",2011,757,269,488,52
"52572","E01018730",2011,635,186,449,31
"52573","E01018731",2011,676,46,630,149
"52574","E01018732",2011,554,35,519,83
"52575","E01018733",2011,611,29,582,42
"52576","E01018734",2011,530,122,408,56
"52577","E01018735",2011,540,16,524,84
"52578","E01018736",2011,657,53,604,97
"52579","E01018737",2011,534,4,530,48
"52580","E01018738",2011,560,429,131,19
"52581","E01018739",2011,575,256,319,68
"52582","E01018740",2011,608,298,310,43
"52583","E01018741",2011,527,46,481,34
"52584","E01018742",2011,630,15,615,34
"52585","E01018743",2011,625,30,595,54
"52586","E01018744",2011,680,166,514,30
"52587","E01018745",2011,708,319,389,72
"52588","E01018746",2011,708,181,527,70
"52589","E01018747",2011,657,71,586,100
"52590","E01018748",2011,507,269,238,54
"52591","E01018749",2011,951,107,844,133
"52592","E01018750",2011,953,50,903,129
"52593","E01018751",2011,697,188,509,172
"52594","E01018752",2011,858,67,791,150
"52595","E01018753",2011,686,22,664,54
"52596","E01018754",2011,684,156,528,69
"52597","E01018755",2011,654,10,644,88
"52598","E01018756",2011,745,48,697,88
"52599","E01018757",2011,939,42,897,142
"52600","E01018758",2011,1030,156,874,127
"52601","E01018759",2011,629,53,576,106
"52602","E01018760",2011,514,53,461,65
"52603","E01018761",2011,695,118,577,75
"52604","E01018762",2011,549,27,522,86
"52605","E01018763",2011,447,45,402,70
"52606","E01018764",2011,616,24,592,80
"52607","E01018765",2011,671,82,589,62
"52608","E01018766",2011,858,140,718,138
"52609","E01018767",2011,647,295,352,76
"52610","E01018768",2011,781,96,685,132
"52611","E01018769",2011,832,102,730,177
"52612","E01018770",2011,552,213,339,63
"52613","E01018771",2011,704,65,639,296
"52614","E01018772",2011,705,16,689,73
"52615","E01018773",2011,727,128,599,100
"52616","E01018774",2011,673,153,520,104
"52617","E01018775",2011,636,7,629,73
"52618","E01018776",2011,597,23,574,146
"52619","E01018777",2011,865,69,796,97
"52620","E01018778",2011,736,93,643,140
"52621","E01018779",2011,971,74,897,107
"52622","E01018780",2011,1002,185,817,129
"52623","E01018781",2011,853,84,769,125
"52624","E01018782",2011,630,70,560,75
"52625","E01018783",2011,674,30,644,76
"52626","E01018784",2011,650,50,600,73
"52627","E01018785",2011,822,88,734,156
"52628","E01018786",2011,550,23,527,57
"52629","E01018787",2011,604,11,593,96
"52630","E01018788",2011,723,270,453,62
"52631","E01018789",2011,604,18,586,66
"52632","E01018790",2011,487,122,365,54
"52633","E01018791",2011,531,154,377,43
"52634","E01018792",2011,1183,56,1127,137
"52635","E01018793",2011,772,117,655,161
"52636","E01018794",2011,612,87,525,48
"52637","E01018795",2011,510,8,502,33
"52638","E01018796",2011,498,8,490,87
"52639","E01018797",2011,501,149,352,90
"52640","E01018798",2011,665,64,601,83
"52641","E01018799",2011,561,200,361,77
"52642","E01018800",2011,656,17,639,166
"52643","E01018803",2011,966,59,907,356
"52644","E01018804",2011,742,36,706,376
"52645","E01018805",2011,685,31,654,108
"52646","E01018806",2011,641,47,594,191
"52647","E01018807",2011,626,55,571,156
"52648","E01018808",2011,656,59,597,117
"52649","E01018809",2011,1141,311,830,353
"52650","E01018810",2011,579,10,569,132
"52651","E01018811",2011,622,20,602,62
"52652","E01018812",2011,594,154,440,67
"52653","E01018813",2011,599,6,593,83
"52654","E01018814",2011,597,21,576,70
"52655","E01018815",2011,836,62,774,162
"52656","E01018816",2011,736,16,720,51
"52657","E01018817",2011,886,18,868,181
"52658","E01018818",2011,721,70,651,52
"52659","E01018819",2011,652,72,580,148
"52660","E01018820",2011,759,69,690,159
"52661","E01018821",2011,492,22,470,77
"52662","E01018822",2011,516,12,504,50
"52663","E01018823",2011,748,59,689,114
"52664","E01018824",2011,1031,173,858,87
"52665","E01018825",2011,667,33,634,139
"52666","E01018826",2011,987,59,928,152
"52667","E01018827",2011,656,25,631,81
"52668","E01018828",2011,696,82,614,99
"52669","E01018829",2011,539,22,517,84
"52670","E01018830",2011,673,57,616,56
"52671","E01018831",2011,536,49,487,84
"52672","E01018832",2011,553,15,538,69
"52673","E01018833",2011,591,41,550,67
"52674","E01018834",2011,718,72,646,102
"52675","E01018835",2011,756,89,667,178
"52676","E01018836",2011,758,266,492,195
"52677","E01018837",2011,914,98,816,250
"52678","E01018838",2011,625,208,417,91
"52679","E01018839",2011,586,51,535,163
"52680","E01018840",2011,689,75,614,269
"52681","E01018841",2011,582,270,312,53
"52682","E01018842",2011,621,55,566,76
"52683","E01018843",2011,534,9,525,65
"52684","E01018844",2011,616,77,539,160
"52685","E01018845",2011,665,78,587,107
"52686","E01018846",2011,606,49,557,151
"52687","E01018847",2011,631,26,605,124
"52688","E01018848",2011,698,14,684,107
"52689","E01018849",2011,941,141,800,97
"52690","E01018850",2011,586,80,506,65
"52691","E01018851",2011,672,125,547,115
"52692","E01018852",2011,1078,29,1049,153
"52693","E01018853",2011,1010,192,818,170
"52694","E01018854",2011,598,232,366,80
"52695","E01018855",2011,936,93,843,206
"52696","E01018856",2011,638,159,479,97
"52697","E01018857",2011,540,208,332,51
"52698","E01018858",2011,632,91,541,57
"52699","E01018859",2011,755,13,742,88
"52700","E01018860",2011,826,402,424,58
"52701","E01018861",2011,613,33,580,75
"52702","E01018862",2011,619,32,587,60
"52703","E01018863",2011,660,44,616,84
"52704","E01018864",2011,664,17,647,99
"52705","E01018865",2011,819,72,747,173
"52706","E01018866",2011,716,18,698,115
"52707","E01018867",2011,795,139,656,176
"52708","E01018868",2011,760,23,737,269
"52709","E01018869",2011,661,81,580,76
"52710","E01018870",2011,492,286,206,49
"52711","E01018871",2011,702,10,692,111
"52712","E01018872",2011,532,35,497,80
"52713","E01018873",2011,505,85,420,52
"52714","E01018874",2011,587,90,497,55
"52715","E01018875",2011,630,329,301,82
"52716","E01018876",2011,575,20,555,86
"52717","E01018877",2011,629,63,566,70
"52718","E01018878",2011,702,31,671,263
"52719","E01018879",2011,799,51,748,95
"52720","E01018880",2011,919,86,833,141
"52721","E01018881",2011,815,92,723,101
"52722","E01018882",2011,616,10,606,89
"52723","E01018883",2011,651,10,641,75
"52724","E01018884",2011,684,11,673,117
"52725","E01018885",2011,680,84,596,166
"52726","E01018886",2011,738,46,692,291
"52727","E01018887",2011,643,98,545,196
"52728","E01018888",2011,904,303,601,114
"52729","E01018889",2011,548,3,545,61
"52730","E01018890",2011,630,84,546,43
"52731","E01018891",2011,589,13,576,116
"52732","E01018892",2011,584,6,578,107
"52733","E01018893",2011,618,175,443,54
"52734","E01018894",2011,742,46,696,79
"52735","E01018895",2011,678,17,661,123
"52736","E01018896",2011,649,63,586,73
"52737","E01018897",2011,641,74,567,156
"52738","E01018898",2011,552,244,308,49
"52739","E01018899",2011,618,58,560,75
"52740","E01018900",2011,639,38,601,60
"52741","E01018901",2011,699,40,659,84
"52742","E01018902",2011,512,60,452,86
"52743","E01018903",2011,446,29,417,77
"52744","E01018904",2011,942,109,833,109
"52745","E01018905",2011,570,47,523,78
"52746","E01018906",2011,566,25,541,98
"52747","E01018907",2011,589,152,437,63
"52748","E01018908",2011,692,62,630,98
"52749","E01018909",2011,695,15,680,139
"52750","E01018910",2011,776,479,297,110
"52751","E01018911",2011,835,222,613,198
"52752","E01018912",2011,630,6,624,80
"52753","E01018913",2011,777,41,736,267
"52754","E01018914",2011,814,67,747,137
"52755","E01018915",2011,872,19,853,193
"52756","E01018916",2011,545,83,462,66
"52757","E01018917",2011,597,4,593,80
"52758","E01018918",2011,764,107,657,107
"52759","E01018919",2011,611,28,583,67
"52760","E01018920",2011,885,111,774,122
"52761","E01018921",2011,872,81,791,121
"52762","E01018922",2011,921,18,903,102
"52763","E01018923",2011,531,48,483,72
"52764","E01018924",2011,467,22,445,111
"52765","E01018925",2011,916,50,866,143
"52766","E01018926",2011,1027,77,950,123
"52767","E01018927",2011,648,115,533,89
"52768","E01018928",2011,790,237,553,179
"52769","E01018929",2011,539,45,494,90
"52770","E01018930",2011,669,396,273,75
"52771","E01018931",2011,502,55,447,43
"52772","E01018932",2011,703,164,539,141
"52773","E01018933",2011,657,118,539,227
"52774","E01018934",2011,811,33,778,77
"52775","E01018935",2011,927,95,832,203
"52776","E01018936",2011,713,55,658,209
"52777","E01018937",2011,772,242,530,91
"52778","E01018938",2011,812,151,661,83
"52779","E01018940",2011,691,29,662,78
"52780","E01018941",2011,684,104,580,94
"52781","E01018942",2011,692,41,651,138
"52782","E01018943",2011,897,68,829,103
"52783","E01018944",2011,455,69,386,53
"52784","E01018945",2011,540,20,520,66
"52785","E01018946",2011,678,122,556,99
"52786","E01018947",2011,1179,163,1016,275
"52787","E01018948",2011,710,56,654,191
"52788","E01018949",2011,523,215,308,58
"52789","E01018950",2011,836,67,769,318
"52790","E01018951",2011,949,71,878,119
"52791","E01018952",2011,501,16,485,84
"52792","E01018953",2011,496,27,469,93
"52793","E01018954",2011,476,34,442,136
"52794","E01018955",2011,684,85,599,91
"52795","E01018956",2011,474,39,435,83
"52796","E01018957",2011,542,64,478,79
"52797","E01018958",2011,634,190,444,63
"52798","E01018959",2011,684,9,675,72
"52799","E01018960",2011,796,86,710,141
"52800","E01018961",2011,707,41,666,197
"52801","E01018962",2011,930,136,794,109
"52802","E01018965",2011,995,47,948,142
"52803","E01018966",2011,467,17,450,47
"52804","E01018967",2011,535,37,498,62
"52805","E01018968",2011,1002,48,954,122
"52806","E01018969",2011,1011,50,961,135
"52807","E01018970",2011,634,30,604,85
"52808","E01018971",2011,851,99,752,76
"52809","E01018972",2011,832,210,622,201
"52810","E01018973",2011,638,84,554,88
"52811","E01018974",2011,1007,97,910,130
"52812","E01018975",2011,827,82,745,96
"52813","E01018976",2011,976,44,932,175
"52814","E01018977",2011,608,239,369,63
"52815","E01018978",2011,632,120,512,55
"52816","E01018979",2011,542,61,481,72
"52817","E01018980",2011,577,38,539,67
"52818","E01018981",2011,907,54,853,102
"52819","E01018982",2011,919,95,824,189
"52820","E01018983",2011,682,17,665,85
"52821","E01018984",2011,891,351,540,110
"52822","E01018985",2011,995,21,974,158
"52823","E01018986",2011,746,33,713,124
"52824","E01018987",2011,915,5,910,141
"52825","E01018988",2011,669,44,625,97
"52826","E01018989",2011,717,115,602,135
"52827","E01018990",2011,859,141,718,166
"52828","E01018991",2011,680,81,599,97
"52829","E01018992",2011,727,8,719,114
"52830","E01018993",2011,794,133,661,136
"52831","E01018994",2011,776,142,634,77
"52832","E01018995",2011,1048,399,649,196
"52833","E01018996",2011,752,93,659,209
"52834","E01018997",2011,573,375,198,30
"52835","E01018998",2011,687,22,665,228
"52836","E01018999",2011,797,182,615,238
"52837","E01019000",2011,682,104,578,71
"52838","E01019001",2011,940,103,837,321
"52839","E01019002",2011,705,28,677,115
"52840","E01019003",2011,777,13,764,118
"52841","E01019004",2011,756,197,559,139
"52842","E01019005",2011,908,146,762,145
"52843","E01019006",2011,687,20,667,118
"52844","E01019007",2011,909,65,844,158
"52845","E01019008",2011,642,249,393,67
"52846","E01019009",2011,606,189,417,73
"52847","E01019010",2011,569,36,533,55
"52848","E01019011",2011,628,14,614,105
"52849","E01019012",2011,1000,85,915,264
"52850","E01019013",2011,932,169,763,121
"52851","E01019014",2011,571,50,521,43
"52852","E01019015",2011,591,5,586,67
"52853","E01019016",2011,697,43,654,100
"52854","E01019017",2011,1075,40,1035,118
"52855","E01019018",2011,656,17,639,45
"52856","E01019019",2011,638,47,591,119
"52857","E01019020",2011,688,99,589,275
"52858","E01019021",2011,651,12,639,114
"52859","E01019022",2011,769,178,591,107
"52860","E01019023",2011,630,41,589,187
"52861","E01019024",2011,604,49,555,91
"52862","E01019025",2011,612,16,596,103
"52863","E01019026",2011,644,3,641,95
"52864","E01019027",2011,717,96,621,131
"52865","E01019028",2011,938,178,760,332
"52866","E01019029",2011,687,77,610,264
"52867","E01019030",2011,742,32,710,142
"52868","E01019031",2011,724,62,662,207
"52869","E01019032",2011,611,4,607,75
"52870","E01019033",2011,694,246,448,156
"52871","E01019034",2011,622,47,575,176
"52872","E01019035",2011,720,37,683,137
"52873","E01019036",2011,720,36,684,88
"52874","E01019037",2011,603,87,516,82
"52875","E01019038",2011,549,24,525,137
"52876","E01019039",2011,598,15,583,111
"52877","E01019040",2011,546,41,505,99
"52878","E01019041",2011,763,192,571,194
"52879","E01019042",2011,749,107,642,202
"52880","E01019043",2011,678,49,629,99
"52881","E01019044",2011,721,34,687,89
"52882","E01019045",2011,871,39,832,131
"52883","E01019046",2011,590,230,360,53
"52884","E01019047",2011,483,62,421,109
"52885","E01019048",2011,806,11,795,175
"52886","E01019049",2011,752,68,684,229
"52887","E01019050",2011,583,9,574,120
"52888","E01019051",2011,712,197,515,78
"52889","E01019052",2011,723,129,594,125
"52890","E01019053",2011,842,21,821,175
"52891","E01019054",2011,742,35,707,107
"52892","E01019055",2011,577,184,393,100
"52893","E01019056",2011,610,297,313,60
"52894","E01019057",2011,799,13,786,179
"52895","E01019058",2011,749,20,729,123
"52896","E01019059",2011,683,119,564,77
"52897","E01019060",2011,629,32,597,107
"52898","E01019061",2011,718,40,678,122
"52899","E01019062",2011,788,193,595,154
"52900","E01019063",2011,799,22,777,160
"52901","E01019064",2011,775,21,754,145
"52902","E01019065",2011,523,60,463,72
"52903","E01019066",2011,501,32,469,96
"52904","E01019067",2011,493,18,475,102
"52905","E01019068",2011,720,17,703,48
"52906","E01019069",2011,531,48,483,100
"52907","E01019070",2011,863,96,767,152
"52908","E01019071",2011,601,19,582,102
"52909","E01019072",2011,610,116,494,75
"52910","E01019073",2011,575,21,554,83
"52911","E01019074",2011,721,110,611,132
"52912","E01019075",2011,691,40,651,109
"52913","E01019076",2011,737,65,672,189
"52914","E01019077",2011,989,179,810,294
"52915","E01019078",2011,659,19,640,42
"52916","E01019079",2011,645,80,565,37
"52917","E01019080",2011,835,242,593,124
"52918","E01019081",2011,825,282,543,47
"52919","E01019082",2011,677,60,617,107
"52920","E01019083",2011,784,43,741,122
"52921","E01019084",2011,653,153,500,58
"52922","E01019085",2011,616,33,583,42
"52923","E01019086",2011,460,26,434,51
"52924","E01019087",2011,699,23,676,43
"52925","E01019088",2011,949,168,781,212
"52926","E01019089",2011,710,202,508,55
"52927","E01019090",2011,675,15,660,122
"52928","E01019091",2011,776,16,760,106
"52929","E01019092",2011,642,48,594,67
"52930","E01019093",2011,646,69,577,59
"52931","E01019094",2011,721,125,596,36
"52932","E01019095",2011,680,323,357,67
"52933","E01019096",2011,979,120,859,46
"52934","E01019097",2011,758,472,286,33
"52935","E01019098",2011,711,172,539,36
"52936","E01019099",2011,749,234,515,57
"52937","E01019100",2011,718,33,685,67
"52938","E01019101",2011,619,9,610,22
"52939","E01019102",2011,734,82,652,121
"52940","E01019103",2011,516,132,384,30
"52941","E01019104",2011,699,231,468,68
"52942","E01019105",2011,525,69,456,125
"52943","E01019106",2011,630,63,567,52
"52944","E01019107",2011,683,19,664,51
"52945","E01019108",2011,629,329,300,24
"52946","E01019109",2011,752,241,511,26
"52947","E01019110",2011,865,492,373,29
"52948","E01019111",2011,687,280,407,60
"52949","E01019112",2011,760,404,356,30
"52950","E01019113",2011,837,535,302,52
"52951","E01019114",2011,625,35,590,94
"52952","E01019115",2011,784,213,571,111
"52953","E01019116",2011,611,94,517,141
"52954","E01019117",2011,579,20,559,39
"52955","E01019118",2011,661,12,649,143
"52956","E01019119",2011,636,13,623,23
"52957","E01019120",2011,812,63,749,109
"52958","E01019121",2011,1036,278,758,203
"52959","E01019122",2011,668,304,364,54
"52960","E01019123",2011,667,237,430,25
"52961","E01019124",2011,840,22,818,25
"52962","E01019125",2011,694,40,654,53
"52963","E01019126",2011,755,177,578,103
"52964","E01019127",2011,707,18,689,46
"52965","E01019128",2011,681,64,617,68
"52966","E01019129",2011,702,3,699,43
"52967","E01019130",2011,697,43,654,64
"52968","E01019131",2011,781,29,752,99
"52969","E01019132",2011,728,41,687,67
"52970","E01019133",2011,663,52,611,70
"52971","E01019134",2011,670,103,567,31
"52972","E01019135",2011,676,246,430,39
"52973","E01019136",2011,648,54,594,48
"52974","E01019137",2011,521,83,438,118
"52975","E01019138",2011,609,27,582,137
"52976","E01019139",2011,856,216,640,410
"52977","E01019140",2011,483,181,302,91
"52978","E01019141",2011,692,147,545,280
"52979","E01019142",2011,701,17,684,259
"52980","E01019143",2011,718,115,603,259
"52981","E01019144",2011,590,25,565,50
"52982","E01019145",2011,837,0,837,69
"52983","E01019146",2011,583,22,561,47
"52984","E01019147",2011,670,6,664,108
"52985","E01019148",2011,603,8,595,27
"52986","E01019149",2011,653,22,631,93
"52987","E01019150",2011,739,104,635,90
"52988","E01019151",2011,623,81,542,28
"52989","E01019152",2011,461,7,454,41
"52990","E01019153",2011,460,1,459,14
"52991","E01019154",2011,615,5,610,21
"52992","E01019155",2011,680,0,680,31
"52993","E01019156",2011,766,356,410,127
"52994","E01019157",2011,743,72,671,286
"52995","E01019158",2011,568,51,517,192
"52996","E01019159",2011,505,20,485,91
"52997","E01019160",2011,617,222,395,23
"52998","E01019161",2011,694,101,593,25
"52999","E01019162",2011,630,2,628,32
"53000","E01019163",2011,504,2,502,36
"53001","E01019164",2011,609,369,240,39
"53002","E01019165",2011,659,165,494,63
"53003","E01019166",2011,650,146,504,80
"53004","E01019167",2011,723,11,712,105
"53005","E01019168",2011,613,51,562,65
"53006","E01019169",2011,515,4,511,45
"53007","E01019170",2011,506,2,504,42
"53008","E01019171",2011,633,8,625,157
"53009","E01019172",2011,641,15,626,153
"53010","E01019173",2011,619,51,568,149
"53011","E01019174",2011,472,107,365,54
"53012","E01019175",2011,594,99,495,43
"53013","E01019176",2011,708,4,704,19
"53014","E01019177",2011,598,164,434,44
"53015","E01019178",2011,704,5,699,56
"53016","E01019179",2011,520,9,511,28
"53017","E01019180",2011,942,12,930,64
"53018","E01019182",2011,625,27,598,61
"53019","E01019184",2011,633,46,587,86
"53020","E01019185",2011,614,11,603,31
"53021","E01019186",2011,601,7,594,94
"53022","E01019187",2011,557,81,476,37
"53023","E01019188",2011,651,96,555,72
"53024","E01019189",2011,666,74,592,115
"53025","E01019190",2011,693,3,690,32
"53026","E01019191",2011,689,33,656,77
"53027","E01019192",2011,621,7,614,43
"53028","E01019193",2011,662,343,319,44
"53029","E01019194",2011,864,223,641,84
"53030","E01019195",2011,551,11,540,60
"53031","E01019196",2011,837,101,736,107
"53032","E01019197",2011,887,484,403,51
"53033","E01019198",2011,637,179,458,67
"53034","E01019199",2011,494,176,318,26
"53035","E01019200",2011,727,93,634,113
"53036","E01019201",2011,668,180,488,101
"53037","E01019202",2011,710,175,535,103
"53038","E01019203",2011,871,43,828,69
"53039","E01019204",2011,618,86,532,257
"53040","E01019205",2011,834,184,650,244
"53041","E01019206",2011,785,56,729,409
"53042","E01019207",2011,689,135,554,158
"53043","E01019208",2011,624,185,439,42
"53044","E01019209",2011,683,126,557,100
"53045","E01019210",2011,588,194,394,37
"53046","E01019211",2011,850,17,833,267
"53047","E01019212",2011,640,17,623,104
"53048","E01019213",2011,1155,54,1101,155
"53049","E01019214",2011,826,65,761,82
"53050","E01019215",2011,742,180,562,150
"53051","E01019216",2011,848,116,732,280
"53052","E01019217",2011,915,81,834,311
"53053","E01019218",2011,617,146,471,92
"53054","E01019219",2011,940,54,886,134
"53055","E01019220",2011,708,49,659,180
"53056","E01019221",2011,862,186,676,110
"53057","E01019222",2011,734,223,511,64
"53058","E01019223",2011,669,34,635,38
"53059","E01019224",2011,897,54,843,82
"53060","E01019225",2011,843,34,809,124
"53061","E01019226",2011,481,17,464,69
"53062","E01019227",2011,674,212,462,76
"53063","E01019228",2011,658,20,638,140
"53064","E01019229",2011,816,24,792,93
"53065","E01019230",2011,799,260,539,52
"53066","E01019231",2011,826,393,433,22
"53067","E01019232",2011,651,97,554,48
"53068","E01019233",2011,637,89,548,30
"53069","E01019234",2011,899,295,604,260
"53070","E01019235",2011,674,13,661,126
"53071","E01019236",2011,752,47,705,319
"53072","E01019237",2011,610,35,575,139
"53073","E01019238",2011,595,16,579,49
"53074","E01019239",2011,623,20,603,69
"53075","E01019240",2011,715,17,698,68
"53076","E01019241",2011,679,41,638,23
"53077","E01019242",2011,615,91,524,98
"53078","E01019243",2011,637,10,627,60
"53079","E01019244",2011,636,5,631,51
"53080","E01019245",2011,666,346,320,61
"53081","E01019246",2011,621,202,419,32
"53082","E01019247",2011,656,113,543,53
"53083","E01019248",2011,518,232,286,37
"53084","E01019249",2011,672,7,665,80
"53085","E01019250",2011,588,38,550,50
"53086","E01019251",2011,754,29,725,78
"53087","E01019252",2011,673,157,516,40
"53088","E01019253",2011,768,20,748,63
"53089","E01019254",2011,601,40,561,25
"53090","E01019255",2011,553,11,542,19
"53091","E01019256",2011,660,45,615,60
"53092","E01019257",2011,643,89,554,40
"53093","E01019258",2011,666,23,643,51
"53094","E01019259",2011,584,53,531,91
"53095","E01019260",2011,635,106,529,42
"53096","E01019261",2011,686,13,673,20
"53097","E01019262",2011,726,39,687,46
"53098","E01019263",2011,491,189,302,33
"53099","E01019264",2011,701,96,605,38
"53100","E01019265",2011,612,136,476,80
"53101","E01019266",2011,642,66,576,80
"53102","E01019267",2011,603,293,310,34
"53103","E01019268",2011,489,31,458,44
"53104","E01019269",2011,680,308,372,38
"53105","E01019270",2011,594,153,441,41
"53106","E01019271",2011,582,183,399,35
"53107","E01019272",2011,609,175,434,58
"53108","E01019273",2011,687,54,633,67
"53109","E01019274",2011,790,193,597,96
"53110","E01019275",2011,937,162,775,49
"53111","E01019276",2011,447,29,418,45
"53112","E01019277",2011,552,223,329,34
"53113","E01019278",2011,570,33,537,45
"53114","E01019279",2011,644,28,616,80
"53115","E01019280",2011,1030,448,582,204
"53116","E01019281",2011,569,85,484,40
"53117","E01019282",2011,501,66,435,43
"53118","E01019283",2011,574,56,518,43
"53119","E01019284",2011,582,187,395,36
"53120","E01019285",2011,645,148,497,69
"53121","E01019286",2011,630,85,545,70
"53122","E01019287",2011,510,10,500,13
"53123","E01019288",2011,546,6,540,16
"53124","E01019289",2011,598,151,447,31
"53125","E01019290",2011,463,41,422,76
"53126","E01019291",2011,599,157,442,57
"53127","E01019292",2011,504,36,468,31
"53128","E01019293",2011,571,20,551,57
"53129","E01019294",2011,619,150,469,28
"53130","E01019295",2011,609,292,317,27
"53131","E01019296",2011,595,163,432,23
"53132","E01019297",2011,546,65,481,50
"53133","E01019298",2011,682,72,610,61
"53134","E01019299",2011,903,171,732,153
"53135","E01019300",2011,737,29,708,86
"53136","E01019301",2011,634,396,238,51
"53137","E01019302",2011,423,71,352,41
"53138","E01019303",2011,654,12,642,57
"53139","E01019304",2011,582,31,551,55
"53140","E01019305",2011,996,137,859,155
"53141","E01019306",2011,651,92,559,121
"53142","E01019307",2011,764,49,715,124
"53143","E01019308",2011,620,118,502,150
"53144","E01019309",2011,982,50,932,191
"53145","E01019310",2011,574,20,554,110
"53146","E01019311",2011,637,36,601,114
"53147","E01019312",2011,635,28,607,84
"53148","E01019313",2011,639,51,588,97
"53149","E01019314",2011,531,32,499,74
"53150","E01019315",2011,732,28,704,120
"53151","E01019316",2011,528,11,517,106
"53152","E01019317",2011,549,8,541,67
"53153","E01019318",2011,621,135,486,137
"53154","E01019319",2011,640,63,577,113
"53155","E01019320",2011,600,38,562,93
"53156","E01019321",2011,644,55,589,81
"53157","E01019322",2011,625,69,556,104
"53158","E01019323",2011,538,14,524,68
"53159","E01019324",2011,532,13,519,88
"53160","E01019325",2011,589,41,548,88
"53161","E01019326",2011,696,30,666,67
"53162","E01019327",2011,667,152,515,114
"53163","E01019328",2011,533,51,482,27
"53164","E01019329",2011,501,11,490,62
"53165","E01019330",2011,656,55,601,133
"53166","E01019331",2011,666,73,593,71
"53167","E01019332",2011,663,237,426,76
"53168","E01019333",2011,536,135,401,118
"53169","E01019334",2011,624,61,563,51
"53170","E01019335",2011,656,150,506,98
"53171","E01019336",2011,832,142,690,199
"53172","E01019337",2011,620,68,552,83
"53173","E01019338",2011,608,13,595,110
"53174","E01019339",2011,595,40,555,86
"53175","E01019340",2011,563,15,548,105
"53176","E01019341",2011,752,22,730,37
"53177","E01019342",2011,508,76,432,51
"53178","E01019343",2011,668,29,639,78
"53179","E01019344",2011,468,32,436,60
"53180","E01019345",2011,530,32,498,56
"53181","E01019346",2011,849,151,698,114
"53182","E01019347",2011,781,44,737,94
"53183","E01019348",2011,518,3,515,70
"53184","E01019349",2011,822,47,775,80
"53185","E01019350",2011,735,88,647,131
"53186","E01019351",2011,760,32,728,122
"53187","E01019352",2011,902,18,884,122
"53188","E01019353",2011,695,73,622,64
"53189","E01019354",2011,737,97,640,86
"53190","E01019355",2011,659,3,656,44
"53191","E01019356",2011,684,84,600,170
"53192","E01019357",2011,831,33,798,146
"53193","E01019358",2011,790,62,728,79
"53194","E01019359",2011,953,238,715,90
"53195","E01019360",2011,1059,119,940,333
"53196","E01019361",2011,797,61,736,67
"53197","E01019362",2011,900,6,894,70
"53198","E01019363",2011,949,172,777,227
"53199","E01019364",2011,841,262,579,129
"53200","E01019365",2011,1006,46,960,191
"53201","E01019366",2011,781,79,702,69
"53202","E01019367",2011,1091,104,987,137
"53203","E01019368",2011,840,12,828,70
"53204","E01019369",2011,869,70,799,51
"53205","E01019370",2011,1057,57,1000,191
"53206","E01019371",2011,934,247,687,96
"53207","E01019372",2011,557,94,463,124
"53208","E01019373",2011,543,24,519,110
"53209","E01019374",2011,708,193,515,140
"53210","E01019375",2011,690,117,573,102
"53211","E01019376",2011,576,137,439,108
"53212","E01019377",2011,805,34,771,83
"53213","E01019378",2011,688,48,640,38
"53214","E01019379",2011,633,36,597,57
"53215","E01019380",2011,474,6,468,34
"53216","E01019381",2011,923,41,882,143
"53217","E01019382",2011,947,155,792,118
"53218","E01019383",2011,882,19,863,85
"53219","E01019384",2011,973,33,940,158
"53220","E01019385",2011,588,115,473,110
"53221","E01019386",2011,797,36,761,185
"53222","E01019387",2011,960,73,887,138
"53223","E01019388",2011,774,152,622,79
"53224","E01019389",2011,1005,220,785,117
"53225","E01019390",2011,960,82,878,155
"53226","E01019391",2011,739,62,677,37
"53227","E01019392",2011,1006,143,863,244
"53228","E01019393",2011,904,17,887,82
"53229","E01019394",2011,926,28,898,115
"53230","E01019395",2011,950,173,777,228
"53231","E01019396",2011,937,99,838,161
"53232","E01019397",2011,899,79,820,237
"53233","E01019398",2011,481,132,349,82
"53234","E01019399",2011,461,106,355,38
"53235","E01019400",2011,669,109,560,104
"53236","E01019401",2011,771,239,532,117
"53237","E01019402",2011,646,125,521,54
"53238","E01019403",2011,675,272,403,70
"53239","E01019404",2011,759,121,638,120
"53240","E01019405",2011,592,6,586,75
"53241","E01019406",2011,482,48,434,41
"53242","E01019407",2011,1017,69,948,275
"53243","E01019408",2011,643,41,602,72
"53244","E01019409",2011,743,52,691,36
"53245","E01019410",2011,631,6,625,86
"53246","E01019411",2011,644,95,549,65
"53247","E01019412",2011,579,4,575,37
"53248","E01019413",2011,548,9,539,73
"53249","E01019414",2011,705,13,692,52
"53250","E01019415",2011,801,81,720,132
"53251","E01019416",2011,641,20,621,51
"53252","E01019417",2011,912,210,702,125
"53253","E01019418",2011,703,68,635,77
"53254","E01019419",2011,913,21,892,151
"53255","E01019420",2011,601,58,543,117
"53256","E01019421",2011,818,120,698,58
"53257","E01019422",2011,653,24,629,47
"53258","E01019423",2011,556,13,543,82
"53259","E01019424",2011,506,109,397,46
"53260","E01019425",2011,639,26,613,34
"53261","E01019426",2011,672,73,599,73
"53262","E01019427",2011,717,34,683,93
"53263","E01019428",2011,630,89,541,64
"53264","E01019429",2011,700,11,689,69
"53265","E01019430",2011,800,25,775,58
"53266","E01019431",2011,600,83,517,65
"53267","E01019432",2011,847,146,701,53
"53268","E01019433",2011,769,23,746,108
"53269","E01019434",2011,540,44,496,60
"53270","E01019435",2011,662,50,612,86
"53271","E01019436",2011,558,28,530,83
"53272","E01019437",2011,610,200,410,47
"53273","E01019438",2011,667,43,624,114
"53274","E01019439",2011,516,8,508,49
"53275","E01019440",2011,662,89,573,85
"53276","E01019441",2011,672,164,508,152
"53277","E01019442",2011,649,60,589,83
"53278","E01019443",2011,713,63,650,70
"53279","E01019444",2011,594,348,246,51
"53280","E01019445",2011,640,35,605,129
"53281","E01019446",2011,509,38,471,29
"53282","E01019447",2011,651,42,609,64
"53283","E01019448",2011,686,65,621,43
"53284","E01019449",2011,784,14,770,97
"53285","E01019450",2011,639,182,457,51
"53286","E01019451",2011,830,70,760,126
"53287","E01019452",2011,733,330,403,53
"53288","E01019453",2011,808,119,689,207
"53289","E01019454",2011,632,97,535,24
"53290","E01019455",2011,627,9,618,119
"53291","E01019456",2011,763,70,693,115
"53292","E01019457",2011,548,20,528,52
"53293","E01019458",2011,712,46,666,185
"53294","E01019459",2011,598,198,400,48
"53295","E01019460",2011,664,44,620,73
"53296","E01019461",2011,657,99,558,48
"53297","E01019462",2011,544,8,536,32
"53298","E01019463",2011,639,283,356,49
"53299","E01019464",2011,792,19,773,44
"53300","E01019465",2011,525,119,406,34
"53301","E01019467",2011,650,33,617,61
"53302","E01019468",2011,650,152,498,75
"53303","E01019469",2011,657,254,403,61
"53304","E01019470",2011,707,54,653,90
"53305","E01019471",2011,642,183,459,158
"53306","E01019472",2011,1123,56,1067,186
"53307","E01019473",2011,536,4,532,22
"53308","E01019474",2011,518,3,515,48
"53309","E01019475",2011,532,57,475,75
"53310","E01019476",2011,637,21,616,34
"53311","E01019477",2011,1006,108,898,79
"53312","E01019478",2011,652,22,630,62
"53313","E01019479",2011,690,105,585,62
"53314","E01019480",2011,677,61,616,56
"53315","E01019481",2011,541,166,375,27
"53316","E01019482",2011,670,96,574,43
"53317","E01019483",2011,857,167,690,173
"53318","E01019484",2011,864,110,754,119
"53319","E01019485",2011,555,118,437,80
"53320","E01019486",2011,439,19,420,38
"53321","E01019487",2011,715,278,437,48
"53322","E01019488",2011,643,166,477,152
"53323","E01019489",2011,535,55,480,31
"53324","E01019490",2011,475,61,414,33
"53325","E01019491",2011,981,55,926,204
"53326","E01019492",2011,796,200,596,81
"53327","E01019493",2011,663,27,636,59
"53328","E01019494",2011,913,149,764,116
"53329","E01019495",2011,703,180,523,61
"53330","E01019496",2011,625,128,497,102
"53331","E01019497",2011,651,166,485,121
"53332","E01019498",2011,731,180,551,223
"53333","E01019499",2011,599,79,520,113
"53334","E01019500",2011,597,192,405,43
"53335","E01019501",2011,654,57,597,83
"53336","E01019502",2011,703,148,555,41
"53337","E01019503",2011,1046,120,926,129
"53338","E01019504",2011,611,79,532,74
"53339","E01019505",2011,605,105,500,127
"53340","E01019506",2011,565,128,437,78
"53341","E01019507",2011,778,261,517,152
"53342","E01019508",2011,827,258,569,81
"53343","E01019509",2011,489,276,213,41
"53344","E01019510",2011,561,237,324,29
"53345","E01019511",2011,837,89,748,226
"53346","E01019512",2011,1092,140,952,130
"53347","E01019513",2011,559,6,553,95
"53348","E01019514",2011,661,82,579,96
"53349","E01019515",2011,675,233,442,63
"53350","E01019516",2011,682,71,611,143
"53351","E01019517",2011,657,13,644,67
"53352","E01019518",2011,665,10,655,80
"53353","E01019519",2011,788,128,660,111
"53354","E01019520",2011,724,161,563,73
"53355","E01019521",2011,663,92,571,52
"53356","E01019522",2011,648,134,514,85
"53357","E01019523",2011,500,165,335,60
"53358","E01019524",2011,587,66,521,60
"53359","E01019525",2011,652,126,526,53
"53360","E01019526",2011,620,78,542,95
"53361","E01019527",2011,693,342,351,56
"53362","E01019528",2011,704,94,610,40
"53363","E01019529",2011,649,74,575,115
"53364","E01019530",2011,689,147,542,150
"53365","E01019531",2011,630,112,518,147
"53366","E01019532",2011,535,75,460,49
"53367","E01019533",2011,630,16,614,38
"53368","E01019534",2011,615,90,525,35
"53369","E01019535",2011,638,49,589,44
"53370","E01019536",2011,814,321,493,79
"53371","E01019537",2011,627,71,556,25
"53372","E01019538",2011,803,42,761,285
"53373","E01019539",2011,745,47,698,98
"53374","E01019540",2011,630,5,625,70
"53375","E01019541",2011,667,221,446,30
"53376","E01019542",2011,841,392,449,109
"53377","E01019543",2011,768,413,355,38
"53378","E01019544",2011,724,243,481,49
"53379","E01019545",2011,619,41,578,72
"53380","E01019546",2011,643,65,578,79
"53381","E01019547",2011,653,254,399,98
"53382","E01019548",2011,965,45,920,125
"53383","E01019549",2011,529,194,335,49
"53384","E01019550",2011,670,182,488,42
"53385","E01019551",2011,706,49,657,32
"53386","E01019552",2011,517,105,412,48
"53387","E01019553",2011,737,28,709,100
"53388","E01019554",2011,725,53,672,277
"53389","E01019555",2011,775,272,503,109
"53390","E01019556",2011,705,239,466,194
"53391","E01019557",2011,617,167,450,19
"53392","E01019558",2011,581,13,568,29
"53393","E01019559",2011,494,37,457,23
"53394","E01019560",2011,622,205,417,27
"53395","E01019561",2011,738,506,232,24
"53396","E01019562",2011,628,247,381,32
"53397","E01019563",2011,647,273,374,69
"53398","E01019564",2011,650,41,609,65
"53399","E01019565",2011,652,311,341,42
"53400","E01019566",2011,722,367,355,66
"53401","E01019567",2011,768,283,485,77
"53402","E01019568",2011,557,361,196,25
"53403","E01019569",2011,857,143,714,233
"53404","E01019570",2011,599,112,487,31
"53405","E01019571",2011,638,269,369,66
"53406","E01019572",2011,642,329,313,47
"53407","E01019573",2011,678,101,577,121
"53408","E01019574",2011,642,148,494,58
"53409","E01019575",2011,700,384,316,74
"53410","E01019576",2011,716,314,402,35
"53411","E01019577",2011,762,198,564,78
"53412","E01019578",2011,814,607,207,40
"53413","E01019579",2011,786,135,651,309
"53414","E01019580",2011,659,261,398,56
"53415","E01019581",2011,688,291,397,112
"53416","E01019582",2011,634,78,556,67
"53417","E01019583",2011,611,7,604,79
"53418","E01019585",2011,999,25,974,285
"53419","E01019586",2011,616,13,603,46
"53420","E01019587",2011,642,6,636,62
"53421","E01019588",2011,623,4,619,28
"53422","E01019589",2011,609,2,607,29
"53423","E01019590",2011,848,24,824,75
"53424","E01019591",2011,657,44,613,71
"53425","E01019592",2011,684,4,680,39
"53426","E01019593",2011,498,1,497,21
"53427","E01019594",2011,769,279,490,48
"53428","E01019595",2011,915,51,864,201
"53429","E01019596",2011,708,128,580,72
"53430","E01019597",2011,592,58,534,38
"53431","E01019598",2011,727,208,519,127
"53432","E01019599",2011,653,48,605,58
"53433","E01019600",2011,762,54,708,157
"53434","E01019601",2011,718,229,489,50
"53435","E01019602",2011,841,105,736,129
"53436","E01019603",2011,699,27,672,103
"53437","E01019604",2011,823,66,757,81
"53438","E01019605",2011,781,43,738,98
"53439","E01019606",2011,780,64,716,153
"53440","E01019607",2011,765,18,747,157
"53441","E01019608",2011,774,221,553,69
"53442","E01019609",2011,946,37,909,119
"53443","E01019610",2011,672,7,665,66
"53444","E01019611",2011,702,72,630,130
"53445","E01019612",2011,828,42,786,147
"53446","E01019613",2011,687,39,648,86
"53447","E01019614",2011,726,30,696,60
"53448","E01019615",2011,937,180,757,109
"53449","E01019616",2011,758,33,725,64
"53450","E01019617",2011,705,94,611,114
"53451","E01019618",2011,734,31,703,100
"53452","E01019619",2011,699,96,603,72
"53453","E01019620",2011,683,44,639,100
"53454","E01019621",2011,547,28,519,47
"53455","E01019622",2011,689,20,669,101
"53456","E01019623",2011,670,152,518,132
"53457","E01019624",2011,529,40,489,37
"53458","E01019625",2011,677,404,273,26
"53459","E01019626",2011,668,51,617,90
"53460","E01019627",2011,513,47,466,58
"53461","E01019628",2011,498,66,432,29
"53462","E01019629",2011,674,29,645,86
"53463","E01019630",2011,783,70,713,124
"53464","E01019631",2011,798,101,697,111
"53465","E01019632",2011,732,74,658,55
"53466","E01019633",2011,636,179,457,24
"53467","E01019634",2011,660,83,577,49
"53468","E01019635",2011,574,4,570,54
"53469","E01019636",2011,712,84,628,129
"53470","E01019638",2011,513,16,497,40
"53471","E01019639",2011,428,63,365,36
"53472","E01019640",2011,586,3,583,65
"53473","E01019641",2011,620,1,619,38
"53474","E01019642",2011,641,96,545,41
"53475","E01019643",2011,709,36,673,54
"53476","E01019644",2011,714,187,527,100
"53477","E01019645",2011,702,45,657,104
"53478","E01019646",2011,631,177,454,115
"53479","E01019647",2011,972,176,796,284
"53480","E01019648",2011,648,69,579,80
"53481","E01019649",2011,795,63,732,204
"53482","E01019650",2011,748,337,411,60
"53483","E01019651",2011,621,76,545,50
"53484","E01019652",2011,640,11,629,93
"53485","E01019653",2011,595,5,590,38
"53486","E01019654",2011,708,122,586,73
"53487","E01019655",2011,675,88,587,137
"53488","E01019656",2011,501,23,478,50
"53489","E01019657",2011,774,174,600,149
"53490","E01019658",2011,794,89,705,107
"53491","E01019659",2011,712,6,706,70
"53492","E01019660",2011,853,44,809,179
"53493","E01019661",2011,605,25,580,159
"53494","E01019662",2011,773,199,574,187
"53495","E01019663",2011,689,474,215,46
"53496","E01019664",2011,494,177,317,55
"53497","E01019665",2011,631,48,583,93
"53498","E01019666",2011,612,145,467,41
"53499","E01019667",2011,692,155,537,48
"53500","E01019668",2011,673,336,337,29
"53501","E01019669",2011,690,89,601,49
"53502","E01019670",2011,751,56,695,60
"53503","E01019671",2011,784,61,723,72
"53504","E01019672",2011,729,24,705,200
"53505","E01019673",2011,516,14,502,20
"53506","E01019674",2011,513,8,505,62
"53507","E01019675",2011,752,171,581,171
"53508","E01019676",2011,653,82,571,93
"53509","E01019677",2011,637,13,624,88
"53510","E01019678",2011,670,7,663,111
"53511","E01019679",2011,742,54,688,156
"53512","E01019680",2011,653,26,627,88
"53513","E01019681",2011,680,19,661,63
"53514","E01019682",2011,793,199,594,208
"53515","E01019683",2011,549,37,512,55
"53516","E01019684",2011,694,26,668,84
"53517","E01019685",2011,662,18,644,83
"53518","E01019686",2011,606,39,567,65
"53519","E01019687",2011,664,221,443,44
"53520","E01019688",2011,648,130,518,144
"53521","E01019689",2011,643,80,563,65
"53522","E01019690",2011,550,17,533,131
"53523","E01019691",2011,642,60,582,44
"53524","E01019692",2011,655,226,429,60
"53525","E01019693",2011,847,139,708,207
"53526","E01019694",2011,496,17,479,19
"53527","E01019695",2011,602,8,594,102
"53528","E01019696",2011,585,21,564,42
"53529","E01019697",2011,624,64,560,48
"53530","E01019698",2011,612,7,605,90
"53531","E01019699",2011,725,375,350,47
"53532","E01019700",2011,1006,118,888,112
"53533","E01019701",2011,935,170,765,67
"53534","E01019702",2011,753,5,748,32
"53535","E01019703",2011,651,15,636,58
"53536","E01019704",2011,630,15,615,44
"53537","E01019705",2011,800,47,753,112
"53538","E01019706",2011,512,11,501,32
"53539","E01019707",2011,635,19,616,89
"53540","E01019708",2011,634,3,631,32
"53541","E01019709",2011,527,149,378,52
"53542","E01019710",2011,902,108,794,218
"53543","E01019711",2011,593,82,511,60
"53544","E01019712",2011,607,9,598,56
"53545","E01019713",2011,429,4,425,25
"53546","E01019714",2011,1016,34,982,108
"53547","E01019715",2011,702,49,653,286
"53548","E01019716",2011,547,17,530,99
"53549","E01019717",2011,678,138,540,281
"53550","E01019718",2011,950,112,838,120
"53551","E01019719",2011,678,85,593,117
"53552","E01019720",2011,663,43,620,59
"53553","E01019721",2011,470,6,464,26
"53554","E01019722",2011,734,10,724,140
"53555","E01019723",2011,893,160,733,162
"53556","E01019724",2011,525,155,370,73
"53557","E01019725",2011,581,30,551,57
"53558","E01019726",2011,544,59,485,51
"53559","E01019727",2011,756,13,743,27
"53560","E01019728",2011,518,360,158,21
"53561","E01019729",2011,528,299,229,24
"53562","E01019730",2011,850,247,603,106
"53563","E01019731",2011,490,16,474,27
"53564","E01019732",2011,608,75,533,47
"53565","E01019733",2011,650,87,563,75
"53566","E01019734",2011,911,130,781,76
"53567","E01019735",2011,655,77,578,63
"53568","E01019736",2011,504,23,481,67
"53569","E01019737",2011,559,102,457,67
"53570","E01019738",2011,614,12,602,143
"53571","E01019739",2011,821,103,718,281
"53572","E01019740",2011,526,2,524,104
"53573","E01019741",2011,466,55,411,26
"53574","E01019742",2011,468,44,424,68
"53575","E01019743",2011,587,237,350,46
"53576","E01019744",2011,645,75,570,56
"53577","E01019745",2011,491,143,348,48
"53578","E01019746",2011,693,27,666,144
"53579","E01019747",2011,518,1,517,58
"53580","E01019748",2011,665,4,661,135
"53581","E01019749",2011,492,0,492,18
"53582","E01019750",2011,577,160,417,67
"53583","E01019751",2011,881,16,865,110
"53584","E01019752",2011,557,100,457,105
"53585","E01019753",2011,627,16,611,122
"53586","E01019754",2011,774,33,741,92
"53587","E01019755",2011,838,9,829,83
"53588","E01019756",2011,636,3,633,36
"53589","E01019757",2011,550,24,526,43
"53590","E01019758",2011,587,2,585,40
"53591","E01019759",2011,665,207,458,74
"53592","E01019760",2011,625,97,528,62
"53593","E01019761",2011,576,303,273,53
"53594","E01019762",2011,771,12,759,73
"53595","E01019763",2011,917,118,799,110
"53596","E01019764",2011,655,120,535,41
"53597","E01019765",2011,859,13,846,202
"53598","E01019766",2011,614,62,552,71
"53599","E01019767",2011,666,49,617,57
"53600","E01019768",2011,1044,368,676,125
"53601","E01019769",2011,798,84,714,73
"53602","E01019770",2011,837,138,699,54
"53603","E01019771",2011,956,129,827,89
"53604","E01019772",2011,635,23,612,41
"53605","E01019773",2011,1104,304,800,169
"53606","E01019774",2011,738,34,704,33
"53607","E01019775",2011,808,359,449,65
"53608","E01019776",2011,629,129,500,68
"53609","E01019777",2011,1063,497,566,66
"53610","E01019778",2011,754,64,690,22
"53611","E01019779",2011,750,5,745,51
"53612","E01019780",2011,610,232,378,35
"53613","E01019781",2011,630,45,585,43
"53614","E01019782",2011,605,262,343,50
"53615","E01019783",2011,520,6,514,18
"53616","E01019784",2011,504,5,499,27
"53617","E01019785",2011,516,2,514,7
"53618","E01019786",2011,739,162,577,106
"53619","E01019787",2011,771,45,726,41
"53620","E01019788",2011,677,10,667,18
"53621","E01019790",2011,850,20,830,87
"53622","E01019791",2011,748,225,523,86
"53623","E01019792",2011,879,427,452,49
"53624","E01019793",2011,638,16,622,23
"53625","E01019794",2011,595,9,586,12
"53626","E01019795",2011,958,110,848,47
"53627","E01019796",2011,490,316,174,24
"53628","E01019797",2011,598,161,437,66
"53629","E01019798",2011,603,34,569,43
"53630","E01019799",2011,901,476,425,96
"53631","E01019800",2011,704,150,554,67
"53632","E01019801",2011,459,33,426,52
"53633","E01019802",2011,546,51,495,58
"53634","E01019803",2011,516,178,338,32
"53635","E01019804",2011,528,10,518,32
"53636","E01019805",2011,534,32,502,35
"53637","E01019806",2011,641,125,516,39
"53638","E01019807",2011,621,346,275,24
"53639","E01019808",2011,697,376,321,38
"53640","E01019809",2011,534,103,431,42
"53641","E01019810",2011,697,202,495,83
"53642","E01019811",2011,673,9,664,72
"53643","E01019812",2011,781,19,762,86
"53644","E01019813",2011,746,242,504,58
"53645","E01019814",2011,756,85,671,60
"53646","E01019815",2011,1091,282,809,104
"53647","E01019816",2011,757,144,613,45
"53648","E01019817",2011,523,289,234,25
"53649","E01019818",2011,644,297,347,38
"53650","E01019819",2011,629,99,530,82
"53651","E01019820",2011,618,54,564,27
"53652","E01019821",2011,608,22,586,45
"53653","E01019822",2011,678,119,559,50
"53654","E01019823",2011,525,179,346,32
"53655","E01019824",2011,516,102,414,39
"53656","E01019825",2011,547,39,508,28
"53657","E01019826",2011,637,298,339,32
"53658","E01019827",2011,803,237,566,52
"53659","E01019828",2011,682,3,679,28
"53660","E01019829",2011,621,44,577,41
"53661","E01019830",2011,524,1,523,25
"53662","E01019831",2011,587,13,574,43
"53663","E01019832",2011,803,63,740,67
"53664","E01019833",2011,746,14,732,68
"53665","E01019834",2011,646,34,612,53
"53666","E01019835",2011,605,16,589,39
"53667","E01019837",2011,814,77,737,156
"53668","E01019838",2011,734,157,577,145
"53669","E01019839",2011,681,3,678,126
"53670","E01019840",2011,666,104,562,55
"53671","E01019841",2011,636,13,623,55
"53672","E01019842",2011,666,264,402,40
"53673","E01019843",2011,673,69,604,114
"53674","E01019844",2011,662,120,542,31
"53675","E01019845",2011,570,4,566,77
"53676","E01019846",2011,553,106,447,61
"53677","E01019847",2011,590,70,520,41
"53678","E01019848",2011,792,56,736,82
"53679","E01019850",2011,658,30,628,34
"53680","E01019851",2011,673,122,551,67
"53681","E01019852",2011,738,47,691,99
"53682","E01019853",2011,635,59,576,72
"53683","E01019854",2011,860,140,720,192
"53684","E01019855",2011,648,32,616,101
"53685","E01019856",2011,638,202,436,56
"53686","E01019857",2011,479,9,470,32
"53687","E01019858",2011,646,236,410,80
"53688","E01019859",2011,716,29,687,56
"53689","E01019860",2011,510,5,505,30
"53690","E01019861",2011,766,64,702,112
"53691","E01019862",2011,645,41,604,120
"53692","E01019863",2011,732,291,441,104
"53693","E01019864",2011,602,107,495,96
"53694","E01019865",2011,520,43,477,59
"53695","E01019866",2011,896,10,886,137
"53696","E01019867",2011,618,10,608,67
"53697","E01019868",2011,661,68,593,62
"53698","E01019869",2011,538,3,535,105
"53699","E01019870",2011,649,119,530,101
"53700","E01019871",2011,750,85,665,69
"53701","E01019872",2011,828,26,802,92
"53702","E01019873",2011,573,13,560,121
"53703","E01019874",2011,589,9,580,60
"53704","E01019875",2011,485,10,475,45
"53705","E01019876",2011,812,132,680,75
"53706","E01019877",2011,789,195,594,160
"53707","E01019878",2011,654,78,576,69
"53708","E01019879",2011,754,36,718,62
"53709","E01019880",2011,655,2,653,54
"53710","E01019881",2011,573,10,563,42
"53711","E01019882",2011,683,83,600,61
"53712","E01019883",2011,1206,155,1051,263
"53713","E01019885",2011,730,40,690,93
"53714","E01019886",2011,1112,254,858,98
"53715","E01019887",2011,654,147,507,92
"53716","E01019888",2011,817,29,788,205
"53717","E01019889",2011,657,25,632,65
"53718","E01019890",2011,821,98,723,124
"53719","E01019891",2011,574,65,509,140
"53720","E01019892",2011,617,80,537,73
"53721","E01019893",2011,728,60,668,96
"53722","E01019894",2011,786,32,754,84
"53723","E01019895",2011,656,26,630,79
"53724","E01019896",2011,757,23,734,91
"53725","E01019897",2011,697,149,548,90
"53726","E01019898",2011,1023,17,1006,129
"53727","E01019899",2011,629,124,505,57
"53728","E01019900",2011,812,38,774,59
"53729","E01019901",2011,579,32,547,60
"53730","E01019902",2011,917,43,874,78
"53731","E01019903",2011,891,78,813,125
"53732","E01019904",2011,603,135,468,46
"53733","E01019905",2011,743,8,735,48
"53734","E01019906",2011,658,9,649,63
"53735","E01019907",2011,675,33,642,52
"53736","E01019908",2011,709,87,622,112
"53737","E01019909",2011,813,17,796,60
"53738","E01019910",2011,668,32,636,68
"53739","E01019911",2011,783,29,754,79
"53740","E01019912",2011,855,81,774,185
"53741","E01019913",2011,794,13,781,94
"53742","E01019914",2011,948,352,596,111
"53743","E01019915",2011,753,32,721,78
"53744","E01019916",2011,952,48,904,434
"53745","E01019917",2011,650,12,638,149
"53746","E01019918",2011,948,36,912,404
"53747","E01019919",2011,778,51,727,251
"53748","E01019920",2011,626,103,523,76
"53749","E01019921",2011,635,34,601,50
"53750","E01019922",2011,643,276,367,41
"53751","E01019923",2011,534,94,440,55
"53752","E01019924",2011,605,139,466,89
"53753","E01019925",2011,522,21,501,51
"53754","E01019927",2011,625,155,470,147
"53755","E01019928",2011,597,101,496,55
"53756","E01019929",2011,625,43,582,103
"53757","E01019930",2011,667,16,651,86
"53758","E01019931",2011,532,12,520,47
"53759","E01019932",2011,819,232,587,175
"53760","E01019933",2011,604,66,538,107
"53761","E01019934",2011,825,45,780,62
"53762","E01019935",2011,563,41,522,46
"53763","E01019936",2011,507,56,451,59
"53764","E01019937",2011,928,80,848,107
"53765","E01019938",2011,905,42,863,101
"53766","E01019939",2011,628,28,600,59
"53767","E01019940",2011,659,17,642,41
"53768","E01019942",2011,796,147,649,90
"53769","E01019943",2011,630,28,602,37
"53770","E01019944",2011,685,30,655,156
"53771","E01019945",2011,835,57,778,167
"53772","E01019946",2011,645,29,616,48
"53773","E01019947",2011,982,10,972,316
"53774","E01019948",2011,637,41,596,38
"53775","E01019949",2011,703,6,697,71
"53776","E01019950",2011,597,166,431,40
"53777","E01019951",2011,975,58,917,80
"53778","E01019952",2011,842,73,769,74
"53779","E01019953",2011,727,107,620,24
"53780","E01019954",2011,688,162,526,41
"53781","E01019955",2011,775,138,637,85
"53782","E01019956",2011,879,44,835,198
"53783","E01019957",2011,918,27,891,65
"53784","E01019958",2011,809,44,765,63
"53785","E01019959",2011,485,46,439,80
"53786","E01019960",2011,530,21,509,78
"53787","E01019961",2011,1093,60,1033,123
"53788","E01019962",2011,961,78,883,114
"53789","E01019963",2011,709,68,641,85
"53790","E01019964",2011,428,6,422,56
"53791","E01019965",2011,773,80,693,159
"53792","E01019966",2011,471,38,433,30
"53793","E01019967",2011,541,17,524,96
"53794","E01019968",2011,703,63,640,115
"53795","E01019969",2011,612,41,571,102
"53796","E01019970",2011,529,25,504,95
"53797","E01019971",2011,801,117,684,335
"53798","E01019972",2011,602,89,513,148
"53799","E01019973",2011,616,97,519,42
"53800","E01019974",2011,648,84,564,55
"53801","E01019975",2011,500,138,362,51
"53802","E01019976",2011,555,24,531,49
"53803","E01019977",2011,612,68,544,31
"53804","E01019980",2011,738,191,547,160
"53805","E01019981",2011,599,143,456,51
"53806","E01019982",2011,727,103,624,205
"53807","E01019983",2011,626,82,544,53
"53808","E01019984",2011,549,18,531,56
"53809","E01019985",2011,579,288,291,41
"53810","E01019986",2011,627,13,614,86
"53811","E01019987",2011,648,78,570,198
"53812","E01019988",2011,645,51,594,68
"53813","E01019989",2011,528,5,523,120
"53814","E01019990",2011,607,278,329,43
"53815","E01019991",2011,620,225,395,79
"53816","E01019992",2011,616,108,508,52
"53817","E01019993",2011,497,14,483,41
"53818","E01019994",2011,659,159,500,212
"53819","E01019995",2011,816,435,381,168
"53820","E01019996",2011,563,74,489,269
"53821","E01019997",2011,620,11,609,342
"53822","E01019998",2011,608,48,560,108
"53823","E01019999",2011,503,18,485,103
"53824","E01020000",2011,604,221,383,84
"53825","E01020001",2011,601,12,589,89
"53826","E01020002",2011,638,147,491,50
"53827","E01020003",2011,695,39,656,46
"53828","E01020004",2011,631,12,619,74
"53829","E01020005",2011,704,243,461,45
"53830","E01020006",2011,785,195,590,180
"53831","E01020007",2011,507,17,490,289
"53832","E01020008",2011,607,28,579,328
"53833","E01020009",2011,615,19,596,178
"53834","E01020010",2011,742,237,505,91
"53835","E01020011",2011,514,43,471,51
"53836","E01020012",2011,621,196,425,46
"53837","E01020013",2011,558,88,470,134
"53838","E01020014",2011,651,324,327,52
"53839","E01020015",2011,717,404,313,75
"53840","E01020016",2011,1166,426,740,431
"53841","E01020017",2011,1009,145,864,511
"53842","E01020018",2011,1116,316,800,443
"53843","E01020019",2011,558,18,540,316
"53844","E01020020",2011,599,27,572,360
"53845","E01020021",2011,536,11,525,228
"53846","E01020022",2011,673,177,496,356
"53847","E01020023",2011,1004,101,903,192
"53848","E01020024",2011,667,39,628,131
"53849","E01020025",2011,759,70,689,265
"53850","E01020026",2011,742,10,732,85
"53851","E01020027",2011,695,57,638,84
"53852","E01020029",2011,661,53,608,112
"53853","E01020030",2011,889,129,760,249
"53854","E01020031",2011,645,39,606,112
"53855","E01020032",2011,622,20,602,161
"53856","E01020033",2011,739,53,686,59
"53857","E01020035",2011,669,54,615,75
"53858","E01020036",2011,655,162,493,38
"53859","E01020037",2011,602,249,353,32
"53860","E01020038",2011,606,35,571,71
"53861","E01020039",2011,839,460,379,61
"53862","E01020040",2011,582,139,443,35
"53863","E01020041",2011,916,222,694,148
"53864","E01020042",2011,726,10,716,93
"53865","E01020043",2011,831,134,697,137
"53866","E01020044",2011,671,58,613,79
"53867","E01020045",2011,665,46,619,60
"53868","E01020046",2011,625,29,596,102
"53869","E01020047",2011,956,22,934,183
"53870","E01020048",2011,965,109,856,349
"53871","E01020049",2011,547,14,533,69
"53872","E01020050",2011,953,95,858,166
"53873","E01020051",2011,826,17,809,92
"53874","E01020052",2011,867,225,642,203
"53875","E01020053",2011,606,167,439,67
"53876","E01020054",2011,840,75,765,100
"53877","E01020055",2011,789,156,633,136
"53878","E01020056",2011,803,37,766,122
"53879","E01020057",2011,757,206,551,120
"53880","E01020058",2011,837,33,804,122
"53881","E01020059",2011,825,78,747,102
"53882","E01020060",2011,888,173,715,248
"53883","E01020061",2011,866,77,789,112
"53884","E01020062",2011,643,11,632,58
"53885","E01020063",2011,1049,227,822,115
"53886","E01020064",2011,725,133,592,107
"53887","E01020065",2011,758,170,588,145
"53888","E01020066",2011,1115,30,1085,278
"53889","E01020067",2011,784,329,455,112
"53890","E01020068",2011,655,78,577,102
"53891","E01020069",2011,597,56,541,75
"53892","E01020070",2011,760,39,721,100
"53893","E01020071",2011,839,77,762,105
"53894","E01020072",2011,676,42,634,67
"53895","E01020073",2011,715,73,642,71
"53896","E01020074",2011,876,45,831,113
"53897","E01020075",2011,790,84,706,105
"53898","E01020076",2011,699,45,654,117
"53899","E01020077",2011,622,31,591,70
"53900","E01020078",2011,653,217,436,189
"53901","E01020079",2011,603,221,382,32
"53902","E01020080",2011,536,9,527,71
"53903","E01020081",2011,513,135,378,53
"53904","E01020082",2011,481,35,446,60
"53905","E01020083",2011,910,65,845,136
"53906","E01020084",2011,672,105,567,94
"53907","E01020085",2011,628,33,595,149
"53908","E01020086",2011,638,11,627,64
"53909","E01020087",2011,840,69,771,89
"53910","E01020088",2011,819,66,753,123
"53911","E01020089",2011,960,69,891,179
"53912","E01020090",2011,676,8,668,63
"53913","E01020091",2011,574,2,572,78
"53914","E01020092",2011,634,18,616,62
"53915","E01020093",2011,708,130,578,111
"53916","E01020094",2011,1012,394,618,338
"53917","E01020095",2011,658,134,524,177
"53918","E01020096",2011,864,113,751,252
"53919","E01020097",2011,913,42,871,155
"53920","E01020098",2011,921,85,836,115
"53921","E01020099",2011,600,5,595,120
"53922","E01020100",2011,464,27,437,51
"53923","E01020101",2011,642,34,608,124
"53924","E01020102",2011,654,24,630,139
"53925","E01020103",2011,569,248,321,47
"53926","E01020104",2011,577,139,438,174
"53927","E01020105",2011,616,83,533,44
"53928","E01020106",2011,513,3,510,20
"53929","E01020107",2011,708,25,683,42
"53930","E01020108",2011,964,33,931,180
"53931","E01020109",2011,620,30,590,89
"53932","E01020110",2011,841,128,713,272
"53933","E01020111",2011,667,186,481,192
"53934","E01020112",2011,799,63,736,424
"53935","E01020113",2011,644,28,616,289
"53936","E01020114",2011,502,13,489,155
"53937","E01020115",2011,523,4,519,99
"53938","E01020116",2011,685,71,614,126
"53939","E01020117",2011,670,34,636,61
"53940","E01020118",2011,542,134,408,79
"53941","E01020119",2011,673,27,646,149
"53942","E01020120",2011,737,7,730,92
"53943","E01020121",2011,794,76,718,93
"53944","E01020122",2011,694,31,663,122
"53945","E01020123",2011,601,117,484,51
"53946","E01020124",2011,592,4,588,89
"53947","E01020125",2011,597,4,593,73
"53948","E01020126",2011,715,63,652,132
"53949","E01020127",2011,717,17,700,93
"53950","E01020128",2011,522,14,508,49
"53951","E01020129",2011,523,150,373,62
"53952","E01020130",2011,687,75,612,202
"53953","E01020131",2011,882,80,802,188
"53954","E01020132",2011,827,58,769,112
"53955","E01020133",2011,624,28,596,107
"53956","E01020134",2011,495,169,326,93
"53957","E01020135",2011,697,153,544,117
"53958","E01020136",2011,775,74,701,105
"53959","E01020137",2011,699,63,636,198
"53960","E01020138",2011,982,100,882,106
"53961","E01020139",2011,625,150,475,96
"53962","E01020140",2011,516,41,475,85
"53963","E01020141",2011,710,224,486,151
"53964","E01020142",2011,973,74,899,160
"53965","E01020143",2011,933,68,865,190
"53966","E01020144",2011,616,9,607,98
"53967","E01020145",2011,749,44,705,106
"53968","E01020146",2011,525,6,519,136
"53969","E01020147",2011,869,95,774,108
"53970","E01020148",2011,483,44,439,77
"53971","E01020149",2011,527,72,455,106
"53972","E01020150",2011,749,109,640,94
"53973","E01020151",2011,796,39,757,108
"53974","E01020152",2011,857,153,704,204
"53975","E01020153",2011,615,14,601,88
"53976","E01020154",2011,500,141,359,88
"53977","E01020155",2011,482,237,245,36
"53978","E01020156",2011,836,25,811,136
"53979","E01020157",2011,941,59,882,148
"53980","E01020158",2011,745,82,663,110
"53981","E01020159",2011,597,38,559,126
"53982","E01020160",2011,754,60,694,110
"53983","E01020161",2011,1074,186,888,131
"53984","E01020162",2011,644,16,628,66
"53985","E01020163",2011,679,35,644,60
"53986","E01020164",2011,643,118,525,77
"53987","E01020165",2011,621,24,597,102
"53988","E01020166",2011,577,5,572,40
"53989","E01020167",2011,503,6,497,41
"53990","E01020168",2011,924,108,816,112
"53991","E01020169",2011,1067,103,964,266
"53992","E01020170",2011,942,43,899,63
"53993","E01020171",2011,853,59,794,111
"53994","E01020172",2011,855,69,786,101
"53995","E01020173",2011,800,129,671,92
"53996","E01020174",2011,724,74,650,98
"53997","E01020175",2011,926,73,853,106
"53998","E01020176",2011,505,34,471,81
"53999","E01020177",2011,602,151,451,44
"54000","E01020178",2011,900,48,852,97
"54001","E01020179",2011,877,89,788,104
"54002","E01020180",2011,834,238,596,109
"54003","E01020181",2011,778,187,591,57
"54004","E01020182",2011,624,119,505,98
"54005","E01020183",2011,766,41,725,268
"54006","E01020184",2011,846,208,638,174
"54007","E01020185",2011,594,25,569,41
"54008","E01020186",2011,691,4,687,52
"54009","E01020187",2011,736,135,601,88
"54010","E01020188",2011,837,46,791,112
"54011","E01020189",2011,989,344,645,130
"54012","E01020190",2011,900,109,791,109
"54013","E01020191",2011,431,8,423,75
"54014","E01020192",2011,648,32,616,49
"54015","E01020193",2011,571,28,543,75
"54016","E01020194",2011,589,5,584,66
"54017","E01020195",2011,716,69,647,92
"54018","E01020196",2011,794,161,633,166
"54019","E01020197",2011,543,32,511,73
"54020","E01020198",2011,618,162,456,141
"54021","E01020199",2011,711,79,632,154
"54022","E01020200",2011,521,8,513,66
"54023","E01020201",2011,695,28,667,34
"54024","E01020202",2011,734,58,676,43
"54025","E01020203",2011,794,17,777,80
"54026","E01020204",2011,624,95,529,134
"54027","E01020205",2011,612,12,600,44
"54028","E01020206",2011,710,84,626,123
"54029","E01020207",2011,427,2,425,89
"54030","E01020208",2011,523,144,379,43
"54031","E01020209",2011,627,27,600,115
"54032","E01020210",2011,499,9,490,32
"54033","E01020211",2011,675,279,396,73
"54034","E01020212",2011,497,155,342,46
"54035","E01020213",2011,637,72,565,80
"54036","E01020214",2011,674,37,637,60
"54037","E01020215",2011,575,7,568,24
"54038","E01020216",2011,675,198,477,91
"54039","E01020217",2011,879,40,839,292
"54040","E01020218",2011,746,149,597,229
"54041","E01020219",2011,845,94,751,117
"54042","E01020220",2011,542,127,415,64
"54043","E01020221",2011,710,60,650,122
"54044","E01020222",2011,539,4,535,79
"54045","E01020223",2011,743,53,690,103
"54046","E01020224",2011,521,16,505,169
"54047","E01020225",2011,603,120,483,154
"54048","E01020226",2011,469,15,454,54
"54049","E01020227",2011,643,48,595,111
"54050","E01020228",2011,945,122,823,316
"54051","E01020229",2011,750,20,730,133
"54052","E01020230",2011,740,17,723,122
"54053","E01020231",2011,639,14,625,84
"54054","E01020232",2011,630,58,572,93
"54055","E01020233",2011,832,9,823,91
"54056","E01020234",2011,598,156,442,66
"54057","E01020235",2011,841,88,753,227
"54058","E01020236",2011,539,6,533,29
"54059","E01020237",2011,637,34,603,71
"54060","E01020238",2011,538,58,480,70
"54061","E01020239",2011,540,9,531,53
"54062","E01020240",2011,671,103,568,90
"54063","E01020241",2011,738,25,713,173
"54064","E01020242",2011,587,12,575,57
"54065","E01020243",2011,498,36,462,78
"54066","E01020244",2011,640,104,536,97
"54067","E01020245",2011,696,31,665,116
"54068","E01020246",2011,460,19,441,51
"54069","E01020247",2011,689,113,576,85
"54070","E01020248",2011,701,5,696,69
"54071","E01020249",2011,612,2,610,59
"54072","E01020250",2011,695,24,671,59
"54073","E01020251",2011,576,5,571,81
"54074","E01020252",2011,639,142,497,88
"54075","E01020253",2011,593,27,566,99
"54076","E01020254",2011,557,124,433,70
"54077","E01020255",2011,568,40,528,93
"54078","E01020256",2011,602,8,594,103
"54079","E01020257",2011,501,6,495,46
"54080","E01020258",2011,727,80,647,109
"54081","E01020259",2011,491,21,470,100
"54082","E01020260",2011,628,13,615,112
"54083","E01020261",2011,526,10,516,64
"54084","E01020262",2011,506,19,487,65
"54085","E01020263",2011,691,32,659,60
"54086","E01020264",2011,677,84,593,165
"54087","E01020265",2011,749,13,736,67
"54088","E01020266",2011,671,19,652,95
"54089","E01020267",2011,646,1,645,120
"54090","E01020268",2011,641,23,618,61
"54091","E01020269",2011,1158,105,1053,490
"54092","E01020270",2011,716,8,708,71
"54093","E01020271",2011,674,134,540,130
"54094","E01020272",2011,759,217,542,85
"54095","E01020273",2011,595,70,525,52
"54096","E01020274",2011,536,13,523,81
"54097","E01020275",2011,672,63,609,135
"54098","E01020276",2011,682,53,629,67
"54099","E01020277",2011,859,333,526,124
"54100","E01020278",2011,637,36,601,82
"54101","E01020279",2011,993,129,864,152
"54102","E01020280",2011,1166,86,1080,541
"54103","E01020281",2011,794,7,787,87
"54104","E01020282",2011,802,184,618,147
"54105","E01020283",2011,653,41,612,51
"54106","E01020284",2011,827,122,705,159
"54107","E01020285",2011,824,215,609,120
"54108","E01020286",2011,670,25,645,120
"54109","E01020287",2011,650,18,632,102
"54110","E01020288",2011,709,29,680,201
"54111","E01020289",2011,659,22,637,69
"54112","E01020290",2011,711,27,684,87
"54113","E01020291",2011,640,34,606,99
"54114","E01020292",2011,646,65,581,139
"54115","E01020293",2011,938,45,893,196
"54116","E01020294",2011,761,124,637,120
"54117","E01020295",2011,669,28,641,81
"54118","E01020296",2011,616,20,596,81
"54119","E01020297",2011,765,206,559,132
"54120","E01020298",2011,940,39,901,91
"54121","E01020299",2011,908,14,894,161
"54122","E01020300",2011,738,5,733,94
"54123","E01020301",2011,790,47,743,89
"54124","E01020302",2011,680,30,650,106
"54125","E01020303",2011,754,32,722,85
"54126","E01020304",2011,739,101,638,136
"54127","E01020305",2011,524,38,486,179
"54128","E01020306",2011,521,19,502,57
"54129","E01020307",2011,654,148,506,105
"54130","E01020308",2011,703,19,684,81
"54131","E01020309",2011,663,28,635,64
"54132","E01020310",2011,1089,19,1070,271
"54133","E01020311",2011,940,73,867,135
"54134","E01020312",2011,714,21,693,74
"54135","E01020313",2011,632,120,512,85
"54136","E01020314",2011,662,27,635,102
"54137","E01020315",2011,645,108,537,88
"54138","E01020316",2011,774,26,748,88
"54139","E01020317",2011,648,21,627,71
"54140","E01020318",2011,685,64,621,141
"54141","E01020319",2011,679,44,635,103
"54142","E01020320",2011,706,21,685,94
"54143","E01020321",2011,905,87,818,162
"54144","E01020322",2011,798,45,753,89
"54145","E01020323",2011,642,80,562,123
"54146","E01020324",2011,661,36,625,47
"54147","E01020325",2011,643,16,627,136
"54148","E01020326",2011,863,66,797,145
"54149","E01020327",2011,807,72,735,117
"54150","E01020328",2011,934,124,810,211
"54151","E01020329",2011,671,83,588,75
"54152","E01020330",2011,830,134,696,215
"54153","E01020331",2011,628,39,589,96
"54154","E01020332",2011,932,76,856,302
"54155","E01020333",2011,811,50,761,94
"54156","E01020334",2011,840,136,704,152
"54157","E01020335",2011,668,75,593,35
"54158","E01020336",2011,606,6,600,34
"54159","E01020337",2011,581,134,447,60
"54160","E01020338",2011,1029,164,865,159
"54161","E01020339",2011,704,66,638,101
"54162","E01020340",2011,706,53,653,95
"54163","E01020341",2011,668,12,656,57
"54164","E01020342",2011,653,152,501,58
"54165","E01020343",2011,641,77,564,50
"54166","E01020344",2011,562,42,520,62
"54167","E01020345",2011,528,77,451,54
"54168","E01020346",2011,704,227,477,57
"54169","E01020347",2011,740,393,347,49
"54170","E01020348",2011,633,315,318,40
"54171","E01020349",2011,1046,148,898,171
"54172","E01020350",2011,919,6,913,87
"54173","E01020351",2011,511,23,488,48
"54174","E01020352",2011,518,41,477,38
"54175","E01020353",2011,674,189,485,51
"54176","E01020354",2011,719,98,621,111
"54177","E01020355",2011,913,10,903,56
"54178","E01020356",2011,782,35,747,104
"54179","E01020357",2011,867,116,751,82
"54180","E01020358",2011,671,11,660,35
"54181","E01020359",2011,496,101,395,43
"54182","E01020360",2011,654,70,584,104
"54183","E01020361",2011,647,37,610,133
"54184","E01020362",2011,678,16,662,55
"54185","E01020363",2011,499,153,346,53
"54186","E01020364",2011,773,160,613,130
"54187","E01020365",2011,709,53,656,67
"54188","E01020366",2011,906,9,897,51
"54189","E01020367",2011,913,36,877,175
"54190","E01020368",2011,1145,300,845,213
"54191","E01020369",2011,630,3,627,70
"54192","E01020370",2011,649,18,631,69
"54193","E01020371",2011,742,4,738,20
"54194","E01020372",2011,606,16,590,43
"54195","E01020373",2011,495,56,439,46
"54196","E01020374",2011,646,10,636,24
"54197","E01020375",2011,642,61,581,40
"54198","E01020376",2011,483,11,472,25
"54199","E01020377",2011,631,5,626,30
"54200","E01020378",2011,634,21,613,61
"54201","E01020379",2011,642,136,506,24
"54202","E01020380",2011,447,9,438,34
"54203","E01020381",2011,503,2,501,18
"54204","E01020382",2011,628,11,617,82
"54205","E01020383",2011,741,19,722,41
"54206","E01020384",2011,638,37,601,74
"54207","E01020385",2011,481,55,426,41
"54208","E01020386",2011,477,15,462,26
"54209","E01020387",2011,470,3,467,13
"54210","E01020388",2011,643,120,523,66
"54211","E01020389",2011,851,108,743,214
"54212","E01020390",2011,732,77,655,42
"54213","E01020391",2011,668,12,656,55
"54214","E01020392",2011,786,45,741,120
"54215","E01020393",2011,563,163,400,75
"54216","E01020394",2011,820,195,625,49
"54217","E01020395",2011,904,22,882,76
"54218","E01020396",2011,450,33,417,147
"54219","E01020397",2011,613,94,519,90
"54220","E01020398",2011,913,47,866,93
"54221","E01020399",2011,1014,25,989,94
"54222","E01020400",2011,671,5,666,40
"54223","E01020401",2011,722,4,718,35
"54224","E01020402",2011,633,6,627,23
"54225","E01020403",2011,628,3,625,26
"54226","E01020404",2011,689,43,646,34
"54227","E01020405",2011,675,9,666,57
"54228","E01020406",2011,1048,2,1046,44
"54229","E01020407",2011,518,5,513,32
"54230","E01020408",2011,480,34,446,34
"54231","E01020409",2011,482,16,466,58
"54232","E01020410",2011,528,127,401,127
"54233","E01020411",2011,422,95,327,22
"54234","E01020412",2011,567,190,377,45
"54235","E01020413",2011,571,12,559,29
"54236","E01020414",2011,808,89,719,82
"54237","E01020415",2011,597,25,572,24
"54238","E01020416",2011,674,6,668,108
"54239","E01020417",2011,447,7,440,37
"54240","E01020418",2011,673,4,669,25
"54241","E01020419",2011,776,4,772,50
"54242","E01020420",2011,526,20,506,34
"54243","E01020421",2011,529,36,493,73
"54244","E01020422",2011,867,158,709,77
"54245","E01020423",2011,637,36,601,29
"54246","E01020424",2011,643,52,591,23
"54247","E01020425",2011,816,38,778,52
"54248","E01020426",2011,806,35,771,107
"54249","E01020427",2011,725,315,410,45
"54250","E01020428",2011,1095,221,874,243
"54251","E01020429",2011,796,131,665,156
"54252","E01020430",2011,618,62,556,51
"54253","E01020431",2011,438,54,384,68
"54254","E01020432",2011,539,75,464,97
"54255","E01020433",2011,745,53,692,108
"54256","E01020434",2011,788,160,628,60
"54257","E01020435",2011,782,68,714,115
"54258","E01020436",2011,809,104,705,83
"54259","E01020437",2011,774,140,634,49
"54260","E01020438",2011,1086,267,819,267
"54261","E01020439",2011,987,251,736,133
"54262","E01020440",2011,826,76,750,75
"54263","E01020441",2011,786,122,664,74
"54264","E01020442",2011,888,59,829,172
"54265","E01020443",2011,1106,218,888,268
"54266","E01020444",2011,752,185,567,87
"54267","E01020445",2011,513,45,468,56
"54268","E01020446",2011,652,53,599,55
"54269","E01020447",2011,846,154,692,55
"54270","E01020448",2011,816,106,710,70
"54271","E01020449",2011,905,111,794,61
"54272","E01020450",2011,956,44,912,140
"54273","E01020452",2011,826,205,621,131
"54274","E01020453",2011,716,50,666,74
"54275","E01020454",2011,968,236,732,171
"54276","E01020455",2011,780,80,700,89
"54277","E01020456",2011,761,104,657,128
"54278","E01020457",2011,726,71,655,80
"54279","E01020458",2011,940,33,907,138
"54280","E01020459",2011,1167,313,854,168
"54281","E01020460",2011,842,89,753,85
"54282","E01020462",2011,767,59,708,65
"54283","E01020463",2011,756,28,728,84
"54284","E01020464",2011,691,52,639,75
"54285","E01020465",2011,883,170,713,165
"54286","E01020466",2011,794,128,666,152
"54287","E01020467",2011,781,53,728,125
"54288","E01020468",2011,666,44,622,63
"54289","E01020469",2011,840,172,668,123
"54290","E01020470",2011,740,13,727,45
"54291","E01020471",2011,537,84,453,82
"54292","E01020472",2011,604,95,509,89
"54293","E01020473",2011,640,10,630,96
"54294","E01020474",2011,746,21,725,85
"54295","E01020475",2011,845,53,792,76
"54296","E01020476",2011,544,22,522,74
"54297","E01020477",2011,589,127,462,36
"54298","E01020478",2011,477,11,466,52
"54299","E01020479",2011,648,65,583,137
"54300","E01020480",2011,730,64,666,76
"54301","E01020481",2011,748,44,704,135
"54302","E01020482",2011,778,75,703,174
"54303","E01020483",2011,498,117,381,44
"54304","E01020484",2011,625,140,485,50
"54305","E01020485",2011,745,202,543,162
"54306","E01020486",2011,643,80,563,90
"54307","E01020487",2011,516,19,497,49
"54308","E01020488",2011,653,106,547,67
"54309","E01020489",2011,581,62,519,198
"54310","E01020490",2011,717,71,646,142
"54311","E01020491",2011,669,98,571,74
"54312","E01020492",2011,538,100,438,57
"54313","E01020493",2011,808,200,608,287
"54314","E01020494",2011,490,35,455,65
"54315","E01020495",2011,665,55,610,106
"54316","E01020496",2011,792,226,566,70
"54317","E01020497",2011,811,64,747,90
"54318","E01020498",2011,933,98,835,73
"54319","E01020499",2011,619,286,333,57
"54320","E01020500",2011,850,125,725,170
"54321","E01020501",2011,599,40,559,42
"54322","E01020502",2011,819,325,494,87
"54323","E01020503",2011,902,117,785,210
"54324","E01020504",2011,1092,37,1055,113
"54325","E01020505",2011,807,76,731,61
"54326","E01020506",2011,771,86,685,82
"54327","E01020507",2011,912,84,828,96
"54328","E01020508",2011,840,52,788,113
"54329","E01020509",2011,1146,68,1078,143
"54330","E01020510",2011,901,194,707,123
"54331","E01020511",2011,815,135,680,70
"54332","E01020512",2011,938,77,861,207
"54333","E01020513",2011,676,142,534,74
"54334","E01020514",2011,531,34,497,81
"54335","E01020515",2011,505,36,469,62
"54336","E01020516",2011,674,75,599,45
"54337","E01020517",2011,811,30,781,107
"54338","E01020518",2011,746,278,468,86
"54339","E01020519",2011,809,100,709,132
"54340","E01020520",2011,657,82,575,82
"54341","E01020523",2011,514,15,499,80
"54342","E01020524",2011,629,46,583,34
"54343","E01020525",2011,521,14,507,23
"54344","E01020526",2011,509,74,435,42
"54345","E01020527",2011,584,101,483,94
"54346","E01020528",2011,853,219,634,125
"54347","E01020529",2011,974,83,891,152
"54348","E01020530",2011,785,48,737,157
"54349","E01020531",2011,762,50,712,103
"54350","E01020532",2011,835,29,806,126
"54351","E01020533",2011,935,252,683,78
"54352","E01020534",2011,905,108,797,170
"54353","E01020535",2011,753,49,704,82
"54354","E01020536",2011,881,104,777,122
"54355","E01020537",2011,807,52,755,102
"54356","E01020538",2011,813,141,672,65
"54357","E01020539",2011,856,90,766,131
"54358","E01020540",2011,1048,109,939,150
"54359","E01020541",2011,863,102,761,182
"54360","E01020542",2011,665,102,563,95
"54361","E01020543",2011,614,206,408,52
"54362","E01020544",2011,821,74,747,180
"54363","E01020546",2011,582,108,474,201
"54364","E01020547",2011,510,165,345,44
"54365","E01020549",2011,896,72,824,150
"54366","E01020550",2011,712,79,633,57
"54367","E01020551",2011,836,122,714,174
"54368","E01020552",2011,739,432,307,58
"54369","E01020553",2011,579,94,485,221
"54370","E01020554",2011,991,73,918,588
"54371","E01020555",2011,669,47,622,289
"54372","E01020556",2011,744,44,700,280
"54373","E01020557",2011,754,4,750,59
"54374","E01020558",2011,787,6,781,80
"54375","E01020559",2011,739,6,733,34
"54376","E01020560",2011,820,12,808,81
"54377","E01020561",2011,812,99,713,173
"54378","E01020562",2011,876,28,848,157
"54379","E01020563",2011,516,56,460,72
"54380","E01020564",2011,659,145,514,106
"54381","E01020565",2011,646,40,606,90
"54382","E01020566",2011,900,22,878,96
"54383","E01020569",2011,640,321,319,124
"54384","E01020570",2011,705,15,690,87
"54385","E01020571",2011,896,210,686,126
"54386","E01020572",2011,850,29,821,218
"54387","E01020573",2011,869,181,688,195
"54388","E01020574",2011,766,136,630,77
"54389","E01020575",2011,730,358,372,63
"54390","E01020576",2011,779,51,728,54
"54391","E01020577",2011,640,78,562,81
"54392","E01020578",2011,940,282,658,80
"54393","E01020579",2011,829,17,812,109
"54394","E01020580",2011,605,21,584,41
"54395","E01020581",2011,992,40,952,272
"54396","E01020582",2011,768,221,547,172
"54397","E01020583",2011,800,38,762,129
"54398","E01020584",2011,719,100,619,117
"54399","E01020585",2011,603,175,428,35
"54400","E01020586",2011,533,54,479,46
"54401","E01020587",2011,675,110,565,117
"54402","E01020588",2011,545,12,533,68
"54403","E01020589",2011,646,124,522,73
"54404","E01020590",2011,570,6,564,94
"54405","E01020591",2011,645,220,425,78
"54406","E01020592",2011,655,402,253,61
"54407","E01020593",2011,638,142,496,130
"54408","E01020594",2011,788,9,779,181
"54409","E01020595",2011,773,21,752,80
"54410","E01020596",2011,758,269,489,68
"54411","E01020597",2011,662,21,641,44
"54412","E01020598",2011,839,56,783,132
"54413","E01020599",2011,871,421,450,47
"54414","E01020600",2011,652,2,650,28
"54415","E01020601",2011,650,111,539,42
"54416","E01020602",2011,890,399,491,54
"54417","E01020603",2011,671,1,670,18
"54418","E01020604",2011,632,124,508,57
"54419","E01020605",2011,771,3,768,68
"54420","E01020606",2011,750,108,642,192
"54421","E01020607",2011,703,186,517,56
"54422","E01020608",2011,749,181,568,56
"54423","E01020609",2011,609,116,493,28
"54424","E01020610",2011,640,50,590,49
"54425","E01020611",2011,582,9,573,31
"54426","E01020612",2011,682,10,672,28
"54427","E01020613",2011,545,14,531,21
"54428","E01020614",2011,670,129,541,53
"54429","E01020615",2011,755,307,448,60
"54430","E01020616",2011,780,226,554,93
"54431","E01020617",2011,846,73,773,89
"54432","E01020618",2011,708,266,442,46
"54433","E01020619",2011,677,95,582,57
"54434","E01020620",2011,658,138,520,62
"54435","E01020621",2011,859,300,559,57
"54436","E01020622",2011,677,31,646,49
"54437","E01020623",2011,626,4,622,66
"54438","E01020624",2011,710,41,669,179
"54439","E01020625",2011,684,61,623,117
"54440","E01020626",2011,758,263,495,94
"54441","E01020627",2011,703,35,668,90
"54442","E01020628",2011,728,16,712,92
"54443","E01020629",2011,623,144,479,42
"54444","E01020630",2011,597,168,429,44
"54445","E01020631",2011,782,272,510,91
"54446","E01020632",2011,812,43,769,136
"54447","E01020633",2011,707,166,541,65
"54448","E01020634",2011,666,46,620,41
"54449","E01020635",2011,615,17,598,45
"54450","E01020636",2011,811,224,587,76
"54451","E01020637",2011,730,54,676,66
"54452","E01020638",2011,706,119,587,89
"54453","E01020639",2011,664,245,419,89
"54454","E01020640",2011,991,45,946,179
"54455","E01020641",2011,968,145,823,199
"54456","E01020642",2011,626,40,586,76
"54457","E01020643",2011,1051,173,878,220
"54458","E01020644",2011,1054,288,766,154
"54459","E01020645",2011,653,226,427,68
"54460","E01020646",2011,688,137,551,46
"54461","E01020647",2011,857,405,452,65
"54462","E01020648",2011,778,283,495,102
"54463","E01020649",2011,688,159,529,107
"54464","E01020650",2011,927,113,814,118
"54465","E01020651",2011,801,100,701,83
"54466","E01020652",2011,849,184,665,99
"54467","E01020653",2011,692,208,484,73
"54468","E01020654",2011,759,76,683,80
"54469","E01020655",2011,835,96,739,57
"54470","E01020656",2011,678,153,525,57
"54471","E01020657",2011,611,28,583,50
"54472","E01020658",2011,828,216,612,115
"54473","E01020659",2011,668,12,656,93
"54474","E01020660",2011,694,110,584,66
"54475","E01020661",2011,818,126,692,192
"54476","E01020662",2011,782,199,583,80
"54477","E01020663",2011,842,58,784,109
"54478","E01020664",2011,679,3,676,68
"54479","E01020665",2011,652,156,496,36
"54480","E01020666",2011,643,30,613,29
"54481","E01020667",2011,805,96,709,128
"54482","E01020668",2011,683,115,568,109
"54483","E01020669",2011,636,151,485,55
"54484","E01020670",2011,753,140,613,111
"54485","E01020671",2011,612,53,559,228
"54486","E01020672",2011,771,116,655,152
"54487","E01020673",2011,791,298,493,105
"54488","E01020674",2011,738,214,524,66
"54489","E01020675",2011,799,279,520,83
"54490","E01020676",2011,699,68,631,81
"54491","E01020677",2011,671,204,467,63
"54492","E01020678",2011,578,92,486,43
"54493","E01020679",2011,714,252,462,64
"54494","E01020680",2011,677,10,667,68
"54495","E01020681",2011,693,226,467,55
"54496","E01020682",2011,834,7,827,35
"54497","E01020683",2011,664,3,661,75
"54498","E01020684",2011,994,39,955,241
"54499","E01020685",2011,714,137,577,55
"54500","E01020686",2011,797,443,354,72
"54501","E01020687",2011,719,210,509,36
"54502","E01020688",2011,681,184,497,61
"54503","E01020689",2011,643,309,334,57
"54504","E01020690",2011,635,9,626,71
"54505","E01020691",2011,617,131,486,83
"54506","E01020692",2011,659,1,658,62
"54507","E01020693",2011,629,156,473,141
"54508","E01020694",2011,687,270,417,51
"54509","E01020695",2011,807,178,629,57
"54510","E01020696",2011,609,122,487,91
"54511","E01020697",2011,631,17,614,118
"54512","E01020698",2011,654,14,640,63
"54513","E01020699",2011,516,204,312,48
"54514","E01020700",2011,712,227,485,37
"54515","E01020701",2011,604,101,503,84
"54516","E01020702",2011,825,19,806,218
"54517","E01020703",2011,695,130,565,397
"54518","E01020704",2011,553,7,546,194
"54519","E01020705",2011,720,290,430,49
"54520","E01020706",2011,856,58,798,105
"54521","E01020708",2011,535,7,528,103
"54522","E01020709",2011,584,40,544,55
"54523","E01020710",2011,746,98,648,141
"54524","E01020711",2011,789,290,499,69
"54525","E01020712",2011,679,10,669,156
"54526","E01020713",2011,794,4,790,144
"54527","E01020714",2011,695,36,659,60
"54528","E01020715",2011,1068,194,874,165
"54529","E01020716",2011,747,375,372,91
"54530","E01020717",2011,765,9,756,41
"54531","E01020718",2011,619,30,589,76
"54532","E01020719",2011,533,1,532,70
"54533","E01020720",2011,699,214,485,69
"54534","E01020721",2011,486,4,482,42
"54535","E01020722",2011,882,375,507,154
"54536","E01020723",2011,772,224,548,272
"54537","E01020724",2011,674,404,270,86
"54538","E01020725",2011,657,89,568,43
"54539","E01020726",2011,538,40,498,57
"54540","E01020727",2011,538,258,280,24
"54541","E01020729",2011,943,238,705,84
"54542","E01020730",2011,808,263,545,52
"54543","E01020731",2011,634,98,536,42
"54544","E01020732",2011,739,71,668,61
"54545","E01020733",2011,507,120,387,63
"54546","E01020734",2011,513,165,348,58
"54547","E01020735",2011,626,99,527,39
"54548","E01020736",2011,521,165,356,26
"54549","E01020737",2011,598,27,571,81
"54550","E01020738",2011,488,43,445,46
"54551","E01020739",2011,686,234,452,135
"54552","E01020740",2011,561,38,523,59
"54553","E01020741",2011,534,16,518,172
"54554","E01020742",2011,723,70,653,145
"54555","E01020743",2011,560,242,318,66
"54556","E01020744",2011,449,51,398,32
"54557","E01020745",2011,588,227,361,72
"54558","E01020746",2011,489,77,412,18
"54559","E01020747",2011,492,277,215,34
"54560","E01020748",2011,508,160,348,67
"54561","E01020749",2011,758,269,489,66
"54562","E01020750",2011,534,22,512,35
"54563","E01020751",2011,819,59,760,161
"54564","E01020752",2011,580,122,458,201
"54565","E01020753",2011,864,300,564,81
"54566","E01020754",2011,633,161,472,49
"54567","E01020756",2011,556,3,553,34
"54568","E01020757",2011,469,168,301,55
"54569","E01020758",2011,624,254,370,84
"54570","E01020759",2011,462,196,266,52
"54571","E01020760",2011,692,122,570,48
"54572","E01020761",2011,548,117,431,84
"54573","E01020762",2011,648,277,371,55
"54574","E01020763",2011,825,198,627,88
"54575","E01020764",2011,686,170,516,168
"54576","E01020765",2011,715,232,483,60
"54577","E01020766",2011,692,162,530,59
"54578","E01020767",2011,873,283,590,184
"54579","E01020768",2011,662,57,605,87
"54580","E01020769",2011,476,82,394,43
"54581","E01020770",2011,502,107,395,53
"54582","E01020771",2011,457,156,301,44
"54583","E01020772",2011,854,92,762,70
"54584","E01020773",2011,658,262,396,42
"54585","E01020775",2011,793,424,369,70
"54586","E01020776",2011,805,128,677,39
"54587","E01020777",2011,673,273,400,74
"54588","E01020778",2011,511,27,484,28
"54589","E01020779",2011,658,11,647,18
"54590","E01020780",2011,510,142,368,41
"54591","E01020781",2011,492,116,376,29
"54592","E01020782",2011,514,85,429,35
"54593","E01020783",2011,593,76,517,87
"54594","E01020784",2011,737,255,482,137
"54595","E01020786",2011,669,18,651,34
"54596","E01020787",2011,812,234,578,88
"54597","E01020788",2011,664,143,521,83
"54598","E01020789",2011,634,142,492,54
"54599","E01020790",2011,590,222,368,55
"54600","E01020791",2011,588,154,434,50
"54601","E01020792",2011,608,123,485,69
"54602","E01020793",2011,762,254,508,63
"54603","E01020794",2011,738,69,669,51
"54604","E01020795",2011,759,123,636,132
"54605","E01020796",2011,559,82,477,37
"54606","E01020797",2011,1198,371,827,190
"54607","E01020798",2011,735,381,354,60
"54608","E01020799",2011,683,162,521,70
"54609","E01020801",2011,716,69,647,103
"54610","E01020802",2011,939,201,738,203
"54611","E01020803",2011,830,19,811,138
"54612","E01020805",2011,945,412,533,80
"54613","E01020806",2011,622,182,440,56
"54614","E01020807",2011,668,156,512,221
"54615","E01020808",2011,648,114,534,91
"54616","E01020809",2011,635,260,375,61
"54617","E01020810",2011,551,56,495,71
"54618","E01020811",2011,559,148,411,61
"54619","E01020812",2011,669,127,542,46
"54620","E01020813",2011,508,7,501,21
"54621","E01020814",2011,610,120,490,59
"54622","E01020815",2011,511,59,452,38
"54623","E01020816",2011,589,267,322,99
"54624","E01020817",2011,542,4,538,29
"54625","E01020818",2011,667,157,510,58
"54626","E01020819",2011,507,252,255,29
"54627","E01020820",2011,732,340,392,95
"54628","E01020821",2011,752,85,667,68
"54629","E01020822",2011,799,45,754,78
"54630","E01020823",2011,853,362,491,87
"54631","E01020824",2011,771,235,536,92
"54632","E01020825",2011,717,221,496,48
"54633","E01020826",2011,669,192,477,53
"54634","E01020827",2011,778,130,648,92
"54635","E01020828",2011,667,12,655,58
"54636","E01020829",2011,1039,20,1019,130
"54637","E01020830",2011,732,192,540,64
"54638","E01020831",2011,662,224,438,61
"54639","E01020832",2011,640,124,516,53
"54640","E01020833",2011,502,90,412,39
"54641","E01020834",2011,611,224,387,56
"54642","E01020835",2011,696,41,655,121
"54643","E01020836",2011,937,299,638,98
"54644","E01020837",2011,751,22,729,33
"54645","E01020838",2011,812,84,728,178
"54646","E01020839",2011,788,259,529,109
"54647","E01020840",2011,721,226,495,94
"54648","E01020841",2011,836,411,425,121
"54649","E01020842",2011,907,351,556,113
"54650","E01020843",2011,728,76,652,49
"54651","E01020844",2011,679,353,326,79
"54652","E01020845",2011,634,228,406,68
"54653","E01020846",2011,530,92,438,43
"54654","E01020847",2011,614,255,359,126
"54655","E01020848",2011,508,60,448,60
"54656","E01020849",2011,519,224,295,79
"54657","E01020850",2011,699,42,657,54
"54658","E01020851",2011,638,7,631,59
"54659","E01020852",2011,817,235,582,124
"54660","E01020853",2011,649,99,550,61
"54661","E01020854",2011,991,120,871,186
"54662","E01020855",2011,555,43,512,51
"54663","E01020856",2011,733,129,604,89
"54664","E01020857",2011,641,62,579,94
"54665","E01020858",2011,475,94,381,34
"54666","E01020859",2011,537,13,524,53
"54667","E01020860",2011,476,145,331,64
"54668","E01020861",2011,549,43,506,79
"54669","E01020862",2011,1107,113,994,178
"54670","E01020863",2011,589,7,582,149
"54671","E01020864",2011,922,78,844,113
"54672","E01020865",2011,642,42,600,134
"54673","E01020866",2011,472,45,427,162
"54674","E01020867",2011,956,135,821,206
"54675","E01020868",2011,875,103,772,201
"54676","E01020869",2011,631,25,606,171
"54677","E01020870",2011,605,1,604,15
"54678","E01020871",2011,638,3,635,122
"54679","E01020872",2011,816,80,736,137
"54680","E01020873",2011,678,357,321,71
"54681","E01020874",2011,643,111,532,138
"54682","E01020875",2011,570,97,473,63
"54683","E01020876",2011,773,174,599,59
"54684","E01020877",2011,740,43,697,151
"54685","E01020878",2011,734,304,430,58
"54686","E01020879",2011,983,61,922,95
"54687","E01020880",2011,679,67,612,238
"54688","E01020881",2011,581,42,539,68
"54689","E01020882",2011,645,52,593,76
"54690","E01020883",2011,692,3,689,36
"54691","E01020884",2011,642,115,527,76
"54692","E01020885",2011,543,271,272,24
"54693","E01020886",2011,562,47,515,100
"54694","E01020887",2011,830,95,735,102
"54695","E01020888",2011,844,57,787,104
"54696","E01020889",2011,705,28,677,85
"54697","E01020890",2011,799,97,702,133
"54698","E01020891",2011,759,118,641,76
"54699","E01020892",2011,497,96,401,59
"54700","E01020893",2011,741,82,659,118
"54701","E01020894",2011,518,169,349,70
"54702","E01020895",2011,697,200,497,108
"54703","E01020896",2011,624,80,544,59
"54704","E01020897",2011,1081,250,831,171
"54705","E01020898",2011,729,421,308,55
"54706","E01020899",2011,640,107,533,83
"54707","E01020900",2011,582,113,469,33
"54708","E01020901",2011,648,220,428,82
"54709","E01020902",2011,657,340,317,59
"54710","E01020903",2011,512,39,473,67
"54711","E01020904",2011,762,49,713,132
"54712","E01020905",2011,717,127,590,83
"54713","E01020906",2011,720,40,680,80
"54714","E01020907",2011,708,188,520,100
"54715","E01020908",2011,601,191,410,49
"54716","E01020909",2011,753,481,272,64
"54717","E01020910",2011,829,159,670,354
"54718","E01020911",2011,958,58,900,619
"54719","E01020912",2011,1034,144,890,655
"54720","E01020913",2011,972,228,744,189
"54721","E01020914",2011,814,37,777,273
"54722","E01020915",2011,839,87,752,244
"54723","E01020916",2011,769,28,741,324
"54724","E01020917",2011,587,281,306,68
"54725","E01020918",2011,625,79,546,112
"54726","E01020919",2011,584,105,479,110
"54727","E01020920",2011,741,331,410,133
"54728","E01020921",2011,604,155,449,54
"54729","E01020922",2011,599,194,405,131
"54730","E01020923",2011,569,303,266,87
"54731","E01020924",2011,551,97,454,53
"54732","E01020925",2011,605,248,357,77
"54733","E01020926",2011,613,103,510,32
"54734","E01020927",2011,567,114,453,83
"54735","E01020928",2011,791,83,708,111
"54736","E01020929",2011,739,293,446,90
"54737","E01020930",2011,495,214,281,46
"54738","E01020931",2011,829,44,785,166
"54739","E01020932",2011,843,57,786,116
"54740","E01020933",2011,434,12,422,57
"54741","E01020934",2011,685,7,678,208
"54742","E01020935",2011,1075,53,1022,579
"54743","E01020936",2011,1025,14,1011,338
"54744","E01020937",2011,747,34,713,375
"54745","E01020938",2011,627,103,524,76
"54746","E01020939",2011,649,17,632,112
"54747","E01020940",2011,602,29,573,55
"54748","E01020941",2011,646,253,393,50
"54749","E01020942",2011,626,21,605,49
"54750","E01020943",2011,751,73,678,176
"54751","E01020944",2011,610,31,579,47
"54752","E01020945",2011,802,22,780,52
"54753","E01020946",2011,734,16,718,62
"54754","E01020947",2011,722,170,552,62
"54755","E01020948",2011,758,90,668,155
"54756","E01020949",2011,685,48,637,66
"54757","E01020950",2011,738,87,651,45
"54758","E01020951",2011,647,97,550,121
"54759","E01020952",2011,741,147,594,130
"54760","E01020953",2011,572,7,565,50
"54761","E01020954",2011,619,37,582,60
"54762","E01020955",2011,700,213,487,84
"54763","E01020956",2011,822,23,799,52
"54764","E01020957",2011,663,118,545,72
"54765","E01020959",2011,609,71,538,80
"54766","E01020960",2011,1172,18,1154,418
"54767","E01020961",2011,652,5,647,44
"54768","E01020962",2011,976,48,928,234
"54769","E01020963",2011,639,18,621,147
"54770","E01020964",2011,887,63,824,240
"54771","E01020965",2011,1027,42,985,540
"54772","E01020966",2011,856,86,770,270
"54773","E01020967",2011,994,196,798,179
"54774","E01020968",2011,911,34,877,438
"54775","E01020969",2011,656,78,578,36
"54776","E01020970",2011,1003,11,992,87
"54777","E01020971",2011,841,184,657,104
"54778","E01020972",2011,661,461,200,57
"54779","E01020973",2011,716,140,576,84
"54780","E01020974",2011,605,29,576,45
"54781","E01020975",2011,838,124,714,264
"54782","E01020976",2011,876,15,861,283
"54783","E01020977",2011,742,39,703,363
"54784","E01020978",2011,1113,56,1057,701
"54785","E01020979",2011,1171,142,1029,722
"54786","E01020980",2011,811,98,713,422
"54787","E01020981",2011,698,24,674,241
"54788","E01020982",2011,1034,128,906,707
"54789","E01020983",2011,1034,356,678,484
"54790","E01020984",2011,1173,48,1125,738
"54791","E01020985",2011,1088,40,1048,604
"54792","E01020986",2011,590,4,586,65
"54793","E01020987",2011,753,22,731,187
"54794","E01020988",2011,744,7,737,35
"54795","E01020989",2011,926,81,845,543
"54796","E01020990",2011,697,33,664,334
"54797","E01020991",2011,660,9,651,281
"54798","E01020992",2011,902,105,797,463
"54799","E01020993",2011,593,322,271,61
"54800","E01020994",2011,581,248,333,84
"54801","E01020995",2011,585,281,304,64
"54802","E01020996",2011,637,199,438,59
"54803","E01020997",2011,642,107,535,88
"54804","E01020998",2011,939,35,904,450
"54805","E01020999",2011,736,13,723,114
"54806","E01021000",2011,645,31,614,139
"54807","E01021001",2011,497,11,486,87
"54808","E01021002",2011,639,58,581,132
"54809","E01021003",2011,941,131,810,334
"54810","E01021004",2011,773,41,732,127
"54811","E01021005",2011,661,338,323,64
"54812","E01021006",2011,847,44,803,288
"54813","E01021007",2011,667,6,661,25
"54814","E01021008",2011,792,186,606,104
"54815","E01021009",2011,808,5,803,48
"54816","E01021010",2011,636,7,629,68
"54817","E01021011",2011,650,42,608,168
"54818","E01021012",2011,774,165,609,177
"54819","E01021013",2011,726,39,687,162
"54820","E01021014",2011,808,88,720,314
"54821","E01021015",2011,682,426,256,100
"54822","E01021016",2011,754,79,675,233
"54823","E01021017",2011,667,28,639,111
"54824","E01021018",2011,742,46,696,77
"54825","E01021019",2011,827,478,349,72
"54826","E01021020",2011,734,248,486,60
"54827","E01021021",2011,844,52,792,203
"54828","E01021022",2011,840,133,707,111
"54829","E01021023",2011,758,55,703,61
"54830","E01021024",2011,487,121,366,37
"54831","E01021025",2011,681,33,648,69
"54832","E01021026",2011,994,73,921,108
"54833","E01021027",2011,655,3,652,57
"54834","E01021028",2011,615,30,585,76
"54835","E01021029",2011,610,7,603,60
"54836","E01021030",2011,570,7,563,71
"54837","E01021031",2011,711,108,603,152
"54838","E01021032",2011,847,50,797,123
"54839","E01021033",2011,807,146,661,122
"54840","E01021034",2011,559,115,444,77
"54841","E01021035",2011,922,101,821,284
"54842","E01021036",2011,631,100,531,68
"54843","E01021037",2011,625,300,325,44
"54844","E01021038",2011,819,97,722,183
"54845","E01021039",2011,654,49,605,128
"54846","E01021040",2011,675,74,601,119
"54847","E01021041",2011,646,121,525,35
"54848","E01021042",2011,499,37,462,37
"54849","E01021043",2011,620,151,469,54
"54850","E01021044",2011,716,213,503,94
"54851","E01021045",2011,849,82,767,105
"54852","E01021046",2011,595,7,588,67
"54853","E01021047",2011,610,52,558,93
"54854","E01021048",2011,730,33,697,242
"54855","E01021049",2011,686,76,610,270
"54856","E01021050",2011,542,151,391,53
"54857","E01021051",2011,524,54,470,68
"54858","E01021052",2011,516,6,510,33
"54859","E01021053",2011,484,98,386,55
"54860","E01021054",2011,598,68,530,149
"54861","E01021055",2011,766,125,641,74
"54862","E01021056",2011,723,17,706,73
"54863","E01021057",2011,682,193,489,187
"54864","E01021058",2011,795,22,773,149
"54865","E01021059",2011,711,58,653,96
"54866","E01021060",2011,712,143,569,58
"54867","E01021061",2011,593,10,583,82
"54868","E01021062",2011,610,197,413,61
"54869","E01021063",2011,698,30,668,57
"54870","E01021064",2011,821,14,807,177
"54871","E01021065",2011,657,108,549,180
"54872","E01021066",2011,652,39,613,80
"54873","E01021067",2011,453,47,406,43
"54874","E01021068",2011,439,20,419,65
"54875","E01021069",2011,669,6,663,80
"54876","E01021070",2011,795,51,744,222
"54877","E01021071",2011,982,47,935,426
"54878","E01021072",2011,725,12,713,23
"54879","E01021073",2011,634,19,615,39
"54880","E01021074",2011,772,161,611,36
"54881","E01021075",2011,748,35,713,49
"54882","E01021076",2011,790,212,578,67
"54883","E01021077",2011,656,61,595,39
"54884","E01021078",2011,552,12,540,36
"54885","E01021079",2011,759,127,632,141
"54886","E01021080",2011,605,57,548,65
"54887","E01021081",2011,747,23,724,106
"54888","E01021082",2011,788,8,780,68
"54889","E01021083",2011,572,4,568,24
"54890","E01021084",2011,929,214,715,182
"54891","E01021085",2011,698,25,673,107
"54892","E01021086",2011,714,78,636,52
"54893","E01021087",2011,695,14,681,62
"54894","E01021088",2011,673,45,628,49
"54895","E01021089",2011,646,112,534,44
"54896","E01021090",2011,802,14,788,399
"54897","E01021091",2011,1086,12,1074,496
"54898","E01021092",2011,1146,161,985,425
"54899","E01021093",2011,687,9,678,29
"54900","E01021094",2011,842,62,780,93
"54901","E01021095",2011,631,4,627,21
"54902","E01021096",2011,492,33,459,104
"54903","E01021097",2011,529,40,489,33
"54904","E01021098",2011,722,95,627,71
"54905","E01021099",2011,679,18,661,85
"54906","E01021100",2011,658,55,603,74
"54907","E01021101",2011,833,131,702,73
"54908","E01021102",2011,761,72,689,134
"54909","E01021103",2011,673,75,598,105
"54910","E01021104",2011,588,49,539,49
"54911","E01021105",2011,548,99,449,54
"54912","E01021106",2011,893,66,827,78
"54913","E01021107",2011,744,19,725,38
"54914","E01021108",2011,638,52,586,82
"54915","E01021109",2011,697,41,656,47
"54916","E01021110",2011,1104,28,1076,66
"54917","E01021111",2011,520,110,410,66
"54918","E01021112",2011,642,14,628,73
"54919","E01021113",2011,603,87,516,97
"54920","E01021114",2011,692,151,541,54
"54921","E01021115",2011,728,22,706,64
"54922","E01021116",2011,670,147,523,62
"54923","E01021117",2011,783,66,717,151
"54924","E01021118",2011,753,48,705,138
"54925","E01021119",2011,512,285,227,20
"54926","E01021120",2011,749,20,729,98
"54927","E01021121",2011,818,20,798,204
"54928","E01021122",2011,860,24,836,299
"54929","E01021123",2011,714,6,708,43
"54930","E01021124",2011,828,5,823,66
"54931","E01021125",2011,555,7,548,37
"54932","E01021126",2011,649,36,613,134
"54933","E01021127",2011,686,130,556,73
"54934","E01021128",2011,846,27,819,110
"54935","E01021129",2011,806,16,790,55
"54936","E01021130",2011,684,18,666,88
"54937","E01021131",2011,633,158,475,105
"54938","E01021132",2011,495,31,464,30
"54939","E01021133",2011,707,125,582,88
"54940","E01021134",2011,599,65,534,66
"54941","E01021135",2011,735,230,505,182
"54942","E01021136",2011,575,334,241,38
"54943","E01021137",2011,613,196,417,52
"54944","E01021138",2011,476,45,431,29
"54945","E01021139",2011,561,151,410,42
"54946","E01021140",2011,693,15,678,70
"54947","E01021141",2011,584,30,554,56
"54948","E01021142",2011,609,4,605,47
"54949","E01021143",2011,560,50,510,82
"54950","E01021144",2011,689,11,678,45
"54951","E01021145",2011,817,90,727,76
"54952","E01021146",2011,701,102,599,52
"54953","E01021147",2011,642,23,619,84
"54954","E01021148",2011,600,52,548,66
"54955","E01021149",2011,529,58,471,58
"54956","E01021150",2011,441,8,433,25
"54957","E01021151",2011,679,30,649,55
"54958","E01021152",2011,501,180,321,41
"54959","E01021153",2011,861,76,785,162
"54960","E01021154",2011,606,145,461,43
"54961","E01021155",2011,479,21,458,73
"54962","E01021156",2011,758,61,697,98
"54963","E01021157",2011,742,21,721,58
"54964","E01021158",2011,842,58,784,49
"54965","E01021159",2011,942,30,912,61
"54966","E01021160",2011,739,67,672,128
"54967","E01021161",2011,667,6,661,80
"54968","E01021162",2011,640,6,634,53
"54969","E01021163",2011,837,5,832,77
"54970","E01021164",2011,770,69,701,100
"54971","E01021165",2011,455,28,427,57
"54972","E01021166",2011,1050,30,1020,117
"54973","E01021167",2011,945,140,805,157
"54974","E01021168",2011,675,15,660,111
"54975","E01021169",2011,495,12,483,86
"54976","E01021170",2011,1103,46,1057,103
"54977","E01021171",2011,812,67,745,86
"54978","E01021172",2011,732,70,662,86
"54979","E01021173",2011,548,10,538,89
"54980","E01021174",2011,659,12,647,71
"54981","E01021175",2011,628,5,623,59
"54982","E01021176",2011,652,3,649,73
"54983","E01021177",2011,581,82,499,138
"54984","E01021178",2011,546,182,364,43
"54985","E01021179",2011,637,290,347,49
"54986","E01021180",2011,537,14,523,38
"54987","E01021181",2011,529,8,521,48
"54988","E01021182",2011,677,82,595,55
"54989","E01021183",2011,541,267,274,52
"54990","E01021184",2011,648,21,627,61
"54991","E01021185",2011,642,181,461,71
"54992","E01021186",2011,508,49,459,58
"54993","E01021187",2011,582,19,563,68
"54994","E01021188",2011,477,14,463,57
"54995","E01021189",2011,523,15,508,44
"54996","E01021190",2011,640,11,629,63
"54997","E01021191",2011,841,19,822,222
"54998","E01021192",2011,659,9,650,73
"54999","E01021193",2011,756,185,571,100
"55000","E01021194",2011,633,7,626,80
"55001","E01021195",2011,780,18,762,76
"55002","E01021196",2011,805,17,788,77
"55003","E01021197",2011,723,27,696,55
"55004","E01021198",2011,644,78,566,81
"55005","E01021199",2011,581,11,570,60
"55006","E01021200",2011,510,93,417,71
"55007","E01021201",2011,604,7,597,50
"55008","E01021202",2011,521,43,478,95
"55009","E01021203",2011,618,25,593,38
"55010","E01021204",2011,499,55,444,41
"55011","E01021205",2011,494,20,474,47
"55012","E01021206",2011,667,68,599,75
"55013","E01021207",2011,660,6,654,72
"55014","E01021208",2011,743,33,710,103
"55015","E01021209",2011,668,34,634,48
"55016","E01021210",2011,581,5,576,35
"55017","E01021211",2011,806,3,803,151
"55018","E01021212",2011,918,22,896,82
"55019","E01021213",2011,805,54,751,183
"55020","E01021214",2011,774,21,753,101
"55021","E01021215",2011,642,74,568,58
"55022","E01021216",2011,510,61,449,35
"55023","E01021217",2011,544,59,485,38
"55024","E01021218",2011,478,7,471,29
"55025","E01021219",2011,545,1,544,22
"55026","E01021220",2011,793,106,687,133
"55027","E01021221",2011,540,59,481,97
"55028","E01021222",2011,685,87,598,114
"55029","E01021223",2011,494,44,450,67
"55030","E01021224",2011,641,240,401,35
"55031","E01021225",2011,673,13,660,94
"55032","E01021226",2011,522,27,495,81
"55033","E01021227",2011,607,31,576,55
"55034","E01021228",2011,577,9,568,36
"55035","E01021229",2011,695,14,681,91
"55036","E01021230",2011,688,12,676,75
"55037","E01021231",2011,773,179,594,80
"55038","E01021232",2011,816,7,809,112
"55039","E01021233",2011,640,3,637,38
"55040","E01021234",2011,675,7,668,41
"55041","E01021235",2011,647,3,644,31
"55042","E01021236",2011,728,59,669,42
"55043","E01021237",2011,518,3,515,15
"55044","E01021238",2011,520,6,514,25
"55045","E01021239",2011,522,10,512,17
"55046","E01021240",2011,787,135,652,136
"55047","E01021241",2011,650,148,502,51
"55048","E01021242",2011,482,2,480,24
"55049","E01021243",2011,668,7,661,47
"55050","E01021244",2011,633,4,629,66
"55051","E01021245",2011,638,268,370,53
"55052","E01021246",2011,652,12,640,52
"55053","E01021247",2011,657,65,592,63
"55054","E01021248",2011,620,10,610,92
"55055","E01021249",2011,622,8,614,45
"55056","E01021250",2011,632,6,626,39
"55057","E01021251",2011,603,2,601,33
"55058","E01021252",2011,637,13,624,85
"55059","E01021253",2011,675,4,671,36
"55060","E01021254",2011,550,8,542,37
"55061","E01021255",2011,632,47,585,27
"55062","E01021256",2011,608,9,599,18
"55063","E01021257",2011,615,7,608,38
"55064","E01021258",2011,785,188,597,47
"55065","E01021259",2011,636,44,592,55
"55066","E01021260",2011,803,3,800,66
"55067","E01021261",2011,687,66,621,91
"55068","E01021262",2011,747,196,551,102
"55069","E01021263",2011,789,100,689,139
"55070","E01021264",2011,519,21,498,10
"55071","E01021265",2011,630,168,462,47
"55072","E01021266",2011,735,192,543,61
"55073","E01021267",2011,766,256,510,63
"55074","E01021268",2011,651,339,312,36
"55075","E01021269",2011,653,160,493,44
"55076","E01021270",2011,625,181,444,71
"55077","E01021271",2011,685,349,336,94
"55078","E01021272",2011,650,173,477,78
"55079","E01021273",2011,763,304,459,65
"55080","E01021274",2011,806,195,611,117
"55081","E01021275",2011,676,94,582,34
"55082","E01021276",2011,690,232,458,86
"55083","E01021277",2011,664,137,527,66
"55084","E01021278",2011,790,384,406,68
"55085","E01021279",2011,662,289,373,56
"55086","E01021280",2011,627,42,585,88
"55087","E01021281",2011,598,22,576,71
"55088","E01021282",2011,619,23,596,29
"55089","E01021283",2011,647,235,412,55
"55090","E01021284",2011,579,13,566,55
"55091","E01021285",2011,532,16,516,56
"55092","E01021286",2011,706,241,465,128
"55093","E01021287",2011,613,103,510,45
"55094","E01021288",2011,606,442,164,49
"55095","E01021289",2011,707,312,395,58
"55096","E01021290",2011,669,508,161,46
"55097","E01021291",2011,784,257,527,132
"55098","E01021292",2011,632,173,459,55
"55099","E01021293",2011,736,201,535,87
"55100","E01021294",2011,645,94,551,47
"55101","E01021295",2011,705,180,525,78
"55102","E01021296",2011,772,208,564,100
"55103","E01021297",2011,693,185,508,102
"55104","E01021298",2011,656,137,519,67
"55105","E01021299",2011,600,17,583,21
"55106","E01021300",2011,852,289,563,109
"55107","E01021301",2011,618,260,358,71
"55108","E01021302",2011,623,395,228,62
"55109","E01021303",2011,592,172,420,73
"55110","E01021304",2011,612,309,303,58
"55111","E01021305",2011,613,247,366,67
"55112","E01021306",2011,609,225,384,63
"55113","E01021307",2011,586,138,448,103
"55114","E01021308",2011,489,10,479,64
"55115","E01021309",2011,610,36,574,137
"55116","E01021310",2011,700,34,666,214
"55117","E01021311",2011,613,234,379,68
"55118","E01021312",2011,559,8,551,55
"55119","E01021313",2011,588,25,563,43
"55120","E01021314",2011,572,278,294,46
"55121","E01021315",2011,679,335,344,51
"55122","E01021316",2011,702,355,347,61
"55123","E01021317",2011,668,254,414,75
"55124","E01021318",2011,925,335,590,173
"55125","E01021319",2011,717,248,469,94
"55126","E01021320",2011,652,215,437,85
"55127","E01021321",2011,697,230,467,65
"55128","E01021322",2011,627,220,407,90
"55129","E01021323",2011,673,380,293,56
"55130","E01021324",2011,667,409,258,28
"55131","E01021325",2011,642,345,297,84
"55132","E01021326",2011,720,193,527,101
"55133","E01021327",2011,741,377,364,71
"55134","E01021328",2011,635,166,469,74
"55135","E01021329",2011,691,105,586,81
"55136","E01021330",2011,656,5,651,53
"55137","E01021331",2011,639,28,611,86
"55138","E01021332",2011,608,4,604,21
"55139","E01021333",2011,637,3,634,24
"55140","E01021334",2011,690,43,647,79
"55141","E01021335",2011,515,19,496,24
"55142","E01021336",2011,740,64,676,94
"55143","E01021337",2011,615,2,613,34
"55144","E01021338",2011,615,112,503,50
"55145","E01021339",2011,649,224,425,66
"55146","E01021340",2011,659,10,649,67
"55147","E01021341",2011,653,5,648,45
"55148","E01021342",2011,714,221,493,66
"55149","E01021343",2011,746,98,648,129
"55150","E01021344",2011,859,38,821,121
"55151","E01021345",2011,764,7,757,74
"55152","E01021346",2011,856,12,844,129
"55153","E01021347",2011,918,74,844,86
"55154","E01021348",2011,640,79,561,152
"55155","E01021349",2011,491,14,477,53
"55156","E01021350",2011,712,35,677,93
"55157","E01021351",2011,559,4,555,46
"55158","E01021352",2011,589,17,572,60
"55159","E01021353",2011,807,120,687,132
"55160","E01021354",2011,548,241,307,43
"55161","E01021355",2011,825,128,697,127
"55162","E01021356",2011,545,72,473,35
"55163","E01021357",2011,636,141,495,74
"55164","E01021358",2011,919,342,577,144
"55165","E01021359",2011,866,378,488,62
"55166","E01021360",2011,781,303,478,42
"55167","E01021361",2011,647,72,575,67
"55168","E01021362",2011,577,59,518,41
"55169","E01021364",2011,677,20,657,80
"55170","E01021365",2011,1133,222,911,338
"55171","E01021366",2011,597,8,589,44
"55172","E01021367",2011,572,230,342,37
"55173","E01021368",2011,682,124,558,116
"55174","E01021369",2011,1078,210,868,165
"55175","E01021370",2011,717,327,390,94
"55176","E01021371",2011,698,49,649,84
"55177","E01021372",2011,769,75,694,117
"55178","E01021373",2011,1041,131,910,192
"55179","E01021374",2011,600,247,353,41
"55180","E01021375",2011,473,67,406,47
"55181","E01021376",2011,556,37,519,41
"55182","E01021377",2011,729,82,647,100
"55183","E01021378",2011,792,229,563,103
"55184","E01021379",2011,707,34,673,58
"55185","E01021380",2011,963,184,779,84
"55186","E01021381",2011,513,31,482,21
"55187","E01021382",2011,524,32,492,72
"55188","E01021383",2011,712,58,654,60
"55189","E01021384",2011,845,26,819,95
"55190","E01021385",2011,515,62,453,70
"55191","E01021386",2011,564,16,548,28
"55192","E01021387",2011,1015,161,854,252
"55193","E01021388",2011,720,163,557,103
"55194","E01021389",2011,719,65,654,59
"55195","E01021390",2011,664,26,638,72
"55196","E01021391",2011,692,336,356,51
"55197","E01021392",2011,754,127,627,116
"55198","E01021393",2011,650,123,527,68
"55199","E01021394",2011,664,168,496,76
"55200","E01021395",2011,614,97,517,26
"55201","E01021396",2011,535,20,515,74
"55202","E01021397",2011,742,27,715,181
"55203","E01021398",2011,627,65,562,66
"55204","E01021399",2011,675,150,525,43
"55205","E01021400",2011,747,111,636,86
"55206","E01021401",2011,661,194,467,79
"55207","E01021402",2011,824,76,748,126
"55208","E01021403",2011,626,14,612,65
"55209","E01021404",2011,892,102,790,83
"55210","E01021405",2011,898,70,828,90
"55211","E01021406",2011,952,82,870,150
"55212","E01021407",2011,921,79,842,85
"55213","E01021408",2011,699,42,657,63
"55214","E01021409",2011,720,41,679,83
"55215","E01021410",2011,719,207,512,106
"55216","E01021411",2011,536,86,450,62
"55217","E01021412",2011,595,72,523,133
"55218","E01021413",2011,525,48,477,55
"55219","E01021414",2011,884,102,782,76
"55220","E01021415",2011,743,219,524,102
"55221","E01021416",2011,769,42,727,194
"55222","E01021417",2011,657,170,487,83
"55223","E01021418",2011,549,182,367,63
"55224","E01021419",2011,712,158,554,50
"55225","E01021420",2011,730,130,600,111
"55226","E01021422",2011,787,252,535,86
"55227","E01021423",2011,596,188,408,78
"55228","E01021424",2011,811,80,731,104
"55229","E01021425",2011,596,201,395,50
"55230","E01021426",2011,588,163,425,40
"55231","E01021427",2011,538,198,340,56
"55232","E01021428",2011,623,16,607,33
"55233","E01021429",2011,528,145,383,47
"55234","E01021430",2011,836,145,691,73
"55235","E01021431",2011,633,23,610,92
"55236","E01021432",2011,698,255,443,50
"55237","E01021433",2011,919,45,874,222
"55238","E01021434",2011,512,76,436,59
"55239","E01021435",2011,777,205,572,55
"55240","E01021436",2011,1138,127,1011,344
"55241","E01021437",2011,728,301,427,74
"55242","E01021438",2011,784,5,779,73
"55243","E01021439",2011,1149,220,929,270
"55244","E01021441",2011,573,74,499,21
"55245","E01021442",2011,514,3,511,10
"55246","E01021443",2011,541,41,500,48
"55247","E01021444",2011,633,82,551,37
"55248","E01021445",2011,842,23,819,70
"55249","E01021446",2011,671,12,659,74
"55250","E01021447",2011,966,15,951,71
"55251","E01021448",2011,640,207,433,40
"55252","E01021449",2011,638,118,520,49
"55253","E01021450",2011,793,14,779,41
"55254","E01021451",2011,623,262,361,54
"55255","E01021452",2011,620,14,606,33
"55256","E01021453",2011,519,27,492,75
"55257","E01021454",2011,536,18,518,73
"55258","E01021455",2011,519,0,519,16
"55259","E01021456",2011,511,8,503,69
"55260","E01021457",2011,611,137,474,50
"55261","E01021458",2011,777,54,723,135
"55262","E01021459",2011,525,6,519,22
"55263","E01021460",2011,675,91,584,72
"55264","E01021461",2011,620,256,364,35
"55265","E01021462",2011,568,13,555,36
"55266","E01021463",2011,629,81,548,34
"55267","E01021464",2011,599,99,500,48
"55268","E01021465",2011,816,9,807,150
"55269","E01021466",2011,656,1,655,32
"55270","E01021467",2011,668,3,665,32
"55271","E01021468",2011,768,21,747,93
"55272","E01021469",2011,462,35,427,21
"55273","E01021470",2011,406,69,337,12
"55274","E01021471",2011,613,28,585,16
"55275","E01021472",2011,725,176,549,130
"55276","E01021473",2011,517,32,485,65
"55277","E01021474",2011,613,12,601,37
"55278","E01021475",2011,666,41,625,145
"55279","E01021476",2011,770,72,698,57
"55280","E01021477",2011,629,1,628,36
"55281","E01021478",2011,666,5,661,43
"55282","E01021479",2011,592,14,578,44
"55283","E01021480",2011,706,3,703,80
"55284","E01021481",2011,562,5,557,33
"55285","E01021482",2011,607,27,580,60
"55286","E01021483",2011,688,2,686,46
"55287","E01021484",2011,589,22,567,70
"55288","E01021485",2011,494,142,352,44
"55289","E01021486",2011,462,96,366,94
"55290","E01021487",2011,593,15,578,52
"55291","E01021488",2011,611,149,462,63
"55292","E01021489",2011,623,4,619,66
"55293","E01021490",2011,663,81,582,78
"55294","E01021491",2011,662,20,642,68
"55295","E01021492",2011,761,23,738,103
"55296","E01021493",2011,702,25,677,81
"55297","E01021494",2011,598,35,563,54
"55298","E01021495",2011,1141,3,1138,93
"55299","E01021496",2011,590,23,567,95
"55300","E01021497",2011,659,11,648,85
"55301","E01021498",2011,596,4,592,62
"55302","E01021499",2011,660,30,630,37
"55303","E01021500",2011,754,60,694,153
"55304","E01021501",2011,630,34,596,81
"55305","E01021502",2011,985,11,974,302
"55306","E01021503",2011,519,50,469,65
"55307","E01021504",2011,503,26,477,47
"55308","E01021505",2011,496,28,468,33
"55309","E01021506",2011,519,19,500,102
"55310","E01021507",2011,619,249,370,91
"55311","E01021508",2011,442,43,399,73
"55312","E01021509",2011,649,40,609,43
"55313","E01021510",2011,670,7,663,56
"55314","E01021511",2011,533,14,519,43
"55315","E01021512",2011,648,6,642,54
"55316","E01021513",2011,643,20,623,42
"55317","E01021514",2011,610,50,560,48
"55318","E01021515",2011,493,14,479,22
"55319","E01021516",2011,542,2,540,44
"55320","E01021517",2011,711,10,701,60
"55321","E01021518",2011,940,75,865,232
"55322","E01021519",2011,636,11,625,37
"55323","E01021520",2011,671,13,658,99
"55324","E01021521",2011,607,3,604,44
"55325","E01021522",2011,711,68,643,117
"55326","E01021523",2011,602,20,582,28
"55327","E01021524",2011,644,19,625,42
"55328","E01021525",2011,668,14,654,149
"55329","E01021526",2011,650,6,644,55
"55330","E01021527",2011,674,4,670,37
"55331","E01021528",2011,586,5,581,35
"55332","E01021529",2011,646,188,458,65
"55333","E01021530",2011,614,13,601,39
"55334","E01021531",2011,556,13,543,60
"55335","E01021532",2011,645,2,643,26
"55336","E01021533",2011,926,68,858,72
"55337","E01021535",2011,685,84,601,50
"55338","E01021536",2011,700,217,483,71
"55339","E01021537",2011,787,33,754,73
"55340","E01021538",2011,998,128,870,98
"55341","E01021539",2011,534,102,432,49
"55342","E01021540",2011,636,39,597,63
"55343","E01021541",2011,637,182,455,40
"55344","E01021542",2011,839,151,688,110
"55345","E01021543",2011,650,12,638,47
"55346","E01021544",2011,617,9,608,133
"55347","E01021545",2011,641,21,620,51
"55348","E01021546",2011,608,133,475,92
"55349","E01021547",2011,702,57,645,136
"55350","E01021548",2011,542,55,487,62
"55351","E01021550",2011,570,43,527,75
"55352","E01021551",2011,557,72,485,57
"55353","E01021552",2011,673,126,547,36
"55354","E01021553",2011,570,101,469,32
"55355","E01021554",2011,653,205,448,54
"55356","E01021555",2011,532,33,499,39
"55357","E01021556",2011,677,57,620,76
"55358","E01021557",2011,487,4,483,18
"55359","E01021558",2011,502,6,496,21
"55360","E01021559",2011,578,33,545,30
"55361","E01021560",2011,781,42,739,93
"55362","E01021561",2011,752,16,736,50
"55363","E01021562",2011,800,256,544,72
"55364","E01021563",2011,809,285,524,109
"55365","E01021564",2011,638,42,596,45
"55366","E01021565",2011,681,373,308,31
"55367","E01021566",2011,697,82,615,41
"55368","E01021568",2011,627,32,595,41
"55369","E01021569",2011,640,13,627,34
"55370","E01021570",2011,763,28,735,52
"55371","E01021571",2011,595,52,543,42
"55372","E01021572",2011,633,209,424,37
"55373","E01021573",2011,700,103,597,103
"55374","E01021574",2011,1010,94,916,476
"55375","E01021575",2011,717,187,530,147
"55376","E01021576",2011,611,398,213,46
"55377","E01021577",2011,613,8,605,74
"55378","E01021578",2011,859,63,796,286
"55379","E01021579",2011,608,17,591,107
"55380","E01021580",2011,505,10,495,28
"55381","E01021582",2011,976,81,895,329
"55382","E01021583",2011,603,57,546,56
"55383","E01021584",2011,471,4,467,9
"55384","E01021585",2011,492,7,485,26
"55385","E01021586",2011,614,9,605,44
"55386","E01021587",2011,616,20,596,39
"55387","E01021588",2011,623,247,376,41
"55388","E01021589",2011,665,145,520,125
"55389","E01021590",2011,588,9,579,57
"55390","E01021591",2011,643,13,630,88
"55391","E01021592",2011,678,404,274,57
"55392","E01021593",2011,666,15,651,37
"55393","E01021594",2011,679,64,615,78
"55394","E01021595",2011,708,17,691,41
"55395","E01021596",2011,698,392,306,48
"55396","E01021597",2011,590,129,461,58
"55397","E01021598",2011,660,204,456,32
"55398","E01021599",2011,728,55,673,76
"55399","E01021600",2011,441,23,418,25
"55400","E01021601",2011,685,261,424,60
"55401","E01021602",2011,754,150,604,91
"55402","E01021604",2011,861,42,819,55
"55403","E01021605",2011,469,5,464,42
"55404","E01021606",2011,593,101,492,29
"55405","E01021607",2011,648,82,566,91
"55406","E01021608",2011,547,70,477,132
"55407","E01021609",2011,515,3,512,31
"55408","E01021610",2011,571,12,559,132
"55409","E01021611",2011,528,6,522,43
"55410","E01021612",2011,608,5,603,32
"55411","E01021613",2011,853,49,804,172
"55412","E01021614",2011,646,10,636,56
"55413","E01021615",2011,622,12,610,62
"55414","E01021616",2011,553,6,547,27
"55415","E01021617",2011,599,169,430,35
"55416","E01021618",2011,572,18,554,77
"55417","E01021619",2011,634,42,592,63
"55418","E01021620",2011,643,10,633,130
"55419","E01021621",2011,616,9,607,103
"55420","E01021622",2011,632,19,613,50
"55421","E01021623",2011,514,5,509,60
"55422","E01021624",2011,503,1,502,25
"55423","E01021625",2011,615,21,594,49
"55424","E01021626",2011,554,4,550,64
"55425","E01021627",2011,588,91,497,108
"55426","E01021628",2011,665,85,580,118
"55427","E01021629",2011,677,145,532,111
"55428","E01021631",2011,787,348,439,71
"55429","E01021632",2011,601,39,562,20
"55430","E01021633",2011,514,18,496,69
"55431","E01021634",2011,614,18,596,67
"55432","E01021635",2011,625,85,540,51
"55433","E01021636",2011,510,229,281,30
"55434","E01021637",2011,471,82,389,42
"55435","E01021638",2011,506,160,346,54
"55436","E01021639",2011,750,145,605,166
"55437","E01021640",2011,481,74,407,49
"55438","E01021641",2011,590,112,478,69
"55439","E01021642",2011,836,204,632,172
"55440","E01021643",2011,927,16,911,69
"55441","E01021644",2011,670,75,595,86
"55442","E01021645",2011,583,17,566,28
"55443","E01021646",2011,1019,97,922,425
"55444","E01021647",2011,811,47,764,181
"55445","E01021648",2011,1127,125,1002,405
"55446","E01021649",2011,1050,248,802,438
"55447","E01021650",2011,954,49,905,490
"55448","E01021651",2011,731,33,698,228
"55449","E01021652",2011,647,38,609,130
"55450","E01021653",2011,486,3,483,53
"55451","E01021654",2011,733,44,689,82
"55452","E01021655",2011,529,30,499,40
"55453","E01021656",2011,682,87,595,67
"55454","E01021657",2011,720,70,650,130
"55455","E01021658",2011,442,112,330,38
"55456","E01021659",2011,826,82,744,69
"55457","E01021660",2011,574,50,524,62
"55458","E01021661",2011,659,34,625,52
"55459","E01021662",2011,636,36,600,46
"55460","E01021663",2011,458,38,420,34
"55461","E01021664",2011,884,119,765,210
"55462","E01021665",2011,612,278,334,76
"55463","E01021666",2011,627,59,568,175
"55464","E01021667",2011,619,181,438,71
"55465","E01021668",2011,801,68,733,297
"55466","E01021669",2011,716,192,524,192
"55467","E01021670",2011,630,140,490,114
"55468","E01021671",2011,596,61,535,62
"55469","E01021673",2011,623,1,622,51
"55470","E01021674",2011,519,121,398,61
"55471","E01021675",2011,526,31,495,53
"55472","E01021676",2011,643,54,589,82
"55473","E01021677",2011,494,12,482,34
"55474","E01021678",2011,559,52,507,103
"55475","E01021679",2011,991,79,912,286
"55476","E01021680",2011,1090,123,967,224
"55477","E01021681",2011,1184,67,1117,343
"55478","E01021682",2011,1148,110,1038,302
"55479","E01021683",2011,558,91,467,227
"55480","E01021684",2011,703,91,612,158
"55481","E01021685",2011,838,236,602,307
"55482","E01021686",2011,981,267,714,406
"55483","E01021687",2011,757,54,703,263
"55484","E01021688",2011,600,31,569,162
"55485","E01021689",2011,614,97,517,41
"55486","E01021690",2011,500,15,485,39
"55487","E01021691",2011,641,65,576,43
"55488","E01021692",2011,603,3,600,42
"55489","E01021693",2011,718,17,701,56
"55490","E01021694",2011,592,40,552,40
"55491","E01021695",2011,459,21,438,28
"55492","E01021696",2011,747,449,298,91
"55493","E01021697",2011,705,296,409,102
"55494","E01021698",2011,457,145,312,92
"55495","E01021699",2011,647,294,353,130
"55496","E01021700",2011,582,324,258,120
"55497","E01021702",2011,591,35,556,112
"55498","E01021703",2011,491,255,236,33
"55499","E01021704",2011,661,147,514,98
"55500","E01021705",2011,765,60,705,70
"55501","E01021706",2011,598,74,524,192
"55502","E01021707",2011,591,89,502,49
"55503","E01021708",2011,629,63,566,35
"55504","E01021709",2011,632,10,622,39
"55505","E01021710",2011,771,15,756,47
"55506","E01021711",2011,577,252,325,40
"55507","E01021713",2011,474,161,313,30
"55508","E01021714",2011,671,87,584,224
"55509","E01021715",2011,578,132,446,61
"55510","E01021717",2011,719,72,647,211
"55511","E01021718",2011,665,12,653,113
"55512","E01021719",2011,663,29,634,75
"55513","E01021720",2011,704,219,485,75
"55514","E01021721",2011,773,36,737,75
"55515","E01021722",2011,701,116,585,61
"55516","E01021723",2011,720,55,665,80
"55517","E01021724",2011,739,12,727,83
"55518","E01021725",2011,528,6,522,65
"55519","E01021726",2011,679,208,471,60
"55520","E01021727",2011,627,7,620,47
"55521","E01021728",2011,656,13,643,23
"55522","E01021729",2011,708,99,609,78
"55523","E01021730",2011,682,88,594,47
"55524","E01021731",2011,638,10,628,62
"55525","E01021732",2011,705,144,561,102
"55526","E01021733",2011,657,26,631,38
"55527","E01021734",2011,631,18,613,60
"55528","E01021735",2011,669,10,659,64
"55529","E01021736",2011,516,21,495,159
"55530","E01021737",2011,582,19,563,125
"55531","E01021738",2011,967,20,947,233
"55532","E01021739",2011,648,5,643,79
"55533","E01021740",2011,744,96,648,91
"55534","E01021741",2011,784,61,723,66
"55535","E01021742",2011,513,113,400,29
"55536","E01021743",2011,824,166,658,132
"55537","E01021744",2011,648,51,597,81
"55538","E01021745",2011,655,23,632,100
"55539","E01021746",2011,859,24,835,159
"55540","E01021747",2011,643,21,622,70
"55541","E01021748",2011,752,29,723,174
"55542","E01021749",2011,912,56,856,88
"55543","E01021750",2011,476,22,454,65
"55544","E01021751",2011,444,6,438,20
"55545","E01021752",2011,564,36,528,69
"55546","E01021753",2011,629,119,510,107
"55547","E01021754",2011,615,7,608,36
"55548","E01021755",2011,479,9,470,45
"55549","E01021756",2011,612,47,565,60
"55550","E01021757",2011,795,14,781,170
"55551","E01021758",2011,749,205,544,168
"55552","E01021759",2011,608,107,501,55
"55553","E01021760",2011,655,95,560,63
"55554","E01021761",2011,744,112,632,86
"55555","E01021762",2011,611,193,418,44
"55556","E01021763",2011,653,116,537,22
"55557","E01021764",2011,720,380,340,83
"55558","E01021765",2011,646,17,629,126
"55559","E01021766",2011,498,15,483,45
"55560","E01021767",2011,638,21,617,57
"55561","E01021768",2011,865,110,755,77
"55562","E01021769",2011,852,131,721,85
"55563","E01021770",2011,907,157,750,86
"55564","E01021771",2011,713,334,379,59
"55565","E01021772",2011,599,123,476,38
"55566","E01021773",2011,595,120,475,73
"55567","E01021774",2011,617,191,426,97
"55568","E01021775",2011,631,225,406,51
"55569","E01021776",2011,717,326,391,71
"55570","E01021777",2011,567,160,407,33
"55571","E01021778",2011,571,128,443,57
"55572","E01021779",2011,702,227,475,115
"55573","E01021780",2011,523,7,516,44
"55574","E01021781",2011,633,12,621,84
"55575","E01021782",2011,639,8,631,100
"55576","E01021783",2011,639,38,601,53
"55577","E01021784",2011,642,15,627,69
"55578","E01021785",2011,662,180,482,60
"55579","E01021786",2011,520,2,518,92
"55580","E01021787",2011,629,6,623,67
"55581","E01021788",2011,624,23,601,64
"55582","E01021789",2011,526,7,519,29
"55583","E01021790",2011,556,130,426,41
"55584","E01021791",2011,660,10,650,148
"55585","E01021792",2011,482,7,475,19
"55586","E01021793",2011,616,6,610,19
"55587","E01021794",2011,484,105,379,24
"55588","E01021795",2011,935,21,914,247
"55589","E01021796",2011,868,90,778,80
"55590","E01021797",2011,523,33,490,42
"55591","E01021798",2011,638,96,542,33
"55592","E01021799",2011,706,211,495,64
"55593","E01021800",2011,862,57,805,125
"55594","E01021801",2011,876,84,792,38
"55595","E01021802",2011,903,296,607,64
"55596","E01021803",2011,536,109,427,21
"55597","E01021804",2011,586,25,561,85
"55598","E01021805",2011,491,7,484,9
"55599","E01021806",2011,1002,16,986,98
"55600","E01021807",2011,591,54,537,48
"55601","E01021808",2011,617,207,410,36
"55602","E01021809",2011,616,152,464,41
"55603","E01021810",2011,788,70,718,180
"55604","E01021811",2011,602,240,362,34
"55605","E01021812",2011,579,32,547,30
"55606","E01021813",2011,581,41,540,52
"55607","E01021814",2011,604,134,470,41
"55608","E01021815",2011,603,189,414,31
"55609","E01021816",2011,609,329,280,37
"55610","E01021817",2011,1066,279,787,110
"55611","E01021818",2011,912,178,734,221
"55612","E01021819",2011,638,239,399,36
"55613","E01021820",2011,644,221,423,42
"55614","E01021821",2011,640,305,335,54
"55615","E01021822",2011,626,215,411,51
"55616","E01021823",2011,759,358,401,71
"55617","E01021824",2011,641,3,638,66
"55618","E01021825",2011,648,4,644,116
"55619","E01021826",2011,645,68,577,48
"55620","E01021827",2011,715,70,645,111
"55621","E01021828",2011,864,6,858,97
"55622","E01021829",2011,651,219,432,54
"55623","E01021830",2011,493,52,441,37
"55624","E01021831",2011,641,221,420,68
"55625","E01021832",2011,514,39,475,40
"55626","E01021833",2011,522,155,367,46
"55627","E01021834",2011,654,239,415,53
"55628","E01021835",2011,607,203,404,35
"55629","E01021836",2011,644,301,343,61
"55630","E01021837",2011,635,192,443,43
"55631","E01021838",2011,605,158,447,27
"55632","E01021839",2011,633,198,435,85
"55633","E01021840",2011,623,256,367,65
"55634","E01021841",2011,539,189,350,34
"55635","E01021842",2011,634,259,375,107
"55636","E01021843",2011,940,333,607,144
"55637","E01021844",2011,525,188,337,30
"55638","E01021845",2011,621,303,318,61
"55639","E01021846",2011,573,249,324,80
"55640","E01021847",2011,616,255,361,49
"55641","E01021848",2011,690,235,455,89
"55642","E01021849",2011,670,256,414,52
"55643","E01021850",2011,617,281,336,72
"55644","E01021851",2011,713,282,431,163
"55645","E01021852",2011,670,277,393,58
"55646","E01021853",2011,590,204,386,74
"55647","E01021854",2011,732,192,540,75
"55648","E01021855",2011,601,173,428,64
"55649","E01021856",2011,610,132,478,62
"55650","E01021857",2011,1069,217,852,157
"55651","E01021858",2011,640,273,367,58
"55652","E01021859",2011,615,248,367,75
"55653","E01021860",2011,598,202,396,70
"55654","E01021861",2011,491,182,309,24
"55655","E01021862",2011,626,206,420,77
"55656","E01021863",2011,621,205,416,68
"55657","E01021864",2011,549,205,344,79
"55658","E01021865",2011,568,165,403,53
"55659","E01021866",2011,609,164,445,81
"55660","E01021867",2011,584,43,541,41
"55661","E01021868",2011,674,209,465,60
"55662","E01021869",2011,558,117,441,54
"55663","E01021870",2011,577,192,385,57
"55664","E01021871",2011,629,273,356,58
"55665","E01021872",2011,829,377,452,224
"55666","E01021873",2011,513,4,509,31
"55667","E01021874",2011,530,91,439,49
"55668","E01021875",2011,639,15,624,48
"55669","E01021878",2011,633,55,578,51
"55670","E01021879",2011,628,62,566,74
"55671","E01021880",2011,782,129,653,150
"55672","E01021881",2011,526,9,517,95
"55673","E01021882",2011,842,38,804,69
"55674","E01021883",2011,651,63,588,51
"55675","E01021884",2011,604,24,580,98
"55676","E01021885",2011,475,7,468,35
"55677","E01021886",2011,601,40,561,38
"55678","E01021887",2011,864,65,799,58
"55679","E01021888",2011,821,281,540,84
"55680","E01021889",2011,930,300,630,124
"55681","E01021890",2011,905,103,802,219
"55682","E01021891",2011,743,49,694,95
"55683","E01021892",2011,481,152,329,46
"55684","E01021893",2011,592,6,586,20
"55685","E01021894",2011,498,111,387,35
"55686","E01021895",2011,492,28,464,51
"55687","E01021896",2011,494,6,488,24
"55688","E01021897",2011,484,39,445,39
"55689","E01021898",2011,587,117,470,20
"55690","E01021899",2011,513,11,502,27
"55691","E01021900",2011,442,31,411,54
"55692","E01021901",2011,794,33,761,63
"55693","E01021902",2011,668,20,648,45
"55694","E01021903",2011,624,73,551,33
"55695","E01021904",2011,562,51,511,49
"55696","E01021905",2011,499,81,418,46
"55697","E01021906",2011,642,72,570,109
"55698","E01021907",2011,886,80,806,103
"55699","E01021908",2011,857,25,832,90
"55700","E01021909",2011,536,65,471,41
"55701","E01021910",2011,637,94,543,62
"55702","E01021911",2011,473,27,446,27
"55703","E01021912",2011,830,46,784,46
"55704","E01021913",2011,589,36,553,46
"55705","E01021914",2011,800,8,792,53
"55706","E01021915",2011,515,71,444,67
"55707","E01021916",2011,415,44,371,26
"55708","E01021917",2011,704,39,665,83
"55709","E01021918",2011,568,2,566,35
"55710","E01021919",2011,517,12,505,16
"55711","E01021920",2011,737,48,689,53
"55712","E01021921",2011,591,74,517,111
"55713","E01021922",2011,669,176,493,51
"55714","E01021923",2011,520,32,488,37
"55715","E01021924",2011,494,4,490,40
"55716","E01021925",2011,653,7,646,67
"55717","E01021926",2011,860,44,816,103
"55718","E01021927",2011,490,4,486,24
"55719","E01021928",2011,668,51,617,53
"55720","E01021929",2011,579,1,578,30
"55721","E01021930",2011,665,59,606,177
"55722","E01021931",2011,585,1,584,47
"55723","E01021932",2011,634,9,625,74
"55724","E01021933",2011,509,20,489,24
"55725","E01021934",2011,528,3,525,19
"55726","E01021935",2011,533,1,532,31
"55727","E01021936",2011,784,138,646,78
"55728","E01021937",2011,700,12,688,109
"55729","E01021938",2011,641,1,640,22
"55730","E01021939",2011,671,3,668,28
"55731","E01021940",2011,789,44,745,38
"55732","E01021941",2011,774,3,771,28
"55733","E01021942",2011,825,13,812,59
"55734","E01021943",2011,707,53,654,39
"55735","E01021944",2011,633,2,631,38
"55736","E01021945",2011,621,7,614,21
"55737","E01021946",2011,551,2,549,23
"55738","E01021947",2011,499,23,476,20
"55739","E01021948",2011,524,11,513,44
"55740","E01021949",2011,604,4,600,25
"55741","E01021950",2011,594,93,501,35
"55742","E01021951",2011,509,41,468,24
"55743","E01021952",2011,602,25,577,69
"55744","E01021953",2011,564,328,236,42
"55745","E01021954",2011,604,37,567,91
"55746","E01021955",2011,885,324,561,184
"55747","E01021956",2011,628,89,539,64
"55748","E01021957",2011,622,179,443,44
"55749","E01021958",2011,518,9,509,62
"55750","E01021959",2011,635,55,580,47
"55751","E01021960",2011,759,5,754,27
"55752","E01021961",2011,636,33,603,31
"55753","E01021962",2011,507,104,403,65
"55754","E01021963",2011,520,6,514,47
"55755","E01021964",2011,667,30,637,63
"55756","E01021965",2011,963,0,963,50
"55757","E01021966",2011,794,163,631,106
"55758","E01021967",2011,836,37,799,65
"55759","E01021968",2011,729,67,662,200
"55760","E01021969",2011,587,42,545,138
"55761","E01021970",2011,825,207,618,255
"55762","E01021971",2011,416,5,411,38
"55763","E01021972",2011,491,69,422,44
"55764","E01021973",2011,471,7,464,22
"55765","E01021974",2011,483,57,426,63
"55766","E01021975",2011,644,81,563,99
"55767","E01021976",2011,613,5,608,73
"55768","E01021977",2011,710,29,681,90
"55769","E01021978",2011,906,49,857,77
"55770","E01021979",2011,624,113,511,49
"55771","E01021980",2011,770,46,724,87
"55772","E01021981",2011,793,35,758,129
"55773","E01021982",2011,830,31,799,272
"55774","E01021983",2011,611,5,606,70
"55775","E01021984",2011,1004,17,987,73
"55776","E01021985",2011,660,6,654,92
"55777","E01021986",2011,726,7,719,144
"55778","E01021987",2011,593,26,567,70
"55779","E01021988",2011,1029,33,996,502
"55780","E01021989",2011,757,7,750,53
"55781","E01021990",2011,842,5,837,146
"55782","E01021991",2011,418,14,404,32
"55783","E01021992",2011,476,57,419,43
"55784","E01021993",2011,944,62,882,82
"55785","E01021994",2011,606,30,576,51
"55786","E01021995",2011,634,3,631,50
"55787","E01021996",2011,615,51,564,83
"55788","E01021997",2011,663,188,475,183
"55789","E01021998",2011,631,40,591,189
"55790","E01021999",2011,752,122,630,138
"55791","E01022000",2011,646,44,602,86
"55792","E01022001",2011,827,78,749,361
"55793","E01022002",2011,791,31,760,66
"55794","E01022004",2011,748,36,712,76
"55795","E01022005",2011,757,9,748,74
"55796","E01022006",2011,732,205,527,119
"55797","E01022007",2011,653,145,508,84
"55798","E01022008",2011,1002,30,972,84
"55799","E01022009",2011,640,5,635,69
"55800","E01022010",2011,704,5,699,83
"55801","E01022011",2011,742,54,688,74
"55802","E01022012",2011,1001,84,917,106
"55803","E01022013",2011,650,21,629,69
"55804","E01022014",2011,584,140,444,42
"55805","E01022015",2011,608,28,580,96
"55806","E01022016",2011,839,9,830,71
"55807","E01022017",2011,575,9,566,58
"55808","E01022018",2011,624,85,539,44
"55809","E01022019",2011,560,32,528,62
"55810","E01022020",2011,901,98,803,211
"55811","E01022021",2011,603,131,472,75
"55812","E01022022",2011,602,27,575,112
"55813","E01022023",2011,645,33,612,140
"55814","E01022024",2011,642,127,515,96
"55815","E01022025",2011,776,41,735,396
"55816","E01022026",2011,630,41,589,288
"55817","E01022027",2011,788,13,775,346
"55818","E01022028",2011,546,78,468,36
"55819","E01022030",2011,759,251,508,71
"55820","E01022031",2011,577,293,284,94
"55821","E01022032",2011,715,162,553,103
"55822","E01022033",2011,733,3,730,49
"55823","E01022034",2011,772,8,764,109
"55824","E01022035",2011,698,10,688,58
"55825","E01022036",2011,571,6,565,84
"55826","E01022037",2011,622,11,611,107
"55827","E01022038",2011,632,98,534,61
"55828","E01022039",2011,657,124,533,90
"55829","E01022040",2011,816,34,782,59
"55830","E01022041",2011,711,11,700,72
"55831","E01022042",2011,687,99,588,170
"55832","E01022043",2011,751,58,693,261
"55833","E01022044",2011,743,83,660,63
"55834","E01022045",2011,681,172,509,86
"55835","E01022046",2011,686,3,683,85
"55836","E01022047",2011,578,11,567,75
"55837","E01022048",2011,705,7,698,129
"55838","E01022049",2011,618,14,604,118
"55839","E01022050",2011,870,91,779,161
"55840","E01022051",2011,575,24,551,59
"55841","E01022052",2011,600,59,541,56
"55842","E01022053",2011,710,23,687,45
"55843","E01022054",2011,629,56,573,118
"55844","E01022055",2011,642,153,489,72
"55845","E01022056",2011,766,48,718,286
"55846","E01022057",2011,674,76,598,59
"55847","E01022058",2011,636,63,573,64
"55848","E01022059",2011,622,53,569,108
"55849","E01022060",2011,696,62,634,60
"55850","E01022061",2011,568,60,508,38
"55851","E01022062",2011,786,31,755,68
"55852","E01022063",2011,622,88,534,51
"55853","E01022064",2011,676,25,651,64
"55854","E01022067",2011,926,156,770,250
"55855","E01022068",2011,618,103,515,60
"55856","E01022069",2011,661,53,608,106
"55857","E01022070",2011,712,117,595,61
"55858","E01022071",2011,652,63,589,110
"55859","E01022072",2011,733,64,669,73
"55860","E01022073",2011,628,123,505,47
"55861","E01022074",2011,584,185,399,44
"55862","E01022075",2011,715,8,707,97
"55863","E01022076",2011,939,192,747,186
"55864","E01022077",2011,637,40,597,84
"55865","E01022078",2011,622,240,382,66
"55866","E01022079",2011,750,104,646,123
"55867","E01022080",2011,633,39,594,111
"55868","E01022081",2011,963,173,790,101
"55869","E01022082",2011,667,61,606,84
"55870","E01022083",2011,684,44,640,74
"55871","E01022084",2011,610,6,604,53
"55872","E01022085",2011,691,43,648,163
"55873","E01022086",2011,524,186,338,58
"55874","E01022087",2011,715,93,622,91
"55875","E01022088",2011,609,52,557,55
"55876","E01022089",2011,603,69,534,93
"55877","E01022090",2011,923,124,799,183
"55878","E01022091",2011,910,78,832,120
"55879","E01022092",2011,716,32,684,128
"55880","E01022093",2011,719,186,533,50
"55881","E01022094",2011,679,60,619,78
"55882","E01022095",2011,602,59,543,106
"55883","E01022096",2011,730,86,644,78
"55884","E01022097",2011,713,78,635,78
"55885","E01022098",2011,609,63,546,52
"55886","E01022099",2011,785,76,709,214
"55887","E01022100",2011,770,30,740,198
"55888","E01022101",2011,857,63,794,223
"55889","E01022102",2011,1038,65,973,622
"55890","E01022103",2011,1001,56,945,150
"55891","E01022104",2011,721,37,684,120
"55892","E01022105",2011,584,8,576,51
"55893","E01022106",2011,747,6,741,81
"55894","E01022107",2011,656,6,650,87
"55895","E01022108",2011,734,50,684,51
"55896","E01022109",2011,606,10,596,45
"55897","E01022110",2011,616,114,502,68
"55898","E01022111",2011,589,28,561,80
"55899","E01022112",2011,469,9,460,38
"55900","E01022113",2011,714,38,676,31
"55901","E01022114",2011,662,6,656,47
"55902","E01022115",2011,807,37,770,155
"55903","E01022116",2011,554,25,529,246
"55904","E01022117",2011,967,40,927,563
"55905","E01022118",2011,572,17,555,73
"55906","E01022119",2011,577,7,570,152
"55907","E01022120",2011,691,386,305,38
"55908","E01022121",2011,732,298,434,145
"55909","E01022122",2011,572,324,248,64
"55910","E01022123",2011,988,52,936,216
"55911","E01022124",2011,761,169,592,304
"55912","E01022125",2011,592,6,586,212
"55913","E01022126",2011,943,76,867,541
"55914","E01022127",2011,678,35,643,412
"55915","E01022128",2011,670,1,669,57
"55916","E01022129",2011,874,48,826,60
"55917","E01022130",2011,732,6,726,138
"55918","E01022131",2011,572,226,346,44
"55919","E01022132",2011,596,200,396,46
"55920","E01022133",2011,508,230,278,49
"55921","E01022134",2011,767,188,579,125
"55922","E01022135",2011,624,35,589,89
"55923","E01022136",2011,742,61,681,164
"55924","E01022137",2011,879,16,863,301
"55925","E01022138",2011,776,14,762,191
"55926","E01022139",2011,526,33,493,48
"55927","E01022140",2011,570,6,564,85
"55928","E01022141",2011,787,20,767,374
"55929","E01022142",2011,772,131,641,308
"55930","E01022143",2011,667,10,657,62
"55931","E01022144",2011,536,80,456,47
"55932","E01022145",2011,512,11,501,28
"55933","E01022146",2011,626,12,614,48
"55934","E01022147",2011,768,465,303,70
"55935","E01022148",2011,648,96,552,89
"55936","E01022149",2011,525,117,408,45
"55937","E01022150",2011,657,94,563,121
"55938","E01022151",2011,640,98,542,255
"55939","E01022152",2011,434,215,219,109
"55940","E01022153",2011,658,126,532,368
"55941","E01022154",2011,700,59,641,399
"55942","E01022155",2011,612,39,573,121
"55943","E01022156",2011,657,115,542,193
"55944","E01022157",2011,643,242,401,72
"55945","E01022158",2011,1048,52,996,540
"55946","E01022159",2011,603,185,418,60
"55947","E01022160",2011,879,364,515,132
"55948","E01022161",2011,631,79,552,130
"55949","E01022162",2011,689,58,631,58
"55950","E01022163",2011,605,28,577,70
"55951","E01022164",2011,597,197,400,114
"55952","E01022165",2011,709,12,697,125
"55953","E01022166",2011,540,10,530,59
"55954","E01022167",2011,509,2,507,21
"55955","E01022168",2011,476,17,459,49
"55956","E01022169",2011,667,80,587,88
"55957","E01022170",2011,628,17,611,75
"55958","E01022171",2011,551,8,543,93
"55959","E01022172",2011,711,6,705,53
"55960","E01022173",2011,613,112,501,83
"55961","E01022174",2011,597,8,589,56
"55962","E01022175",2011,818,96,722,144
"55963","E01022176",2011,815,93,722,195
"55964","E01022177",2011,966,211,755,111
"55965","E01022178",2011,595,47,548,104
"55966","E01022179",2011,905,139,766,88
"55967","E01022180",2011,923,246,677,100
"55968","E01022181",2011,782,22,760,116
"55969","E01022182",2011,689,78,611,84
"55970","E01022183",2011,694,123,571,73
"55971","E01022184",2011,674,81,593,92
"55972","E01022185",2011,627,97,530,64
"55973","E01022186",2011,721,44,677,128
"55974","E01022187",2011,732,63,669,162
"55975","E01022188",2011,601,243,358,41
"55976","E01022189",2011,512,43,469,28
"55977","E01022190",2011,529,82,447,49
"55978","E01022191",2011,653,112,541,172
"55979","E01022192",2011,532,205,327,68
"55980","E01022193",2011,417,28,389,27
"55981","E01022194",2011,995,191,804,288
"55982","E01022195",2011,641,82,559,149
"55983","E01022196",2011,731,88,643,76
"55984","E01022197",2011,776,23,753,67
"55985","E01022198",2011,563,109,454,108
"55986","E01022199",2011,860,160,700,178
"55987","E01022200",2011,607,352,255,61
"55988","E01022201",2011,749,43,706,155
"55989","E01022202",2011,429,41,388,53
"55990","E01022203",2011,642,39,603,81
"55991","E01022204",2011,611,139,472,61
"55992","E01022205",2011,841,99,742,164
"55993","E01022206",2011,796,55,741,168
"55994","E01022207",2011,751,75,676,100
"55995","E01022208",2011,671,7,664,72
"55996","E01022209",2011,447,70,377,35
"55997","E01022210",2011,651,183,468,63
"55998","E01022211",2011,931,220,711,142
"55999","E01022212",2011,722,76,646,99
"56000","E01022213",2011,787,107,680,118
"56001","E01022214",2011,848,65,783,102
"56002","E01022215",2011,815,98,717,236
"56003","E01022216",2011,788,54,734,155
"56004","E01022217",2011,561,99,462,43
"56005","E01022218",2011,525,233,292,38
"56006","E01022219",2011,522,37,485,32
"56007","E01022220",2011,795,81,714,137
"56008","E01022221",2011,782,116,666,152
"56009","E01022222",2011,875,86,789,178
"56010","E01022223",2011,1020,158,862,111
"56011","E01022224",2011,686,31,655,103
"56012","E01022225",2011,633,118,515,147
"56013","E01022226",2011,690,114,576,113
"56014","E01022227",2011,682,60,622,97
"56015","E01022228",2011,686,65,621,76
"56016","E01022229",2011,677,128,549,48
"56017","E01022230",2011,689,22,667,65
"56018","E01022231",2011,692,175,517,49
"56019","E01022232",2011,643,28,615,74
"56020","E01022233",2011,785,73,712,88
"56021","E01022234",2011,639,27,612,35
"56022","E01022235",2011,735,42,693,75
"56023","E01022236",2011,898,77,821,135
"56024","E01022237",2011,628,189,439,76
"56025","E01022238",2011,607,276,331,42
"56026","E01022239",2011,691,54,637,64
"56027","E01022240",2011,930,82,848,239
"56028","E01022241",2011,819,95,724,177
"56029","E01022242",2011,592,124,468,52
"56030","E01022243",2011,532,128,404,35
"56031","E01022244",2011,616,157,459,43
"56032","E01022245",2011,594,119,475,112
"56033","E01022246",2011,532,8,524,49
"56034","E01022247",2011,673,25,648,73
"56035","E01022248",2011,711,45,666,39
"56036","E01022249",2011,817,52,765,53
"56037","E01022250",2011,762,176,586,64
"56038","E01022251",2011,629,146,483,47
"56039","E01022252",2011,710,28,682,32
"56040","E01022253",2011,713,50,663,55
"56041","E01022254",2011,757,210,547,75
"56042","E01022255",2011,622,27,595,69
"56043","E01022256",2011,742,226,516,98
"56044","E01022257",2011,770,7,763,54
"56045","E01022258",2011,470,116,354,59
"56046","E01022259",2011,640,20,620,39
"56047","E01022260",2011,752,128,624,60
"56048","E01022261",2011,781,123,658,84
"56049","E01022262",2011,861,153,708,184
"56050","E01022263",2011,778,43,735,93
"56051","E01022264",2011,613,60,553,71
"56052","E01022265",2011,704,45,659,93
"56053","E01022266",2011,526,32,494,72
"56054","E01022267",2011,660,22,638,80
"56055","E01022268",2011,674,119,555,32
"56056","E01022269",2011,801,57,744,50
"56057","E01022270",2011,749,65,684,73
"56058","E01022271",2011,703,29,674,74
"56059","E01022272",2011,564,142,422,62
"56060","E01022273",2011,457,20,437,163
"56061","E01022274",2011,496,5,491,54
"56062","E01022275",2011,675,23,652,89
"56063","E01022276",2011,685,6,679,55
"56064","E01022277",2011,659,54,605,56
"56065","E01022278",2011,638,51,587,53
"56066","E01022279",2011,569,9,560,60
"56067","E01022280",2011,685,22,663,170
"56068","E01022281",2011,690,27,663,59
"56069","E01022282",2011,1043,55,988,114
"56070","E01022283",2011,635,41,594,46
"56071","E01022284",2011,511,104,407,82
"56072","E01022285",2011,497,157,340,26
"56073","E01022286",2011,611,127,484,80
"56074","E01022287",2011,711,57,654,87
"56075","E01022288",2011,705,84,621,225
"56076","E01022289",2011,625,134,491,175
"56077","E01022290",2011,529,112,417,111
"56078","E01022291",2011,635,71,564,251
"56079","E01022292",2011,493,28,465,166
"56080","E01022293",2011,633,53,580,231
"56081","E01022294",2011,634,24,610,201
"56082","E01022295",2011,590,14,576,32
"56083","E01022296",2011,597,84,513,88
"56084","E01022297",2011,496,2,494,18
"56085","E01022298",2011,602,28,574,68
"56086","E01022299",2011,629,11,618,61
"56087","E01022300",2011,635,4,631,66
"56088","E01022301",2011,660,85,575,112
"56089","E01022302",2011,625,19,606,62
"56090","E01022303",2011,622,94,528,61
"56091","E01022304",2011,765,5,760,85
"56092","E01022305",2011,589,14,575,39
"56093","E01022306",2011,584,3,581,73
"56094","E01022307",2011,638,4,634,86
"56095","E01022308",2011,649,5,644,64
"56096","E01022309",2011,618,53,565,133
"56097","E01022310",2011,742,99,643,195
"56098","E01022311",2011,1000,309,691,374
"56099","E01022312",2011,958,79,879,436
"56100","E01022313",2011,702,14,688,86
"56101","E01022314",2011,647,8,639,46
"56102","E01022315",2011,628,2,626,62
"56103","E01022316",2011,676,18,658,104
"56104","E01022317",2011,610,17,593,38
"56105","E01022318",2011,656,4,652,32
"56106","E01022319",2011,703,467,236,38
"56107","E01022320",2011,626,157,469,39
"56108","E01022321",2011,609,82,527,71
"56109","E01022322",2011,609,250,359,46
"56110","E01022323",2011,633,334,299,50
"56111","E01022324",2011,649,260,389,52
"56112","E01022325",2011,586,114,472,53
"56113","E01022326",2011,555,21,534,159
"56114","E01022327",2011,618,46,572,123
"56115","E01022328",2011,501,148,353,62
"56116","E01022329",2011,599,180,419,115
"56117","E01022330",2011,587,22,565,137
"56118","E01022331",2011,496,80,416,48
"56119","E01022332",2011,671,79,592,265
"56120","E01022333",2011,641,413,228,46
"56121","E01022334",2011,650,125,525,65
"56122","E01022335",2011,612,39,573,73
"56123","E01022336",2011,496,7,489,69
"56124","E01022338",2011,630,11,619,221
"56125","E01022339",2011,660,11,649,74
"56126","E01022340",2011,622,10,612,177
"56127","E01022341",2011,853,83,770,174
"56128","E01022342",2011,677,3,674,124
"56129","E01022343",2011,510,59,451,40
"56130","E01022344",2011,625,99,526,40
"56131","E01022345",2011,630,74,556,40
"56132","E01022346",2011,658,353,305,41
"56133","E01022347",2011,919,106,813,594
"56134","E01022348",2011,1113,100,1013,329
"56135","E01022350",2011,888,53,835,72
"56136","E01022351",2011,592,123,469,75
"56137","E01022352",2011,578,30,548,73
"56138","E01022353",2011,643,100,543,117
"56139","E01022354",2011,936,55,881,82
"56140","E01022355",2011,641,87,554,53
"56141","E01022356",2011,952,101,851,225
"56142","E01022357",2011,778,75,703,84
"56143","E01022358",2011,656,249,407,39
"56144","E01022359",2011,638,29,609,42
"56145","E01022360",2011,567,34,533,34
"56146","E01022361",2011,603,185,418,36
"56147","E01022362",2011,512,43,469,27
"56148","E01022363",2011,765,75,690,52
"56149","E01022364",2011,488,233,255,29
"56150","E01022365",2011,1005,96,909,260
"56151","E01022366",2011,676,7,669,62
"56152","E01022367",2011,674,33,641,52
"56153","E01022368",2011,587,16,571,29
"56154","E01022369",2011,744,52,692,182
"56155","E01022370",2011,534,81,453,47
"56156","E01022371",2011,413,26,387,26
"56157","E01022372",2011,755,33,722,125
"56158","E01022373",2011,737,133,604,73
"56159","E01022374",2011,932,191,741,130
"56160","E01022375",2011,485,228,257,40
"56161","E01022376",2011,736,91,645,71
"56162","E01022377",2011,987,258,729,94
"56163","E01022378",2011,739,9,730,114
"56164","E01022379",2011,665,72,593,171
"56165","E01022380",2011,606,16,590,77
"56166","E01022381",2011,784,51,733,70
"56167","E01022382",2011,662,12,650,37
"56168","E01022383",2011,593,209,384,29
"56169","E01022384",2011,617,29,588,84
"56170","E01022385",2011,663,82,581,66
"56171","E01022386",2011,746,86,660,145
"56172","E01022387",2011,722,115,607,115
"56173","E01022388",2011,696,138,558,70
"56174","E01022389",2011,717,43,674,53
"56175","E01022390",2011,594,74,520,104
"56176","E01022391",2011,640,8,632,72
"56177","E01022392",2011,658,15,643,107
"56178","E01022393",2011,619,18,601,27
"56179","E01022394",2011,672,62,610,156
"56180","E01022395",2011,635,13,622,47
"56181","E01022396",2011,667,35,632,95
"56182","E01022397",2011,717,86,631,66
"56183","E01022398",2011,449,36,413,38
"56184","E01022399",2011,917,228,689,124
"56185","E01022400",2011,789,81,708,129
"56186","E01022401",2011,596,157,439,56
"56187","E01022402",2011,648,58,590,94
"56188","E01022403",2011,609,262,347,30
"56189","E01022404",2011,551,32,519,84
"56190","E01022405",2011,625,181,444,37
"56191","E01022406",2011,521,16,505,37
"56192","E01022407",2011,547,51,496,45
"56193","E01022408",2011,435,14,421,32
"56194","E01022409",2011,499,35,464,49
"56195","E01022410",2011,986,175,811,175
"56196","E01022411",2011,950,153,797,112
"56197","E01022412",2011,1163,82,1081,167
"56198","E01022413",2011,727,45,682,110
"56199","E01022414",2011,1109,199,910,221
"56200","E01022415",2011,628,19,609,72
"56201","E01022416",2011,585,164,421,34
"56202","E01022417",2011,727,49,678,65
"56203","E01022418",2011,819,170,649,144
"56204","E01022420",2011,910,52,858,79
"56205","E01022421",2011,735,214,521,70
"56206","E01022422",2011,642,35,607,76
"56207","E01022423",2011,839,79,760,53
"56208","E01022424",2011,658,226,432,60
"56209","E01022425",2011,499,33,466,31
"56210","E01022426",2011,642,5,637,34
"56211","E01022427",2011,643,37,606,126
"56212","E01022428",2011,797,256,541,105
"56213","E01022429",2011,672,17,655,91
"56214","E01022430",2011,632,24,608,30
"56215","E01022431",2011,893,10,883,163
"56216","E01022432",2011,950,66,884,98
"56217","E01022433",2011,854,48,806,48
"56218","E01022434",2011,852,11,841,40
"56219","E01022435",2011,958,293,665,48
"56220","E01022436",2011,914,87,827,101
"56221","E01022437",2011,584,89,495,65
"56222","E01022438",2011,604,11,593,83
"56223","E01022439",2011,710,17,693,144
"56224","E01022440",2011,735,58,677,187
"56225","E01022441",2011,667,48,619,104
"56226","E01022442",2011,618,44,574,49
"56227","E01022443",2011,548,29,519,31
"56228","E01022444",2011,579,8,571,44
"56229","E01022445",2011,564,65,499,86
"56230","E01022446",2011,762,46,716,100
"56231","E01022447",2011,473,83,390,257
"56232","E01022448",2011,580,92,488,63
"56233","E01022449",2011,848,38,810,119
"56234","E01022450",2011,885,263,622,141
"56235","E01022451",2011,636,46,590,59
"56236","E01022452",2011,534,15,519,53
"56237","E01022453",2011,648,12,636,46
"56238","E01022454",2011,861,217,644,43
"56239","E01022455",2011,812,30,782,48
"56240","E01022456",2011,539,46,493,64
"56241","E01022457",2011,600,214,386,42
"56242","E01022458",2011,668,402,266,39
"56243","E01022459",2011,850,98,752,318
"56244","E01022460",2011,832,175,657,105
"56245","E01022461",2011,635,37,598,43
"56246","E01022462",2011,695,42,653,39
"56247","E01022463",2011,718,76,642,133
"56248","E01022464",2011,743,225,518,53
"56249","E01022465",2011,627,28,599,45
"56250","E01022466",2011,748,26,722,108
"56251","E01022467",2011,668,23,645,39
"56252","E01022468",2011,749,52,697,83
"56253","E01022469",2011,662,119,543,43
"56254","E01022470",2011,791,9,782,106
"56255","E01022471",2011,619,11,608,69
"56256","E01022472",2011,500,22,478,56
"56257","E01022473",2011,504,18,486,40
"56258","E01022474",2011,614,209,405,80
"56259","E01022475",2011,719,38,681,119
"56260","E01022476",2011,696,18,678,61
"56261","E01022477",2011,633,132,501,86
"56262","E01022478",2011,621,288,333,55
"56263","E01022479",2011,599,277,322,54
"56264","E01022480",2011,494,165,329,37
"56265","E01022481",2011,753,106,647,108
"56266","E01022482",2011,712,188,524,109
"56267","E01022484",2011,504,267,237,30
"56268","E01022485",2011,465,189,276,34
"56269","E01022486",2011,801,226,575,70
"56270","E01022487",2011,484,197,287,33
"56271","E01022488",2011,451,135,316,58
"56272","E01022489",2011,548,62,486,70
"56273","E01022490",2011,742,114,628,40
"56274","E01022491",2011,746,200,546,53
"56275","E01022492",2011,661,46,615,134
"56276","E01022493",2011,521,56,465,52
"56277","E01022494",2011,1024,139,885,170
"56278","E01022495",2011,652,19,633,152
"56279","E01022496",2011,937,97,840,78
"56280","E01022497",2011,610,10,600,133
"56281","E01022498",2011,650,34,616,119
"56282","E01022499",2011,557,29,528,31
"56283","E01022500",2011,535,60,475,75
"56284","E01022502",2011,690,49,641,128
"56285","E01022503",2011,617,47,570,166
"56286","E01022504",2011,643,67,576,43
"56287","E01022505",2011,627,12,615,64
"56288","E01022506",2011,592,74,518,96
"56289","E01022507",2011,680,208,472,78
"56290","E01022509",2011,574,24,550,70
"56291","E01022510",2011,577,29,548,47
"56292","E01022511",2011,446,6,440,46
"56293","E01022512",2011,468,6,462,35
"56294","E01022513",2011,616,82,534,57
"56295","E01022514",2011,631,85,546,89
"56296","E01022515",2011,656,9,647,23
"56297","E01022516",2011,610,37,573,13
"56298","E01022517",2011,489,2,487,16
"56299","E01022518",2011,744,57,687,31
"56300","E01022519",2011,497,15,482,7
"56301","E01022520",2011,759,228,531,87
"56302","E01022521",2011,741,42,699,70
"56303","E01022522",2011,623,67,556,64
"56304","E01022523",2011,804,345,459,103
"56305","E01022524",2011,745,351,394,57
"56306","E01022525",2011,651,61,590,78
"56307","E01022526",2011,657,171,486,103
"56308","E01022527",2011,749,300,449,109
"56309","E01022528",2011,497,12,485,25
"56310","E01022529",2011,660,165,495,62
"56311","E01022530",2011,523,8,515,21
"56312","E01022531",2011,597,12,585,84
"56313","E01022532",2011,537,43,494,75
"56314","E01022533",2011,694,105,589,80
"56315","E01022534",2011,724,120,604,60
"56316","E01022535",2011,689,121,568,90
"56317","E01022536",2011,551,45,506,26
"56318","E01022537",2011,550,6,544,31
"56319","E01022539",2011,488,126,362,47
"56320","E01022540",2011,749,295,454,70
"56321","E01022542",2011,456,148,308,61
"56322","E01022543",2011,653,203,450,89
"56323","E01022546",2011,557,47,510,66
"56324","E01022547",2011,724,75,649,77
"56325","E01022548",2011,631,167,464,52
"56326","E01022549",2011,791,410,381,50
"56327","E01022550",2011,793,402,391,52
"56328","E01022551",2011,650,175,475,60
"56329","E01022552",2011,607,287,320,38
"56330","E01022553",2011,606,30,576,45
"56331","E01022554",2011,678,53,625,52
"56332","E01022555",2011,629,70,559,57
"56333","E01022556",2011,666,256,410,39
"56334","E01022557",2011,627,49,578,80
"56335","E01022558",2011,588,39,549,112
"56336","E01022559",2011,524,28,496,45
"56337","E01022560",2011,481,38,443,40
"56338","E01022561",2011,608,61,547,156
"56339","E01022562",2011,545,56,489,68
"56340","E01022563",2011,731,31,700,84
"56341","E01022564",2011,783,142,641,102
"56342","E01022565",2011,727,192,535,86
"56343","E01022566",2011,473,66,407,22
"56344","E01022567",2011,511,216,295,29
"56345","E01022568",2011,614,208,406,46
"56346","E01022569",2011,507,62,445,44
"56347","E01022570",2011,637,44,593,34
"56348","E01022571",2011,475,15,460,75
"56349","E01022572",2011,507,30,477,46
"56350","E01022573",2011,1066,51,1015,169
"56351","E01022574",2011,621,136,485,102
"56352","E01022575",2011,573,327,246,42
"56353","E01022576",2011,803,323,480,164
"56354","E01022577",2011,736,25,711,116
"56355","E01022578",2011,1174,164,1010,71
"56356","E01022579",2011,506,230,276,35
"56357","E01022580",2011,484,4,480,54
"56358","E01022581",2011,573,42,531,109
"56359","E01022582",2011,558,11,547,60
"56360","E01022583",2011,699,100,599,67
"56361","E01022584",2011,785,216,569,104
"56362","E01022585",2011,653,25,628,46
"56363","E01022586",2011,634,10,624,60
"56364","E01022587",2011,761,69,692,103
"56365","E01022588",2011,647,12,635,35
"56366","E01022589",2011,741,72,669,86
"56367","E01022590",2011,595,28,567,20
"56368","E01022591",2011,961,71,890,94
"56369","E01022592",2011,929,177,752,114
"56370","E01022593",2011,482,4,478,19
"56371","E01022594",2011,587,65,522,53
"56372","E01022595",2011,728,61,667,27
"56373","E01022596",2011,537,4,533,37
"56374","E01022597",2011,993,96,897,196
"56375","E01022599",2011,597,64,533,114
"56376","E01022600",2011,640,3,637,41
"56377","E01022601",2011,597,74,523,48
"56378","E01022602",2011,520,1,519,14
"56379","E01022603",2011,534,167,367,59
"56380","E01022604",2011,485,48,437,66
"56381","E01022605",2011,607,21,586,72
"56382","E01022606",2011,943,24,919,70
"56383","E01022607",2011,515,64,451,51
"56384","E01022608",2011,522,8,514,30
"56385","E01022610",2011,536,4,532,56
"56386","E01022611",2011,634,100,534,50
"56387","E01022613",2011,518,69,449,37
"56388","E01022614",2011,474,117,357,30
"56389","E01022615",2011,1101,141,960,94
"56390","E01022616",2011,735,213,522,109
"56391","E01022617",2011,657,42,615,83
"56392","E01022618",2011,671,14,657,63
"56393","E01022619",2011,517,9,508,91
"56394","E01022620",2011,489,91,398,72
"56395","E01022621",2011,607,273,334,40
"56396","E01022622",2011,568,60,508,57
"56397","E01022623",2011,940,149,791,124
"56398","E01022624",2011,1000,13,987,104
"56399","E01022625",2011,1090,122,968,104
"56400","E01022627",2011,880,82,798,116
"56401","E01022628",2011,520,51,469,82
"56402","E01022629",2011,618,50,568,52
"56403","E01022630",2011,939,89,850,134
"56404","E01022631",2011,514,42,472,52
"56405","E01022632",2011,453,33,420,41
"56406","E01022633",2011,608,20,588,80
"56407","E01022634",2011,498,109,389,74
"56408","E01022635",2011,514,215,299,17
"56409","E01022636",2011,499,61,438,40
"56410","E01022639",2011,567,96,471,238
"56411","E01022640",2011,571,171,400,94
"56412","E01022641",2011,519,40,479,81
"56413","E01022642",2011,420,16,404,42
"56414","E01022643",2011,667,55,612,52
"56415","E01022644",2011,511,70,441,44
"56416","E01022645",2011,494,2,492,23
"56417","E01022646",2011,650,36,614,69
"56418","E01022647",2011,618,13,605,53
"56419","E01022648",2011,612,116,496,77
"56420","E01022649",2011,656,376,280,35
"56421","E01022650",2011,461,35,426,46
"56422","E01022651",2011,794,5,789,103
"56423","E01022652",2011,746,168,578,54
"56424","E01022653",2011,616,30,586,55
"56425","E01022654",2011,572,35,537,83
"56426","E01022655",2011,558,408,150,20
"56427","E01022656",2011,604,84,520,56
"56428","E01022657",2011,745,78,667,142
"56429","E01022658",2011,721,38,683,80
"56430","E01022659",2011,630,6,624,85
"56431","E01022660",2011,663,118,545,69
"56432","E01022661",2011,799,8,791,104
"56433","E01022662",2011,543,8,535,24
"56434","E01022663",2011,635,15,620,73
"56435","E01022664",2011,646,8,638,70
"56436","E01022665",2011,748,121,627,122
"56437","E01022666",2011,930,80,850,291
"56438","E01022667",2011,614,55,559,71
"56439","E01022668",2011,1010,214,796,282
"56440","E01022669",2011,740,93,647,211
"56441","E01022670",2011,671,291,380,105
"56442","E01022671",2011,719,187,532,157
"56443","E01022672",2011,623,132,491,50
"56444","E01022673",2011,864,175,689,168
"56445","E01022674",2011,716,93,623,91
"56446","E01022675",2011,566,5,561,36
"56447","E01022676",2011,608,30,578,45
"56448","E01022677",2011,849,326,523,72
"56449","E01022678",2011,718,176,542,54
"56450","E01022679",2011,736,106,630,141
"56451","E01022680",2011,779,392,387,33
"56452","E01022681",2011,640,254,386,55
"56453","E01022682",2011,508,10,498,12
"56454","E01022683",2011,544,25,519,41
"56455","E01022684",2011,592,3,589,44
"56456","E01022685",2011,553,59,494,78
"56457","E01022686",2011,615,31,584,62
"56458","E01022687",2011,671,2,669,73
"56459","E01022688",2011,1037,52,985,242
"56460","E01022689",2011,659,26,633,70
"56461","E01022690",2011,821,196,625,149
"56462","E01022691",2011,627,16,611,99
"56463","E01022692",2011,1110,184,926,173
"56464","E01022693",2011,544,5,539,65
"56465","E01022694",2011,672,35,637,120
"56466","E01022695",2011,594,82,512,70
"56467","E01022696",2011,644,2,642,32
"56468","E01022697",2011,610,25,585,34
"56469","E01022698",2011,652,8,644,37
"56470","E01022699",2011,620,9,611,62
"56471","E01022700",2011,677,157,520,77
"56472","E01022701",2011,416,60,356,14
"56473","E01022702",2011,496,5,491,79
"56474","E01022703",2011,665,71,594,81
"56475","E01022704",2011,745,6,739,57
"56476","E01022705",2011,652,12,640,28
"56477","E01022706",2011,647,1,646,19
"56478","E01022707",2011,761,13,748,59
"56479","E01022708",2011,736,4,732,115
"56480","E01022709",2011,691,4,687,76
"56481","E01022710",2011,964,158,806,187
"56482","E01022711",2011,749,319,430,62
"56483","E01022712",2011,685,28,657,124
"56484","E01022713",2011,695,64,631,75
"56485","E01022714",2011,720,33,687,41
"56486","E01022715",2011,747,63,684,129
"56487","E01022716",2011,765,93,672,175
"56488","E01022717",2011,523,8,515,69
"56489","E01022718",2011,605,57,548,50
"56490","E01022719",2011,693,43,650,57
"56491","E01022720",2011,525,1,524,30
"56492","E01022721",2011,634,12,622,92
"56493","E01022722",2011,703,55,648,92
"56494","E01022723",2011,723,105,618,172
"56495","E01022724",2011,577,50,527,56
"56496","E01022725",2011,496,3,493,16
"56497","E01022726",2011,607,43,564,23
"56498","E01022727",2011,655,26,629,40
"56499","E01022728",2011,841,96,745,226
"56500","E01022729",2011,455,14,441,51
"56501","E01022730",2011,631,30,601,42
"56502","E01022731",2011,515,25,490,35
"56503","E01022732",2011,666,302,364,46
"56504","E01022733",2011,735,148,587,50
"56505","E01022734",2011,515,132,383,48
"56506","E01022735",2011,619,76,543,93
"56507","E01022736",2011,662,94,568,57
"56508","E01022737",2011,652,39,613,94
"56509","E01022738",2011,483,186,297,33
"56510","E01022739",2011,673,312,361,61
"56511","E01022740",2011,727,6,721,37
"56512","E01022741",2011,466,11,455,116
"56513","E01022742",2011,872,4,868,48
"56514","E01022743",2011,806,49,757,64
"56515","E01022744",2011,567,3,564,31
"56516","E01022745",2011,633,5,628,38
"56517","E01022746",2011,703,17,686,134
"56518","E01022747",2011,586,56,530,58
"56519","E01022748",2011,629,4,625,76
"56520","E01022749",2011,536,20,516,24
"56521","E01022750",2011,631,6,625,53
"56522","E01022751",2011,652,64,588,46
"56523","E01022752",2011,542,3,539,22
"56524","E01022753",2011,493,63,430,45
"56525","E01022754",2011,760,106,654,135
"56526","E01022755",2011,610,67,543,43
"56527","E01022756",2011,524,4,520,50
"56528","E01022757",2011,695,17,678,161
"56529","E01022758",2011,600,86,514,36
"56530","E01022759",2011,660,14,646,43
"56531","E01022760",2011,644,72,572,56
"56532","E01022761",2011,657,126,531,57
"56533","E01022762",2011,639,13,626,53
"56534","E01022763",2011,686,5,681,27
"56535","E01022764",2011,761,134,627,52
"56536","E01022765",2011,760,7,753,52
"56537","E01022766",2011,529,3,526,33
"56538","E01022767",2011,511,24,487,29
"56539","E01022768",2011,599,74,525,44
"56540","E01022769",2011,552,28,524,85
"56541","E01022770",2011,693,12,681,38
"56542","E01022771",2011,601,6,595,84
"56543","E01022772",2011,793,30,763,85
"56544","E01022773",2011,651,31,620,60
"56545","E01022774",2011,739,10,729,60
"56546","E01022776",2011,627,29,598,55
"56547","E01022777",2011,769,139,630,44
"56548","E01022778",2011,598,11,587,51
"56549","E01022780",2011,614,61,553,101
"56550","E01022781",2011,564,128,436,98
"56551","E01022782",2011,646,32,614,93
"56552","E01022783",2011,641,3,638,48
"56553","E01022784",2011,500,5,495,28
"56554","E01022785",2011,614,53,561,38
"56555","E01022786",2011,653,68,585,40
"56556","E01022787",2011,541,59,482,52
"56557","E01022788",2011,528,60,468,79
"56558","E01022789",2011,634,16,618,98
"56559","E01022790",2011,712,3,709,98
"56560","E01022791",2011,838,36,802,126
"56561","E01022792",2011,626,61,565,67
"56562","E01022793",2011,681,5,676,52
"56563","E01022794",2011,626,4,622,90
"56564","E01022795",2011,740,7,733,131
"56565","E01022796",2011,496,34,462,21
"56566","E01022797",2011,451,18,433,57
"56567","E01022798",2011,497,77,420,48
"56568","E01022799",2011,582,22,560,68
"56569","E01022800",2011,645,159,486,41
"56570","E01022801",2011,644,246,398,41
"56571","E01022802",2011,607,53,554,40
"56572","E01022803",2011,626,217,409,45
"56573","E01022804",2011,680,114,566,55
"56574","E01022805",2011,646,215,431,63
"56575","E01022806",2011,602,42,560,106
"56576","E01022807",2011,760,141,619,191
"56577","E01022810",2011,731,99,632,180
"56578","E01022811",2011,1093,150,943,364
"56579","E01022812",2011,529,11,518,82
"56580","E01022813",2011,546,7,539,57
"56581","E01022814",2011,762,128,634,122
"56582","E01022815",2011,619,16,603,71
"56583","E01022816",2011,615,113,502,77
"56584","E01022817",2011,709,162,547,93
"56585","E01022818",2011,606,228,378,69
"56586","E01022819",2011,671,38,633,224
"56587","E01022820",2011,610,226,384,190
"56588","E01022823",2011,644,15,629,85
"56589","E01022824",2011,1210,114,1096,316
"56590","E01022825",2011,591,24,567,70
"56591","E01022826",2011,675,7,668,67
"56592","E01022828",2011,764,23,741,157
"56593","E01022829",2011,805,43,762,189
"56594","E01022830",2011,639,4,635,58
"56595","E01022831",2011,636,39,597,92
"56596","E01022832",2011,697,20,677,134
"56597","E01022833",2011,867,372,495,173
"56598","E01022834",2011,614,152,462,39
"56599","E01022835",2011,627,94,533,87
"56600","E01022836",2011,639,30,609,29
"56601","E01022837",2011,676,21,655,53
"56602","E01022838",2011,520,1,519,30
"56603","E01022839",2011,639,229,410,85
"56604","E01022840",2011,664,254,410,59
"56605","E01022841",2011,608,208,400,157
"56606","E01022842",2011,607,126,481,236
"56607","E01022843",2011,703,361,342,72
"56608","E01022845",2011,675,63,612,138
"56609","E01022846",2011,456,20,436,72
"56610","E01022847",2011,746,27,719,121
"56611","E01022848",2011,631,14,617,43
"56612","E01022849",2011,646,57,589,45
"56613","E01022850",2011,631,9,622,99
"56614","E01022851",2011,662,8,654,44
"56615","E01022852",2011,754,38,716,155
"56616","E01022853",2011,693,8,685,40
"56617","E01022854",2011,648,25,623,55
"56618","E01022855",2011,504,97,407,39
"56619","E01022856",2011,591,67,524,44
"56620","E01022857",2011,444,19,425,242
"56621","E01022858",2011,410,35,375,62
"56622","E01022859",2011,622,56,566,49
"56623","E01022860",2011,889,42,847,134
"56624","E01022861",2011,643,4,639,36
"56625","E01022862",2011,945,49,896,247
"56626","E01022863",2011,631,10,621,39
"56627","E01022864",2011,636,160,476,28
"56628","E01022865",2011,628,2,626,19
"56629","E01022867",2011,645,36,609,144
"56630","E01022868",2011,674,32,642,28
"56631","E01022869",2011,607,40,567,50
"56632","E01022870",2011,584,35,549,49
"56633","E01022871",2011,562,127,435,67
"56634","E01022872",2011,714,33,681,87
"56635","E01022873",2011,638,55,583,22
"56636","E01022874",2011,491,25,466,35
"56637","E01022875",2011,485,95,390,30
"56638","E01022876",2011,499,4,495,45
"56639","E01022877",2011,543,24,519,28
"56640","E01022878",2011,705,9,696,45
"56641","E01022879",2011,806,140,666,144
"56642","E01022880",2011,628,173,455,66
"56643","E01022881",2011,915,151,764,88
"56644","E01022882",2011,565,9,556,74
"56645","E01022883",2011,524,26,498,53
"56646","E01022884",2011,666,98,568,67
"56647","E01022885",2011,544,21,523,61
"56648","E01022887",2011,550,20,530,69
"56649","E01022888",2011,739,46,693,115
"56650","E01022889",2011,638,179,459,60
"56651","E01022890",2011,612,192,420,42
"56652","E01022891",2011,650,26,624,74
"56653","E01022892",2011,782,23,759,57
"56654","E01022893",2011,627,35,592,32
"56655","E01022894",2011,622,110,512,46
"56656","E01022895",2011,738,11,727,66
"56657","E01022896",2011,594,7,587,32
"56658","E01022897",2011,627,4,623,58
"56659","E01022898",2011,581,3,578,19
"56660","E01022899",2011,503,141,362,33
"56661","E01022900",2011,747,280,467,73
"56662","E01022901",2011,643,195,448,65
"56663","E01022902",2011,575,175,400,42
"56664","E01022903",2011,776,397,379,63
"56665","E01022904",2011,766,210,556,59
"56666","E01022905",2011,823,481,342,88
"56667","E01022906",2011,570,248,322,41
"56668","E01022907",2011,632,85,547,35
"56669","E01022908",2011,593,161,432,60
"56670","E01022909",2011,628,25,603,40
"56671","E01022910",2011,654,61,593,133
"56672","E01022911",2011,638,62,576,46
"56673","E01022913",2011,549,264,285,31
"56674","E01022914",2011,543,211,332,35
"56675","E01022915",2011,621,326,295,51
"56676","E01022916",2011,639,174,465,57
"56677","E01022917",2011,528,249,279,39
"56678","E01022918",2011,667,107,560,41
"56679","E01022919",2011,644,73,571,66
"56680","E01022920",2011,657,11,646,55
"56681","E01022921",2011,651,12,639,46
"56682","E01022922",2011,675,5,670,157
"56683","E01022924",2011,719,74,645,96
"56684","E01022925",2011,594,58,536,49
"56685","E01022926",2011,625,35,590,63
"56686","E01022927",2011,719,204,515,49
"56687","E01022928",2011,815,11,804,74
"56688","E01022929",2011,857,52,805,211
"56689","E01022930",2011,753,16,737,28
"56690","E01022931",2011,641,6,635,26
"56691","E01022933",2011,711,428,283,31
"56692","E01022934",2011,798,389,409,67
"56693","E01022935",2011,650,68,582,33
"56694","E01022936",2011,776,41,735,183
"56695","E01022937",2011,585,131,454,37
"56696","E01022938",2011,638,14,624,98
"56697","E01022939",2011,697,69,628,60
"56698","E01022940",2011,729,87,642,96
"56699","E01022941",2011,694,8,686,73
"56700","E01022942",2011,830,191,639,226
"56701","E01022943",2011,650,3,647,35
"56702","E01022944",2011,536,7,529,25
"56703","E01022945",2011,1049,29,1020,162
"56704","E01022946",2011,775,30,745,83
"56705","E01022947",2011,633,6,627,44
"56706","E01022948",2011,687,29,658,77
"56707","E01022949",2011,757,361,396,59
"56708","E01022950",2011,584,9,575,28
"56709","E01022951",2011,562,21,541,23
"56710","E01022952",2011,629,16,613,59
"56711","E01022953",2011,1030,178,852,271
"56712","E01022954",2011,693,6,687,60
"56713","E01022955",2011,615,26,589,46
"56714","E01022956",2011,496,111,385,41
"56715","E01022957",2011,522,111,411,38
"56716","E01022958",2011,613,3,610,42
"56717","E01022959",2011,556,263,293,30
"56718","E01022960",2011,508,97,411,76
"56719","E01022961",2011,492,84,408,44
"56720","E01022962",2011,608,70,538,35
"56721","E01022963",2011,621,114,507,59
"56722","E01022964",2011,653,266,387,96
"56723","E01022965",2011,601,297,304,31
"56724","E01022966",2011,516,235,281,38
"56725","E01022967",2011,513,335,178,28
"56726","E01022968",2011,525,309,216,31
"56727","E01022969",2011,607,280,327,72
"56728","E01022970",2011,692,297,395,73
"56729","E01022971",2011,722,9,713,118
"56730","E01022972",2011,646,2,644,52
"56731","E01022973",2011,867,234,633,104
"56732","E01022974",2011,597,4,593,80
"56733","E01022975",2011,688,27,661,41
"56734","E01022976",2011,689,245,444,33
"56735","E01022977",2011,609,7,602,38
"56736","E01022978",2011,633,18,615,56
"56737","E01022979",2011,498,39,459,32
"56738","E01022980",2011,549,17,532,52
"56739","E01022981",2011,909,1,908,45
"56740","E01022982",2011,935,53,882,121
"56741","E01022983",2011,808,5,803,48
"56742","E01022984",2011,654,4,650,45
"56743","E01022985",2011,528,5,523,66
"56744","E01022986",2011,642,12,630,43
"56745","E01022987",2011,909,7,902,77
"56746","E01022988",2011,676,188,488,96
"56747","E01022989",2011,719,88,631,47
"56748","E01022990",2011,651,72,579,84
"56749","E01022991",2011,891,12,879,90
"56750","E01022992",2011,484,4,480,42
"56751","E01022993",2011,564,49,515,84
"56752","E01022994",2011,670,36,634,51
"56753","E01022995",2011,589,13,576,42
"56754","E01022996",2011,515,53,462,64
"56755","E01022997",2011,585,68,517,71
"56756","E01022998",2011,680,10,670,53
"56757","E01022999",2011,906,84,822,228
"56758","E01023000",2011,791,105,686,96
"56759","E01023001",2011,861,36,825,201
"56760","E01023002",2011,777,218,559,112
"56761","E01023003",2011,779,102,677,42
"56762","E01023004",2011,709,62,647,45
"56763","E01023005",2011,627,16,611,20
"56764","E01023006",2011,501,233,268,31
"56765","E01023007",2011,507,33,474,35
"56766","E01023008",2011,859,87,772,145
"56767","E01023009",2011,648,26,622,98
"56768","E01023010",2011,655,149,506,112
"56769","E01023011",2011,614,87,527,107
"56770","E01023012",2011,593,40,553,120
"56771","E01023013",2011,650,74,576,45
"56772","E01023014",2011,720,54,666,63
"56773","E01023015",2011,599,59,540,107
"56774","E01023016",2011,614,2,612,29
"56775","E01023017",2011,810,199,611,52
"56776","E01023018",2011,679,229,450,57
"56777","E01023019",2011,668,152,516,126
"56778","E01023020",2011,624,9,615,39
"56779","E01023021",2011,625,11,614,52
"56780","E01023022",2011,888,144,744,227
"56781","E01023023",2011,754,193,561,68
"56782","E01023024",2011,629,8,621,47
"56783","E01023025",2011,588,2,586,49
"56784","E01023026",2011,476,11,465,72
"56785","E01023027",2011,592,102,490,62
"56786","E01023028",2011,859,144,715,123
"56787","E01023029",2011,621,447,174,19
"56788","E01023030",2011,507,25,482,67
"56789","E01023031",2011,548,12,536,81
"56790","E01023032",2011,549,50,499,28
"56791","E01023033",2011,524,132,392,43
"56792","E01023034",2011,785,78,707,55
"56793","E01023035",2011,732,41,691,54
"56794","E01023036",2011,936,28,908,49
"56795","E01023037",2011,931,315,616,101
"56796","E01023038",2011,634,10,624,41
"56797","E01023039",2011,666,78,588,81
"56798","E01023040",2011,673,4,669,53
"56799","E01023041",2011,743,60,683,95
"56800","E01023042",2011,893,114,779,265
"56801","E01023043",2011,835,20,815,174
"56802","E01023044",2011,535,5,530,43
"56803","E01023045",2011,716,19,697,76
"56804","E01023046",2011,658,151,507,121
"56805","E01023047",2011,546,16,530,85
"56806","E01023048",2011,525,78,447,30
"56807","E01023049",2011,682,51,631,182
"56808","E01023050",2011,693,71,622,185
"56809","E01023051",2011,658,45,613,81
"56810","E01023052",2011,890,4,886,82
"56811","E01023053",2011,859,9,850,125
"56812","E01023054",2011,849,39,810,141
"56813","E01023055",2011,511,239,272,40
"56814","E01023056",2011,811,83,728,131
"56815","E01023057",2011,903,60,843,221
"56816","E01023058",2011,645,331,314,31
"56817","E01023059",2011,774,37,737,83
"56818","E01023060",2011,590,22,568,38
"56819","E01023061",2011,667,215,452,78
"56820","E01023062",2011,564,27,537,38
"56821","E01023063",2011,466,24,442,96
"56822","E01023064",2011,536,30,506,66
"56823","E01023065",2011,680,135,545,63
"56824","E01023066",2011,695,56,639,47
"56825","E01023067",2011,616,4,612,53
"56826","E01023068",2011,525,170,355,53
"56827","E01023069",2011,669,51,618,96
"56828","E01023070",2011,925,142,783,283
"56829","E01023071",2011,646,32,614,195
"56830","E01023072",2011,547,8,539,83
"56831","E01023073",2011,518,5,513,46
"56832","E01023074",2011,649,23,626,76
"56833","E01023075",2011,486,70,416,35
"56834","E01023076",2011,637,28,609,35
"56835","E01023077",2011,712,161,551,156
"56836","E01023078",2011,633,37,596,40
"56837","E01023079",2011,693,93,600,69
"56838","E01023080",2011,526,28,498,61
"56839","E01023081",2011,749,107,642,55
"56840","E01023082",2011,617,73,544,76
"56841","E01023083",2011,660,205,455,76
"56842","E01023084",2011,627,20,607,45
"56843","E01023085",2011,635,174,461,60
"56844","E01023086",2011,640,112,528,35
"56845","E01023087",2011,624,12,612,126
"56846","E01023088",2011,636,196,440,42
"56847","E01023089",2011,716,25,691,110
"56848","E01023090",2011,823,71,752,141
"56849","E01023091",2011,670,296,374,85
"56850","E01023092",2011,569,8,561,47
"56851","E01023093",2011,524,7,517,37
"56852","E01023094",2011,558,23,535,63
"56853","E01023095",2011,743,123,620,137
"56854","E01023096",2011,910,56,854,138
"56855","E01023097",2011,570,5,565,76
"56856","E01023098",2011,669,52,617,116
"56857","E01023099",2011,609,185,424,41
"56858","E01023100",2011,484,49,435,48
"56859","E01023101",2011,487,8,479,34
"56860","E01023102",2011,541,4,537,32
"56861","E01023103",2011,631,29,602,65
"56862","E01023104",2011,601,178,423,43
"56863","E01023105",2011,602,265,337,50
"56864","E01023106",2011,567,174,393,75
"56865","E01023107",2011,611,293,318,27
"56866","E01023108",2011,592,349,243,18
"56867","E01023109",2011,592,3,589,88
"56868","E01023110",2011,705,222,483,62
"56869","E01023111",2011,756,80,676,62
"56870","E01023112",2011,467,6,461,23
"56871","E01023113",2011,668,72,596,112
"56872","E01023114",2011,547,42,505,73
"56873","E01023115",2011,464,6,458,42
"56874","E01023116",2011,665,29,636,150
"56875","E01023117",2011,674,13,661,54
"56876","E01023118",2011,675,85,590,147
"56877","E01023119",2011,466,299,167,31
"56878","E01023120",2011,608,215,393,66
"56879","E01023121",2011,770,180,590,39
"56880","E01023122",2011,500,133,367,74
"56881","E01023123",2011,579,37,542,82
"56882","E01023124",2011,486,32,454,79
"56883","E01023125",2011,920,129,791,113
"56884","E01023128",2011,607,124,483,64
"56885","E01023129",2011,531,33,498,133
"56886","E01023130",2011,549,27,522,31
"56887","E01023131",2011,585,114,471,75
"56888","E01023132",2011,614,109,505,51
"56889","E01023133",2011,525,13,512,75
"56890","E01023134",2011,703,22,681,103
"56891","E01023135",2011,945,151,794,128
"56892","E01023136",2011,657,69,588,256
"56893","E01023137",2011,520,34,486,116
"56894","E01023138",2011,654,109,545,192
"56895","E01023139",2011,531,138,393,78
"56896","E01023140",2011,603,158,445,342
"56897","E01023141",2011,630,94,536,469
"56898","E01023142",2011,853,182,671,460
"56899","E01023143",2011,699,139,560,402
"56900","E01023144",2011,674,62,612,295
"56901","E01023145",2011,938,110,828,376
"56902","E01023146",2011,472,155,317,41
"56903","E01023147",2011,565,23,542,33
"56904","E01023148",2011,602,36,566,67
"56905","E01023149",2011,543,25,518,31
"56906","E01023150",2011,727,99,628,129
"56907","E01023151",2011,782,248,534,142
"56908","E01023152",2011,858,136,722,111
"56909","E01023153",2011,742,251,491,101
"56910","E01023154",2011,636,332,304,34
"56911","E01023155",2011,1086,382,704,133
"56912","E01023156",2011,470,265,205,34
"56913","E01023157",2011,534,230,304,44
"56914","E01023158",2011,916,38,878,104
"56915","E01023159",2011,931,97,834,126
"56916","E01023160",2011,600,37,563,66
"56917","E01023162",2011,669,40,629,68
"56918","E01023163",2011,663,5,658,48
"56919","E01023164",2011,654,87,567,62
"56920","E01023165",2011,867,104,763,138
"56921","E01023166",2011,646,84,562,94
"56922","E01023167",2011,697,89,608,97
"56923","E01023168",2011,644,50,594,70
"56924","E01023169",2011,839,41,798,58
"56925","E01023170",2011,703,95,608,129
"56926","E01023171",2011,595,22,573,48
"56927","E01023172",2011,615,7,608,25
"56928","E01023173",2011,588,5,583,35
"56929","E01023174",2011,721,27,694,84
"56930","E01023175",2011,701,13,688,51
"56931","E01023176",2011,719,121,598,71
"56932","E01023177",2011,883,149,734,132
"56933","E01023178",2011,917,109,808,200
"56934","E01023179",2011,706,169,537,96
"56935","E01023180",2011,701,53,648,107
"56936","E01023181",2011,513,41,472,62
"56937","E01023182",2011,642,80,562,81
"56938","E01023183",2011,583,151,432,41
"56939","E01023184",2011,516,21,495,108
"56940","E01023185",2011,513,111,402,31
"56941","E01023186",2011,721,125,596,77
"56942","E01023187",2011,632,15,617,119
"56943","E01023188",2011,515,28,487,52
"56944","E01023189",2011,609,30,579,168
"56945","E01023190",2011,561,97,464,96
"56946","E01023191",2011,778,39,739,90
"56947","E01023192",2011,822,302,520,57
"56948","E01023193",2011,660,29,631,41
"56949","E01023194",2011,642,10,632,36
"56950","E01023195",2011,722,93,629,263
"56951","E01023196",2011,692,96,596,93
"56952","E01023197",2011,584,77,507,144
"56953","E01023198",2011,619,79,540,71
"56954","E01023199",2011,634,94,540,121
"56955","E01023200",2011,598,9,589,57
"56956","E01023201",2011,625,138,487,53
"56957","E01023202",2011,971,403,568,259
"56958","E01023203",2011,668,85,583,69
"56959","E01023204",2011,741,185,556,182
"56960","E01023205",2011,455,191,264,25
"56961","E01023206",2011,497,96,401,36
"56962","E01023207",2011,645,10,635,36
"56963","E01023208",2011,484,100,384,49
"56964","E01023209",2011,544,5,539,54
"56965","E01023210",2011,532,2,530,42
"56966","E01023211",2011,679,64,615,87
"56967","E01023212",2011,592,6,586,38
"56968","E01023213",2011,498,26,472,42
"56969","E01023214",2011,530,1,529,50
"56970","E01023215",2011,669,103,566,74
"56971","E01023216",2011,847,170,677,209
"56972","E01023217",2011,670,8,662,96
"56973","E01023218",2011,627,13,614,57
"56974","E01023219",2011,617,174,443,40
"56975","E01023220",2011,838,28,810,98
"56976","E01023221",2011,819,186,633,97
"56977","E01023222",2011,631,7,624,73
"56978","E01023223",2011,599,191,408,29
"56979","E01023224",2011,502,52,450,214
"56980","E01023225",2011,830,76,754,181
"56981","E01023226",2011,638,79,559,80
"56982","E01023227",2011,796,191,605,61
"56983","E01023228",2011,869,17,852,54
"56984","E01023229",2011,776,93,683,100
"56985","E01023230",2011,807,11,796,86
"56986","E01023231",2011,695,19,676,47
"56987","E01023232",2011,737,36,701,60
"56988","E01023233",2011,630,10,620,55
"56989","E01023234",2011,665,160,505,49
"56990","E01023235",2011,841,83,758,91
"56991","E01023236",2011,804,64,740,114
"56992","E01023237",2011,563,267,296,24
"56993","E01023238",2011,587,22,565,54
"56994","E01023239",2011,654,24,630,75
"56995","E01023240",2011,879,59,820,118
"56996","E01023241",2011,518,36,482,31
"56997","E01023242",2011,491,3,488,61
"56998","E01023243",2011,617,8,609,162
"56999","E01023244",2011,655,18,637,27
"57000","E01023245",2011,917,59,858,76
"57001","E01023246",2011,575,54,521,73
"57002","E01023247",2011,631,98,533,45
"57003","E01023248",2011,685,15,670,32
"57004","E01023249",2011,524,134,390,37
"57005","E01023250",2011,681,266,415,53
"57006","E01023251",2011,635,304,331,139
"57007","E01023252",2011,961,244,717,334
"57008","E01023253",2011,709,115,594,69
"57009","E01023254",2011,831,150,681,161
"57010","E01023255",2011,700,293,407,93
"57011","E01023256",2011,620,385,235,62
"57012","E01023257",2011,688,240,448,96
"57013","E01023258",2011,524,212,312,62
"57014","E01023259",2011,553,94,459,72
"57015","E01023260",2011,493,327,166,75
"57016","E01023261",2011,616,345,271,117
"57017","E01023262",2011,499,219,280,121
"57018","E01023263",2011,596,48,548,126
"57019","E01023264",2011,680,115,565,229
"57020","E01023265",2011,816,163,653,168
"57021","E01023266",2011,569,139,430,110
"57022","E01023267",2011,534,58,476,142
"57023","E01023268",2011,485,19,466,84
"57024","E01023269",2011,651,39,612,132
"57025","E01023270",2011,456,92,364,60
"57026","E01023271",2011,454,58,396,34
"57027","E01023272",2011,520,9,511,51
"57028","E01023273",2011,579,19,560,38
"57029","E01023274",2011,626,67,559,92
"57030","E01023275",2011,580,84,496,49
"57031","E01023276",2011,585,30,555,34
"57032","E01023277",2011,494,13,481,35
"57033","E01023278",2011,727,77,650,58
"57034","E01023279",2011,613,16,597,53
"57035","E01023280",2011,588,65,523,78
"57036","E01023281",2011,833,184,649,100
"57037","E01023282",2011,814,93,721,97
"57038","E01023284",2011,1170,124,1046,261
"57039","E01023285",2011,696,203,493,57
"57040","E01023286",2011,591,102,489,113
"57041","E01023287",2011,1068,35,1033,229
"57042","E01023288",2011,577,61,516,93
"57043","E01023289",2011,525,6,519,12
"57044","E01023290",2011,632,47,585,43
"57045","E01023291",2011,612,11,601,62
"57046","E01023292",2011,629,9,620,66
"57047","E01023293",2011,661,78,583,29
"57048","E01023294",2011,712,293,419,47
"57049","E01023295",2011,567,115,452,36
"57050","E01023296",2011,636,175,461,36
"57051","E01023297",2011,507,8,499,35
"57052","E01023298",2011,651,33,618,44
"57053","E01023299",2011,671,20,651,87
"57054","E01023300",2011,632,162,470,107
"57055","E01023301",2011,683,106,577,170
"57056","E01023302",2011,685,224,461,44
"57057","E01023303",2011,618,121,497,75
"57058","E01023304",2011,638,116,522,48
"57059","E01023305",2011,504,18,486,50
"57060","E01023306",2011,619,58,561,49
"57061","E01023307",2011,539,28,511,21
"57062","E01023308",2011,632,12,620,27
"57063","E01023309",2011,621,1,620,24
"57064","E01023310",2011,881,261,620,176
"57065","E01023311",2011,653,38,615,59
"57066","E01023312",2011,576,20,556,26
"57067","E01023313",2011,630,15,615,15
"57068","E01023314",2011,510,43,467,30
"57069","E01023315",2011,627,34,593,45
"57070","E01023316",2011,512,9,503,19
"57071","E01023317",2011,906,73,833,106
"57072","E01023318",2011,597,11,586,42
"57073","E01023319",2011,633,35,598,20
"57074","E01023320",2011,982,98,884,264
"57075","E01023321",2011,842,51,791,86
"57076","E01023322",2011,745,93,652,118
"57077","E01023323",2011,798,321,477,134
"57078","E01023324",2011,519,62,457,20
"57079","E01023325",2011,620,64,556,47
"57080","E01023326",2011,666,190,476,58
"57081","E01023327",2011,551,68,483,62
"57082","E01023328",2011,509,67,442,48
"57083","E01023329",2011,502,66,436,22
"57084","E01023330",2011,607,105,502,84
"57085","E01023331",2011,598,115,483,49
"57086","E01023332",2011,888,46,842,150
"57087","E01023333",2011,786,174,612,165
"57088","E01023334",2011,688,8,680,67
"57089","E01023335",2011,655,12,643,58
"57090","E01023336",2011,821,114,707,180
"57091","E01023337",2011,650,64,586,132
"57092","E01023338",2011,1098,391,707,227
"57093","E01023339",2011,594,238,356,64
"57094","E01023340",2011,722,65,657,121
"57095","E01023341",2011,719,70,649,56
"57096","E01023342",2011,1109,243,866,194
"57097","E01023343",2011,728,329,399,54
"57098","E01023344",2011,762,63,699,89
"57099","E01023345",2011,651,119,532,103
"57100","E01023346",2011,534,148,386,42
"57101","E01023347",2011,514,115,399,32
"57102","E01023348",2011,688,392,296,72
"57103","E01023349",2011,780,346,434,61
"57104","E01023350",2011,661,290,371,35
"57105","E01023351",2011,663,112,551,81
"57106","E01023352",2011,1015,112,903,96
"57107","E01023354",2011,691,29,662,113
"57108","E01023355",2011,620,67,553,46
"57109","E01023356",2011,457,56,401,37
"57110","E01023357",2011,675,309,366,41
"57111","E01023358",2011,521,209,312,62
"57112","E01023359",2011,670,252,418,37
"57113","E01023360",2011,543,105,438,41
"57114","E01023361",2011,924,103,821,285
"57115","E01023362",2011,790,5,785,100
"57116","E01023363",2011,629,7,622,66
"57117","E01023364",2011,509,5,504,35
"57118","E01023365",2011,566,81,485,129
"57119","E01023366",2011,645,233,412,60
"57120","E01023367",2011,405,7,398,12
"57121","E01023368",2011,677,29,648,113
"57122","E01023369",2011,622,311,311,34
"57123","E01023370",2011,726,112,614,106
"57124","E01023371",2011,514,71,443,17
"57125","E01023372",2011,539,14,525,26
"57126","E01023373",2011,505,76,429,56
"57127","E01023374",2011,612,26,586,102
"57128","E01023375",2011,641,89,552,34
"57129","E01023376",2011,534,112,422,68
"57130","E01023377",2011,499,5,494,28
"57131","E01023378",2011,590,8,582,46
"57132","E01023379",2011,675,55,620,84
"57133","E01023380",2011,481,22,459,46
"57134","E01023381",2011,516,14,502,29
"57135","E01023382",2011,678,169,509,76
"57136","E01023383",2011,597,126,471,62
"57137","E01023384",2011,780,284,496,74
"57138","E01023385",2011,687,172,515,37
"57139","E01023386",2011,608,243,365,72
"57140","E01023387",2011,502,194,308,35
"57141","E01023388",2011,652,118,534,95
"57142","E01023389",2011,659,74,585,56
"57143","E01023390",2011,874,264,610,88
"57144","E01023391",2011,693,128,565,75
"57145","E01023392",2011,633,236,397,44
"57146","E01023393",2011,884,412,472,123
"57147","E01023394",2011,506,107,399,52
"57148","E01023395",2011,628,211,417,76
"57149","E01023396",2011,594,135,459,49
"57150","E01023397",2011,518,298,220,32
"57151","E01023398",2011,1077,149,928,296
"57152","E01023399",2011,848,215,633,170
"57153","E01023400",2011,878,279,599,141
"57154","E01023401",2011,720,358,362,65
"57155","E01023402",2011,654,218,436,77
"57156","E01023403",2011,670,261,409,75
"57157","E01023404",2011,529,357,172,39
"57158","E01023405",2011,621,343,278,59
"57159","E01023406",2011,872,188,684,108
"57160","E01023407",2011,640,84,556,55
"57161","E01023408",2011,623,30,593,55
"57162","E01023409",2011,633,137,496,72
"57163","E01023410",2011,540,39,501,17
"57164","E01023411",2011,594,158,436,46
"57165","E01023412",2011,498,18,480,8
"57166","E01023413",2011,536,170,366,39
"57167","E01023414",2011,595,161,434,83
"57168","E01023415",2011,537,86,451,25
"57169","E01023416",2011,652,14,638,82
"57170","E01023417",2011,665,130,535,79
"57171","E01023418",2011,628,282,346,33
"57172","E01023419",2011,830,101,729,109
"57173","E01023420",2011,611,45,566,64
"57174","E01023421",2011,642,58,584,87
"57175","E01023422",2011,484,5,479,33
"57176","E01023423",2011,549,42,507,29
"57177","E01023424",2011,564,65,499,55
"57178","E01023425",2011,522,27,495,45
"57179","E01023426",2011,715,77,638,174
"57180","E01023427",2011,649,246,403,32
"57181","E01023428",2011,625,43,582,104
"57182","E01023429",2011,800,403,397,54
"57183","E01023430",2011,490,42,448,49
"57184","E01023431",2011,502,79,423,69
"57185","E01023432",2011,579,65,514,57
"57186","E01023433",2011,676,168,508,104
"57187","E01023434",2011,663,105,558,125
"57188","E01023435",2011,690,34,656,226
"57189","E01023436",2011,483,17,466,52
"57190","E01023437",2011,680,326,354,131
"57191","E01023438",2011,583,71,512,95
"57192","E01023439",2011,504,94,410,55
"57193","E01023440",2011,647,14,633,21
"57194","E01023441",2011,491,23,468,136
"57195","E01023442",2011,798,128,670,155
"57196","E01023443",2011,647,79,568,78
"57197","E01023444",2011,681,31,650,159
"57198","E01023445",2011,701,200,501,51
"57199","E01023446",2011,1135,190,945,414
"57200","E01023447",2011,484,305,179,18
"57201","E01023448",2011,585,75,510,63
"57202","E01023449",2011,669,5,664,101
"57203","E01023450",2011,989,172,817,314
"57204","E01023451",2011,929,14,915,108
"57205","E01023452",2011,482,20,462,27
"57206","E01023453",2011,538,12,526,76
"57207","E01023454",2011,504,6,498,42
"57208","E01023455",2011,538,23,515,65
"57209","E01023456",2011,511,3,508,37
"57210","E01023457",2011,610,6,604,88
"57211","E01023458",2011,520,32,488,80
"57212","E01023459",2011,518,1,517,39
"57213","E01023460",2011,548,2,546,37
"57214","E01023461",2011,515,6,509,22
"57215","E01023462",2011,524,80,444,44
"57216","E01023463",2011,497,69,428,52
"57217","E01023464",2011,806,17,789,41
"57218","E01023465",2011,559,42,517,41
"57219","E01023466",2011,764,138,626,94
"57220","E01023467",2011,975,149,826,60
"57221","E01023468",2011,532,15,517,66
"57222","E01023469",2011,606,182,424,57
"57223","E01023470",2011,906,70,836,253
"57224","E01023471",2011,536,12,524,53
"57225","E01023472",2011,606,243,363,49
"57226","E01023473",2011,598,3,595,40
"57227","E01023474",2011,624,6,618,57
"57228","E01023475",2011,623,223,400,60
"57229","E01023476",2011,599,28,571,38
"57230","E01023477",2011,922,51,871,210
"57231","E01023478",2011,961,129,832,308
"57232","E01023479",2011,705,41,664,123
"57233","E01023480",2011,675,126,549,45
"57234","E01023481",2011,480,17,463,64
"57235","E01023482",2011,751,18,733,77
"57236","E01023483",2011,740,60,680,82
"57237","E01023484",2011,638,154,484,65
"57238","E01023485",2011,954,115,839,129
"57239","E01023486",2011,989,106,883,88
"57240","E01023487",2011,624,276,348,31
"57241","E01023488",2011,706,344,362,56
"57242","E01023489",2011,641,35,606,74
"57243","E01023490",2011,478,91,387,16
"57244","E01023491",2011,528,90,438,82
"57245","E01023492",2011,586,107,479,43
"57246","E01023493",2011,933,108,825,87
"57247","E01023494",2011,481,88,393,55
"57248","E01023495",2011,498,65,433,41
"57249","E01023496",2011,442,65,377,65
"57250","E01023497",2011,648,121,527,70
"57251","E01023498",2011,1103,176,927,102
"57252","E01023499",2011,755,220,535,59
"57253","E01023500",2011,615,6,609,22
"57254","E01023501",2011,679,33,646,65
"57255","E01023502",2011,799,11,788,227
"57256","E01023503",2011,739,28,711,100
"57257","E01023504",2011,574,141,433,75
"57258","E01023505",2011,734,28,706,117
"57259","E01023506",2011,578,87,491,46
"57260","E01023507",2011,627,30,597,64
"57261","E01023508",2011,578,80,498,76
"57262","E01023509",2011,552,99,453,47
"57263","E01023510",2011,605,40,565,54
"57264","E01023511",2011,815,178,637,243
"57265","E01023512",2011,834,65,769,174
"57266","E01023513",2011,590,137,453,29
"57267","E01023514",2011,907,129,778,248
"57268","E01023515",2011,670,4,666,119
"57269","E01023516",2011,874,16,858,93
"57270","E01023517",2011,679,153,526,91
"57271","E01023518",2011,705,207,498,34
"57272","E01023519",2011,668,162,506,47
"57273","E01023520",2011,664,13,651,68
"57274","E01023523",2011,613,4,609,45
"57275","E01023524",2011,516,4,512,26
"57276","E01023525",2011,748,59,689,181
"57277","E01023526",2011,665,5,660,60
"57278","E01023527",2011,601,180,421,45
"57279","E01023528",2011,629,23,606,131
"57280","E01023529",2011,559,170,389,51
"57281","E01023530",2011,557,274,283,136
"57282","E01023531",2011,779,160,619,116
"57283","E01023532",2011,661,52,609,105
"57284","E01023533",2011,617,208,409,60
"57285","E01023534",2011,613,240,373,23
"57286","E01023535",2011,667,220,447,62
"57287","E01023536",2011,786,538,248,50
"57288","E01023537",2011,645,242,403,37
"57289","E01023538",2011,774,375,399,92
"57290","E01023539",2011,1163,110,1053,352
"57291","E01023540",2011,634,121,513,44
"57292","E01023541",2011,712,90,622,61
"57293","E01023542",2011,652,162,490,69
"57294","E01023543",2011,577,212,365,52
"57295","E01023544",2011,489,58,431,59
"57296","E01023545",2011,580,114,466,119
"57297","E01023546",2011,722,208,514,82
"57298","E01023547",2011,695,313,382,48
"57299","E01023548",2011,790,34,756,110
"57300","E01023549",2011,782,22,760,137
"57301","E01023550",2011,648,10,638,191
"57302","E01023551",2011,542,3,539,28
"57303","E01023552",2011,599,130,469,28
"57304","E01023553",2011,584,18,566,100
"57305","E01023554",2011,695,105,590,162
"57306","E01023555",2011,713,169,544,120
"57307","E01023556",2011,623,103,520,55
"57308","E01023557",2011,606,31,575,65
"57309","E01023558",2011,752,24,728,114
"57310","E01023559",2011,586,17,569,82
"57311","E01023560",2011,604,273,331,69
"57312","E01023561",2011,641,117,524,89
"57313","E01023562",2011,557,53,504,31
"57314","E01023563",2011,634,30,604,101
"57315","E01023564",2011,641,89,552,115
"57316","E01023565",2011,621,23,598,100
"57317","E01023566",2011,514,3,511,19
"57318","E01023567",2011,743,16,727,31
"57319","E01023568",2011,634,16,618,24
"57320","E01023569",2011,601,100,501,57
"57321","E01023570",2011,610,180,430,84
"57322","E01023571",2011,597,18,579,41
"57323","E01023572",2011,618,82,536,62
"57324","E01023573",2011,524,216,308,60
"57325","E01023574",2011,654,261,393,52
"57326","E01023575",2011,647,127,520,61
"57327","E01023576",2011,599,9,590,61
"57328","E01023577",2011,719,8,711,62
"57329","E01023578",2011,651,2,649,56
"57330","E01023579",2011,586,41,545,174
"57331","E01023580",2011,708,58,650,131
"57332","E01023581",2011,488,17,471,39
"57333","E01023582",2011,617,142,475,48
"57334","E01023583",2011,563,148,415,63
"57335","E01023584",2011,433,95,338,53
"57336","E01023585",2011,465,55,410,83
"57337","E01023586",2011,646,76,570,80
"57338","E01023587",2011,497,6,491,83
"57339","E01023588",2011,544,11,533,51
"57340","E01023589",2011,800,127,673,190
"57341","E01023590",2011,738,107,631,121
"57342","E01023591",2011,627,37,590,55
"57343","E01023592",2011,556,248,308,35
"57344","E01023593",2011,613,201,412,44
"57345","E01023594",2011,972,252,720,102
"57346","E01023595",2011,679,50,629,96
"57347","E01023596",2011,492,140,352,29
"57348","E01023597",2011,491,46,445,49
"57349","E01023598",2011,549,100,449,71
"57350","E01023600",2011,574,147,427,63
"57351","E01023601",2011,1103,204,899,369
"57352","E01023602",2011,637,43,594,134
"57353","E01023603",2011,611,22,589,98
"57354","E01023604",2011,536,28,508,60
"57355","E01023605",2011,728,114,614,256
"57356","E01023606",2011,780,183,597,128
"57357","E01023607",2011,588,5,583,52
"57358","E01023608",2011,634,8,626,36
"57359","E01023609",2011,714,29,685,185
"57360","E01023610",2011,500,5,495,65
"57361","E01023611",2011,664,298,366,34
"57362","E01023612",2011,739,104,635,93
"57363","E01023613",2011,763,489,274,56
"57364","E01023614",2011,806,17,789,67
"57365","E01023615",2011,652,14,638,48
"57366","E01023616",2011,1036,127,909,280
"57367","E01023617",2011,622,40,582,39
"57368","E01023618",2011,602,141,461,67
"57369","E01023619",2011,730,58,672,171
"57370","E01023620",2011,528,231,297,45
"57371","E01023621",2011,591,133,458,79
"57372","E01023622",2011,455,125,330,46
"57373","E01023623",2011,596,132,464,77
"57374","E01023624",2011,524,114,410,108
"57375","E01023625",2011,425,23,402,113
"57376","E01023626",2011,862,122,740,61
"57377","E01023627",2011,671,36,635,82
"57378","E01023628",2011,750,51,699,132
"57379","E01023629",2011,782,234,548,84
"57380","E01023630",2011,618,274,344,35
"57381","E01023631",2011,712,324,388,68
"57382","E01023632",2011,560,154,406,50
"57383","E01023633",2011,616,181,435,146
"57384","E01023634",2011,609,43,566,104
"57385","E01023635",2011,616,208,408,36
"57386","E01023636",2011,783,212,571,46
"57387","E01023637",2011,870,503,367,44
"57388","E01023638",2011,666,226,440,57
"57389","E01023639",2011,541,69,472,53
"57390","E01023640",2011,560,295,265,35
"57391","E01023641",2011,579,305,274,27
"57392","E01023642",2011,497,15,482,10
"57393","E01023643",2011,495,144,351,32
"57394","E01023644",2011,717,102,615,88
"57395","E01023645",2011,642,175,467,63
"57396","E01023646",2011,507,276,231,25
"57397","E01023647",2011,597,22,575,47
"57398","E01023648",2011,470,24,446,57
"57399","E01023649",2011,641,78,563,163
"57400","E01023650",2011,606,356,250,54
"57401","E01023651",2011,483,60,423,56
"57402","E01023652",2011,605,299,306,34
"57403","E01023653",2011,887,175,712,107
"57404","E01023654",2011,647,11,636,66
"57405","E01023655",2011,623,61,562,50
"57406","E01023656",2011,999,142,857,252
"57407","E01023657",2011,1018,20,998,102
"57408","E01023658",2011,638,140,498,40
"57409","E01023659",2011,506,7,499,29
"57410","E01023660",2011,1047,157,890,219
"57411","E01023661",2011,521,192,329,30
"57412","E01023662",2011,607,42,565,99
"57413","E01023663",2011,839,117,722,142
"57414","E01023664",2011,649,37,612,117
"57415","E01023665",2011,592,17,575,115
"57416","E01023666",2011,773,130,643,275
"57417","E01023667",2011,568,7,561,126
"57418","E01023668",2011,475,36,439,24
"57419","E01023669",2011,670,313,357,45
"57420","E01023670",2011,811,105,706,94
"57421","E01023671",2011,735,227,508,42
"57422","E01023672",2011,664,169,495,46
"57423","E01023673",2011,501,20,481,41
"57424","E01023674",2011,723,39,684,164
"57425","E01023675",2011,501,14,487,31
"57426","E01023676",2011,1000,138,862,312
"57427","E01023677",2011,458,175,283,42
"57428","E01023678",2011,725,46,679,74
"57429","E01023679",2011,593,124,469,47
"57430","E01023680",2011,506,70,436,61
"57431","E01023681",2011,689,297,392,70
"57432","E01023682",2011,651,110,541,102
"57433","E01023683",2011,670,222,448,41
"57434","E01023684",2011,672,14,658,77
"57435","E01023685",2011,645,69,576,79
"57436","E01023686",2011,523,9,514,28
"57437","E01023687",2011,604,228,376,46
"57438","E01023688",2011,626,94,532,118
"57439","E01023689",2011,509,31,478,75
"57440","E01023690",2011,608,8,600,59
"57441","E01023691",2011,502,7,495,21
"57442","E01023692",2011,502,121,381,59
"57443","E01023693",2011,523,46,477,46
"57444","E01023694",2011,509,2,507,29
"57445","E01023695",2011,613,22,591,22
"57446","E01023696",2011,633,6,627,23
"57447","E01023697",2011,792,74,718,134
"57448","E01023698",2011,601,5,596,13
"57449","E01023699",2011,597,1,596,70
"57450","E01023700",2011,472,2,470,17
"57451","E01023701",2011,845,108,737,225
"57452","E01023702",2011,682,8,674,195
"57453","E01023703",2011,518,16,502,54
"57454","E01023704",2011,755,73,682,172
"57455","E01023705",2011,613,179,434,75
"57456","E01023706",2011,649,49,600,92
"57457","E01023708",2011,647,142,505,70
"57458","E01023709",2011,728,148,580,56
"57459","E01023710",2011,542,8,534,16
"57460","E01023711",2011,605,53,552,33
"57461","E01023712",2011,738,94,644,141
"57462","E01023713",2011,680,119,561,67
"57463","E01023714",2011,638,7,631,43
"57464","E01023715",2011,525,40,485,26
"57465","E01023716",2011,841,19,822,173
"57466","E01023717",2011,487,43,444,55
"57467","E01023718",2011,698,18,680,37
"57468","E01023719",2011,471,115,356,38
"57469","E01023720",2011,804,149,655,145
"57470","E01023721",2011,540,20,520,30
"57471","E01023722",2011,582,37,545,99
"57472","E01023723",2011,677,246,431,37
"57473","E01023724",2011,703,50,653,78
"57474","E01023725",2011,572,14,558,41
"57475","E01023726",2011,827,46,781,281
"57476","E01023727",2011,1024,204,820,390
"57477","E01023728",2011,956,75,881,262
"57478","E01023729",2011,854,171,683,279
"57479","E01023730",2011,672,6,666,26
"57480","E01023731",2011,610,27,583,78
"57481","E01023732",2011,666,8,658,89
"57482","E01023733",2011,645,2,643,28
"57483","E01023734",2011,651,13,638,63
"57484","E01023735",2011,799,23,776,109
"57485","E01023736",2011,648,132,516,80
"57486","E01023737",2011,509,197,312,74
"57487","E01023738",2011,635,281,354,62
"57488","E01023739",2011,544,142,402,71
"57489","E01023740",2011,654,91,563,173
"57490","E01023741",2011,633,51,582,77
"57491","E01023742",2011,557,2,555,28
"57492","E01023743",2011,777,9,768,165
"57493","E01023744",2011,614,0,614,34
"57494","E01023745",2011,759,19,740,142
"57495","E01023746",2011,626,241,385,49
"57496","E01023747",2011,735,84,651,69
"57497","E01023748",2011,565,41,524,44
"57498","E01023749",2011,656,21,635,26
"57499","E01023750",2011,615,328,287,62
"57500","E01023751",2011,467,101,366,36
"57501","E01023752",2011,505,134,371,33
"57502","E01023753",2011,636,16,620,110
"57503","E01023754",2011,471,113,358,37
"57504","E01023755",2011,630,197,433,62
"57505","E01023756",2011,602,266,336,53
"57506","E01023757",2011,753,280,473,83
"57507","E01023758",2011,1056,574,482,143
"57508","E01023759",2011,591,163,428,38
"57509","E01023760",2011,615,121,494,39
"57510","E01023761",2011,866,237,629,138
"57511","E01023762",2011,638,153,485,43
"57512","E01023763",2011,594,89,505,41
"57513","E01023764",2011,632,182,450,49
"57514","E01023765",2011,596,147,449,32
"57515","E01023766",2011,612,190,422,49
"57516","E01023767",2011,613,6,607,95
"57517","E01023768",2011,679,10,669,97
"57518","E01023769",2011,704,202,502,42
"57519","E01023770",2011,636,17,619,89
"57520","E01023771",2011,683,100,583,92
"57521","E01023772",2011,755,245,510,90
"57522","E01023773",2011,526,227,299,39
"57523","E01023774",2011,668,189,479,110
"57524","E01023775",2011,940,336,604,175
"57525","E01023776",2011,1122,181,941,158
"57526","E01023777",2011,759,96,663,98
"57527","E01023778",2011,664,350,314,51
"57528","E01023779",2011,678,244,434,82
"57529","E01023780",2011,650,201,449,70
"57530","E01023781",2011,782,334,448,87
"57531","E01023782",2011,639,144,495,57
"57532","E01023783",2011,694,255,439,79
"57533","E01023784",2011,680,179,501,41
"57534","E01023785",2011,675,266,409,59
"57535","E01023786",2011,624,170,454,90
"57536","E01023787",2011,546,101,445,82
"57537","E01023788",2011,629,185,444,75
"57538","E01023789",2011,751,231,520,67
"57539","E01023790",2011,633,192,441,91
"57540","E01023791",2011,620,180,440,37
"57541","E01023792",2011,608,217,391,49
"57542","E01023793",2011,616,279,337,51
"57543","E01023794",2011,623,240,383,59
"57544","E01023795",2011,676,158,518,121
"57545","E01023796",2011,724,310,414,120
"57546","E01023797",2011,569,243,326,44
"57547","E01023798",2011,642,96,546,137
"57548","E01023799",2011,504,91,413,36
"57549","E01023800",2011,793,167,626,134
"57550","E01023801",2011,914,169,745,128
"57551","E01023802",2011,739,57,682,74
"57552","E01023803",2011,610,39,571,22
"57553","E01023804",2011,627,212,415,45
"57554","E01023805",2011,638,207,431,37
"57555","E01023806",2011,861,275,586,69
"57556","E01023807",2011,611,128,483,30
"57557","E01023808",2011,1151,78,1073,242
"57558","E01023809",2011,761,66,695,82
"57559","E01023810",2011,731,4,727,39
"57560","E01023811",2011,624,2,622,68
"57561","E01023812",2011,486,1,485,20
"57562","E01023813",2011,489,5,484,23
"57563","E01023814",2011,500,10,490,43
"57564","E01023815",2011,590,61,529,57
"57565","E01023816",2011,496,60,436,37
"57566","E01023817",2011,592,6,586,146
"57567","E01023818",2011,506,20,486,10
"57568","E01023819",2011,678,48,630,110
"57569","E01023820",2011,537,29,508,41
"57570","E01023821",2011,493,25,468,27
"57571","E01023822",2011,528,16,512,34
"57572","E01023823",2011,586,144,442,40
"57573","E01023824",2011,738,11,727,40
"57574","E01023825",2011,898,5,893,129
"57575","E01023826",2011,547,64,483,33
"57576","E01023827",2011,860,260,600,83
"57577","E01023828",2011,612,271,341,49
"57578","E01023829",2011,620,242,378,42
"57579","E01023830",2011,748,186,562,77
"57580","E01023831",2011,749,74,675,69
"57581","E01023832",2011,683,132,551,89
"57582","E01023833",2011,912,86,826,80
"57583","E01023834",2011,573,39,534,63
"57584","E01023835",2011,534,117,417,16
"57585","E01023836",2011,629,197,432,106
"57586","E01023837",2011,649,70,579,100
"57587","E01023838",2011,502,218,284,34
"57588","E01023839",2011,764,4,760,55
"57589","E01023840",2011,560,8,552,184
"57590","E01023841",2011,541,2,539,94
"57591","E01023842",2011,618,308,310,34
"57592","E01023843",2011,829,238,591,79
"57593","E01023844",2011,777,484,293,89
"57594","E01023845",2011,695,157,538,38
"57595","E01023846",2011,569,37,532,30
"57596","E01023847",2011,783,77,706,120
"57597","E01023848",2011,624,183,441,37
"57598","E01023849",2011,600,35,565,40
"57599","E01023850",2011,775,129,646,206
"57600","E01023851",2011,762,44,718,236
"57601","E01023852",2011,591,80,511,64
"57602","E01023853",2011,744,6,738,38
"57603","E01023854",2011,788,61,727,58
"57604","E01023855",2011,808,28,780,272
"57605","E01023856",2011,994,21,973,307
"57606","E01023857",2011,578,147,431,144
"57607","E01023858",2011,781,15,766,251
"57608","E01023859",2011,989,80,909,421
"57609","E01023860",2011,889,346,543,249
"57610","E01023861",2011,1117,134,983,471
"57611","E01023862",2011,953,150,803,244
"57612","E01023863",2011,686,24,662,253
"57613","E01023864",2011,649,172,477,161
"57614","E01023865",2011,626,337,289,75
"57615","E01023866",2011,618,350,268,43
"57616","E01023867",2011,881,120,761,328
"57617","E01023868",2011,678,237,441,58
"57618","E01023869",2011,481,117,364,58
"57619","E01023870",2011,475,210,265,53
"57620","E01023871",2011,507,27,480,113
"57621","E01023872",2011,633,24,609,122
"57622","E01023873",2011,539,213,326,55
"57623","E01023874",2011,493,107,386,28
"57624","E01023875",2011,813,62,751,91
"57625","E01023876",2011,723,463,260,28
"57626","E01023877",2011,661,244,417,45
"57627","E01023878",2011,764,13,751,86
"57628","E01023879",2011,969,52,917,269
"57629","E01023880",2011,855,99,756,298
"57630","E01023881",2011,585,38,547,53
"57631","E01023882",2011,649,35,614,53
"57632","E01023883",2011,661,273,388,51
"57633","E01023884",2011,789,62,727,180
"57634","E01023885",2011,678,14,664,116
"57635","E01023886",2011,1108,107,1001,265
"57636","E01023887",2011,621,8,613,34
"57637","E01023888",2011,580,56,524,90
"57638","E01023889",2011,629,10,619,22
"57639","E01023890",2011,511,61,450,60
"57640","E01023891",2011,513,256,257,34
"57641","E01023892",2011,506,94,412,44
"57642","E01023893",2011,728,23,705,105
"57643","E01023894",2011,534,11,523,60
"57644","E01023895",2011,753,8,745,281
"57645","E01023896",2011,472,7,465,66
"57646","E01023897",2011,673,104,569,64
"57647","E01023898",2011,558,5,553,32
"57648","E01023899",2011,532,39,493,217
"57649","E01023900",2011,557,7,550,183
"57650","E01023901",2011,720,19,701,222
"57651","E01023902",2011,613,105,508,157
"57652","E01023903",2011,549,80,469,134
"57653","E01023904",2011,777,231,546,56
"57654","E01023905",2011,842,181,661,113
"57655","E01023906",2011,630,296,334,33
"57656","E01023907",2011,753,65,688,123
"57657","E01023908",2011,599,8,591,63
"57658","E01023909",2011,418,4,414,29
"57659","E01023910",2011,520,16,504,55
"57660","E01023911",2011,687,39,648,53
"57661","E01023912",2011,607,96,511,53
"57662","E01023913",2011,568,165,403,47
"57663","E01023914",2011,754,339,415,37
"57664","E01023915",2011,652,203,449,100
"57665","E01023916",2011,700,220,480,40
"57666","E01023917",2011,763,136,627,71
"57667","E01023918",2011,963,328,635,160
"57668","E01023919",2011,571,33,538,18
"57669","E01023920",2011,762,474,288,161
"57670","E01023921",2011,881,311,570,262
"57671","E01023922",2011,635,269,366,129
"57672","E01023923",2011,687,143,544,181
"57673","E01023924",2011,639,319,320,173
"57674","E01023925",2011,549,71,478,115
"57675","E01023926",2011,740,32,708,148
"57676","E01023927",2011,685,274,411,90
"57677","E01023929",2011,642,189,453,64
"57678","E01023930",2011,678,287,391,115
"57679","E01023932",2011,587,177,410,170
"57680","E01023933",2011,635,295,340,122
"57681","E01023934",2011,485,114,371,189
"57682","E01023935",2011,449,103,346,114
"57683","E01023936",2011,783,248,535,162
"57684","E01023937",2011,491,217,274,142
"57685","E01023938",2011,603,68,535,70
"57686","E01023939",2011,526,244,282,32
"57687","E01023940",2011,718,291,427,54
"57688","E01023941",2011,1168,315,853,199
"57689","E01023942",2011,606,242,364,44
"57690","E01023943",2011,590,192,398,28
"57691","E01023944",2011,839,301,538,47
"57692","E01023945",2011,638,275,363,19
"57693","E01023946",2011,665,200,465,70
"57694","E01023947",2011,702,77,625,126
"57695","E01023948",2011,644,4,640,21
"57696","E01023949",2011,747,1,746,17
"57697","E01023950",2011,620,83,537,66
"57698","E01023951",2011,784,441,343,40
"57699","E01023952",2011,861,268,593,155
"57700","E01023953",2011,613,42,571,74
"57701","E01023954",2011,711,410,301,68
"57702","E01023955",2011,516,268,248,21
"57703","E01023956",2011,511,248,263,40
"57704","E01023957",2011,633,297,336,83
"57705","E01023958",2011,564,371,193,51
"57706","E01023959",2011,567,13,554,36
"57707","E01023960",2011,646,177,469,44
"57708","E01023961",2011,621,236,385,38
"57709","E01023962",2011,574,123,451,29
"57710","E01023963",2011,1021,235,786,164
"57711","E01023964",2011,617,16,601,70
"57712","E01023965",2011,531,3,528,22
"57713","E01023966",2011,654,14,640,47
"57714","E01023967",2011,576,93,483,63
"57715","E01023968",2011,506,23,483,24
"57716","E01023969",2011,617,78,539,65
"57717","E01023970",2011,596,245,351,62
"57718","E01023971",2011,626,23,603,40
"57719","E01023972",2011,508,179,329,41
"57720","E01023973",2011,712,363,349,94
"57721","E01023974",2011,520,193,327,52
"57722","E01023975",2011,614,246,368,59
"57723","E01023976",2011,672,272,400,50
"57724","E01023977",2011,530,23,507,98
"57725","E01023978",2011,510,9,501,38
"57726","E01023979",2011,534,109,425,47
"57727","E01023980",2011,516,81,435,24
"57728","E01023981",2011,507,173,334,36
"57729","E01023983",2011,606,10,596,64
"57730","E01023984",2011,493,200,293,42
"57731","E01023985",2011,508,39,469,38
"57732","E01023986",2011,563,139,424,58
"57733","E01023987",2011,453,98,355,52
"57734","E01023988",2011,558,24,534,88
"57735","E01023989",2011,454,20,434,18
"57736","E01023990",2011,504,127,377,46
"57737","E01023992",2011,624,130,494,115
"57738","E01023993",2011,528,15,513,88
"57739","E01023995",2011,479,3,476,51
"57740","E01023996",2011,481,7,474,73
"57741","E01023997",2011,609,118,491,50
"57742","E01023998",2011,474,76,398,40
"57743","E01023999",2011,904,22,882,87
"57744","E01024001",2011,650,190,460,97
"57745","E01024002",2011,566,51,515,180
"57746","E01024003",2011,757,58,699,64
"57747","E01024004",2011,705,26,679,125
"57748","E01024005",2011,645,77,568,92
"57749","E01024006",2011,445,5,440,54
"57750","E01024008",2011,720,11,709,136
"57751","E01024009",2011,482,20,462,62
"57752","E01024010",2011,577,117,460,65
"57753","E01024011",2011,497,25,472,43
"57754","E01024012",2011,453,42,411,31
"57755","E01024013",2011,709,104,605,81
"57756","E01024014",2011,650,24,626,45
"57757","E01024015",2011,651,15,636,70
"57758","E01024016",2011,655,13,642,212
"57759","E01024017",2011,779,102,677,149
"57760","E01024019",2011,484,162,322,78
"57761","E01024020",2011,634,319,315,69
"57762","E01024021",2011,614,42,572,207
"57763","E01024022",2011,610,99,511,65
"57764","E01024023",2011,994,151,843,240
"57765","E01024024",2011,1105,148,957,131
"57766","E01024025",2011,572,155,417,80
"57767","E01024026",2011,503,50,453,34
"57768","E01024027",2011,713,119,594,274
"57769","E01024028",2011,697,304,393,94
"57770","E01024029",2011,937,197,740,118
"57771","E01024031",2011,629,69,560,73
"57772","E01024032",2011,623,60,563,52
"57773","E01024033",2011,679,74,605,58
"57774","E01024034",2011,942,46,896,99
"57775","E01024035",2011,453,48,405,39
"57776","E01024036",2011,526,72,454,42
"57777","E01024037",2011,745,78,667,88
"57778","E01024038",2011,818,67,751,66
"57779","E01024039",2011,577,29,548,37
"57780","E01024040",2011,548,173,375,71
"57781","E01024041",2011,507,6,501,103
"57782","E01024042",2011,535,78,457,61
"57783","E01024043",2011,565,7,558,37
"57784","E01024044",2011,857,76,781,335
"57785","E01024045",2011,661,60,601,112
"57786","E01024046",2011,781,78,703,191
"57787","E01024047",2011,495,160,335,248
"57788","E01024048",2011,535,153,382,213
"57789","E01024049",2011,551,331,220,86
"57790","E01024052",2011,910,207,703,138
"57791","E01024053",2011,743,10,733,127
"57792","E01024054",2011,732,47,685,100
"57793","E01024055",2011,691,12,679,54
"57794","E01024056",2011,788,2,786,18
"57795","E01024057",2011,802,4,798,59
"57796","E01024058",2011,666,4,662,103
"57797","E01024059",2011,752,230,522,84
"57798","E01024060",2011,663,15,648,157
"57799","E01024061",2011,658,357,301,67
"57800","E01024062",2011,620,34,586,55
"57801","E01024063",2011,622,6,616,61
"57802","E01024064",2011,913,41,872,82
"57803","E01024065",2011,789,8,781,102
"57804","E01024066",2011,647,200,447,71
"57805","E01024067",2011,456,5,451,59
"57806","E01024068",2011,590,30,560,60
"57807","E01024069",2011,602,19,583,133
"57808","E01024070",2011,694,66,628,215
"57809","E01024071",2011,706,120,586,104
"57810","E01024072",2011,656,10,646,281
"57811","E01024073",2011,808,34,774,104
"57812","E01024074",2011,542,3,539,34
"57813","E01024075",2011,685,49,636,79
"57814","E01024076",2011,752,9,743,106
"57815","E01024077",2011,565,2,563,92
"57816","E01024078",2011,920,42,878,461
"57817","E01024079",2011,627,12,615,92
"57818","E01024080",2011,608,60,548,278
"57819","E01024081",2011,789,146,643,297
"57820","E01024082",2011,598,24,574,148
"57821","E01024083",2011,654,240,414,71
"57822","E01024084",2011,469,101,368,55
"57823","E01024085",2011,645,25,620,112
"57824","E01024086",2011,795,133,662,128
"57825","E01024087",2011,471,20,451,66
"57826","E01024088",2011,621,47,574,108
"57827","E01024089",2011,482,15,467,64
"57828","E01024090",2011,751,214,537,260
"57829","E01024091",2011,495,186,309,75
"57830","E01024092",2011,627,269,358,212
"57831","E01024093",2011,734,328,406,194
"57832","E01024094",2011,989,33,956,71
"57833","E01024095",2011,607,7,600,166
"57834","E01024096",2011,756,28,728,60
"57835","E01024097",2011,748,104,644,39
"57836","E01024098",2011,659,3,656,41
"57837","E01024099",2011,545,222,323,186
"57838","E01024100",2011,511,75,436,181
"57839","E01024101",2011,617,123,494,232
"57840","E01024102",2011,657,57,600,217
"57841","E01024103",2011,629,305,324,139
"57842","E01024104",2011,956,60,896,440
"57843","E01024105",2011,696,27,669,35
"57844","E01024106",2011,688,4,684,97
"57845","E01024107",2011,589,6,583,44
"57846","E01024108",2011,532,166,366,52
"57847","E01024109",2011,956,17,939,62
"57848","E01024110",2011,557,14,543,57
"57849","E01024111",2011,613,181,432,54
"57850","E01024112",2011,662,7,655,47
"57851","E01024113",2011,538,24,514,86
"57852","E01024114",2011,786,1,785,79
"57853","E01024115",2011,646,5,641,38
"57854","E01024116",2011,640,17,623,84
"57855","E01024117",2011,633,12,621,56
"57856","E01024118",2011,762,42,720,102
"57857","E01024119",2011,618,153,465,74
"57858","E01024120",2011,766,7,759,97
"57859","E01024121",2011,666,26,640,245
"57860","E01024122",2011,619,164,455,134
"57861","E01024123",2011,631,34,597,122
"57862","E01024124",2011,543,16,527,262
"57863","E01024126",2011,532,220,312,101
"57864","E01024127",2011,661,41,620,61
"57865","E01024128",2011,631,270,361,115
"57866","E01024129",2011,641,53,588,281
"57867","E01024130",2011,1084,264,820,300
"57868","E01024131",2011,661,10,651,186
"57869","E01024132",2011,489,131,358,20
"57870","E01024133",2011,460,11,449,41
"57871","E01024134",2011,650,107,543,47
"57872","E01024135",2011,541,160,381,81
"57873","E01024136",2011,679,26,653,164
"57874","E01024137",2011,552,12,540,65
"57875","E01024138",2011,657,110,547,67
"57876","E01024139",2011,690,4,686,41
"57877","E01024140",2011,1175,96,1079,291
"57878","E01024141",2011,633,39,594,94
"57879","E01024142",2011,1249,243,1006,324
"57880","E01024143",2011,999,40,959,271
"57881","E01024144",2011,544,2,542,32
"57882","E01024145",2011,594,2,592,56
"57883","E01024146",2011,538,0,538,34
"57884","E01024147",2011,653,4,649,59
"57885","E01024148",2011,849,554,295,51
"57886","E01024149",2011,1220,344,876,189
"57887","E01024150",2011,643,5,638,32
"57888","E01024151",2011,625,7,618,16
"57889","E01024152",2011,931,111,820,122
"57890","E01024153",2011,543,7,536,15
"57891","E01024154",2011,512,216,296,19
"57892","E01024155",2011,575,295,280,27
"57893","E01024156",2011,784,69,715,247
"57894","E01024157",2011,674,62,612,64
"57895","E01024158",2011,650,49,601,92
"57896","E01024159",2011,647,8,639,27
"57897","E01024160",2011,550,2,548,25
"57898","E01024161",2011,800,43,757,166
"57899","E01024162",2011,818,39,779,276
"57900","E01024163",2011,728,25,703,117
"57901","E01024164",2011,801,22,779,248
"57902","E01024165",2011,675,397,278,75
"57903","E01024166",2011,620,211,409,59
"57904","E01024167",2011,773,161,612,130
"57905","E01024168",2011,488,115,373,34
"57906","E01024169",2011,629,201,428,79
"57907","E01024170",2011,668,276,392,63
"57908","E01024171",2011,620,90,530,124
"57909","E01024172",2011,980,74,906,370
"57910","E01024173",2011,698,19,679,48
"57911","E01024174",2011,498,129,369,33
"57912","E01024175",2011,514,57,457,51
"57913","E01024176",2011,787,179,608,181
"57914","E01024177",2011,599,317,282,39
"57915","E01024178",2011,623,157,466,96
"57916","E01024179",2011,1214,202,1012,506
"57917","E01024180",2011,673,36,637,211
"57918","E01024181",2011,499,12,487,91
"57919","E01024182",2011,773,143,630,255
"57920","E01024183",2011,521,17,504,42
"57921","E01024184",2011,771,40,731,151
"57922","E01024185",2011,856,87,769,174
"57923","E01024186",2011,514,6,508,45
"57924","E01024187",2011,442,20,422,25
"57925","E01024188",2011,508,23,485,31
"57926","E01024189",2011,685,133,552,52
"57927","E01024190",2011,594,64,530,109
"57928","E01024191",2011,687,129,558,57
"57929","E01024192",2011,681,312,369,38
"57930","E01024193",2011,723,349,374,113
"57931","E01024194",2011,638,70,568,178
"57932","E01024195",2011,528,126,402,49
"57933","E01024196",2011,628,292,336,58
"57934","E01024197",2011,686,141,545,113
"57935","E01024198",2011,1076,63,1013,72
"57936","E01024200",2011,715,24,691,96
"57937","E01024201",2011,613,31,582,105
"57938","E01024202",2011,800,204,596,83
"57939","E01024203",2011,649,17,632,84
"57940","E01024204",2011,657,155,502,48
"57941","E01024205",2011,643,84,559,48
"57942","E01024206",2011,717,107,610,63
"57943","E01024207",2011,719,55,664,98
"57944","E01024208",2011,666,114,552,105
"57945","E01024209",2011,749,84,665,114
"57946","E01024212",2011,663,43,620,110
"57947","E01024213",2011,572,1,571,46
"57948","E01024214",2011,726,100,626,279
"57949","E01024215",2011,674,70,604,356
"57950","E01024216",2011,604,10,594,121
"57951","E01024217",2011,754,117,637,125
"57952","E01024218",2011,528,171,357,69
"57953","E01024219",2011,562,105,457,43
"57954","E01024220",2011,754,29,725,98
"57955","E01024221",2011,635,11,624,74
"57956","E01024222",2011,670,201,469,83
"57957","E01024223",2011,625,121,504,56
"57958","E01024224",2011,647,71,576,61
"57959","E01024225",2011,680,52,628,102
"57960","E01024226",2011,626,145,481,57
"57961","E01024227",2011,675,37,638,158
"57962","E01024228",2011,801,33,768,249
"57963","E01024229",2011,727,123,604,121
"57964","E01024230",2011,761,18,743,191
"57965","E01024231",2011,743,13,730,274
"57966","E01024232",2011,913,61,852,80
"57967","E01024233",2011,646,2,644,29
"57968","E01024234",2011,565,22,543,33
"57969","E01024235",2011,699,17,682,94
"57970","E01024236",2011,742,73,669,87
"57971","E01024237",2011,758,31,727,78
"57972","E01024238",2011,566,70,496,204
"57973","E01024239",2011,873,179,694,260
"57974","E01024240",2011,651,351,300,104
"57975","E01024241",2011,810,147,663,248
"57976","E01024242",2011,730,19,711,93
"57977","E01024243",2011,761,206,555,54
"57978","E01024244",2011,960,53,907,259
"57979","E01024245",2011,748,75,673,73
"57980","E01024246",2011,894,104,790,389
"57981","E01024247",2011,909,223,686,305
"57982","E01024248",2011,850,253,597,209
"57983","E01024249",2011,915,400,515,147
"57984","E01024250",2011,777,113,664,84
"57985","E01024251",2011,732,130,602,64
"57986","E01024252",2011,1141,33,1108,272
"57987","E01024253",2011,787,9,778,92
"57988","E01024254",2011,805,168,637,69
"57989","E01024255",2011,671,27,644,34
"57990","E01024256",2011,608,6,602,21
"57991","E01024257",2011,890,262,628,355
"57992","E01024258",2011,625,73,552,176
"57993","E01024259",2011,560,1,559,61
"57994","E01024260",2011,808,30,778,162
"57995","E01024261",2011,946,18,928,131
"57996","E01024262",2011,715,155,560,158
"57997","E01024263",2011,593,274,319,46
"57998","E01024264",2011,612,258,354,28
"57999","E01024265",2011,499,8,491,37
"58000","E01024266",2011,482,112,370,40
"58001","E01024267",2011,623,46,577,47
"58002","E01024268",2011,631,3,628,37
"58003","E01024269",2011,758,10,748,37
"58004","E01024270",2011,586,5,581,50
"58005","E01024271",2011,579,100,479,47
"58006","E01024272",2011,592,16,576,24
"58007","E01024273",2011,552,4,548,36
"58008","E01024274",2011,616,10,606,23
"58009","E01024275",2011,526,2,524,42
"58010","E01024276",2011,916,57,859,266
"58011","E01024277",2011,769,245,524,176
"58012","E01024278",2011,863,470,393,164
"58013","E01024279",2011,619,96,523,188
"58014","E01024280",2011,682,269,413,87
"58015","E01024281",2011,528,76,452,57
"58016","E01024282",2011,580,31,549,170
"58017","E01024283",2011,491,29,462,103
"58018","E01024284",2011,595,62,533,162
"58019","E01024285",2011,525,66,459,38
"58020","E01024286",2011,620,50,570,31
"58021","E01024287",2011,645,228,417,33
"58022","E01024288",2011,499,24,475,21
"58023","E01024290",2011,584,45,539,183
"58024","E01024291",2011,793,117,676,316
"58025","E01024292",2011,557,29,528,137
"58026","E01024293",2011,599,51,548,131
"58027","E01024294",2011,811,308,503,115
"58028","E01024295",2011,934,288,646,341
"58029","E01024296",2011,1165,171,994,425
"58030","E01024297",2011,564,5,559,32
"58031","E01024298",2011,537,4,533,25
"58032","E01024299",2011,553,3,550,53
"58033","E01024300",2011,580,27,553,24
"58034","E01024301",2011,518,58,460,52
"58035","E01024302",2011,598,80,518,48
"58036","E01024303",2011,668,90,578,104
"58037","E01024304",2011,610,135,475,64
"58038","E01024305",2011,547,311,236,50
"58039","E01024306",2011,436,279,157,17
"58040","E01024307",2011,643,191,452,26
"58041","E01024308",2011,612,358,254,24
"58042","E01024309",2011,478,173,305,32
"58043","E01024310",2011,627,212,415,26
"58044","E01024311",2011,457,162,295,45
"58045","E01024312",2011,474,69,405,35
"58046","E01024313",2011,631,61,570,86
"58047","E01024314",2011,485,31,454,54
"58048","E01024315",2011,596,198,398,44
"58049","E01024316",2011,683,62,621,76
"58050","E01024317",2011,641,74,567,83
"58051","E01024318",2011,622,7,615,117
"58052","E01024319",2011,554,114,440,36
"58053","E01024320",2011,492,2,490,17
"58054","E01024321",2011,736,4,732,35
"58055","E01024322",2011,494,7,487,21
"58056","E01024323",2011,593,3,590,56
"58057","E01024324",2011,637,2,635,68
"58058","E01024325",2011,1002,45,957,53
"58059","E01024326",2011,784,9,775,39
"58060","E01024327",2011,672,10,662,81
"58061","E01024328",2011,673,46,627,82
"58062","E01024329",2011,604,4,600,39
"58063","E01024330",2011,641,5,636,42
"58064","E01024331",2011,580,24,556,48
"58065","E01024332",2011,496,47,449,62
"58066","E01024333",2011,521,9,512,78
"58067","E01024334",2011,412,4,408,43
"58068","E01024335",2011,605,25,580,72
"58069","E01024336",2011,624,3,621,68
"58070","E01024337",2011,606,2,604,61
"58071","E01024338",2011,513,2,511,35
"58072","E01024339",2011,850,113,737,284
"58073","E01024340",2011,1034,66,968,387
"58074","E01024341",2011,698,1,697,73
"58075","E01024342",2011,749,160,589,66
"58076","E01024343",2011,522,25,497,31
"58077","E01024344",2011,616,5,611,39
"58078","E01024345",2011,605,44,561,73
"58079","E01024346",2011,560,52,508,86
"58080","E01024347",2011,655,32,623,73
"58081","E01024348",2011,518,2,516,40
"58082","E01024349",2011,603,3,600,142
"58083","E01024350",2011,566,52,514,78
"58084","E01024351",2011,666,58,608,102
"58085","E01024352",2011,868,228,640,230
"58086","E01024353",2011,720,9,711,76
"58087","E01024354",2011,602,3,599,119
"58088","E01024355",2011,823,27,796,213
"58089","E01024356",2011,625,23,602,206
"58090","E01024357",2011,670,85,585,176
"58091","E01024358",2011,748,244,504,86
"58092","E01024360",2011,636,49,587,117
"58093","E01024361",2011,725,96,629,68
"58094","E01024362",2011,699,43,656,94
"58095","E01024363",2011,824,63,761,64
"58096","E01024364",2011,699,97,602,68
"58097","E01024365",2011,760,22,738,94
"58098","E01024366",2011,652,38,614,83
"58099","E01024367",2011,543,61,482,95
"58100","E01024369",2011,615,18,597,69
"58101","E01024371",2011,648,77,571,55
"58102","E01024372",2011,801,85,716,287
"58103","E01024373",2011,790,175,615,208
"58104","E01024374",2011,580,248,332,95
"58105","E01024375",2011,977,90,887,80
"58106","E01024376",2011,921,67,854,45
"58107","E01024377",2011,717,77,640,123
"58108","E01024378",2011,582,105,477,66
"58109","E01024379",2011,658,31,627,95
"58110","E01024380",2011,689,9,680,106
"58111","E01024381",2011,612,170,442,52
"58112","E01024382",2011,641,58,583,261
"58113","E01024383",2011,868,104,764,421
"58114","E01024384",2011,783,168,615,117
"58115","E01024385",2011,623,76,547,40
"58116","E01024386",2011,697,18,679,106
"58117","E01024387",2011,982,63,919,162
"58118","E01024388",2011,1146,228,918,104
"58119","E01024389",2011,920,662,258,42
"58120","E01024390",2011,573,336,237,41
"58121","E01024391",2011,494,223,271,30
"58122","E01024392",2011,608,176,432,50
"58123","E01024393",2011,607,161,446,40
"58124","E01024394",2011,521,17,504,21
"58125","E01024395",2011,528,136,392,27
"58126","E01024396",2011,630,229,401,34
"58127","E01024397",2011,654,340,314,34
"58128","E01024398",2011,711,368,343,31
"58129","E01024399",2011,620,281,339,25
"58130","E01024400",2011,558,89,469,28
"58131","E01024401",2011,640,85,555,99
"58132","E01024402",2011,601,19,582,25
"58133","E01024403",2011,777,82,695,151
"58134","E01024404",2011,615,1,614,43
"58135","E01024405",2011,924,86,838,123
"58136","E01024406",2011,547,50,497,84
"58137","E01024407",2011,567,6,561,83
"58138","E01024408",2011,580,16,564,58
"58139","E01024409",2011,617,47,570,75
"58140","E01024410",2011,635,71,564,38
"58141","E01024411",2011,468,61,407,82
"58142","E01024413",2011,719,127,592,131
"58143","E01024414",2011,606,29,577,69
"58144","E01024415",2011,507,10,497,19
"58145","E01024416",2011,621,35,586,71
"58146","E01024417",2011,650,125,525,86
"58147","E01024418",2011,514,37,477,29
"58148","E01024419",2011,731,22,709,120
"58149","E01024420",2011,831,97,734,120
"58150","E01024421",2011,801,121,680,89
"58151","E01024422",2011,769,99,670,124
"58152","E01024423",2011,758,64,694,189
"58153","E01024424",2011,486,13,473,39
"58154","E01024425",2011,724,101,623,103
"58155","E01024426",2011,770,17,753,85
"58156","E01024427",2011,508,172,336,23
"58157","E01024428",2011,532,112,420,31
"58158","E01024429",2011,651,226,425,64
"58159","E01024430",2011,600,32,568,82
"58160","E01024431",2011,799,67,732,72
"58161","E01024432",2011,611,90,521,46
"58162","E01024433",2011,552,37,515,59
"58163","E01024434",2011,934,108,826,80
"58164","E01024435",2011,579,24,555,46
"58165","E01024436",2011,700,22,678,31
"58166","E01024437",2011,603,97,506,44
"58167","E01024438",2011,623,8,615,39
"58168","E01024439",2011,628,64,564,36
"58169","E01024440",2011,769,27,742,137
"58170","E01024441",2011,630,7,623,16
"58171","E01024442",2011,596,9,587,33
"58172","E01024443",2011,654,8,646,22
"58173","E01024444",2011,525,189,336,44
"58174","E01024445",2011,498,10,488,30
"58175","E01024446",2011,586,5,581,51
"58176","E01024447",2011,578,91,487,23
"58177","E01024448",2011,504,56,448,36
"58178","E01024449",2011,563,25,538,19
"58179","E01024450",2011,621,97,524,43
"58180","E01024451",2011,873,138,735,157
"58181","E01024452",2011,590,80,510,82
"58182","E01024453",2011,644,12,632,33
"58183","E01024454",2011,618,93,525,32
"58184","E01024455",2011,472,55,417,75
"58185","E01024456",2011,518,65,453,51
"58186","E01024457",2011,519,152,367,33
"58187","E01024458",2011,526,10,516,88
"58188","E01024459",2011,637,76,561,80
"58189","E01024460",2011,669,186,483,64
"58190","E01024461",2011,1049,111,938,204
"58191","E01024462",2011,659,140,519,38
"58192","E01024463",2011,519,17,502,36
"58193","E01024464",2011,577,20,557,52
"58194","E01024465",2011,617,108,509,120
"58195","E01024466",2011,526,151,375,45
"58196","E01024467",2011,645,23,622,59
"58197","E01024468",2011,629,50,579,123
"58198","E01024469",2011,709,16,693,270
"58199","E01024470",2011,642,65,577,115
"58200","E01024471",2011,741,145,596,161
"58201","E01024472",2011,526,90,436,40
"58202","E01024473",2011,637,34,603,46
"58203","E01024474",2011,472,3,469,23
"58204","E01024475",2011,623,49,574,77
"58205","E01024476",2011,593,324,269,25
"58206","E01024477",2011,614,265,349,32
"58207","E01024478",2011,579,72,507,35
"58208","E01024479",2011,616,18,598,33
"58209","E01024480",2011,809,380,429,55
"58210","E01024481",2011,660,254,406,30
"58211","E01024482",2011,661,256,405,56
"58212","E01024483",2011,682,32,650,133
"58213","E01024484",2011,500,23,477,60
"58214","E01024485",2011,702,213,489,49
"58215","E01024486",2011,874,132,742,88
"58216","E01024487",2011,559,10,549,83
"58217","E01024488",2011,664,69,595,52
"58218","E01024489",2011,795,12,783,53
"58219","E01024490",2011,883,28,855,103
"58220","E01024491",2011,551,30,521,121
"58221","E01024492",2011,639,94,545,105
"58222","E01024493",2011,575,142,433,68
"58223","E01024494",2011,649,149,500,80
"58224","E01024495",2011,677,126,551,202
"58225","E01024496",2011,660,204,456,94
"58226","E01024497",2011,653,138,515,76
"58227","E01024498",2011,638,334,304,63
"58228","E01024499",2011,654,71,583,228
"58229","E01024500",2011,532,157,375,120
"58230","E01024501",2011,635,25,610,240
"58231","E01024502",2011,605,103,502,213
"58232","E01024503",2011,760,182,578,96
"58233","E01024504",2011,1078,127,951,662
"58234","E01024505",2011,828,170,658,234
"58235","E01024507",2011,1060,240,820,561
"58236","E01024508",2011,1110,95,1015,635
"58237","E01024509",2011,957,45,912,455
"58238","E01024510",2011,874,20,854,391
"58239","E01024511",2011,538,4,534,110
"58240","E01024512",2011,698,9,689,221
"58241","E01024513",2011,651,43,608,162
"58242","E01024514",2011,511,11,500,109
"58243","E01024515",2011,639,4,635,69
"58244","E01024516",2011,552,69,483,29
"58245","E01024517",2011,742,10,732,404
"58246","E01024518",2011,677,94,583,43
"58247","E01024519",2011,622,3,619,180
"58248","E01024520",2011,626,150,476,104
"58249","E01024521",2011,857,29,828,242
"58250","E01024522",2011,688,76,612,148
"58251","E01024523",2011,677,3,674,60
"58252","E01024524",2011,780,267,513,104
"58253","E01024525",2011,860,34,826,298
"58254","E01024526",2011,663,3,660,64
"58255","E01024527",2011,695,9,686,85
"58256","E01024528",2011,530,88,442,111
"58257","E01024529",2011,680,144,536,51
"58258","E01024530",2011,587,15,572,43
"58259","E01024531",2011,640,111,529,64
"58260","E01024532",2011,639,6,633,92
"58261","E01024533",2011,558,6,552,100
"58262","E01024534",2011,609,191,418,75
"58263","E01024535",2011,1008,50,958,198
"58264","E01024536",2011,809,31,778,51
"58265","E01024537",2011,750,7,743,114
"58266","E01024538",2011,705,3,702,61
"58267","E01024539",2011,889,242,647,135
"58268","E01024540",2011,640,17,623,38
"58269","E01024541",2011,899,238,661,138
"58270","E01024542",2011,802,27,775,102
"58271","E01024544",2011,574,16,558,46
"58272","E01024545",2011,625,8,617,78
"58273","E01024546",2011,662,55,607,67
"58274","E01024547",2011,613,73,540,51
"58275","E01024548",2011,500,94,406,52
"58276","E01024549",2011,450,57,393,55
"58277","E01024550",2011,858,34,824,106
"58278","E01024551",2011,987,97,890,204
"58279","E01024552",2011,760,270,490,69
"58280","E01024553",2011,1002,85,917,252
"58281","E01024554",2011,988,84,904,103
"58282","E01024555",2011,519,62,457,57
"58283","E01024556",2011,494,58,436,74
"58284","E01024557",2011,611,124,487,56
"58285","E01024558",2011,664,39,625,54
"58286","E01024559",2011,650,83,567,167
"58287","E01024560",2011,503,88,415,77
"58288","E01024561",2011,543,14,529,114
"58289","E01024562",2011,571,27,544,101
"58290","E01024563",2011,655,314,341,44
"58291","E01024564",2011,441,28,413,31
"58292","E01024565",2011,520,60,460,70
"58293","E01024566",2011,603,101,502,78
"58294","E01024567",2011,1133,210,923,187
"58295","E01024568",2011,1035,33,1002,132
"58296","E01024569",2011,707,32,675,86
"58297","E01024570",2011,679,141,538,49
"58298","E01024571",2011,658,41,617,91
"58299","E01024572",2011,447,4,443,51
"58300","E01024573",2011,538,52,486,40
"58301","E01024575",2011,473,33,440,22
"58302","E01024576",2011,673,4,669,125
"58303","E01024577",2011,521,90,431,37
"58304","E01024578",2011,659,66,593,83
"58305","E01024579",2011,1056,262,794,202
"58306","E01024580",2011,797,64,733,180
"58307","E01024581",2011,539,17,522,80
"58308","E01024582",2011,629,53,576,86
"58309","E01024583",2011,640,118,522,72
"58310","E01024584",2011,707,302,405,79
"58311","E01024585",2011,607,210,397,57
"58312","E01024586",2011,662,20,642,75
"58313","E01024587",2011,638,15,623,76
"58314","E01024588",2011,585,24,561,39
"58315","E01024589",2011,662,22,640,43
"58316","E01024590",2011,685,381,304,111
"58317","E01024591",2011,768,139,629,126
"58318","E01024592",2011,512,22,490,70
"58319","E01024593",2011,504,53,451,84
"58320","E01024594",2011,593,20,573,52
"58321","E01024595",2011,635,24,611,90
"58322","E01024596",2011,689,85,604,171
"58323","E01024597",2011,612,189,423,141
"58324","E01024598",2011,610,15,595,120
"58325","E01024599",2011,835,95,740,261
"58326","E01024600",2011,618,211,407,47
"58327","E01024601",2011,718,159,559,74
"58328","E01024602",2011,699,89,610,116
"58329","E01024603",2011,510,14,496,63
"58330","E01024604",2011,478,178,300,56
"58331","E01024605",2011,583,22,561,45
"58332","E01024606",2011,523,33,490,62
"58333","E01024608",2011,815,123,692,224
"58334","E01024609",2011,530,74,456,283
"58335","E01024610",2011,660,14,646,303
"58336","E01024611",2011,617,31,586,303
"58337","E01024612",2011,634,30,604,215
"58338","E01024613",2011,615,135,480,222
"58339","E01024614",2011,639,325,314,97
"58340","E01024615",2011,613,352,261,46
"58341","E01024616",2011,700,228,472,80
"58342","E01024618",2011,731,77,654,123
"58343","E01024619",2011,602,7,595,91
"58344","E01024620",2011,544,29,515,51
"58345","E01024621",2011,478,266,212,33
"58346","E01024622",2011,712,113,599,94
"58347","E01024623",2011,785,145,640,72
"58348","E01024624",2011,738,116,622,161
"58349","E01024625",2011,793,39,754,81
"58350","E01024626",2011,620,15,605,74
"58351","E01024627",2011,817,278,539,75
"58352","E01024628",2011,605,51,554,84
"58353","E01024629",2011,452,21,431,28
"58354","E01024630",2011,755,82,673,70
"58355","E01024631",2011,648,16,632,42
"58356","E01024632",2011,648,16,632,21
"58357","E01024633",2011,659,241,418,57
"58358","E01024634",2011,546,147,399,73
"58359","E01024635",2011,695,35,660,111
"58360","E01024636",2011,1088,3,1085,151
"58361","E01024637",2011,748,4,744,45
"58362","E01024638",2011,780,33,747,108
"58363","E01024639",2011,826,35,791,181
"58364","E01024640",2011,772,45,727,74
"58365","E01024641",2011,730,182,548,92
"58366","E01024642",2011,730,4,726,88
"58367","E01024643",2011,616,50,566,219
"58368","E01024644",2011,597,6,591,35
"58369","E01024645",2011,612,88,524,106
"58370","E01024646",2011,943,108,835,412
"58371","E01024647",2011,649,13,636,252
"58372","E01024648",2011,715,85,630,291
"58373","E01024649",2011,913,59,854,482
"58374","E01024650",2011,626,3,623,58
"58375","E01024651",2011,685,67,618,174
"58376","E01024652",2011,772,1,771,71
"58377","E01024653",2011,722,12,710,93
"58378","E01024654",2011,737,62,675,90
"58379","E01024655",2011,628,1,627,58
"58380","E01024656",2011,779,19,760,186
"58381","E01024657",2011,1009,22,987,804
"58382","E01024658",2011,949,199,750,450
"58383","E01024659",2011,641,36,605,244
"58384","E01024660",2011,756,46,710,450
"58385","E01024661",2011,643,45,598,304
"58386","E01024662",2011,649,183,466,62
"58387","E01024663",2011,617,389,228,52
"58388","E01024664",2011,604,144,460,115
"58389","E01024665",2011,594,50,544,111
"58390","E01024666",2011,734,367,367,59
"58391","E01024667",2011,972,406,566,322
"58392","E01024668",2011,485,27,458,165
"58393","E01024669",2011,717,43,674,241
"58394","E01024670",2011,687,59,628,281
"58395","E01024671",2011,912,74,838,465
"58396","E01024672",2011,598,245,353,49
"58397","E01024673",2011,804,58,746,154
"58398","E01024674",2011,607,18,589,46
"58399","E01024675",2011,873,4,869,109
"58400","E01024676",2011,822,155,667,433
"58401","E01024677",2011,677,65,612,273
"58402","E01024678",2011,1038,220,818,610
"58403","E01024679",2011,621,60,561,37
"58404","E01024680",2011,703,21,682,105
"58405","E01024681",2011,697,11,686,237
"58406","E01024682",2011,717,357,360,56
"58407","E01024683",2011,691,389,302,60
"58408","E01024684",2011,642,70,572,143
"58409","E01024685",2011,764,175,589,98
"58410","E01024686",2011,717,153,564,77
"58411","E01024687",2011,626,305,321,68
"58412","E01024688",2011,734,77,657,77
"58413","E01024689",2011,536,11,525,64
"58414","E01024690",2011,643,104,539,46
"58415","E01024691",2011,478,8,470,62
"58416","E01024692",2011,810,95,715,164
"58417","E01024693",2011,597,7,590,83
"58418","E01024694",2011,786,188,598,199
"58419","E01024695",2011,488,17,471,143
"58420","E01024696",2011,595,43,552,107
"58421","E01024697",2011,504,173,331,151
"58422","E01024698",2011,633,41,592,172
"58423","E01024699",2011,762,259,503,82
"58424","E01024700",2011,735,21,714,177
"58425","E01024701",2011,853,24,829,154
"58426","E01024702",2011,623,166,457,68
"58427","E01024703",2011,753,59,694,122
"58428","E01024704",2011,719,55,664,77
"58429","E01024705",2011,612,22,590,258
"58430","E01024706",2011,644,8,636,144
"58431","E01024707",2011,587,2,585,120
"58432","E01024708",2011,674,5,669,52
"58433","E01024709",2011,603,49,554,28
"58434","E01024710",2011,588,6,582,368
"58435","E01024711",2011,542,41,501,63
"58436","E01024712",2011,625,7,618,53
"58437","E01024713",2011,708,178,530,118
"58438","E01024714",2011,735,70,665,192
"58439","E01024715",2011,967,32,935,481
"58440","E01024716",2011,845,70,775,139
"58441","E01024717",2011,689,378,311,59
"58442","E01024718",2011,522,11,511,12
"58443","E01024719",2011,780,94,686,94
"58444","E01024720",2011,542,16,526,22
"58445","E01024721",2011,507,6,501,31
"58446","E01024722",2011,556,8,548,52
"58447","E01024723",2011,625,56,569,72
"58448","E01024724",2011,769,40,729,63
"58449","E01024725",2011,656,12,644,97
"58450","E01024726",2011,738,169,569,63
"58451","E01024727",2011,1106,51,1055,144
"58452","E01024728",2011,676,135,541,39
"58453","E01024729",2011,712,258,454,15
"58454","E01024730",2011,548,44,504,22
"58455","E01024731",2011,472,13,459,12
"58456","E01024732",2011,662,47,615,231
"58457","E01024733",2011,704,27,677,151
"58458","E01024734",2011,666,92,574,50
"58459","E01024735",2011,608,30,578,37
"58460","E01024736",2011,704,177,527,53
"58461","E01024737",2011,937,176,761,93
"58462","E01024740",2011,752,107,645,85
"58463","E01024741",2011,557,291,266,15
"58464","E01024742",2011,705,296,409,45
"58465","E01024743",2011,753,174,579,66
"58466","E01024744",2011,793,36,757,100
"58467","E01024745",2011,723,43,680,79
"58468","E01024746",2011,427,34,393,83
"58469","E01024747",2011,646,273,373,40
"58470","E01024748",2011,534,11,523,22
"58471","E01024749",2011,622,271,351,23
"58472","E01024750",2011,630,125,505,19
"58473","E01024751",2011,647,9,638,31
"58474","E01024752",2011,639,14,625,35
"58475","E01024753",2011,621,62,559,33
"58476","E01024754",2011,624,46,578,60
"58477","E01024755",2011,763,33,730,57
"58478","E01024756",2011,639,156,483,142
"58479","E01024757",2011,684,52,632,130
"58480","E01024758",2011,625,101,524,70
"58481","E01024760",2011,538,85,453,17
"58482","E01024761",2011,884,93,791,94
"58483","E01024762",2011,826,42,784,80
"58484","E01024763",2011,529,70,459,21
"58485","E01024764",2011,517,107,410,43
"58486","E01024765",2011,523,28,495,22
"58487","E01024766",2011,915,193,722,153
"58488","E01024767",2011,546,239,307,28
"58489","E01024768",2011,744,26,718,158
"58490","E01024771",2011,764,178,586,122
"58491","E01024772",2011,650,55,595,54
"58492","E01024773",2011,736,27,709,47
"58493","E01024774",2011,1127,248,879,170
"58494","E01024775",2011,641,362,279,27
"58495","E01024776",2011,509,212,297,14
"58496","E01024777",2011,507,222,285,16
"58497","E01024778",2011,650,15,635,140
"58498","E01024779",2011,775,134,641,176
"58499","E01024780",2011,598,168,430,73
"58500","E01024781",2011,810,46,764,115
"58501","E01024782",2011,481,9,472,27
"58502","E01024783",2011,726,163,563,116
"58503","E01024784",2011,583,36,547,47
"58504","E01024785",2011,615,84,531,50
"58505","E01024786",2011,782,202,580,69
"58506","E01024787",2011,459,43,416,51
"58507","E01024788",2011,606,224,382,51
"58508","E01024789",2011,803,90,713,145
"58509","E01024790",2011,500,166,334,70
"58510","E01024791",2011,549,24,525,60
"58511","E01024792",2011,697,23,674,84
"58512","E01024793",2011,677,77,600,69
"58513","E01024794",2011,662,92,570,78
"58514","E01024795",2011,591,304,287,53
"58515","E01024796",2011,629,141,488,113
"58516","E01024797",2011,743,60,683,118
"58517","E01024798",2011,918,130,788,129
"58518","E01024799",2011,937,37,900,227
"58519","E01024800",2011,657,5,652,74
"58520","E01024801",2011,1405,89,1316,770
"58521","E01024802",2011,1082,28,1054,557
"58522","E01024803",2011,847,92,755,94
"58523","E01024804",2011,546,27,519,103
"58524","E01024805",2011,667,85,582,133
"58525","E01024806",2011,641,152,489,71
"58526","E01024807",2011,675,202,473,84
"58527","E01024808",2011,709,21,688,123
"58528","E01024809",2011,583,85,498,54
"58529","E01024810",2011,613,63,550,69
"58530","E01024811",2011,481,31,450,27
"58531","E01024812",2011,501,54,447,29
"58532","E01024813",2011,789,162,627,197
"58533","E01024814",2011,512,31,481,22
"58534","E01024815",2011,501,125,376,29
"58535","E01024816",2011,496,98,398,23
"58536","E01024817",2011,755,31,724,111
"58537","E01024818",2011,716,91,625,87
"58538","E01024819",2011,859,56,803,378
"58539","E01024820",2011,661,4,657,95
"58540","E01024821",2011,970,174,796,170
"58541","E01024822",2011,844,57,787,101
"58542","E01024823",2011,896,30,866,368
"58543","E01024824",2011,617,23,594,60
"58544","E01024825",2011,522,14,508,43
"58545","E01024826",2011,626,106,520,52
"58546","E01024827",2011,614,93,521,32
"58547","E01024828",2011,638,174,464,71
"58548","E01024829",2011,654,50,604,86
"58549","E01024830",2011,804,246,558,99
"58550","E01024831",2011,618,219,399,61
"58551","E01024832",2011,674,28,646,185
"58552","E01024833",2011,1247,362,885,406
"58553","E01024834",2011,923,107,816,228
"58554","E01024835",2011,830,18,812,215
"58555","E01024836",2011,710,176,534,124
"58556","E01024837",2011,651,64,587,31
"58557","E01024838",2011,673,4,669,174
"58558","E01024839",2011,743,59,684,81
"58559","E01024840",2011,696,350,346,75
"58560","E01024841",2011,856,435,421,77
"58561","E01024842",2011,706,257,449,42
"58562","E01024843",2011,581,200,381,77
"58563","E01024844",2011,660,79,581,149
"58564","E01024845",2011,529,111,418,34
"58565","E01024846",2011,641,161,480,72
"58566","E01024847",2011,700,153,547,109
"58567","E01024848",2011,636,222,414,45
"58568","E01024849",2011,670,64,606,112
"58569","E01024850",2011,475,5,470,26
"58570","E01024851",2011,666,69,597,86
"58571","E01024852",2011,505,2,503,18
"58572","E01024853",2011,538,59,479,46
"58573","E01024854",2011,594,34,560,62
"58574","E01024855",2011,779,275,504,181
"58575","E01024856",2011,604,23,581,194
"58576","E01024857",2011,631,188,443,124
"58577","E01024858",2011,640,79,561,339
"58578","E01024859",2011,689,15,674,141
"58579","E01024860",2011,529,32,497,38
"58580","E01024861",2011,530,22,508,36
"58581","E01024862",2011,661,14,647,77
"58582","E01024863",2011,617,178,439,60
"58583","E01024864",2011,740,36,704,161
"58584","E01024865",2011,771,351,420,62
"58585","E01024866",2011,858,289,569,72
"58586","E01024867",2011,598,7,591,21
"58587","E01024868",2011,520,19,501,77
"58588","E01024869",2011,646,3,643,39
"58589","E01024870",2011,516,17,499,52
"58590","E01024871",2011,520,16,504,58
"58591","E01024872",2011,660,326,334,85
"58592","E01024873",2011,610,94,516,38
"58593","E01024874",2011,436,3,433,29
"58594","E01024875",2011,412,37,375,109
"58595","E01024876",2011,451,52,399,129
"58596","E01024877",2011,538,124,414,185
"58597","E01024878",2011,427,29,398,108
"58598","E01024879",2011,571,90,481,95
"58599","E01024880",2011,632,128,504,49
"58600","E01024881",2011,621,16,605,163
"58601","E01024882",2011,720,91,629,223
"58602","E01024883",2011,655,239,416,66
"58603","E01024884",2011,695,134,561,62
"58604","E01024885",2011,866,57,809,393
"58605","E01024886",2011,633,16,617,219
"58606","E01024887",2011,598,88,510,77
"58607","E01024888",2011,723,23,700,89
"58608","E01024889",2011,626,63,563,145
"58609","E01024890",2011,639,198,441,119
"58610","E01024891",2011,645,157,488,52
"58611","E01024892",2011,628,88,540,56
"58612","E01024893",2011,654,20,634,273
"58613","E01024894",2011,528,85,443,39
"58614","E01024895",2011,587,28,559,256
"58615","E01024896",2011,583,67,516,61
"58616","E01024897",2011,537,17,520,84
"58617","E01024898",2011,708,18,690,269
"58618","E01024899",2011,677,181,496,108
"58619","E01024900",2011,685,326,359,102
"58620","E01024901",2011,767,5,762,122
"58621","E01024902",2011,701,66,635,148
"58622","E01024903",2011,482,156,326,44
"58623","E01024904",2011,720,43,677,149
"58624","E01024905",2011,502,10,492,32
"58625","E01024906",2011,800,159,641,280
"58626","E01024907",2011,579,20,559,210
"58627","E01024908",2011,557,139,418,218
"58628","E01024909",2011,706,130,576,234
"58629","E01024910",2011,636,16,620,198
"58630","E01024911",2011,803,168,635,133
"58631","E01024912",2011,584,2,582,20
"58632","E01024913",2011,504,2,502,38
"58633","E01024914",2011,615,6,609,26
"58634","E01024915",2011,961,129,832,116
"58635","E01024916",2011,725,2,723,57
"58636","E01024917",2011,773,118,655,133
"58637","E01024918",2011,760,17,743,65
"58638","E01024919",2011,1113,339,774,183
"58639","E01024920",2011,920,111,809,73
"58640","E01024921",2011,857,11,846,91
"58641","E01024922",2011,587,32,555,48
"58642","E01024923",2011,523,17,506,31
"58643","E01024924",2011,600,56,544,24
"58644","E01024925",2011,761,265,496,131
"58645","E01024926",2011,854,292,562,73
"58646","E01024927",2011,732,58,674,103
"58647","E01024928",2011,656,88,568,94
"58648","E01024929",2011,545,201,344,58
"58649","E01024930",2011,633,72,561,93
"58650","E01024931",2011,666,95,571,121
"58651","E01024932",2011,417,11,406,25
"58652","E01024933",2011,629,145,484,67
"58653","E01024934",2011,621,34,587,46
"58654","E01024935",2011,627,9,618,22
"58655","E01024936",2011,754,30,724,174
"58656","E01024937",2011,638,13,625,48
"58657","E01024938",2011,699,17,682,52
"58658","E01024939",2011,701,9,692,41
"58659","E01024940",2011,851,198,653,257
"58660","E01024941",2011,742,267,475,106
"58661","E01024942",2011,779,361,418,60
"58662","E01024943",2011,946,181,765,178
"58663","E01024944",2011,636,36,600,51
"58664","E01024945",2011,1162,197,965,211
"58665","E01024946",2011,526,44,482,25
"58666","E01024947",2011,499,7,492,29
"58667","E01024948",2011,642,17,625,41
"58668","E01024949",2011,996,122,874,149
"58669","E01024950",2011,536,1,535,28
"58670","E01024951",2011,472,291,181,20
"58671","E01024952",2011,604,306,298,44
"58672","E01024953",2011,646,432,214,34
"58673","E01024954",2011,638,100,538,76
"58674","E01024955",2011,656,7,649,69
"58675","E01024956",2011,619,5,614,31
"58676","E01024957",2011,592,4,588,24
"58677","E01024958",2011,565,137,428,38
"58678","E01024959",2011,753,213,540,119
"58679","E01024960",2011,639,129,510,61
"58680","E01024961",2011,662,33,629,65
"58681","E01024962",2011,623,7,616,35
"58682","E01024963",2011,673,50,623,50
"58683","E01024964",2011,620,30,590,52
"58684","E01024965",2011,570,3,567,27
"58685","E01024966",2011,657,5,652,62
"58686","E01024967",2011,532,1,531,26
"58687","E01024968",2011,738,11,727,61
"58688","E01024969",2011,598,124,474,29
"58689","E01024970",2011,575,8,567,24
"58690","E01024971",2011,528,14,514,64
"58691","E01024972",2011,535,4,531,25
"58692","E01024973",2011,877,34,843,58
"58693","E01024974",2011,642,25,617,60
"58694","E01024975",2011,535,17,518,51
"58695","E01024976",2011,659,83,576,72
"58696","E01024977",2011,899,46,853,68
"58697","E01024978",2011,573,63,510,47
"58698","E01024979",2011,591,8,583,55
"58699","E01024980",2011,581,51,530,36
"58700","E01024981",2011,685,21,664,103
"58701","E01024982",2011,622,42,580,129
"58702","E01024983",2011,625,12,613,101
"58703","E01024984",2011,670,12,658,113
"58704","E01024985",2011,627,14,613,72
"58705","E01024986",2011,916,25,891,390
"58706","E01024987",2011,753,75,678,449
"58707","E01024988",2011,844,25,819,327
"58708","E01024989",2011,656,6,650,147
"58709","E01024990",2011,815,37,778,250
"58710","E01024991",2011,517,23,494,130
"58711","E01024992",2011,734,8,726,61
"58712","E01024993",2011,626,25,601,41
"58713","E01024994",2011,722,3,719,114
"58714","E01024995",2011,664,6,658,135
"58715","E01024996",2011,639,23,616,305
"58716","E01024997",2011,671,8,663,64
"58717","E01024998",2011,721,155,566,71
"58718","E01024999",2011,691,81,610,54
"58719","E01025000",2011,596,14,582,70
"58720","E01025001",2011,793,159,634,100
"58721","E01025002",2011,664,31,633,127
"58722","E01025003",2011,792,1,791,96
"58723","E01025004",2011,600,15,585,61
"58724","E01025005",2011,736,22,714,92
"58725","E01025006",2011,667,229,438,130
"58726","E01025007",2011,501,6,495,55
"58727","E01025008",2011,498,6,492,31
"58728","E01025009",2011,728,105,623,136
"58729","E01025010",2011,524,26,498,23
"58730","E01025011",2011,675,129,546,156
"58731","E01025012",2011,795,68,727,45
"58732","E01025013",2011,716,154,562,145
"58733","E01025014",2011,685,72,613,71
"58734","E01025015",2011,634,24,610,40
"58735","E01025016",2011,1024,6,1018,105
"58736","E01025017",2011,813,281,532,62
"58737","E01025018",2011,565,8,557,59
"58738","E01025019",2011,620,18,602,52
"58739","E01025020",2011,559,97,462,99
"58740","E01025021",2011,681,48,633,128
"58741","E01025022",2011,874,43,831,216
"58742","E01025023",2011,604,15,589,44
"58743","E01025024",2011,699,45,654,142
"58744","E01025025",2011,695,44,651,135
"58745","E01025026",2011,554,30,524,70
"58746","E01025027",2011,708,63,645,200
"58747","E01025028",2011,545,65,480,45
"58748","E01025029",2011,924,38,886,112
"58749","E01025030",2011,683,134,549,123
"58750","E01025031",2011,535,10,525,40
"58751","E01025032",2011,617,141,476,94
"58752","E01025033",2011,807,11,796,84
"58753","E01025034",2011,719,15,704,154
"58754","E01025035",2011,647,129,518,49
"58755","E01025036",2011,783,113,670,331
"58756","E01025037",2011,624,108,516,93
"58757","E01025038",2011,600,31,569,46
"58758","E01025039",2011,492,4,488,32
"58759","E01025040",2011,624,8,616,78
"58760","E01025041",2011,660,247,413,124
"58761","E01025042",2011,619,51,568,135
"58762","E01025044",2011,500,25,475,132
"58763","E01025045",2011,514,267,247,43
"58764","E01025046",2011,628,193,435,164
"58765","E01025048",2011,689,44,645,58
"58766","E01025049",2011,780,156,624,210
"58767","E01025050",2011,638,43,595,118
"58768","E01025051",2011,602,210,392,57
"58769","E01025052",2011,638,9,629,52
"58770","E01025053",2011,641,43,598,98
"58771","E01025054",2011,769,167,602,98
"58772","E01025055",2011,708,126,582,160
"58773","E01025056",2011,606,0,606,32
"58774","E01025057",2011,692,14,678,108
"58775","E01025058",2011,655,190,465,64
"58776","E01025059",2011,672,184,488,72
"58777","E01025060",2011,602,7,595,195
"58778","E01025061",2011,682,93,589,44
"58779","E01025062",2011,715,68,647,278
"58780","E01025063",2011,694,188,506,58
"58781","E01025064",2011,689,17,672,40
"58782","E01025065",2011,764,56,708,202
"58783","E01025066",2011,642,19,623,84
"58784","E01025067",2011,709,36,673,267
"58785","E01025068",2011,738,123,615,271
"58786","E01025069",2011,632,17,615,164
"58787","E01025070",2011,493,99,394,131
"58788","E01025071",2011,616,67,549,147
"58789","E01025072",2011,641,42,599,207
"58790","E01025073",2011,591,13,578,105
"58791","E01025074",2011,571,3,568,38
"58792","E01025075",2011,779,94,685,180
"58793","E01025076",2011,637,137,500,129
"58794","E01025077",2011,632,164,468,79
"58795","E01025078",2011,631,11,620,55
"58796","E01025079",2011,723,8,715,54
"58797","E01025080",2011,668,9,659,72
"58798","E01025081",2011,662,5,657,71
"58799","E01025082",2011,664,293,371,66
"58800","E01025083",2011,811,89,722,298
"58801","E01025084",2011,551,55,496,108
"58802","E01025085",2011,604,6,598,90
"58803","E01025086",2011,656,3,653,71
"58804","E01025087",2011,683,19,664,207
"58805","E01025088",2011,455,5,450,50
"58806","E01025089",2011,627,42,585,56
"58807","E01025090",2011,751,2,749,56
"58808","E01025091",2011,645,176,469,65
"58809","E01025092",2011,513,197,316,20
"58810","E01025093",2011,713,77,636,412
"58811","E01025094",2011,616,158,458,155
"58812","E01025095",2011,500,8,492,102
"58813","E01025096",2011,675,7,668,78
"58814","E01025097",2011,646,170,476,53
"58815","E01025098",2011,596,5,591,114
"58816","E01025099",2011,781,95,686,340
"58817","E01025100",2011,668,69,599,129
"58818","E01025101",2011,631,265,366,111
"58819","E01025102",2011,533,10,523,122
"58820","E01025103",2011,520,5,515,44
"58821","E01025105",2011,517,3,514,121
"58822","E01025106",2011,754,42,712,119
"58823","E01025107",2011,679,7,672,105
"58824","E01025108",2011,533,62,471,44
"58825","E01025109",2011,447,11,436,40
"58826","E01025110",2011,697,78,619,396
"58827","E01025111",2011,728,35,693,112
"58828","E01025112",2011,779,207,572,218
"58829","E01025113",2011,639,6,633,108
"58830","E01025114",2011,681,7,674,88
"58831","E01025115",2011,660,128,532,105
"58832","E01025116",2011,660,39,621,209
"58833","E01025117",2011,646,40,606,397
"58834","E01025118",2011,478,12,466,124
"58835","E01025119",2011,577,1,576,100
"58836","E01025120",2011,633,11,622,266
"58837","E01025121",2011,739,23,716,97
"58838","E01025122",2011,781,8,773,114
"58839","E01025123",2011,905,32,873,103
"58840","E01025124",2011,676,200,476,94
"58841","E01025125",2011,379,13,366,181
"58842","E01025126",2011,763,8,755,131
"58843","E01025127",2011,600,2,598,50
"58844","E01025128",2011,646,52,594,257
"58845","E01025129",2011,473,12,461,229
"58846","E01025130",2011,956,41,915,107
"58847","E01025131",2011,654,61,593,73
"58848","E01025132",2011,590,13,577,78
"58849","E01025133",2011,676,40,636,66
"58850","E01025136",2011,715,192,523,206
"58851","E01025137",2011,604,36,568,81
"58852","E01025138",2011,585,18,567,150
"58853","E01025139",2011,853,20,833,530
"58854","E01025140",2011,644,54,590,222
"58855","E01025141",2011,606,68,538,65
"58856","E01025142",2011,621,13,608,40
"58857","E01025143",2011,639,226,413,64
"58858","E01025144",2011,797,145,652,213
"58859","E01025145",2011,614,23,591,165
"58860","E01025146",2011,784,8,776,85
"58861","E01025147",2011,607,28,579,151
"58862","E01025148",2011,941,45,896,84
"58863","E01025149",2011,970,71,899,179
"58864","E01025150",2011,609,56,553,59
"58865","E01025151",2011,777,279,498,178
"58866","E01025152",2011,616,132,484,56
"58867","E01025153",2011,499,25,474,35
"58868","E01025154",2011,633,368,265,40
"58869","E01025155",2011,510,6,504,32
"58870","E01025156",2011,444,272,172,31
"58871","E01025157",2011,572,257,315,24
"58872","E01025158",2011,620,4,616,35
"58873","E01025159",2011,612,22,590,63
"58874","E01025160",2011,554,3,551,25
"58875","E01025161",2011,627,1,626,55
"58876","E01025162",2011,682,9,673,46
"58877","E01025163",2011,628,9,619,31
"58878","E01025164",2011,632,14,618,89
"58879","E01025165",2011,587,10,577,70
"58880","E01025166",2011,541,34,507,70
"58881","E01025167",2011,478,17,461,85
"58882","E01025168",2011,523,23,500,78
"58883","E01025169",2011,543,36,507,33
"58884","E01025170",2011,834,47,787,121
"58885","E01025171",2011,794,300,494,83
"58886","E01025172",2011,656,37,619,139
"58887","E01025173",2011,775,195,580,75
"58888","E01025174",2011,613,16,597,50
"58889","E01025175",2011,661,17,644,69
"58890","E01025176",2011,1015,134,881,244
"58891","E01025177",2011,784,7,777,69
"58892","E01025178",2011,793,54,739,109
"58893","E01025179",2011,701,20,681,107
"58894","E01025180",2011,774,30,744,66
"58895","E01025181",2011,618,281,337,74
"58896","E01025182",2011,611,149,462,154
"58897","E01025183",2011,700,83,617,218
"58898","E01025184",2011,522,23,499,158
"58899","E01025185",2011,721,46,675,140
"58900","E01025186",2011,596,25,571,158
"58901","E01025187",2011,575,73,502,47
"58902","E01025188",2011,886,225,661,225
"58903","E01025189",2011,687,58,629,209
"58904","E01025190",2011,647,34,613,63
"58905","E01025191",2011,530,18,512,59
"58906","E01025192",2011,604,41,563,145
"58907","E01025193",2011,609,111,498,44
"58908","E01025194",2011,623,46,577,144
"58909","E01025195",2011,518,3,515,59
"58910","E01025196",2011,810,39,771,291
"58911","E01025197",2011,569,2,567,56
"58912","E01025198",2011,602,67,535,105
"58913","E01025199",2011,733,22,711,130
"58914","E01025200",2011,661,93,568,95
"58915","E01025201",2011,689,87,602,105
"58916","E01025202",2011,595,40,555,65
"58917","E01025203",2011,748,20,728,91
"58918","E01025204",2011,723,14,709,77
"58919","E01025205",2011,606,35,571,158
"58920","E01025206",2011,511,39,472,41
"58921","E01025207",2011,681,113,568,207
"58922","E01025208",2011,664,261,403,95
"58923","E01025209",2011,693,168,525,43
"58924","E01025210",2011,803,128,675,173
"58925","E01025211",2011,663,46,617,58
"58926","E01025212",2011,527,8,519,27
"58927","E01025213",2011,405,24,381,37
"58928","E01025214",2011,533,3,530,31
"58929","E01025215",2011,499,94,405,75
"58930","E01025216",2011,714,91,623,95
"58931","E01025217",2011,635,56,579,217
"58932","E01025218",2011,510,199,311,113
"58933","E01025219",2011,537,31,506,202
"58934","E01025220",2011,655,263,392,113
"58935","E01025221",2011,521,131,390,66
"58936","E01025222",2011,616,41,575,61
"58937","E01025223",2011,621,144,477,106
"58938","E01025224",2011,768,83,685,173
"58939","E01025225",2011,653,11,642,99
"58940","E01025226",2011,784,175,609,234
"58941","E01025227",2011,977,192,785,329
"58942","E01025228",2011,648,21,627,93
"58943","E01025229",2011,659,31,628,142
"58944","E01025230",2011,547,67,480,146
"58945","E01025231",2011,591,14,577,87
"58946","E01025232",2011,760,57,703,308
"58947","E01025233",2011,523,9,514,42
"58948","E01025234",2011,563,138,425,36
"58949","E01025235",2011,675,29,646,43
"58950","E01025236",2011,573,287,286,41
"58951","E01025237",2011,653,185,468,51
"58952","E01025238",2011,649,293,356,47
"58953","E01025239",2011,663,95,568,44
"58954","E01025240",2011,652,2,650,40
"58955","E01025241",2011,666,9,657,74
"58956","E01025242",2011,625,9,616,33
"58957","E01025243",2011,786,99,687,156
"58958","E01025244",2011,511,42,469,127
"58959","E01025245",2011,928,342,586,82
"58960","E01025246",2011,531,31,500,101
"58961","E01025247",2011,667,128,539,224
"58962","E01025248",2011,509,298,211,57
"58963","E01025249",2011,436,70,366,50
"58964","E01025250",2011,642,165,477,162
"58965","E01025251",2011,559,103,456,77
"58966","E01025252",2011,631,149,482,67
"58967","E01025253",2011,692,10,682,102
"58968","E01025254",2011,470,4,466,26
"58969","E01025255",2011,588,4,584,61
"58970","E01025256",2011,636,60,576,46
"58971","E01025257",2011,505,5,500,11
"58972","E01025258",2011,635,4,631,30
"58973","E01025259",2011,874,7,867,44
"58974","E01025260",2011,765,381,384,56
"58975","E01025261",2011,651,16,635,70
"58976","E01025262",2011,719,271,448,41
"58977","E01025263",2011,640,305,335,61
"58978","E01025264",2011,652,292,360,76
"58979","E01025265",2011,648,90,558,54
"58980","E01025266",2011,520,4,516,24
"58981","E01025267",2011,627,157,470,40
"58982","E01025268",2011,811,317,494,64
"58983","E01025269",2011,649,203,446,57
"58984","E01025270",2011,666,59,607,62
"58985","E01025271",2011,620,210,410,32
"58986","E01025272",2011,616,28,588,52
"58987","E01025273",2011,501,3,498,23
"58988","E01025274",2011,818,120,698,372
"58989","E01025275",2011,772,210,562,226
"58990","E01025276",2011,652,35,617,198
"58991","E01025277",2011,737,42,695,40
"58992","E01025278",2011,1003,14,989,99
"58993","E01025279",2011,722,9,713,72
"58994","E01025280",2011,703,23,680,55
"58995","E01025281",2011,583,1,582,34
"58996","E01025282",2011,568,4,564,38
"58997","E01025283",2011,627,319,308,57
"58998","E01025284",2011,665,120,545,53
"58999","E01025285",2011,513,133,380,42
"59000","E01025286",2011,685,391,294,33
"59001","E01025287",2011,991,518,473,67
"59002","E01025288",2011,899,121,778,364
"59003","E01025289",2011,739,130,609,278
"59004","E01025290",2011,785,129,656,412
"59005","E01025291",2011,657,107,550,147
"59006","E01025292",2011,753,329,424,281
"59007","E01025293",2011,924,456,468,183
"59008","E01025294",2011,667,43,624,225
"59009","E01025295",2011,1090,415,675,327
"59010","E01025296",2011,762,276,486,123
"59011","E01025297",2011,829,146,683,261
"59012","E01025298",2011,614,99,515,169
"59013","E01025299",2011,624,6,618,53
"59014","E01025300",2011,557,165,392,51
"59015","E01025301",2011,469,43,426,62
"59016","E01025302",2011,504,0,504,53
"59017","E01025303",2011,608,7,601,71
"59018","E01025304",2011,611,46,565,83
"59019","E01025305",2011,664,108,556,134
"59020","E01025306",2011,854,108,746,535
"59021","E01025308",2011,741,30,711,329
"59022","E01025309",2011,514,51,463,48
"59023","E01025310",2011,709,51,658,237
"59024","E01025311",2011,666,51,615,185
"59025","E01025312",2011,762,24,738,261
"59026","E01025313",2011,652,275,377,183
"59027","E01025314",2011,823,83,740,343
"59028","E01025315",2011,544,11,533,172
"59029","E01025316",2011,567,5,562,49
"59030","E01025317",2011,484,16,468,107
"59031","E01025318",2011,454,36,418,40
"59032","E01025319",2011,801,19,782,98
"59033","E01025320",2011,536,4,532,187
"59034","E01025321",2011,565,58,507,136
"59035","E01025322",2011,544,36,508,95
"59036","E01025323",2011,478,36,442,50
"59037","E01025324",2011,593,3,590,51
"59038","E01025325",2011,737,176,561,139
"59039","E01025326",2011,629,12,617,89
"59040","E01025327",2011,541,26,515,59
"59041","E01025328",2011,503,8,495,68
"59042","E01025329",2011,614,117,497,47
"59043","E01025330",2011,603,124,479,61
"59044","E01025331",2011,563,32,531,85
"59045","E01025332",2011,430,3,427,20
"59046","E01025333",2011,536,24,512,44
"59047","E01025334",2011,681,38,643,108
"59048","E01025335",2011,706,230,476,81
"59049","E01025336",2011,489,14,475,53
"59050","E01025337",2011,695,52,643,53
"59051","E01025338",2011,723,67,656,150
"59052","E01025339",2011,649,110,539,50
"59053","E01025340",2011,609,31,578,87
"59054","E01025341",2011,482,4,478,20
"59055","E01025342",2011,667,45,622,77
"59056","E01025343",2011,614,60,554,67
"59057","E01025344",2011,624,113,511,100
"59058","E01025345",2011,626,18,608,82
"59059","E01025346",2011,652,44,608,136
"59060","E01025347",2011,683,72,611,112
"59061","E01025348",2011,728,43,685,84
"59062","E01025349",2011,573,30,543,79
"59063","E01025350",2011,562,64,498,48
"59064","E01025351",2011,979,29,950,155
"59065","E01025352",2011,554,0,554,13
"59066","E01025353",2011,455,5,450,31
"59067","E01025354",2011,572,21,551,95
"59068","E01025355",2011,837,10,827,47
"59069","E01025356",2011,625,78,547,138
"59070","E01025357",2011,608,83,525,79
"59071","E01025358",2011,943,12,931,105
"59072","E01025359",2011,708,49,659,73
"59073","E01025360",2011,919,168,751,145
"59074","E01025361",2011,892,33,859,123
"59075","E01025362",2011,822,115,707,58
"59076","E01025363",2011,551,99,452,40
"59077","E01025364",2011,537,5,532,45
"59078","E01025365",2011,656,11,645,72
"59079","E01025366",2011,594,85,509,173
"59080","E01025367",2011,682,13,669,90
"59081","E01025368",2011,701,54,647,134
"59082","E01025369",2011,554,118,436,174
"59083","E01025370",2011,513,8,505,74
"59084","E01025371",2011,648,195,453,101
"59085","E01025373",2011,678,57,621,86
"59086","E01025374",2011,629,164,465,45
"59087","E01025375",2011,682,18,664,81
"59088","E01025376",2011,983,274,709,170
"59089","E01025377",2011,554,11,543,43
"59090","E01025378",2011,647,9,638,80
"59091","E01025379",2011,621,213,408,52
"59092","E01025380",2011,583,3,580,35
"59093","E01025381",2011,618,177,441,62
"59094","E01025382",2011,798,289,509,122
"59095","E01025383",2011,928,56,872,128
"59096","E01025384",2011,533,38,495,43
"59097","E01025385",2011,588,280,308,75
"59098","E01025387",2011,501,67,434,33
"59099","E01025388",2011,657,56,601,150
"59100","E01025389",2011,548,107,441,101
"59101","E01025390",2011,517,173,344,56
"59102","E01025391",2011,660,195,465,61
"59103","E01025392",2011,573,49,524,119
"59104","E01025393",2011,611,51,560,83
"59105","E01025394",2011,667,130,537,126
"59106","E01025395",2011,712,34,678,125
"59107","E01025396",2011,660,304,356,103
"59108","E01025397",2011,652,57,595,172
"59109","E01025398",2011,557,144,413,72
"59110","E01025399",2011,618,170,448,80
"59111","E01025400",2011,715,75,640,40
"59112","E01025401",2011,651,12,639,91
"59113","E01025402",2011,605,49,556,95
"59114","E01025403",2011,786,5,781,82
"59115","E01025404",2011,551,4,547,25
"59116","E01025405",2011,560,84,476,79
"59117","E01025406",2011,548,66,482,35
"59118","E01025407",2011,862,188,674,211
"59119","E01025408",2011,651,4,647,53
"59120","E01025409",2011,578,13,565,71
"59121","E01025410",2011,512,3,509,16
"59122","E01025411",2011,878,15,863,123
"59123","E01025412",2011,676,149,527,45
"59124","E01025413",2011,770,42,728,52
"59125","E01025414",2011,680,9,671,21
"59126","E01025415",2011,846,124,722,85
"59127","E01025416",2011,610,33,577,28
"59128","E01025417",2011,622,55,567,31
"59129","E01025418",2011,611,21,590,68
"59130","E01025419",2011,665,92,573,59
"59131","E01025420",2011,1057,68,989,61
"59132","E01025421",2011,912,92,820,185
"59133","E01025422",2011,639,125,514,56
"59134","E01025423",2011,604,332,272,37
"59135","E01025424",2011,505,5,500,34
"59136","E01025425",2011,532,0,532,29
"59137","E01025426",2011,502,3,499,23
"59138","E01025427",2011,741,240,501,72
"59139","E01025428",2011,630,126,504,52
"59140","E01025429",2011,617,265,352,61
"59141","E01025430",2011,796,24,772,67
"59142","E01025431",2011,772,60,712,168
"59143","E01025433",2011,753,28,725,83
"59144","E01025434",2011,827,11,816,19
"59145","E01025435",2011,674,89,585,83
"59146","E01025436",2011,912,22,890,60
"59147","E01025437",2011,781,49,732,87
"59148","E01025438",2011,523,3,520,24
"59149","E01025439",2011,579,2,577,38
"59150","E01025440",2011,603,2,601,39
"59151","E01025441",2011,662,51,611,41
"59152","E01025442",2011,520,103,417,79
"59153","E01025443",2011,603,5,598,43
"59154","E01025444",2011,559,10,549,75
"59155","E01025445",2011,536,265,271,38
"59156","E01025446",2011,663,68,595,47
"59157","E01025447",2011,533,347,186,24
"59158","E01025448",2011,700,20,680,79
"59159","E01025449",2011,425,36,389,22
"59160","E01025450",2011,415,89,326,43
"59161","E01025451",2011,733,11,722,30
"59162","E01025452",2011,738,287,451,66
"59163","E01025453",2011,670,6,664,52
"59164","E01025454",2011,506,47,459,17
"59165","E01025455",2011,642,12,630,46
"59166","E01025456",2011,472,17,455,40
"59167","E01025457",2011,627,5,622,82
"59168","E01025458",2011,674,80,594,87
"59169","E01025459",2011,710,34,676,95
"59170","E01025460",2011,922,376,546,57
"59171","E01025461",2011,737,10,727,40
"59172","E01025462",2011,706,2,704,74
"59173","E01025463",2011,574,3,571,49
"59174","E01025464",2011,502,4,498,21
"59175","E01025465",2011,503,44,459,56
"59176","E01025466",2011,619,25,594,31
"59177","E01025467",2011,874,2,872,38
"59178","E01025468",2011,595,25,570,29
"59179","E01025469",2011,761,266,495,78
"59180","E01025470",2011,542,8,534,32
"59181","E01025471",2011,574,182,392,76
"59182","E01025472",2011,543,6,537,14
"59183","E01025473",2011,607,86,521,46
"59184","E01025474",2011,458,54,404,73
"59185","E01025475",2011,606,5,601,23
"59186","E01025476",2011,547,8,539,51
"59187","E01025477",2011,478,27,451,29
"59188","E01025478",2011,478,3,475,15
"59189","E01025479",2011,837,47,790,115
"59190","E01025480",2011,503,153,350,55
"59191","E01025481",2011,640,265,375,70
"59192","E01025482",2011,578,305,273,56
"59193","E01025483",2011,958,245,713,111
"59194","E01025484",2011,791,11,780,59
"59195","E01025485",2011,702,42,660,120
"59196","E01025486",2011,654,43,611,63
"59197","E01025487",2011,624,84,540,45
"59198","E01025488",2011,743,118,625,201
"59199","E01025489",2011,505,25,480,83
"59200","E01025490",2011,495,69,426,122
"59201","E01025491",2011,575,24,551,39
"59202","E01025492",2011,503,60,443,49
"59203","E01025493",2011,660,405,255,63
"59204","E01025494",2011,676,272,404,131
"59205","E01025495",2011,867,39,828,80
"59206","E01025496",2011,481,49,432,46
"59207","E01025497",2011,563,8,555,42
"59208","E01025498",2011,520,4,516,53
"59209","E01025499",2011,596,54,542,94
"59210","E01025500",2011,664,94,570,150
"59211","E01025501",2011,493,1,492,13
"59212","E01025502",2011,639,9,630,32
"59213","E01025503",2011,499,134,365,93
"59214","E01025504",2011,472,216,256,68
"59215","E01025505",2011,632,107,525,71
"59216","E01025506",2011,842,29,813,59
"59217","E01025507",2011,678,4,674,78
"59218","E01025508",2011,616,23,593,76
"59219","E01025509",2011,553,101,452,55
"59220","E01025510",2011,514,3,511,14
"59221","E01025511",2011,469,8,461,36
"59222","E01025512",2011,563,22,541,57
"59223","E01025513",2011,822,48,774,42
"59224","E01025514",2011,966,27,939,115
"59225","E01025515",2011,680,37,643,47
"59226","E01025516",2011,631,35,596,55
"59227","E01025517",2011,595,139,456,67
"59228","E01025518",2011,629,154,475,162
"59229","E01025519",2011,505,1,504,34
"59230","E01025520",2011,522,197,325,48
"59231","E01025521",2011,659,180,479,75
"59232","E01025522",2011,507,89,418,44
"59233","E01025523",2011,685,100,585,108
"59234","E01025524",2011,746,359,387,80
"59235","E01025525",2011,629,101,528,53
"59236","E01025526",2011,774,120,654,124
"59237","E01025527",2011,621,279,342,66
"59238","E01025528",2011,685,289,396,65
"59239","E01025529",2011,709,173,536,89
"59240","E01025530",2011,620,9,611,32
"59241","E01025531",2011,488,19,469,26
"59242","E01025532",2011,600,6,594,36
"59243","E01025533",2011,709,74,635,92
"59244","E01025534",2011,686,50,636,50
"59245","E01025535",2011,582,58,524,43
"59246","E01025536",2011,646,228,418,46
"59247","E01025537",2011,683,49,634,66
"59248","E01025538",2011,660,25,635,45
"59249","E01025539",2011,560,42,518,39
"59250","E01025540",2011,488,25,463,30
"59251","E01025541",2011,693,29,664,132
"59252","E01025542",2011,684,2,682,69
"59253","E01025543",2011,747,35,712,153
"59254","E01025544",2011,755,93,662,104
"59255","E01025545",2011,789,11,778,85
"59256","E01025546",2011,716,51,665,177
"59257","E01025547",2011,669,56,613,100
"59258","E01025548",2011,747,8,739,47
"59259","E01025549",2011,842,25,817,93
"59260","E01025550",2011,671,4,667,52
"59261","E01025551",2011,552,16,536,44
"59262","E01025552",2011,497,6,491,21
"59263","E01025553",2011,1031,29,1002,108
"59264","E01025554",2011,764,76,688,74
"59265","E01025555",2011,685,12,673,71
"59266","E01025556",2011,638,42,596,81
"59267","E01025557",2011,683,22,661,45
"59268","E01025558",2011,822,91,731,71
"59269","E01025559",2011,776,98,678,142
"59270","E01025560",2011,647,5,642,45
"59271","E01025561",2011,591,11,580,39
"59272","E01025562",2011,871,59,812,93
"59273","E01025563",2011,455,2,453,36
"59274","E01025564",2011,719,28,691,68
"59275","E01025565",2011,642,9,633,43
"59276","E01025566",2011,847,10,837,41
"59277","E01025567",2011,756,107,649,108
"59278","E01025568",2011,792,3,789,95
"59279","E01025569",2011,877,4,873,67
"59280","E01025570",2011,678,16,662,328
"59281","E01025571",2011,586,18,568,145
"59282","E01025572",2011,642,25,617,66
"59283","E01025573",2011,590,13,577,62
"59284","E01025574",2011,741,165,576,210
"59285","E01025575",2011,551,311,240,71
"59286","E01025576",2011,1069,20,1049,160
"59287","E01025577",2011,646,107,539,94
"59288","E01025578",2011,629,143,486,65
"59289","E01025579",2011,513,134,379,81
"59290","E01025580",2011,497,24,473,34
"59291","E01025581",2011,587,9,578,125
"59292","E01025582",2011,581,53,528,222
"59293","E01025583",2011,602,28,574,186
"59294","E01025584",2011,851,149,702,384
"59295","E01025585",2011,890,45,845,76
"59296","E01025586",2011,715,18,697,74
"59297","E01025587",2011,694,32,662,74
"59298","E01025588",2011,704,28,676,116
"59299","E01025589",2011,489,47,442,80
"59300","E01025590",2011,622,266,356,67
"59301","E01025591",2011,748,9,739,41
"59302","E01025592",2011,638,384,254,28
"59303","E01025593",2011,654,15,639,59
"59304","E01025594",2011,744,2,742,92
"59305","E01025595",2011,628,1,627,40
"59306","E01025596",2011,820,22,798,65
"59307","E01025597",2011,480,4,476,48
"59308","E01025598",2011,765,56,709,170
"59309","E01025599",2011,432,6,426,29
"59310","E01025600",2011,667,2,665,62
"59311","E01025601",2011,621,1,620,37
"59312","E01025602",2011,691,12,679,120
"59313","E01025603",2011,710,4,706,72
"59314","E01025604",2011,653,5,648,147
"59315","E01025605",2011,565,13,552,31
"59316","E01025606",2011,516,176,340,75
"59317","E01025607",2011,630,39,591,43
"59318","E01025608",2011,658,8,650,77
"59319","E01025609",2011,826,47,779,137
"59320","E01025610",2011,660,115,545,66
"59321","E01025611",2011,609,41,568,36
"59322","E01025612",2011,691,117,574,35
"59323","E01025613",2011,619,92,527,56
"59324","E01025614",2011,696,52,644,50
"59325","E01025615",2011,557,4,553,33
"59326","E01025616",2011,638,19,619,31
"59327","E01025617",2011,731,20,711,76
"59328","E01025618",2011,735,110,625,59
"59329","E01025619",2011,693,19,674,51
"59330","E01025620",2011,470,68,402,32
"59331","E01025621",2011,448,11,437,54
"59332","E01025622",2011,760,71,689,113
"59333","E01025623",2011,680,62,618,43
"59334","E01025624",2011,685,8,677,54
"59335","E01025625",2011,569,203,366,65
"59336","E01025626",2011,567,23,544,136
"59337","E01025627",2011,897,111,786,81
"59338","E01025629",2011,648,81,567,36
"59339","E01025630",2011,695,4,691,39
"59340","E01025631",2011,491,1,490,53
"59341","E01025632",2011,470,1,469,28
"59342","E01025633",2011,717,4,713,67
"59343","E01025634",2011,535,3,532,39
"59344","E01025635",2011,483,13,470,23
"59345","E01025636",2011,607,43,564,81
"59346","E01025637",2011,554,44,510,67
"59347","E01025638",2011,636,16,620,31
"59348","E01025639",2011,533,34,499,46
"59349","E01025640",2011,658,71,587,84
"59350","E01025641",2011,786,51,735,92
"59351","E01025642",2011,841,78,763,122
"59352","E01025643",2011,632,40,592,48
"59353","E01025644",2011,569,62,507,39
"59354","E01025645",2011,462,36,426,59
"59355","E01025646",2011,752,188,564,101
"59356","E01025647",2011,712,109,603,62
"59357","E01025648",2011,732,5,727,39
"59358","E01025649",2011,673,2,671,50
"59359","E01025650",2011,570,14,556,52
"59360","E01025651",2011,645,14,631,38
"59361","E01025652",2011,505,5,500,54
"59362","E01025653",2011,668,111,557,79
"59363","E01025654",2011,512,5,507,53
"59364","E01025655",2011,619,3,616,94
"59365","E01025656",2011,496,1,495,61
"59366","E01025657",2011,808,135,673,60
"59367","E01025658",2011,736,12,724,76
"59368","E01025659",2011,857,66,791,153
"59369","E01025660",2011,681,6,675,40
"59370","E01025661",2011,678,34,644,62
"59371","E01025662",2011,698,165,533,71
"59372","E01025663",2011,582,58,524,31
"59373","E01025664",2011,544,58,486,34
"59374","E01025665",2011,644,25,619,47
"59375","E01025666",2011,628,123,505,66
"59376","E01025667",2011,490,56,434,47
"59377","E01025668",2011,945,13,932,244
"59378","E01025669",2011,840,6,834,203
"59379","E01025670",2011,534,101,433,17
"59380","E01025671",2011,769,27,742,99
"59381","E01025672",2011,739,68,671,43
"59382","E01025673",2011,769,146,623,127
"59383","E01025674",2011,646,46,600,71
"59384","E01025675",2011,670,30,640,97
"59385","E01025676",2011,841,29,812,75
"59386","E01025677",2011,609,128,481,65
"59387","E01025678",2011,652,20,632,43
"59388","E01025679",2011,989,76,913,102
"59389","E01025680",2011,656,6,650,34
"59390","E01025681",2011,662,23,639,58
"59391","E01025682",2011,637,29,608,31
"59392","E01025683",2011,674,96,578,55
"59393","E01025684",2011,772,9,763,93
"59394","E01025685",2011,542,29,513,33
"59395","E01025686",2011,542,5,537,41
"59396","E01025687",2011,682,7,675,70
"59397","E01025688",2011,665,94,571,123
"59398","E01025689",2011,757,230,527,195
"59399","E01025690",2011,538,230,308,114
"59400","E01025692",2011,808,73,735,107
"59401","E01025693",2011,849,30,819,123
"59402","E01025695",2011,662,11,651,119
"59403","E01025696",2011,541,13,528,49
"59404","E01025697",2011,686,263,423,109
"59405","E01025698",2011,651,22,629,91
"59406","E01025699",2011,813,459,354,154
"59407","E01025700",2011,735,257,478,190
"59408","E01025701",2011,676,207,469,128
"59409","E01025702",2011,527,29,498,63
"59410","E01025703",2011,842,117,725,301
"59411","E01025704",2011,587,87,500,141
"59412","E01025705",2011,520,70,450,186
"59413","E01025706",2011,752,244,508,150
"59414","E01025707",2011,558,48,510,80
"59415","E01025708",2011,519,3,516,32
"59416","E01025709",2011,475,14,461,80
"59417","E01025710",2011,502,4,498,42
"59418","E01025711",2011,645,2,643,25
"59419","E01025712",2011,599,4,595,31
"59420","E01025713",2011,482,2,480,53
"59421","E01025714",2011,795,33,762,82
"59422","E01025715",2011,599,187,412,79
"59423","E01025716",2011,616,128,488,77
"59424","E01025717",2011,807,269,538,76
"59425","E01025718",2011,674,238,436,218
"59426","E01025719",2011,601,33,568,129
"59427","E01025720",2011,680,113,567,364
"59428","E01025721",2011,565,105,460,244
"59429","E01025722",2011,421,33,388,74
"59430","E01025723",2011,616,99,517,273
"59431","E01025724",2011,561,36,525,391
"59432","E01025725",2011,606,318,288,58
"59433","E01025726",2011,793,40,753,128
"59434","E01025727",2011,680,213,467,66
"59435","E01025728",2011,748,82,666,37
"59436","E01025729",2011,665,17,648,43
"59437","E01025730",2011,662,23,639,117
"59438","E01025731",2011,644,24,620,20
"59439","E01025732",2011,651,35,616,68
"59440","E01025733",2011,712,81,631,103
"59441","E01025734",2011,637,5,632,37
"59442","E01025735",2011,873,91,782,173
"59443","E01025736",2011,624,12,612,27
"59444","E01025737",2011,750,52,698,92
"59445","E01025738",2011,575,4,571,34
"59446","E01025739",2011,645,82,563,54
"59447","E01025740",2011,688,49,639,123
"59448","E01025741",2011,643,0,643,58
"59449","E01025742",2011,671,207,464,49
"59450","E01025743",2011,811,66,745,105
"59451","E01025744",2011,772,4,768,65
"59452","E01025745",2011,635,41,594,48
"59453","E01025746",2011,777,146,631,108
"59454","E01025747",2011,796,122,674,78
"59455","E01025748",2011,918,59,859,162
"59456","E01025749",2011,625,145,480,42
"59457","E01025750",2011,602,7,595,45
"59458","E01025751",2011,891,71,820,146
"59459","E01025752",2011,800,59,741,69
"59460","E01025753",2011,688,197,491,74
"59461","E01025754",2011,522,11,511,29
"59462","E01025755",2011,617,19,598,45
"59463","E01025756",2011,855,51,804,210
"59464","E01025757",2011,550,18,532,97
"59465","E01025758",2011,651,27,624,68
"59466","E01025759",2011,722,155,567,111
"59467","E01025760",2011,544,19,525,45
"59468","E01025761",2011,721,32,689,62
"59469","E01025762",2011,647,64,583,79
"59470","E01025763",2011,715,27,688,91
"59471","E01025764",2011,504,9,495,32
"59472","E01025765",2011,606,11,595,54
"59473","E01025766",2011,859,230,629,132
"59474","E01025767",2011,613,42,571,62
"59475","E01025768",2011,582,26,556,53
"59476","E01025769",2011,574,28,546,66
"59477","E01025770",2011,803,62,741,151
"59478","E01025771",2011,1026,78,948,136
"59479","E01025772",2011,880,21,859,117
"59480","E01025773",2011,525,10,515,34
"59481","E01025774",2011,474,7,467,28
"59482","E01025775",2011,769,115,654,48
"59483","E01025776",2011,774,21,753,66
"59484","E01025777",2011,910,62,848,73
"59485","E01025778",2011,801,83,718,98
"59486","E01025779",2011,623,21,602,45
"59487","E01025780",2011,524,7,517,26
"59488","E01025781",2011,600,35,565,103
"59489","E01025782",2011,617,69,548,54
"59490","E01025783",2011,611,12,599,55
"59491","E01025784",2011,531,23,508,60
"59492","E01025785",2011,902,71,831,103
"59493","E01025786",2011,678,170,508,66
"59494","E01025787",2011,720,17,703,78
"59495","E01025788",2011,465,34,431,43
"59496","E01025789",2011,476,46,430,59
"59497","E01025790",2011,921,11,910,61
"59498","E01025791",2011,937,108,829,101
"59499","E01025792",2011,1095,226,869,179
"59500","E01025793",2011,987,193,794,67
"59501","E01025794",2011,724,12,712,92
"59502","E01025795",2011,848,60,788,164
"59503","E01025796",2011,862,274,588,128
"59504","E01025797",2011,713,37,676,59
"59505","E01025798",2011,839,27,812,172
"59506","E01025799",2011,704,10,694,81
"59507","E01025800",2011,538,34,504,95
"59508","E01025801",2011,618,121,497,132
"59509","E01025802",2011,617,11,606,64
"59510","E01025803",2011,582,1,581,28
"59511","E01025804",2011,842,79,763,109
"59512","E01025805",2011,661,22,639,43
"59513","E01025806",2011,680,297,383,61
"59514","E01025807",2011,595,18,577,155
"59515","E01025808",2011,1031,57,974,103
"59516","E01025809",2011,930,73,857,113
"59517","E01025810",2011,919,45,874,74
"59518","E01025812",2011,728,47,681,67
"59519","E01025813",2011,598,4,594,17
"59520","E01025814",2011,622,29,593,41
"59521","E01025815",2011,848,59,789,108
"59522","E01025816",2011,889,58,831,81
"59523","E01025817",2011,834,31,803,63
"59524","E01025818",2011,557,53,504,101
"59525","E01025819",2011,710,138,572,78
"59526","E01025820",2011,657,24,633,55
"59527","E01025821",2011,796,20,776,197
"59528","E01025822",2011,654,223,431,36
"59529","E01025823",2011,639,141,498,52
"59530","E01025824",2011,629,78,551,73
"59531","E01025825",2011,607,59,548,44
"59532","E01025826",2011,583,38,545,50
"59533","E01025827",2011,701,194,507,23
"59534","E01025828",2011,617,46,571,44
"59535","E01025829",2011,643,233,410,30
"59536","E01025830",2011,658,118,540,75
"59537","E01025831",2011,602,57,545,71
"59538","E01025832",2011,614,4,610,38
"59539","E01025833",2011,673,35,638,90
"59540","E01025834",2011,609,4,605,55
"59541","E01025835",2011,715,4,711,40
"59542","E01025836",2011,561,2,559,33
"59543","E01025837",2011,834,65,769,106
"59544","E01025838",2011,671,70,601,60
"59545","E01025839",2011,698,31,667,98
"59546","E01025840",2011,685,67,618,94
"59547","E01025841",2011,763,47,716,34
"59548","E01025842",2011,764,226,538,71
"59549","E01025843",2011,729,71,658,141
"59550","E01025844",2011,751,278,473,117
"59551","E01025845",2011,642,11,631,30
"59552","E01025846",2011,821,15,806,39
"59553","E01025847",2011,654,8,646,65
"59554","E01025848",2011,708,88,620,75
"59555","E01025849",2011,795,89,706,197
"59556","E01025850",2011,626,52,574,114
"59557","E01025851",2011,521,18,503,29
"59558","E01025852",2011,856,40,816,364
"59559","E01025853",2011,1152,76,1076,216
"59560","E01025854",2011,726,20,706,93
"59561","E01025855",2011,598,32,566,73
"59562","E01025856",2011,649,285,364,51
"59563","E01025857",2011,599,11,588,69
"59564","E01025858",2011,905,21,884,305
"59565","E01025859",2011,579,1,578,41
"59566","E01025860",2011,543,0,543,23
"59567","E01025861",2011,748,32,716,96
"59568","E01025862",2011,655,1,654,55
"59569","E01025863",2011,708,126,582,65
"59570","E01025864",2011,639,30,609,54
"59571","E01025865",2011,775,133,642,121
"59572","E01025866",2011,717,209,508,52
"59573","E01025867",2011,665,28,637,97
"59574","E01025868",2011,663,70,593,76
"59575","E01025869",2011,750,42,708,83
"59576","E01025870",2011,597,8,589,32
"59577","E01025871",2011,524,59,465,47
"59578","E01025872",2011,653,22,631,29
"59579","E01025873",2011,651,27,624,59
"59580","E01025874",2011,674,109,565,32
"59581","E01025875",2011,658,192,466,46
"59582","E01025876",2011,742,15,727,58
"59583","E01025877",2011,728,48,680,109
"59584","E01025878",2011,1034,143,891,67
"59585","E01025879",2011,525,150,375,50
"59586","E01025880",2011,637,14,623,33
"59587","E01025881",2011,616,33,583,47
"59588","E01025882",2011,690,70,620,95
"59589","E01025883",2011,702,41,661,70
"59590","E01025884",2011,752,150,602,77
"59591","E01025885",2011,738,19,719,74
"59592","E01025886",2011,815,98,717,94
"59593","E01025887",2011,791,43,748,223
"59594","E01025888",2011,739,22,717,114
"59595","E01025889",2011,720,47,673,103
"59596","E01025890",2011,538,99,439,56
"59597","E01025891",2011,545,25,520,52
"59598","E01025892",2011,660,36,624,100
"59599","E01025893",2011,859,23,836,69
"59600","E01025894",2011,804,263,541,171
"59601","E01025895",2011,740,51,689,98
"59602","E01025896",2011,660,15,645,48
"59603","E01025897",2011,941,229,712,185
"59604","E01025898",2011,529,83,446,86
"59605","E01025899",2011,489,51,438,150
"59606","E01025900",2011,626,234,392,61
"59607","E01025901",2011,793,40,753,80
"59608","E01025902",2011,705,17,688,45
"59609","E01025903",2011,837,67,770,230
"59610","E01025904",2011,832,10,822,54
"59611","E01025905",2011,716,307,409,38
"59612","E01025906",2011,648,11,637,40
"59613","E01025907",2011,696,197,499,71
"59614","E01025908",2011,738,16,722,107
"59615","E01025909",2011,808,81,727,93
"59616","E01025910",2011,759,56,703,113
"59617","E01025911",2011,644,40,604,82
"59618","E01025912",2011,666,31,635,270
"59619","E01025913",2011,918,102,816,63
"59620","E01025914",2011,531,2,529,20
"59621","E01025915",2011,553,40,513,76
"59622","E01025916",2011,652,34,618,110
"59623","E01025917",2011,854,60,794,175
"59624","E01025918",2011,693,251,442,70
"59625","E01025919",2011,589,139,450,37
"59626","E01025920",2011,657,191,466,47
"59627","E01025921",2011,721,75,646,76
"59628","E01025923",2011,590,71,519,64
"59629","E01025924",2011,450,30,420,85
"59630","E01025925",2011,1190,150,1040,302
"59631","E01025926",2011,649,47,602,74
"59632","E01025927",2011,669,135,534,41
"59633","E01025928",2011,618,7,611,66
"59634","E01025929",2011,833,81,752,103
"59635","E01025930",2011,727,108,619,195
"59636","E01025931",2011,789,141,648,161
"59637","E01025932",2011,541,349,192,24
"59638","E01025933",2011,538,151,387,16
"59639","E01025934",2011,646,342,304,49
"59640","E01025935",2011,544,32,512,16
"59641","E01025936",2011,559,204,355,22
"59642","E01025937",2011,668,36,632,63
"59643","E01025938",2011,532,81,451,41
"59644","E01025939",2011,794,72,722,120
"59645","E01025940",2011,837,104,733,75
"59646","E01025941",2011,630,34,596,52
"59647","E01025942",2011,698,29,669,45
"59648","E01025943",2011,811,261,550,88
"59649","E01025944",2011,625,33,592,92
"59650","E01025945",2011,666,57,609,109
"59651","E01025946",2011,717,82,635,166
"59652","E01025947",2011,758,23,735,70
"59653","E01025948",2011,676,92,584,109
"59654","E01025949",2011,722,279,443,125
"59655","E01025950",2011,731,265,466,81
"59656","E01025951",2011,691,25,666,54
"59657","E01025952",2011,650,84,566,27
"59658","E01025953",2011,468,86,382,44
"59659","E01025954",2011,605,91,514,52
"59660","E01025955",2011,576,20,556,35
"59661","E01025956",2011,484,80,404,44
"59662","E01025957",2011,776,133,643,145
"59663","E01025958",2011,652,38,614,75
"59664","E01025959",2011,874,43,831,78
"59665","E01025960",2011,621,39,582,32
"59666","E01025961",2011,640,43,597,47
"59667","E01025962",2011,594,176,418,37
"59668","E01025963",2011,624,92,532,51
"59669","E01025964",2011,661,37,624,55
"59670","E01025965",2011,583,44,539,93
"59671","E01025966",2011,643,164,479,36
"59672","E01025967",2011,736,28,708,22
"59673","E01025968",2011,778,13,765,76
"59674","E01025969",2011,809,105,704,113
"59675","E01025970",2011,507,3,504,27
"59676","E01025971",2011,478,6,472,32
"59677","E01025972",2011,461,9,452,39
"59678","E01025973",2011,474,2,472,25
"59679","E01025974",2011,565,15,550,122
"59680","E01025975",2011,503,25,478,31
"59681","E01025976",2011,575,185,390,53
"59682","E01025977",2011,605,8,597,86
"59683","E01025978",2011,684,80,604,107
"59684","E01025979",2011,490,12,478,52
"59685","E01025980",2011,449,2,447,30
"59686","E01025981",2011,589,1,588,60
"59687","E01025982",2011,607,14,593,49
"59688","E01025983",2011,479,22,457,67
"59689","E01025984",2011,482,0,482,32
"59690","E01025985",2011,589,2,587,28
"59691","E01025986",2011,607,5,602,42
"59692","E01025987",2011,633,121,512,139
"59693","E01025988",2011,681,121,560,160
"59694","E01025989",2011,746,122,624,149
"59695","E01025990",2011,600,11,589,36
"59696","E01025991",2011,573,8,565,30
"59697","E01025992",2011,745,200,545,97
"59698","E01025993",2011,576,29,547,16
"59699","E01025994",2011,578,145,433,66
"59700","E01025995",2011,581,4,577,61
"59701","E01025997",2011,578,171,407,30
"59702","E01025998",2011,742,8,734,83
"59703","E01025999",2011,625,130,495,47
"59704","E01026000",2011,532,1,531,31
"59705","E01026001",2011,590,9,581,51
"59706","E01026003",2011,651,48,603,44
"59707","E01026004",2011,682,4,678,41
"59708","E01026005",2011,719,82,637,53
"59709","E01026006",2011,1149,170,979,512
"59710","E01026007",2011,474,26,448,25
"59711","E01026008",2011,527,92,435,29
"59712","E01026009",2011,516,93,423,42
"59713","E01026010",2011,631,395,236,104
"59714","E01026011",2011,1111,324,787,273
"59715","E01026012",2011,549,215,334,23
"59716","E01026013",2011,625,23,602,31
"59717","E01026014",2011,799,85,714,90
"59718","E01026015",2011,643,40,603,114
"59719","E01026016",2011,987,147,840,84
"59720","E01026017",2011,691,192,499,56
"59721","E01026018",2011,715,44,671,58
"59722","E01026019",2011,1161,402,759,140
"59723","E01026020",2011,926,113,813,154
"59724","E01026021",2011,767,38,729,180
"59725","E01026022",2011,867,24,843,87
"59726","E01026023",2011,589,108,481,54
"59727","E01026024",2011,829,108,721,68
"59728","E01026025",2011,988,196,792,388
"59729","E01026026",2011,819,382,437,61
"59730","E01026027",2011,761,104,657,123
"59731","E01026028",2011,851,215,636,130
"59732","E01026029",2011,1007,44,963,161
"59733","E01026030",2011,994,455,539,174
"59734","E01026031",2011,618,27,591,39
"59735","E01026032",2011,784,117,667,233
"59736","E01026033",2011,789,63,726,93
"59737","E01026034",2011,793,157,636,73
"59738","E01026035",2011,869,2,867,82
"59739","E01026036",2011,687,35,652,286
"59740","E01026037",2011,599,180,419,142
"59741","E01026038",2011,573,14,559,72
"59742","E01026039",2011,493,24,469,29
"59743","E01026040",2011,497,28,469,53
"59744","E01026041",2011,613,283,330,28
"59745","E01026042",2011,672,128,544,184
"59746","E01026043",2011,720,121,599,98
"59747","E01026044",2011,587,29,558,62
"59748","E01026045",2011,861,87,774,121
"59749","E01026046",2011,531,79,452,94
"59750","E01026047",2011,588,14,574,52
"59751","E01026048",2011,756,69,687,212
"59752","E01026049",2011,727,28,699,101
"59753","E01026050",2011,798,34,764,87
"59754","E01026051",2011,525,17,508,54
"59755","E01026052",2011,644,76,568,197
"59756","E01026053",2011,763,32,731,262
"59757","E01026054",2011,725,140,585,148
"59758","E01026055",2011,485,27,458,32
"59759","E01026056",2011,474,30,444,57
"59760","E01026057",2011,825,45,780,100
"59761","E01026058",2011,913,50,863,88
"59762","E01026059",2011,452,38,414,44
"59763","E01026060",2011,565,32,533,71
"59764","E01026061",2011,503,6,497,24
"59765","E01026062",2011,525,47,478,69
"59766","E01026063",2011,555,4,551,29
"59767","E01026064",2011,654,201,453,82
"59768","E01026065",2011,828,25,803,103
"59769","E01026066",2011,876,26,850,131
"59770","E01026067",2011,933,176,757,284
"59771","E01026068",2011,942,50,892,179
"59772","E01026069",2011,978,152,826,171
"59773","E01026070",2011,837,40,797,187
"59774","E01026071",2011,951,48,903,180
"59775","E01026072",2011,888,119,769,171
"59776","E01026073",2011,943,231,712,191
"59777","E01026074",2011,966,132,834,103
"59778","E01026075",2011,927,75,852,128
"59779","E01026076",2011,932,69,863,92
"59780","E01026077",2011,503,152,351,39
"59781","E01026078",2011,472,118,354,60
"59782","E01026079",2011,843,56,787,97
"59783","E01026080",2011,853,35,818,108
"59784","E01026081",2011,1175,93,1082,390
"59785","E01026082",2011,1003,29,974,113
"59786","E01026083",2011,795,440,355,58
"59787","E01026084",2011,683,77,606,159
"59788","E01026085",2011,1094,31,1063,192
"59789","E01026087",2011,490,187,303,70
"59790","E01026088",2011,548,19,529,48
"59791","E01026089",2011,971,45,926,164
"59792","E01026090",2011,610,121,489,76
"59793","E01026091",2011,477,62,415,50
"59794","E01026092",2011,630,57,573,273
"59795","E01026093",2011,852,53,799,528
"59796","E01026094",2011,836,277,559,102
"59797","E01026095",2011,483,10,473,196
"59798","E01026096",2011,614,10,604,90
"59799","E01026097",2011,771,207,564,105
"59800","E01026098",2011,880,72,808,67
"59801","E01026099",2011,889,49,840,91
"59802","E01026100",2011,808,49,759,235
"59803","E01026101",2011,590,185,405,106
"59804","E01026102",2011,946,88,858,79
"59805","E01026103",2011,1009,69,940,174
"59806","E01026104",2011,1086,73,1013,95
"59807","E01026105",2011,959,41,918,154
"59808","E01026106",2011,500,48,452,39
"59809","E01026107",2011,484,10,474,49
"59810","E01026108",2011,1051,381,670,138
"59811","E01026109",2011,1149,27,1122,207
"59812","E01026110",2011,644,77,567,78
"59813","E01026111",2011,652,106,546,69
"59814","E01026112",2011,502,177,325,126
"59815","E01026113",2011,886,58,828,115
"59816","E01026114",2011,730,53,677,351
"59817","E01026115",2011,802,120,682,302
"59818","E01026116",2011,713,75,638,120
"59819","E01026117",2011,778,48,730,85
"59820","E01026118",2011,777,8,769,74
"59821","E01026119",2011,502,12,490,39
"59822","E01026120",2011,663,88,575,134
"59823","E01026121",2011,1105,116,989,148
"59824","E01026122",2011,749,131,618,324
"59825","E01026123",2011,1009,293,716,158
"59826","E01026124",2011,645,40,605,287
"59827","E01026125",2011,500,6,494,165
"59828","E01026126",2011,852,432,420,208
"59829","E01026127",2011,639,328,311,52
"59830","E01026128",2011,1185,120,1065,201
"59831","E01026129",2011,705,496,209,43
"59832","E01026130",2011,588,20,568,57
"59833","E01026131",2011,597,150,447,67
"59834","E01026132",2011,784,186,598,396
"59835","E01026133",2011,995,112,883,389
"59836","E01026134",2011,764,146,618,277
"59837","E01026135",2011,676,47,629,54
"59838","E01026136",2011,616,18,598,43
"59839","E01026137",2011,465,10,455,38
"59840","E01026138",2011,618,13,605,41
"59841","E01026139",2011,496,3,493,26
"59842","E01026140",2011,624,185,439,96
"59843","E01026141",2011,557,31,526,40
"59844","E01026142",2011,508,155,353,38
"59845","E01026143",2011,711,21,690,371
"59846","E01026144",2011,628,66,562,255
"59847","E01026145",2011,619,45,574,203
"59848","E01026146",2011,726,220,506,323
"59849","E01026147",2011,1025,11,1014,253
"59850","E01026148",2011,936,167,769,366
"59851","E01026149",2011,791,362,429,61
"59852","E01026150",2011,766,463,303,36
"59853","E01026151",2011,835,130,705,181
"59854","E01026152",2011,565,445,120,22
"59855","E01026153",2011,1090,116,974,245
"59856","E01026154",2011,512,168,344,45
"59857","E01026155",2011,744,21,723,158
"59858","E01026156",2011,474,204,270,28
"59859","E01026157",2011,628,244,384,77
"59860","E01026158",2011,648,15,633,75
"59861","E01026159",2011,643,14,629,116
"59862","E01026160",2011,606,3,603,85
"59863","E01026161",2011,675,288,387,60
"59864","E01026162",2011,621,90,531,59
"59865","E01026163",2011,602,5,597,86
"59866","E01026164",2011,558,42,516,44
"59867","E01026165",2011,715,292,423,46
"59868","E01026166",2011,537,192,345,33
"59869","E01026167",2011,775,50,725,227
"59870","E01026168",2011,616,349,267,36
"59871","E01026169",2011,752,180,572,40
"59872","E01026170",2011,591,197,394,66
"59873","E01026171",2011,667,7,660,47
"59874","E01026172",2011,575,220,355,41
"59875","E01026173",2011,697,506,191,26
"59876","E01026174",2011,604,54,550,213
"59877","E01026175",2011,883,243,640,270
"59878","E01026176",2011,890,270,620,409
"59879","E01026177",2011,777,32,745,441
"59880","E01026178",2011,771,75,696,301
"59881","E01026179",2011,437,48,389,201
"59882","E01026180",2011,604,81,523,65
"59883","E01026182",2011,579,49,530,80
"59884","E01026183",2011,1096,230,866,128
"59885","E01026184",2011,508,37,471,309
"59886","E01026185",2011,810,118,692,94
"59887","E01026186",2011,690,6,684,67
"59888","E01026187",2011,750,5,745,129
"59889","E01026188",2011,1041,214,827,171
"59890","E01026189",2011,809,3,806,74
"59891","E01026190",2011,646,177,469,60
"59892","E01026191",2011,697,75,622,56
"59893","E01026192",2011,496,57,439,52
"59894","E01026193",2011,615,48,567,51
"59895","E01026194",2011,803,107,696,66
"59896","E01026195",2011,814,37,777,103
"59897","E01026196",2011,651,72,579,93
"59898","E01026197",2011,605,42,563,88
"59899","E01026198",2011,446,18,428,291
"59900","E01026199",2011,954,45,909,109
"59901","E01026200",2011,696,26,670,94
"59902","E01026201",2011,858,132,726,84
"59903","E01026202",2011,852,119,733,64
"59904","E01026203",2011,802,27,775,70
"59905","E01026204",2011,738,4,734,40
"59906","E01026205",2011,665,151,514,47
"59907","E01026206",2011,780,5,775,77
"59908","E01026207",2011,523,60,463,65
"59909","E01026208",2011,662,81,581,59
"59910","E01026209",2011,961,82,879,91
"59911","E01026210",2011,957,143,814,121
"59912","E01026211",2011,746,49,697,95
"59913","E01026212",2011,663,44,619,73
"59914","E01026213",2011,794,176,618,79
"59915","E01026214",2011,513,40,473,33
"59916","E01026215",2011,464,4,460,23
"59917","E01026218",2011,565,25,540,59
"59918","E01026219",2011,506,5,501,36
"59919","E01026220",2011,1019,117,902,59
"59920","E01026221",2011,1039,141,898,176
"59921","E01026222",2011,817,22,795,127
"59922","E01026223",2011,899,23,876,93
"59923","E01026224",2011,763,260,503,61
"59924","E01026225",2011,678,84,594,69
"59925","E01026226",2011,812,4,808,53
"59926","E01026227",2011,752,189,563,193
"59927","E01026228",2011,618,50,568,129
"59928","E01026229",2011,614,57,557,79
"59929","E01026230",2011,534,188,346,68
"59930","E01026231",2011,1091,44,1047,208
"59931","E01026232",2011,1015,195,820,161
"59932","E01026233",2011,723,6,717,85
"59933","E01026234",2011,1051,51,1000,119
"59934","E01026235",2011,731,227,504,117
"59935","E01026236",2011,524,31,493,52
"59936","E01026237",2011,492,12,480,41
"59937","E01026238",2011,526,12,514,63
"59938","E01026239",2011,778,87,691,129
"59939","E01026240",2011,964,125,839,59
"59940","E01026241",2011,772,131,641,121
"59941","E01026242",2011,621,34,587,46
"59942","E01026243",2011,570,140,430,47
"59943","E01026244",2011,545,62,483,35
"59944","E01026245",2011,933,53,880,67
"59945","E01026246",2011,951,139,812,67
"59946","E01026247",2011,815,82,733,80
"59947","E01026248",2011,892,104,788,115
"59948","E01026249",2011,773,53,720,66
"59949","E01026250",2011,841,148,693,213
"59950","E01026251",2011,792,36,756,52
"59951","E01026252",2011,779,84,695,101
"59952","E01026253",2011,797,161,636,92
"59953","E01026254",2011,835,198,637,64
"59954","E01026255",2011,864,45,819,153
"59955","E01026256",2011,688,149,539,56
"59956","E01026257",2011,856,33,823,37
"59957","E01026258",2011,747,15,732,39
"59958","E01026259",2011,703,104,599,61
"59959","E01026260",2011,857,171,686,85
"59960","E01026262",2011,638,12,626,61
"59961","E01026263",2011,805,49,756,115
"59962","E01026264",2011,636,81,555,106
"59963","E01026265",2011,511,56,455,52
"59964","E01026266",2011,919,68,851,347
"59965","E01026267",2011,1177,74,1103,241
"59966","E01026268",2011,873,258,615,136
"59967","E01026269",2011,925,33,892,103
"59968","E01026270",2011,744,235,509,145
"59969","E01026271",2011,756,325,431,113
"59970","E01026272",2011,559,62,497,112
"59971","E01026273",2011,716,29,687,54
"59972","E01026274",2011,755,27,728,118
"59973","E01026275",2011,859,157,702,150
"59974","E01026276",2011,972,89,883,75
"59975","E01026277",2011,704,215,489,141
"59976","E01026278",2011,609,27,582,121
"59977","E01026279",2011,614,57,557,71
"59978","E01026280",2011,1020,118,902,85
"59979","E01026281",2011,538,34,504,40
"59980","E01026282",2011,713,160,553,48
"59981","E01026283",2011,726,52,674,55
"59982","E01026284",2011,781,89,692,56
"59983","E01026285",2011,609,59,550,43
"59984","E01026286",2011,498,66,432,56
"59985","E01026287",2011,623,109,514,95
"59986","E01026288",2011,744,322,422,68
"59987","E01026289",2011,858,139,719,80
"59988","E01026290",2011,905,109,796,94
"59989","E01026291",2011,840,98,742,59
"59990","E01026292",2011,618,10,608,73
"59991","E01026293",2011,844,14,830,192
"59992","E01026294",2011,647,16,631,110
"59993","E01026296",2011,651,27,624,58
"59994","E01026297",2011,586,147,439,36
"59995","E01026298",2011,868,240,628,179
"59996","E01026299",2011,718,130,588,86
"59997","E01026300",2011,628,10,618,26
"59998","E01026301",2011,694,13,681,81
"59999","E01026302",2011,491,6,485,46
"60000","E01026303",2011,521,1,520,54
"60001","E01026304",2011,609,15,594,49
"60002","E01026305",2011,596,7,589,121
"60003","E01026306",2011,709,174,535,57
"60004","E01026307",2011,550,12,538,78
"60005","E01026308",2011,596,382,214,35
"60006","E01026309",2011,693,82,611,138
"60007","E01026310",2011,454,128,326,32
"60008","E01026311",2011,666,204,462,112
"60009","E01026312",2011,452,300,152,21
"60010","E01026313",2011,653,65,588,62
"60011","E01026314",2011,561,71,490,60
"60012","E01026315",2011,922,142,780,212
"60013","E01026316",2011,1038,102,936,187
"60014","E01026317",2011,978,107,871,431
"60015","E01026318",2011,856,165,691,284
"60016","E01026319",2011,932,20,912,205
"60017","E01026320",2011,654,4,650,60
"60018","E01026321",2011,537,2,535,59
"60019","E01026322",2011,534,11,523,92
"60020","E01026323",2011,948,250,698,265
"60021","E01026324",2011,885,20,865,95
"60022","E01026325",2011,613,243,370,37
"60023","E01026326",2011,609,101,508,51
"60024","E01026327",2011,610,187,423,31
"60025","E01026328",2011,600,299,301,35
"60026","E01026329",2011,786,87,699,109
"60027","E01026330",2011,868,78,790,87
"60028","E01026331",2011,1042,196,846,199
"60029","E01026332",2011,945,83,862,88
"60030","E01026333",2011,1017,76,941,84
"60031","E01026334",2011,619,39,580,39
"60032","E01026335",2011,721,40,681,105
"60033","E01026336",2011,693,241,452,69
"60034","E01026337",2011,653,39,614,42
"60035","E01026338",2011,527,58,469,57
"60036","E01026339",2011,539,87,452,71
"60037","E01026340",2011,966,202,764,82
"60038","E01026341",2011,619,83,536,55
"60039","E01026342",2011,570,21,549,64
"60040","E01026343",2011,909,133,776,386
"60041","E01026344",2011,682,12,670,223
"60042","E01026345",2011,628,159,469,74
"60043","E01026346",2011,512,39,473,86
"60044","E01026347",2011,843,140,703,151
"60045","E01026348",2011,466,134,332,29
"60046","E01026349",2011,791,226,565,150
"60047","E01026350",2011,848,118,730,260
"60048","E01026351",2011,850,105,745,288
"60049","E01026352",2011,561,10,551,31
"60050","E01026353",2011,857,187,670,269
"60051","E01026354",2011,489,9,480,40
"60052","E01026355",2011,999,65,934,89
"60053","E01026356",2011,580,7,573,93
"60054","E01026357",2011,588,39,549,75
"60055","E01026358",2011,624,13,611,74
"60056","E01026359",2011,667,8,659,48
"60057","E01026360",2011,885,81,804,64
"60058","E01026361",2011,1130,166,964,153
"60059","E01026362",2011,671,13,658,48
"60060","E01026363",2011,531,25,506,70
"60061","E01026364",2011,709,48,661,40
"60062","E01026365",2011,993,44,949,79
"60063","E01026366",2011,915,134,781,87
"60064","E01026367",2011,741,155,586,160
"60065","E01026368",2011,687,50,637,68
"60066","E01026369",2011,486,91,395,50
"60067","E01026370",2011,940,14,926,80
"60068","E01026371",2011,525,12,513,38
"60069","E01026372",2011,1030,86,944,83
"60070","E01026373",2011,828,79,749,71
"60071","E01026374",2011,641,412,229,41
"60072","E01026375",2011,664,270,394,66
"60073","E01026376",2011,778,354,424,45
"60074","E01026377",2011,898,279,619,69
"60075","E01026378",2011,721,93,628,198
"60076","E01026379",2011,733,42,691,163
"60077","E01026380",2011,736,96,640,83
"60078","E01026381",2011,799,182,617,122
"60079","E01026382",2011,740,37,703,174
"60080","E01026383",2011,614,61,553,250
"60081","E01026384",2011,892,120,772,333
"60082","E01026385",2011,511,32,479,111
"60083","E01026386",2011,522,13,509,197
"60084","E01026387",2011,1089,77,1012,79
"60085","E01026388",2011,933,29,904,71
"60086","E01026389",2011,784,42,742,215
"60087","E01026390",2011,841,223,618,122
"60088","E01026391",2011,818,48,770,115
"60089","E01026392",2011,1281,85,1196,142
"60090","E01026393",2011,636,2,634,47
"60091","E01026394",2011,770,65,705,109
"60092","E01026395",2011,658,54,604,60
"60093","E01026396",2011,545,2,543,33
"60094","E01026397",2011,993,21,972,195
"60095","E01026398",2011,707,131,576,71
"60096","E01026399",2011,607,39,568,95
"60097","E01026400",2011,622,14,608,211
"60098","E01026401",2011,621,8,613,27
"60099","E01026402",2011,828,24,804,79
"60100","E01026403",2011,558,49,509,45
"60101","E01026404",2011,962,88,874,88
"60102","E01026405",2011,523,25,498,27
"60103","E01026406",2011,525,2,523,18
"60104","E01026407",2011,558,74,484,55
"60105","E01026408",2011,580,63,517,52
"60106","E01026409",2011,511,43,468,67
"60107","E01026410",2011,746,42,704,41
"60108","E01026411",2011,1045,71,974,144
"60109","E01026412",2011,722,89,633,57
"60110","E01026413",2011,871,30,841,56
"60111","E01026414",2011,694,18,676,115
"60112","E01026415",2011,406,16,390,108
"60113","E01026416",2011,552,85,467,100
"60114","E01026419",2011,481,36,445,64
"60115","E01026420",2011,470,25,445,49
"60116","E01026421",2011,738,54,684,91
"60117","E01026422",2011,911,10,901,103
"60118","E01026423",2011,751,106,645,104
"60119","E01026424",2011,884,82,802,146
"60120","E01026425",2011,851,284,567,103
"60121","E01026426",2011,1179,337,842,302
"60122","E01026427",2011,939,70,869,121
"60123","E01026428",2011,1070,163,907,122
"60124","E01026429",2011,701,138,563,136
"60125","E01026430",2011,692,92,600,61
"60126","E01026431",2011,492,58,434,48
"60127","E01026432",2011,633,14,619,63
"60128","E01026433",2011,613,73,540,167
"60129","E01026434",2011,915,25,890,163
"60130","E01026435",2011,866,88,778,188
"60131","E01026436",2011,968,93,875,111
"60132","E01026437",2011,540,66,474,44
"60133","E01026438",2011,432,52,380,66
"60134","E01026439",2011,692,12,680,88
"60135","E01026440",2011,463,39,424,82
"60136","E01026441",2011,651,129,522,70
"60137","E01026442",2011,922,137,785,97
"60138","E01026443",2011,834,131,703,165
"60139","E01026444",2011,894,147,747,145
"60140","E01026445",2011,1001,166,835,109
"60141","E01026446",2011,877,88,789,74
"60142","E01026447",2011,716,287,429,108
"60143","E01026448",2011,867,31,836,103
"60144","E01026449",2011,793,68,725,207
"60145","E01026450",2011,722,11,711,110
"60146","E01026451",2011,891,103,788,87
"60147","E01026452",2011,711,90,621,68
"60148","E01026453",2011,628,82,546,82
"60149","E01026454",2011,627,7,620,108
"60150","E01026455",2011,825,237,588,158
"60151","E01026456",2011,493,10,483,80
"60152","E01026457",2011,605,21,584,46
"60153","E01026458",2011,673,188,485,73
"60154","E01026459",2011,662,176,486,89
"60155","E01026461",2011,573,14,559,77
"60156","E01026462",2011,937,56,881,82
"60157","E01026464",2011,499,39,460,59
"60158","E01026465",2011,771,216,555,149
"60159","E01026466",2011,719,169,550,177
"60160","E01026467",2011,765,487,278,72
"60161","E01026468",2011,1042,115,927,318
"60162","E01026469",2011,665,57,608,161
"60163","E01026470",2011,1062,16,1046,332
"60164","E01026471",2011,507,10,497,132
"60165","E01026472",2011,489,1,488,67
"60166","E01026473",2011,564,7,557,103
"60167","E01026474",2011,673,184,489,107
"60168","E01026475",2011,628,134,494,70
"60169","E01026476",2011,566,186,380,79
"60170","E01026477",2011,579,248,331,51
"60171","E01026478",2011,641,260,381,86
"60172","E01026479",2011,640,121,519,44
"60173","E01026480",2011,658,18,640,62
"60174","E01026481",2011,481,76,405,39
"60175","E01026483",2011,491,90,401,118
"60176","E01026484",2011,583,51,532,55
"60177","E01026485",2011,452,33,419,36
"60178","E01026486",2011,705,65,640,89
"60179","E01026487",2011,618,26,592,149
"60180","E01026488",2011,548,175,373,175
"60181","E01026489",2011,625,37,588,56
"60182","E01026490",2011,730,25,705,71
"60183","E01026491",2011,907,50,857,139
"60184","E01026492",2011,563,68,495,83
"60185","E01026493",2011,499,12,487,100
"60186","E01026494",2011,936,77,859,135
"60187","E01026495",2011,572,108,464,49
"60188","E01026496",2011,496,17,479,59
"60189","E01026497",2011,679,23,656,86
"60190","E01026498",2011,606,108,498,62
"60191","E01026499",2011,764,229,535,102
"60192","E01026500",2011,736,51,685,72
"60193","E01026501",2011,680,76,604,67
"60194","E01026502",2011,518,45,473,66
"60195","E01026503",2011,649,22,627,90
"60196","E01026504",2011,627,42,585,106
"60197","E01026505",2011,605,155,450,52
"60198","E01026506",2011,590,11,579,20
"60199","E01026507",2011,568,29,539,43
"60200","E01026508",2011,641,74,567,60
"60201","E01026509",2011,684,14,670,73
"60202","E01026510",2011,700,11,689,85
"60203","E01026511",2011,467,71,396,43
"60204","E01026512",2011,553,120,433,34
"60205","E01026513",2011,578,42,536,35
"60206","E01026514",2011,630,66,564,90
"60207","E01026515",2011,451,15,436,57
"60208","E01026516",2011,563,126,437,86
"60209","E01026517",2011,602,29,573,101
"60210","E01026518",2011,535,70,465,60
"60211","E01026519",2011,735,46,689,160
"60212","E01026520",2011,503,54,449,33
"60213","E01026521",2011,505,7,498,51
"60214","E01026522",2011,595,77,518,83
"60215","E01026523",2011,769,119,650,128
"60216","E01026524",2011,616,64,552,94
"60217","E01026525",2011,451,31,420,68
"60218","E01026526",2011,649,96,553,28
"60219","E01026527",2011,664,11,653,33
"60220","E01026528",2011,602,62,540,29
"60221","E01026529",2011,722,105,617,70
"60222","E01026530",2011,747,21,726,82
"60223","E01026531",2011,748,6,742,44
"60224","E01026532",2011,738,30,708,67
"60225","E01026533",2011,521,30,491,40
"60226","E01026534",2011,628,38,590,71
"60227","E01026535",2011,663,32,631,105
"60228","E01026536",2011,653,61,592,77
"60229","E01026537",2011,573,39,534,45
"60230","E01026538",2011,648,107,541,74
"60231","E01026539",2011,676,61,615,57
"60232","E01026540",2011,644,7,637,39
"60233","E01026541",2011,1027,272,755,126
"60234","E01026542",2011,651,30,621,45
"60235","E01026543",2011,634,5,629,74
"60236","E01026544",2011,722,38,684,83
"60237","E01026545",2011,644,79,565,42
"60238","E01026546",2011,584,6,578,37
"60239","E01026547",2011,636,88,548,126
"60240","E01026548",2011,533,24,509,72
"60241","E01026549",2011,797,139,658,78
"60242","E01026550",2011,437,14,423,41
"60243","E01026551",2011,496,14,482,39
"60244","E01026552",2011,606,4,602,22
"60245","E01026553",2011,611,118,493,57
"60246","E01026554",2011,504,19,485,27
"60247","E01026555",2011,610,88,522,35
"60248","E01026556",2011,639,98,541,71
"60249","E01026557",2011,637,7,630,73
"60250","E01026558",2011,614,5,609,42
"60251","E01026559",2011,626,23,603,41
"60252","E01026560",2011,633,4,629,28
"60253","E01026561",2011,650,7,643,37
"60254","E01026562",2011,453,7,446,26
"60255","E01026563",2011,556,71,485,77
"60256","E01026564",2011,564,37,527,58
"60257","E01026565",2011,511,47,464,107
"60258","E01026566",2011,634,42,592,95
"60259","E01026567",2011,758,3,755,39
"60260","E01026568",2011,625,5,620,24
"60261","E01026569",2011,719,160,559,38
"60262","E01026570",2011,727,15,712,50
"60263","E01026571",2011,655,7,648,57
"60264","E01026572",2011,638,8,630,44
"60265","E01026573",2011,623,143,480,45
"60266","E01026574",2011,683,13,670,70
"60267","E01026575",2011,732,95,637,99
"60268","E01026576",2011,808,39,769,154
"60269","E01026577",2011,775,72,703,169
"60270","E01026578",2011,762,69,693,64
"60271","E01026579",2011,638,41,597,68
"60272","E01026580",2011,708,78,630,71
"60273","E01026581",2011,656,19,637,59
"60274","E01026582",2011,842,15,827,53
"60275","E01026583",2011,565,69,496,42
"60276","E01026584",2011,669,6,663,35
"60277","E01026585",2011,589,102,487,36
"60278","E01026586",2011,499,178,321,38
"60279","E01026587",2011,729,23,706,65
"60280","E01026588",2011,1145,60,1085,146
"60281","E01026589",2011,614,57,557,81
"60282","E01026590",2011,670,5,665,85
"60283","E01026591",2011,803,6,797,77
"60284","E01026592",2011,700,163,537,50
"60285","E01026593",2011,590,5,585,61
"60286","E01026594",2011,761,41,720,112
"60287","E01026595",2011,789,222,567,210
"60288","E01026596",2011,683,64,619,186
"60289","E01026597",2011,888,331,557,319
"60290","E01026598",2011,707,102,605,342
"60291","E01026599",2011,574,26,548,208
"60292","E01026600",2011,628,209,419,85
"60293","E01026601",2011,664,79,585,170
"60294","E01026602",2011,702,142,560,64
"60295","E01026603",2011,742,425,317,59
"60296","E01026604",2011,726,387,339,58
"60297","E01026605",2011,699,19,680,59
"60298","E01026606",2011,708,65,643,56
"60299","E01026607",2011,710,48,662,76
"60300","E01026608",2011,522,27,495,38
"60301","E01026609",2011,496,73,423,54
"60302","E01026610",2011,666,11,655,199
"60303","E01026611",2011,648,29,619,131
"60304","E01026612",2011,1065,80,985,166
"60305","E01026613",2011,561,14,547,41
"60306","E01026614",2011,713,73,640,64
"60307","E01026615",2011,558,5,553,34
"60308","E01026616",2011,491,36,455,44
"60309","E01026617",2011,581,233,348,29
"60310","E01026618",2011,685,176,509,84
"60311","E01026619",2011,596,311,285,49
"60312","E01026620",2011,641,370,271,35
"60313","E01026621",2011,553,126,427,43
"60314","E01026622",2011,632,378,254,89
"60315","E01026623",2011,663,83,580,290
"60316","E01026624",2011,829,161,668,344
"60317","E01026625",2011,773,569,204,87
"60318","E01026626",2011,866,139,727,395
"60319","E01026627",2011,617,4,613,39
"60320","E01026628",2011,595,27,568,49
"60321","E01026629",2011,630,60,570,59
"60322","E01026630",2011,670,134,536,141
"60323","E01026631",2011,777,19,758,233
"60324","E01026632",2011,786,136,650,168
"60325","E01026633",2011,729,58,671,277
"60326","E01026634",2011,612,54,558,160
"60327","E01026635",2011,958,274,684,293
"60328","E01026636",2011,674,54,620,66
"60329","E01026637",2011,822,7,815,102
"60330","E01026638",2011,639,117,522,74
"60331","E01026639",2011,598,20,578,121
"60332","E01026640",2011,756,166,590,58
"60333","E01026641",2011,625,363,262,38
"60334","E01026642",2011,561,29,532,49
"60335","E01026643",2011,596,22,574,119
"60336","E01026644",2011,644,61,583,495
"60337","E01026645",2011,665,77,588,101
"60338","E01026646",2011,844,153,691,139
"60339","E01026647",2011,925,75,850,58
"60340","E01026648",2011,655,84,571,100
"60341","E01026649",2011,661,51,610,107
"60342","E01026650",2011,439,19,420,135
"60343","E01026651",2011,971,90,881,146
"60344","E01026652",2011,525,87,438,60
"60345","E01026653",2011,840,14,826,73
"60346","E01026654",2011,741,180,561,108
"60347","E01026655",2011,659,11,648,92
"60348","E01026656",2011,837,144,693,122
"60349","E01026659",2011,675,111,564,87
"60350","E01026660",2011,697,63,634,59
"60351","E01026661",2011,606,31,575,48
"60352","E01026662",2011,923,360,563,170
"60353","E01026663",2011,714,310,404,58
"60354","E01026664",2011,949,110,839,280
"60355","E01026665",2011,984,140,844,119
"60356","E01026666",2011,726,327,399,88
"60357","E01026667",2011,673,29,644,152
"60358","E01026668",2011,634,34,600,137
"60359","E01026669",2011,746,16,730,71
"60360","E01026670",2011,586,141,445,57
"60361","E01026671",2011,532,4,528,35
"60362","E01026672",2011,625,19,606,57
"60363","E01026673",2011,633,13,620,101
"60364","E01026674",2011,482,37,445,32
"60365","E01026675",2011,508,27,481,47
"60366","E01026676",2011,818,17,801,71
"60367","E01026677",2011,727,180,547,79
"60368","E01026678",2011,755,26,729,77
"60369","E01026679",2011,996,119,877,147
"60370","E01026680",2011,769,173,596,64
"60371","E01026681",2011,686,28,658,101
"60372","E01026682",2011,552,56,496,81
"60373","E01026683",2011,654,11,643,208
"60374","E01026684",2011,461,26,435,33
"60375","E01026685",2011,554,67,487,25
"60376","E01026686",2011,1014,19,995,173
"60377","E01026687",2011,661,406,255,59
"60378","E01026688",2011,526,225,301,46
"60379","E01026689",2011,640,67,573,248
"60380","E01026690",2011,586,275,311,54
"60381","E01026691",2011,457,34,423,30
"60382","E01026692",2011,519,2,517,67
"60383","E01026693",2011,814,95,719,88
"60384","E01026694",2011,1078,155,923,182
"60385","E01026695",2011,984,126,858,162
"60386","E01026696",2011,449,72,377,43
"60387","E01026697",2011,550,23,527,71
"60388","E01026698",2011,1024,219,805,360
"60389","E01026699",2011,848,428,420,262
"60390","E01026700",2011,689,199,490,234
"60391","E01026701",2011,779,31,748,68
"60392","E01026702",2011,617,95,522,91
"60393","E01026703",2011,532,44,488,88
"60394","E01026704",2011,686,293,393,130
"60395","E01026705",2011,638,73,565,65
"60396","E01026706",2011,633,56,577,145
"60397","E01026707",2011,1148,96,1052,54
"60398","E01026708",2011,551,13,538,29
"60399","E01026709",2011,765,23,742,56
"60400","E01026710",2011,485,6,479,49
"60401","E01026711",2011,602,161,441,64
"60402","E01026712",2011,690,66,624,64
"60403","E01026713",2011,629,34,595,46
"60404","E01026714",2011,793,29,764,105
"60405","E01026715",2011,595,33,562,82
"60406","E01026716",2011,793,123,670,64
"60407","E01026717",2011,603,58,545,75
"60408","E01026718",2011,1008,126,882,244
"60409","E01026719",2011,907,86,821,75
"60410","E01026720",2011,526,30,496,40
"60411","E01026721",2011,513,57,456,38
"60412","E01026722",2011,1021,82,939,121
"60413","E01026723",2011,661,22,639,43
"60414","E01026724",2011,724,69,655,81
"60415","E01026725",2011,615,69,546,52
"60416","E01026726",2011,858,88,770,82
"60417","E01026727",2011,1096,93,1003,157
"60418","E01026728",2011,967,114,853,106
"60419","E01026729",2011,934,83,851,167
"60420","E01026730",2011,1067,143,924,146
"60421","E01026731",2011,493,54,439,26
"60422","E01026732",2011,566,51,515,117
"60423","E01026733",2011,1033,149,884,140
"60424","E01026734",2011,619,31,588,276
"60425","E01026735",2011,675,29,646,258
"60426","E01026736",2011,603,150,453,73
"60427","E01026737",2011,1011,87,924,136
"60428","E01026738",2011,1082,145,937,103
"60429","E01026739",2011,964,146,818,141
"60430","E01026740",2011,1085,77,1008,142
"60431","E01026741",2011,927,122,805,79
"60432","E01026742",2011,693,26,667,52
"60433","E01026743",2011,1114,308,806,153
"60434","E01026744",2011,952,133,819,89
"60435","E01026745",2011,760,144,616,78
"60436","E01026746",2011,747,25,722,110
"60437","E01026747",2011,628,164,464,129
"60438","E01026748",2011,667,21,646,47
"60439","E01026749",2011,682,228,454,52
"60440","E01026750",2011,639,106,533,111
"60441","E01026751",2011,674,53,621,72
"60442","E01026752",2011,625,49,576,78
"60443","E01026753",2011,732,297,435,76
"60444","E01026754",2011,616,70,546,86
"60445","E01026755",2011,555,43,512,19
"60446","E01026756",2011,529,174,355,62
"60447","E01026757",2011,677,20,657,112
"60448","E01026758",2011,648,20,628,114
"60449","E01026759",2011,551,146,405,34
"60450","E01026760",2011,584,44,540,125
"60451","E01026761",2011,705,89,616,102
"60452","E01026762",2011,1054,63,991,151
"60453","E01026763",2011,628,210,418,131
"60454","E01026764",2011,648,75,573,101
"60455","E01026765",2011,618,100,518,85
"60456","E01026766",2011,975,97,878,94
"60457","E01026767",2011,528,69,459,58
"60458","E01026768",2011,508,31,477,170
"60459","E01026769",2011,982,110,872,93
"60460","E01026770",2011,1003,32,971,285
"60461","E01026771",2011,748,128,620,83
"60462","E01026772",2011,786,21,765,97
"60463","E01026773",2011,950,114,836,111
"60464","E01026774",2011,640,42,598,75
"60465","E01026775",2011,575,205,370,54
"60466","E01026776",2011,776,42,734,187
"60467","E01026777",2011,532,63,469,33
"60468","E01026778",2011,726,75,651,110
"60469","E01026779",2011,568,154,414,72
"60470","E01026780",2011,1123,78,1045,235
"60471","E01026781",2011,984,46,938,107
"60472","E01026782",2011,1008,165,843,230
"60473","E01026783",2011,836,66,770,63
"60474","E01026784",2011,464,154,310,48
"60475","E01026785",2011,607,48,559,65
"60476","E01026786",2011,957,56,901,149
"60477","E01026787",2011,442,67,375,72
"60478","E01026788",2011,569,60,509,74
"60479","E01026789",2011,495,36,459,53
"60480","E01026790",2011,479,70,409,73
"60481","E01026791",2011,661,345,316,89
"60482","E01026792",2011,627,213,414,63
"60483","E01026793",2011,625,358,267,71
"60484","E01026794",2011,844,269,575,125
"60485","E01026796",2011,650,283,367,129
"60486","E01026797",2011,1070,215,855,299
"60487","E01026798",2011,670,368,302,85
"60488","E01026799",2011,626,284,342,66
"60489","E01026800",2011,901,493,408,155
"60490","E01026801",2011,684,47,637,86
"60491","E01026802",2011,785,168,617,164
"60492","E01026803",2011,638,265,373,42
"60493","E01026804",2011,633,161,472,33
"60494","E01026805",2011,639,271,368,38
"60495","E01026806",2011,508,19,489,36
"60496","E01026807",2011,523,126,397,69
"60497","E01026808",2011,516,316,200,34
"60498","E01026809",2011,762,432,330,28
"60499","E01026810",2011,635,105,530,68
"60500","E01026811",2011,723,50,673,59
"60501","E01026812",2011,639,14,625,81
"60502","E01026813",2011,635,9,626,37
"60503","E01026814",2011,653,253,400,92
"60504","E01026815",2011,648,28,620,123
"60505","E01026816",2011,934,227,707,269
"60506","E01026817",2011,706,280,426,73
"60507","E01026818",2011,626,312,314,35
"60508","E01026819",2011,625,389,236,49
"60509","E01026820",2011,755,400,355,52
"60510","E01026821",2011,712,332,380,39
"60511","E01026822",2011,1228,506,722,335
"60512","E01026823",2011,1099,284,815,414
"60513","E01026824",2011,868,473,395,164
"60514","E01026825",2011,718,245,473,224
"60515","E01026826",2011,864,495,369,212
"60516","E01026827",2011,931,646,285,123
"60517","E01026828",2011,664,393,271,45
"60518","E01026829",2011,857,368,489,185
"60519","E01026830",2011,682,336,346,123
"60520","E01026831",2011,632,70,562,221
"60521","E01026832",2011,498,290,208,24
"60522","E01026833",2011,696,553,143,34
"60523","E01026834",2011,644,340,304,63
"60524","E01026835",2011,643,42,601,267
"60525","E01026836",2011,646,13,633,225
"60526","E01026837",2011,735,103,632,274
"60527","E01026838",2011,645,8,637,199
"60528","E01026839",2011,668,18,650,328
"60529","E01026840",2011,759,39,720,281
"60530","E01026841",2011,726,43,683,286
"60531","E01026842",2011,818,34,784,295
"60532","E01026843",2011,902,308,594,181
"60533","E01026844",2011,823,289,534,140
"60534","E01026845",2011,786,35,751,308
"60535","E01026846",2011,811,79,732,324
"60536","E01026848",2011,1015,678,337,125
"60537","E01026849",2011,913,63,850,370
"60538","E01026850",2011,952,168,784,287
"60539","E01026852",2011,598,17,581,98
"60540","E01026853",2011,1011,511,500,191
"60541","E01026855",2011,773,49,724,315
"60542","E01026856",2011,847,76,771,382
"60543","E01026857",2011,751,159,592,184
"60544","E01026858",2011,745,432,313,108
"60545","E01026859",2011,640,241,399,73
"60546","E01026860",2011,470,152,318,90
"60547","E01026861",2011,549,269,280,104
"60548","E01026862",2011,497,191,306,61
"60549","E01026863",2011,771,130,641,206
"60550","E01026864",2011,657,168,489,85
"60551","E01026865",2011,805,463,342,144
"60552","E01026866",2011,767,159,608,199
"60553","E01026867",2011,562,310,252,52
"60554","E01026868",2011,565,331,234,84
"60555","E01026869",2011,657,436,221,41
"60556","E01026870",2011,873,181,692,218
"60557","E01026871",2011,570,21,549,46
"60558","E01026872",2011,980,137,843,133
"60559","E01026873",2011,511,44,467,63
"60560","E01026874",2011,610,76,534,64
"60561","E01026875",2011,448,10,438,39
"60562","E01026876",2011,652,86,566,49
"60563","E01026877",2011,638,39,599,37
"60564","E01026878",2011,473,71,402,33
"60565","E01026879",2011,499,96,403,53
"60566","E01026880",2011,605,19,586,48
"60567","E01026881",2011,626,45,581,120
"60568","E01026882",2011,855,36,819,62
"60569","E01026883",2011,680,72,608,65
"60570","E01026884",2011,486,98,388,53
"60571","E01026885",2011,555,36,519,72
"60572","E01026886",2011,564,52,512,32
"60573","E01026887",2011,607,62,545,97
"60574","E01026888",2011,778,248,530,73
"60575","E01026889",2011,719,24,695,112
"60576","E01026891",2011,815,208,607,156
"60577","E01026892",2011,557,84,473,96
"60578","E01026893",2011,460,14,446,41
"60579","E01026894",2011,1033,113,920,98
"60580","E01026895",2011,598,50,548,50
"60581","E01026896",2011,486,35,451,52
"60582","E01026897",2011,1099,79,1020,96
"60583","E01026898",2011,601,82,519,60
"60584","E01026899",2011,602,29,573,101
"60585","E01026900",2011,692,118,574,53
"60586","E01026901",2011,606,38,568,70
"60587","E01026902",2011,878,171,707,155
"60588","E01026903",2011,480,21,459,34
"60589","E01026904",2011,562,90,472,42
"60590","E01026905",2011,521,201,320,17
"60591","E01026906",2011,593,17,576,26
"60592","E01026907",2011,795,41,754,97
"60593","E01026908",2011,598,18,580,131
"60594","E01026909",2011,650,156,494,59
"60595","E01026910",2011,649,24,625,58
"60596","E01026911",2011,529,156,373,56
"60597","E01026912",2011,650,49,601,64
"60598","E01026913",2011,714,147,567,71
"60599","E01026914",2011,614,14,600,86
"60600","E01026915",2011,796,33,763,77
"60601","E01026916",2011,896,9,887,54
"60602","E01026917",2011,668,106,562,42
"60603","E01026918",2011,770,21,749,74
"60604","E01026919",2011,625,118,507,55
"60605","E01026920",2011,469,32,437,34
"60606","E01026921",2011,631,15,616,88
"60607","E01026922",2011,689,212,477,62
"60608","E01026924",2011,674,124,550,39
"60609","E01026925",2011,923,369,554,84
"60610","E01026926",2011,662,20,642,76
"60611","E01026927",2011,788,33,755,48
"60612","E01026928",2011,629,125,504,56
"60613","E01026929",2011,553,32,521,55
"60614","E01026930",2011,615,59,556,43
"60615","E01026931",2011,471,9,462,39
"60616","E01026932",2011,535,42,493,79
"60617","E01026933",2011,1113,86,1027,142
"60618","E01026934",2011,463,49,414,40
"60619","E01026935",2011,566,37,529,93
"60620","E01026936",2011,625,66,559,47
"60621","E01026937",2011,629,59,570,117
"60622","E01026938",2011,852,39,813,105
"60623","E01026939",2011,703,39,664,54
"60624","E01026940",2011,719,196,523,86
"60625","E01026941",2011,506,32,474,41
"60626","E01026942",2011,449,16,433,29
"60627","E01026943",2011,654,48,606,69
"60628","E01026944",2011,461,24,437,53
"60629","E01026945",2011,870,64,806,118
"60630","E01026946",2011,496,28,468,34
"60631","E01026947",2011,509,53,456,71
"60632","E01026948",2011,486,22,464,37
"60633","E01026949",2011,613,200,413,98
"60634","E01026950",2011,614,224,390,111
"60635","E01026951",2011,495,162,333,64
"60636","E01026952",2011,499,68,431,64
"60637","E01026953",2011,590,46,544,40
"60638","E01026954",2011,534,143,391,75
"60639","E01026955",2011,557,4,553,40
"60640","E01026956",2011,818,199,619,119
"60641","E01026957",2011,727,185,542,159
"60642","E01026958",2011,738,189,549,158
"60643","E01026959",2011,646,146,500,107
"60644","E01026960",2011,609,247,362,116
"60645","E01026961",2011,502,155,347,88
"60646","E01026962",2011,602,127,475,65
"60647","E01026963",2011,550,210,340,99
"60648","E01026965",2011,426,159,267,88
"60649","E01026966",2011,564,137,427,54
"60650","E01026967",2011,693,186,507,94
"60651","E01026968",2011,611,288,323,109
"60652","E01026969",2011,802,250,552,114
"60653","E01026970",2011,656,129,527,62
"60654","E01026971",2011,739,188,551,104
"60655","E01026972",2011,766,186,580,100
"60656","E01026973",2011,587,80,507,61
"60657","E01026974",2011,476,36,440,34
"60658","E01026975",2011,645,244,401,84
"60659","E01026976",2011,544,148,396,67
"60660","E01026977",2011,838,84,754,56
"60661","E01026978",2011,604,78,526,77
"60662","E01026979",2011,566,48,518,62
"60663","E01026980",2011,652,35,617,69
"60664","E01026981",2011,480,33,447,45
"60665","E01026982",2011,787,229,558,132
"60666","E01026983",2011,464,92,372,83
"60667","E01026984",2011,752,179,573,93
"60668","E01026985",2011,637,93,544,45
"60669","E01026986",2011,1134,286,848,218
"60670","E01026987",2011,516,66,450,33
"60671","E01026988",2011,596,229,367,81
"60672","E01026989",2011,592,108,484,97
"60673","E01026990",2011,1069,135,934,208
"60674","E01026991",2011,759,33,726,72
"60675","E01026992",2011,931,313,618,207
"60676","E01026993",2011,824,56,768,59
"60677","E01026994",2011,453,77,376,37
"60678","E01026997",2011,682,37,645,50
"60679","E01026998",2011,742,29,713,156
"60680","E01026999",2011,776,126,650,71
"60681","E01027000",2011,608,118,490,58
"60682","E01027001",2011,510,12,498,44
"60683","E01027002",2011,638,37,601,65
"60684","E01027003",2011,593,20,573,80
"60685","E01027004",2011,773,79,694,84
"60686","E01027005",2011,823,73,750,124
"60687","E01027006",2011,745,91,654,68
"60688","E01027007",2011,536,120,416,85
"60689","E01027008",2011,888,28,860,191
"60690","E01027009",2011,595,214,381,95
"60691","E01027010",2011,489,38,451,21
"60692","E01027011",2011,820,78,742,92
"60693","E01027012",2011,726,166,560,65
"60694","E01027013",2011,715,414,301,67
"60695","E01027014",2011,799,46,753,109
"60696","E01027015",2011,522,13,509,33
"60697","E01027016",2011,616,17,599,95
"60698","E01027017",2011,670,227,443,52
"60699","E01027018",2011,623,13,610,61
"60700","E01027019",2011,652,136,516,84
"60701","E01027020",2011,535,17,518,44
"60702","E01027021",2011,768,54,714,89
"60703","E01027022",2011,745,63,682,76
"60704","E01027023",2011,824,119,705,70
"60705","E01027024",2011,714,29,685,77
"60706","E01027025",2011,751,197,554,114
"60707","E01027026",2011,794,74,720,73
"60708","E01027027",2011,903,86,817,95
"60709","E01027028",2011,887,33,854,124
"60710","E01027029",2011,671,186,485,83
"60711","E01027030",2011,731,56,675,81
"60712","E01027031",2011,832,80,752,130
"60713","E01027032",2011,779,97,682,144
"60714","E01027033",2011,802,134,668,100
"60715","E01027034",2011,739,198,541,84
"60716","E01027035",2011,588,174,414,76
"60717","E01027037",2011,836,12,824,82
"60718","E01027038",2011,675,195,480,83
"60719","E01027039",2011,737,113,624,104
"60720","E01027040",2011,707,41,666,76
"60721","E01027041",2011,728,280,448,114
"60722","E01027042",2011,721,30,691,71
"60723","E01027043",2011,805,121,684,126
"60724","E01027044",2011,839,69,770,134
"60725","E01027045",2011,819,118,701,89
"60726","E01027046",2011,513,28,485,76
"60727","E01027047",2011,561,128,433,62
"60728","E01027048",2011,614,102,512,130
"60729","E01027049",2011,439,37,402,72
"60730","E01027050",2011,791,94,697,91
"60731","E01027051",2011,750,165,585,134
"60732","E01027052",2011,576,31,545,56
"60733","E01027053",2011,624,21,603,64
"60734","E01027054",2011,515,9,506,37
"60735","E01027055",2011,465,19,446,42
"60736","E01027056",2011,625,209,416,56
"60737","E01027057",2011,718,76,642,53
"60738","E01027058",2011,622,253,369,36
"60739","E01027059",2011,750,70,680,147
"60740","E01027060",2011,845,139,706,195
"60741","E01027061",2011,757,177,580,67
"60742","E01027062",2011,929,173,756,124
"60743","E01027063",2011,730,20,710,71
"60744","E01027064",2011,641,8,633,43
"60745","E01027065",2011,847,134,713,216
"60746","E01027066",2011,808,2,806,58
"60747","E01027067",2011,675,0,675,46
"60748","E01027068",2011,1118,9,1109,136
"60749","E01027069",2011,805,221,584,123
"60750","E01027070",2011,682,17,665,55
"60751","E01027071",2011,598,25,573,42
"60752","E01027072",2011,608,287,321,32
"60753","E01027073",2011,889,112,777,102
"60754","E01027074",2011,858,96,762,58
"60755","E01027075",2011,804,45,759,109
"60756","E01027076",2011,926,177,749,151
"60757","E01027077",2011,736,25,711,114
"60758","E01027078",2011,888,140,748,85
"60759","E01027079",2011,739,41,698,128
"60760","E01027080",2011,752,13,739,65
"60761","E01027081",2011,613,181,432,79
"60762","E01027082",2011,703,146,557,161
"60763","E01027083",2011,648,322,326,75
"60764","E01027084",2011,642,1,641,43
"60765","E01027085",2011,517,53,464,33
"60766","E01027086",2011,684,12,672,50
"60767","E01027087",2011,495,24,471,80
"60768","E01027088",2011,482,3,479,65
"60769","E01027089",2011,809,34,775,79
"60770","E01027090",2011,615,38,577,149
"60771","E01027091",2011,762,200,562,65
"60772","E01027092",2011,619,34,585,50
"60773","E01027094",2011,649,60,589,38
"60774","E01027095",2011,576,87,489,52
"60775","E01027096",2011,453,8,445,41
"60776","E01027097",2011,592,4,588,70
"60777","E01027098",2011,482,26,456,54
"60778","E01027099",2011,670,1,669,52
"60779","E01027100",2011,683,73,610,74
"60780","E01027101",2011,1017,103,914,157
"60781","E01027102",2011,679,69,610,55
"60782","E01027103",2011,682,72,610,86
"60783","E01027104",2011,1096,248,848,271
"60784","E01027105",2011,918,38,880,416
"60785","E01027106",2011,876,100,776,336
"60786","E01027107",2011,565,39,526,83
"60787","E01027108",2011,526,2,524,26
"60788","E01027109",2011,505,67,438,44
"60789","E01027110",2011,1110,497,613,253
"60790","E01027111",2011,916,46,870,326
"60791","E01027112",2011,935,63,872,298
"60792","E01027113",2011,963,119,844,205
"60793","E01027114",2011,680,59,621,86
"60794","E01027115",2011,485,3,482,32
"60795","E01027116",2011,817,24,793,201
"60796","E01027117",2011,610,41,569,132
"60797","E01027119",2011,748,132,616,92
"60798","E01027120",2011,521,7,514,76
"60799","E01027121",2011,533,2,531,16
"60800","E01027122",2011,503,4,499,41
"60801","E01027123",2011,662,78,584,42
"60802","E01027124",2011,1003,242,761,184
"60803","E01027125",2011,709,13,696,45
"60804","E01027126",2011,992,145,847,218
"60805","E01027127",2011,780,420,360,47
"60806","E01027128",2011,676,229,447,62
"60807","E01027129",2011,949,86,863,86
"60808","E01027130",2011,788,124,664,73
"60809","E01027131",2011,994,461,533,128
"60810","E01027132",2011,937,95,842,426
"60811","E01027133",2011,759,29,730,235
"60812","E01027134",2011,690,36,654,238
"60813","E01027135",2011,716,36,680,148
"60814","E01027136",2011,776,44,732,238
"60815","E01027137",2011,631,180,451,115
"60816","E01027138",2011,635,27,608,70
"60817","E01027139",2011,616,68,548,112
"60818","E01027140",2011,461,177,284,56
"60819","E01027141",2011,540,29,511,34
"60820","E01027142",2011,601,139,462,59
"60821","E01027143",2011,530,59,471,32
"60822","E01027144",2011,635,2,633,30
"60823","E01027145",2011,567,55,512,64
"60824","E01027146",2011,635,6,629,50
"60825","E01027147",2011,809,213,596,107
"60826","E01027148",2011,572,6,566,40
"60827","E01027149",2011,612,55,557,57
"60828","E01027151",2011,728,137,591,224
"60829","E01027152",2011,742,176,566,244
"60830","E01027153",2011,994,435,559,314
"60831","E01027154",2011,778,104,674,339
"60832","E01027155",2011,980,114,866,514
"60833","E01027156",2011,504,176,328,56
"60834","E01027158",2011,646,41,605,160
"60835","E01027159",2011,511,25,486,52
"60836","E01027160",2011,705,20,685,134
"60837","E01027161",2011,669,341,328,38
"60838","E01027162",2011,689,65,624,166
"60839","E01027163",2011,566,5,561,57
"60840","E01027164",2011,622,6,616,198
"60841","E01027165",2011,491,3,488,61
"60842","E01027166",2011,625,5,620,139
"60843","E01027167",2011,572,5,567,76
"60844","E01027168",2011,728,387,341,101
"60845","E01027169",2011,585,38,547,81
"60846","E01027170",2011,621,230,391,67
"60847","E01027171",2011,683,186,497,57
"60848","E01027172",2011,658,28,630,49
"60849","E01027173",2011,600,157,443,78
"60850","E01027174",2011,515,14,501,31
"60851","E01027175",2011,599,119,480,93
"60852","E01027176",2011,602,102,500,55
"60853","E01027177",2011,630,288,342,80
"60854","E01027178",2011,781,298,483,79
"60855","E01027179",2011,770,105,665,61
"60856","E01027180",2011,707,194,513,45
"60857","E01027181",2011,770,56,714,54
"60858","E01027182",2011,606,13,593,68
"60859","E01027183",2011,613,4,609,37
"60860","E01027184",2011,625,61,564,192
"60861","E01027185",2011,595,176,419,131
"60862","E01027186",2011,668,8,660,111
"60863","E01027187",2011,539,49,490,171
"60864","E01027188",2011,732,171,561,95
"60865","E01027189",2011,734,79,655,177
"60866","E01027190",2011,778,88,690,109
"60867","E01027191",2011,761,122,639,176
"60868","E01027192",2011,538,8,530,200
"60869","E01027193",2011,619,4,615,62
"60870","E01027194",2011,626,2,624,43
"60871","E01027195",2011,607,206,401,126
"60872","E01027196",2011,527,90,437,92
"60873","E01027197",2011,605,210,395,50
"60874","E01027198",2011,650,286,364,100
"60875","E01027199",2011,504,283,221,53
"60876","E01027200",2011,577,170,407,96
"60877","E01027201",2011,880,56,824,126
"60878","E01027202",2011,674,109,565,55
"60879","E01027203",2011,557,5,552,81
"60880","E01027204",2011,642,90,552,55
"60881","E01027205",2011,723,6,717,83
"60882","E01027206",2011,1027,30,997,82
"60883","E01027207",2011,605,2,603,32
"60884","E01027208",2011,602,18,584,73
"60885","E01027209",2011,551,5,546,127
"60886","E01027210",2011,451,46,405,17
"60887","E01027211",2011,629,3,626,52
"60888","E01027212",2011,566,5,561,87
"60889","E01027213",2011,642,122,520,83
"60890","E01027214",2011,746,235,511,79
"60891","E01027215",2011,601,63,538,50
"60892","E01027216",2011,776,27,749,92
"60893","E01027217",2011,941,45,896,84
"60894","E01027218",2011,701,1,700,40
"60895","E01027219",2011,798,9,789,60
"60896","E01027220",2011,596,30,566,32
"60897","E01027221",2011,748,19,729,86
"60898","E01027222",2011,497,9,488,28
"60899","E01027223",2011,1107,268,839,486
"60900","E01027224",2011,904,262,642,307
"60901","E01027225",2011,724,65,659,385
"60902","E01027226",2011,853,204,649,324
"60903","E01027227",2011,659,57,602,289
"60904","E01027228",2011,929,149,780,434
"60905","E01027229",2011,613,210,403,102
"60906","E01027230",2011,618,207,411,136
"60907","E01027231",2011,800,410,390,87
"60908","E01027232",2011,622,73,549,117
"60909","E01027233",2011,483,158,325,75
"60910","E01027234",2011,588,48,540,67
"60911","E01027235",2011,629,332,297,68
"60912","E01027236",2011,679,42,637,83
"60913","E01027237",2011,882,46,836,249
"60914","E01027238",2011,960,217,743,299
"60915","E01027239",2011,666,322,344,70
"60916","E01027240",2011,512,200,312,33
"60917","E01027241",2011,711,210,501,209
"60918","E01027242",2011,595,254,341,52
"60919","E01027243",2011,674,271,403,47
"60920","E01027244",2011,684,483,201,39
"60921","E01027245",2011,667,113,554,112
"60922","E01027246",2011,756,282,474,97
"60923","E01027247",2011,619,64,555,85
"60924","E01027248",2011,586,216,370,74
"60925","E01027249",2011,683,249,434,103
"60926","E01027250",2011,595,10,585,77
"60927","E01027252",2011,640,125,515,98
"60928","E01027253",2011,730,33,697,57
"60929","E01027254",2011,652,4,648,53
"60930","E01027255",2011,540,2,538,35
"60931","E01027256",2011,630,7,623,46
"60932","E01027257",2011,477,23,454,29
"60933","E01027258",2011,497,2,495,40
"60934","E01027259",2011,581,19,562,75
"60935","E01027260",2011,584,22,562,32
"60936","E01027261",2011,776,69,707,80
"60937","E01027262",2011,675,53,622,79
"60938","E01027263",2011,796,103,693,80
"60939","E01027264",2011,648,65,583,109
"60940","E01027265",2011,669,18,651,66
"60941","E01027266",2011,482,0,482,23
"60942","E01027267",2011,509,94,415,78
"60943","E01027268",2011,517,19,498,80
"60944","E01027269",2011,689,224,465,93
"60945","E01027270",2011,581,2,579,54
"60946","E01027271",2011,628,29,599,111
"60947","E01027272",2011,591,10,581,56
"60948","E01027273",2011,763,143,620,85
"60949","E01027274",2011,623,18,605,53
"60950","E01027275",2011,600,45,555,42
"60951","E01027276",2011,1040,63,977,121
"60952","E01027277",2011,760,53,707,82
"60953","E01027279",2011,743,149,594,38
"60954","E01027280",2011,897,23,874,80
"60955","E01027281",2011,684,129,555,47
"60956","E01027282",2011,653,128,525,36
"60957","E01027283",2011,611,32,579,76
"60958","E01027284",2011,756,50,706,67
"60959","E01027285",2011,689,84,605,59
"60960","E01027286",2011,654,56,598,49
"60961","E01027287",2011,679,68,611,30
"60962","E01027288",2011,904,180,724,83
"60963","E01027289",2011,714,106,608,55
"60964","E01027290",2011,918,59,859,129
"60965","E01027291",2011,590,11,579,43
"60966","E01027292",2011,466,143,323,28
"60967","E01027293",2011,483,4,479,47
"60968","E01027294",2011,744,65,679,51
"60969","E01027295",2011,858,95,763,89
"60970","E01027296",2011,845,91,754,103
"60971","E01027297",2011,695,78,617,76
"60972","E01027298",2011,516,4,512,36
"60973","E01027299",2011,616,140,476,54
"60974","E01027300",2011,523,22,501,36
"60975","E01027301",2011,909,77,832,167
"60976","E01027302",2011,672,247,425,76
"60977","E01027303",2011,639,20,619,115
"60978","E01027304",2011,729,42,687,80
"60979","E01027305",2011,769,76,693,101
"60980","E01027306",2011,722,61,661,98
"60981","E01027307",2011,832,74,758,81
"60982","E01027308",2011,687,73,614,161
"60983","E01027309",2011,651,18,633,42
"60984","E01027310",2011,607,312,295,73
"60985","E01027311",2011,483,30,453,44
"60986","E01027312",2011,627,179,448,54
"60987","E01027313",2011,639,29,610,211
"60988","E01027314",2011,897,129,768,342
"60989","E01027315",2011,1062,131,931,407
"60990","E01027316",2011,650,97,553,149
"60991","E01027317",2011,644,205,439,52
"60992","E01027318",2011,591,338,253,39
"60993","E01027319",2011,605,150,455,66
"60994","E01027320",2011,744,158,586,86
"60995","E01027321",2011,580,45,535,46
"60996","E01027322",2011,511,44,467,70
"60997","E01027323",2011,610,118,492,67
"60998","E01027324",2011,503,13,490,24
"60999","E01027325",2011,673,57,616,96
"61000","E01027326",2011,710,66,644,79
"61001","E01027327",2011,695,202,493,102
"61002","E01027328",2011,582,116,466,65
"61003","E01027329",2011,791,52,739,53
"61004","E01027330",2011,633,177,456,88
"61005","E01027331",2011,623,206,417,81
"61006","E01027332",2011,649,7,642,50
"61007","E01027333",2011,840,15,825,116
"61008","E01027334",2011,531,347,184,47
"61009","E01027335",2011,632,33,599,36
"61010","E01027336",2011,652,142,510,67
"61011","E01027337",2011,793,29,764,88
"61012","E01027338",2011,994,125,869,72
"61013","E01027339",2011,555,290,265,32
"61014","E01027340",2011,658,186,472,42
"61015","E01027341",2011,593,178,415,82
"61016","E01027342",2011,652,262,390,75
"61017","E01027343",2011,621,2,619,73
"61018","E01027344",2011,628,37,591,66
"61019","E01027345",2011,489,4,485,18
"61020","E01027346",2011,577,8,569,66
"61021","E01027347",2011,744,8,736,57
"61022","E01027348",2011,890,65,825,103
"61023","E01027349",2011,860,278,582,293
"61024","E01027350",2011,672,104,568,103
"61025","E01027351",2011,794,341,453,81
"61026","E01027352",2011,638,109,529,155
"61027","E01027353",2011,772,59,713,86
"61028","E01027354",2011,1053,165,888,174
"61029","E01027355",2011,659,10,649,42
"61030","E01027356",2011,795,75,720,180
"61031","E01027357",2011,515,12,503,32
"61032","E01027358",2011,1012,269,743,145
"61033","E01027359",2011,925,383,542,95
"61034","E01027361",2011,974,138,836,181
"61035","E01027362",2011,584,162,422,58
"61036","E01027363",2011,508,271,237,35
"61037","E01027364",2011,908,52,856,119
"61038","E01027365",2011,972,71,901,168
"61039","E01027366",2011,705,83,622,155
"61040","E01027367",2011,675,90,585,267
"61041","E01027368",2011,789,150,639,150
"61042","E01027369",2011,742,58,684,96
"61043","E01027370",2011,787,55,732,44
"61044","E01027371",2011,762,161,601,84
"61045","E01027372",2011,985,94,891,105
"61046","E01027373",2011,904,88,816,247
"61047","E01027374",2011,976,160,816,194
"61048","E01027375",2011,812,46,766,293
"61049","E01027376",2011,742,268,474,64
"61050","E01027377",2011,908,155,753,292
"61051","E01027378",2011,454,7,447,68
"61052","E01027379",2011,624,16,608,41
"61053","E01027380",2011,656,103,553,151
"61054","E01027381",2011,852,85,767,292
"61055","E01027382",2011,796,110,686,159
"61056","E01027383",2011,674,115,559,89
"61057","E01027384",2011,725,77,648,108
"61058","E01027385",2011,491,211,280,45
"61059","E01027386",2011,593,98,495,44
"61060","E01027387",2011,863,248,615,133
"61061","E01027388",2011,633,263,370,58
"61062","E01027389",2011,692,148,544,102
"61063","E01027390",2011,974,234,740,134
"61064","E01027391",2011,592,135,457,59
"61065","E01027392",2011,781,419,362,53
"61066","E01027393",2011,621,314,307,43
"61067","E01027394",2011,536,7,529,71
"61068","E01027395",2011,681,232,449,107
"61069","E01027396",2011,568,166,402,50
"61070","E01027397",2011,637,292,345,35
"61071","E01027398",2011,894,421,473,93
"61072","E01027399",2011,595,9,586,58
"61073","E01027400",2011,488,2,486,16
"61074","E01027401",2011,540,1,539,12
"61075","E01027402",2011,491,3,488,20
"61076","E01027403",2011,484,1,483,16
"61077","E01027404",2011,610,4,606,46
"61078","E01027405",2011,641,7,634,35
"61079","E01027406",2011,617,4,613,53
"61080","E01027407",2011,618,4,614,72
"61081","E01027408",2011,649,131,518,98
"61082","E01027409",2011,741,109,632,85
"61083","E01027410",2011,665,7,658,28
"61084","E01027411",2011,624,224,400,60
"61085","E01027412",2011,634,419,215,48
"61086","E01027413",2011,821,214,607,75
"61087","E01027414",2011,649,12,637,189
"61088","E01027415",2011,790,232,558,201
"61089","E01027416",2011,759,448,311,92
"61090","E01027417",2011,696,55,641,50
"61091","E01027418",2011,788,139,649,62
"61092","E01027419",2011,775,161,614,54
"61093","E01027420",2011,611,83,528,28
"61094","E01027421",2011,728,282,446,47
"61095","E01027422",2011,845,345,500,82
"61096","E01027423",2011,645,229,416,44
"61097","E01027424",2011,823,380,443,83
"61098","E01027425",2011,922,27,895,88
"61099","E01027426",2011,533,308,225,44
"61100","E01027427",2011,827,278,549,155
"61101","E01027428",2011,632,8,624,57
"61102","E01027429",2011,886,452,434,65
"61103","E01027430",2011,712,307,405,50
"61104","E01027431",2011,897,223,674,220
"61105","E01027432",2011,780,125,655,162
"61106","E01027433",2011,773,281,492,88
"61107","E01027434",2011,633,121,512,46
"61108","E01027435",2011,671,201,470,75
"61109","E01027436",2011,679,162,517,47
"61110","E01027437",2011,760,3,757,35
"61111","E01027438",2011,621,6,615,49
"61112","E01027439",2011,759,4,755,45
"61113","E01027440",2011,596,3,593,37
"61114","E01027441",2011,926,108,818,159
"61115","E01027442",2011,805,155,650,161
"61116","E01027443",2011,675,325,350,83
"61117","E01027444",2011,576,34,542,88
"61118","E01027445",2011,682,69,613,83
"61119","E01027446",2011,583,8,575,36
"61120","E01027447",2011,768,56,712,263
"61121","E01027448",2011,770,24,746,99
"61122","E01027449",2011,685,53,632,56
"61123","E01027450",2011,696,41,655,76
"61124","E01027451",2011,814,245,569,111
"61125","E01027452",2011,651,74,577,71
"61126","E01027453",2011,849,179,670,158
"61127","E01027455",2011,635,11,624,20
"61128","E01027456",2011,525,3,522,14
"61129","E01027457",2011,554,18,536,75
"61130","E01027458",2011,654,7,647,32
"61131","E01027460",2011,734,28,706,65
"61132","E01027461",2011,614,232,382,43
"61133","E01027462",2011,883,343,540,131
"61134","E01027463",2011,703,50,653,67
"61135","E01027464",2011,646,50,596,62
"61136","E01027465",2011,644,16,628,68
"61137","E01027466",2011,530,133,397,47
"61138","E01027468",2011,516,5,511,22
"61139","E01027469",2011,536,5,531,17
"61140","E01027471",2011,642,2,640,33
"61141","E01027472",2011,629,63,566,211
"61142","E01027473",2011,756,53,703,180
"61143","E01027474",2011,851,216,635,111
"61144","E01027475",2011,641,27,614,55
"61145","E01027476",2011,1161,257,904,201
"61146","E01027477",2011,520,11,509,87
"61147","E01027478",2011,502,66,436,82
"61148","E01027479",2011,1028,160,868,192
"61149","E01027480",2011,520,38,482,136
"61150","E01027481",2011,796,136,660,158
"61151","E01027482",2011,685,86,599,55
"61152","E01027483",2011,559,51,508,106
"61153","E01027484",2011,953,62,891,122
"61154","E01027485",2011,696,219,477,73
"61155","E01027486",2011,524,60,464,90
"61156","E01027487",2011,531,78,453,82
"61157","E01027488",2011,943,160,783,181
"61158","E01027489",2011,650,127,523,35
"61159","E01027490",2011,812,207,605,115
"61160","E01027491",2011,642,14,628,43
"61161","E01027492",2011,764,12,752,99
"61162","E01027493",2011,677,333,344,104
"61163","E01027494",2011,1019,34,985,168
"61164","E01027495",2011,459,44,415,99
"61165","E01027496",2011,528,108,420,50
"61166","E01027497",2011,1013,175,838,62
"61167","E01027498",2011,1167,474,693,90
"61168","E01027499",2011,629,73,556,29
"61169","E01027500",2011,763,215,548,92
"61170","E01027501",2011,475,64,411,41
"61171","E01027502",2011,486,21,465,36
"61172","E01027503",2011,796,98,698,136
"61173","E01027504",2011,802,22,780,132
"61174","E01027505",2011,553,30,523,81
"61175","E01027506",2011,468,32,436,125
"61176","E01027507",2011,542,9,533,31
"61177","E01027508",2011,482,43,439,68
"61178","E01027509",2011,612,47,565,50
"61179","E01027510",2011,510,64,446,98
"61180","E01027511",2011,495,49,446,153
"61181","E01027512",2011,468,40,428,149
"61182","E01027513",2011,826,47,779,60
"61183","E01027514",2011,709,108,601,62
"61184","E01027515",2011,689,132,557,127
"61185","E01027516",2011,505,105,400,36
"61186","E01027517",2011,879,86,793,147
"61187","E01027518",2011,640,326,314,38
"61188","E01027519",2011,635,215,420,113
"61189","E01027520",2011,594,8,586,29
"61190","E01027521",2011,623,9,614,38
"61191","E01027522",2011,624,228,396,77
"61192","E01027523",2011,533,121,412,74
"61193","E01027524",2011,635,86,549,91
"61194","E01027525",2011,859,265,594,116
"61195","E01027526",2011,522,16,506,18
"61196","E01027527",2011,605,293,312,51
"61197","E01027528",2011,611,73,538,161
"61198","E01027529",2011,482,15,467,79
"61199","E01027530",2011,625,232,393,54
"61200","E01027531",2011,715,162,553,107
"61201","E01027532",2011,837,32,805,107
"61202","E01027533",2011,902,549,353,94
"61203","E01027534",2011,904,287,617,124
"61204","E01027535",2011,658,6,652,33
"61205","E01027536",2011,611,127,484,35
"61206","E01027537",2011,631,135,496,64
"61207","E01027538",2011,720,17,703,31
"61208","E01027539",2011,773,86,687,269
"61209","E01027540",2011,831,362,469,178
"61210","E01027541",2011,830,88,742,153
"61211","E01027542",2011,843,357,486,148
"61212","E01027543",2011,548,242,306,40
"61213","E01027544",2011,632,85,547,57
"61214","E01027545",2011,927,229,698,254
"61215","E01027546",2011,828,122,706,274
"61216","E01027549",2011,586,27,559,44
"61217","E01027550",2011,606,137,469,80
"61218","E01027551",2011,631,271,360,75
"61219","E01027552",2011,597,106,491,95
"61220","E01027553",2011,734,141,593,73
"61221","E01027554",2011,621,34,587,38
"61222","E01027555",2011,826,38,788,96
"61223","E01027556",2011,703,55,648,66
"61224","E01027557",2011,655,9,646,186
"61225","E01027558",2011,845,25,820,96
"61226","E01027559",2011,781,82,699,145
"61227","E01027560",2011,977,59,918,132
"61228","E01027561",2011,831,59,772,126
"61229","E01027562",2011,669,17,652,123
"61230","E01027563",2011,681,89,592,77
"61231","E01027564",2011,569,134,435,103
"61232","E01027565",2011,657,11,646,76
"61233","E01027566",2011,535,34,501,70
"61234","E01027567",2011,789,91,698,106
"61235","E01027568",2011,942,76,866,98
"61236","E01027569",2011,589,22,567,104
"61237","E01027570",2011,1099,92,1007,153
"61238","E01027571",2011,782,38,744,103
"61239","E01027572",2011,998,117,881,189
"61240","E01027573",2011,699,83,616,95
"61241","E01027574",2011,646,4,642,47
"61242","E01027575",2011,879,138,741,74
"61243","E01027576",2011,668,3,665,22
"61244","E01027577",2011,929,59,870,239
"61245","E01027578",2011,737,16,721,237
"61246","E01027579",2011,533,205,328,43
"61247","E01027580",2011,486,238,248,44
"61248","E01027581",2011,1141,137,1004,307
"61249","E01027582",2011,678,51,627,119
"61250","E01027583",2011,845,26,819,119
"61251","E01027584",2011,728,146,582,64
"61252","E01027585",2011,832,31,801,111
"61253","E01027586",2011,854,27,827,212
"61254","E01027587",2011,623,192,431,45
"61255","E01027588",2011,677,28,649,146
"61256","E01027589",2011,714,96,618,101
"61257","E01027590",2011,982,232,750,139
"61258","E01027591",2011,730,50,680,72
"61259","E01027592",2011,758,33,725,105
"61260","E01027593",2011,751,64,687,141
"61261","E01027594",2011,737,255,482,108
"61262","E01027595",2011,740,58,682,103
"61263","E01027596",2011,731,72,659,99
"61264","E01027597",2011,687,20,667,117
"61265","E01027598",2011,855,14,841,56
"61266","E01027599",2011,801,296,505,103
"61267","E01027600",2011,773,77,696,137
"61268","E01027601",2011,791,53,738,114
"61269","E01027603",2011,789,71,718,128
"61270","E01027604",2011,762,21,741,127
"61271","E01027605",2011,728,112,616,178
"61272","E01027606",2011,692,19,673,66
"61273","E01027607",2011,550,6,544,31
"61274","E01027608",2011,731,228,503,131
"61275","E01027609",2011,548,239,309,58
"61276","E01027610",2011,733,165,568,107
"61277","E01027611",2011,925,86,839,114
"61278","E01027612",2011,757,391,366,56
"61279","E01027613",2011,767,41,726,138
"61280","E01027614",2011,565,40,525,35
"61281","E01027615",2011,504,9,495,26
"61282","E01027616",2011,661,190,471,75
"61283","E01027617",2011,451,25,426,104
"61284","E01027618",2011,1042,42,1000,86
"61285","E01027619",2011,952,83,869,210
"61286","E01027620",2011,808,57,751,179
"61287","E01027621",2011,1000,113,887,132
"61288","E01027622",2011,798,57,741,103
"61289","E01027623",2011,584,7,577,39
"61290","E01027624",2011,527,4,523,31
"61291","E01027625",2011,772,332,440,79
"61292","E01027626",2011,584,63,521,46
"61293","E01027627",2011,803,45,758,114
"61294","E01027628",2011,766,66,700,176
"61295","E01027629",2011,615,314,301,43
"61296","E01027630",2011,869,158,711,268
"61297","E01027631",2011,677,12,665,117
"61298","E01027632",2011,595,58,537,68
"61299","E01027633",2011,788,15,773,130
"61300","E01027634",2011,785,54,731,82
"61301","E01027635",2011,925,99,826,211
"61302","E01027636",2011,870,59,811,123
"61303","E01027637",2011,823,24,799,134
"61304","E01027638",2011,598,8,590,69
"61305","E01027639",2011,546,7,539,55
"61306","E01027640",2011,657,44,613,78
"61307","E01027641",2011,470,2,468,35
"61308","E01027642",2011,596,17,579,83
"61309","E01027643",2011,631,52,579,98
"61310","E01027644",2011,664,100,564,111
"61311","E01027645",2011,677,27,650,165
"61312","E01027646",2011,669,32,637,63
"61313","E01027647",2011,677,51,626,63
"61314","E01027648",2011,679,119,560,57
"61315","E01027649",2011,696,94,602,165
"61316","E01027650",2011,625,63,562,57
"61317","E01027651",2011,600,271,329,46
"61318","E01027652",2011,691,13,678,204
"61319","E01027653",2011,658,97,561,93
"61320","E01027654",2011,487,3,484,77
"61321","E01027655",2011,535,53,482,128
"61322","E01027656",2011,872,26,846,233
"61323","E01027657",2011,580,33,547,225
"61324","E01027658",2011,740,46,694,248
"61325","E01027659",2011,939,80,859,470
"61326","E01027660",2011,640,60,580,36
"61327","E01027661",2011,620,64,556,54
"61328","E01027662",2011,447,6,441,25
"61329","E01027663",2011,616,9,607,64
"61330","E01027664",2011,895,54,841,193
"61331","E01027665",2011,453,12,441,98
"61332","E01027666",2011,720,48,672,108
"61333","E01027667",2011,563,36,527,110
"61334","E01027668",2011,672,67,605,110
"61335","E01027669",2011,934,244,690,150
"61336","E01027670",2011,662,10,652,61
"61337","E01027671",2011,621,2,619,26
"61338","E01027672",2011,698,7,691,43
"61339","E01027673",2011,881,129,752,215
"61340","E01027674",2011,546,11,535,37
"61341","E01027675",2011,938,24,914,67
"61342","E01027676",2011,686,153,533,72
"61343","E01027677",2011,685,35,650,270
"61344","E01027678",2011,920,174,746,471
"61345","E01027679",2011,820,8,812,260
"61346","E01027680",2011,727,21,706,342
"61347","E01027681",2011,668,57,611,102
"61348","E01027682",2011,674,20,654,109
"61349","E01027683",2011,585,31,554,57
"61350","E01027684",2011,588,57,531,70
"61351","E01027685",2011,592,101,491,122
"61352","E01027686",2011,461,11,450,134
"61353","E01027687",2011,617,29,588,98
"61354","E01027688",2011,681,76,605,105
"61355","E01027689",2011,635,60,575,120
"61356","E01027690",2011,632,29,603,68
"61357","E01027691",2011,665,40,625,119
"61358","E01027692",2011,545,88,457,170
"61359","E01027693",2011,745,13,732,123
"61360","E01027694",2011,478,34,444,74
"61361","E01027695",2011,690,74,616,72
"61362","E01027696",2011,549,24,525,76
"61363","E01027697",2011,588,14,574,54
"61364","E01027698",2011,629,8,621,83
"61365","E01027699",2011,515,1,514,32
"61366","E01027700",2011,494,18,476,35
"61367","E01027701",2011,681,40,641,132
"61368","E01027702",2011,551,99,452,104
"61369","E01027703",2011,773,43,730,159
"61370","E01027704",2011,500,16,484,54
"61371","E01027705",2011,706,83,623,158
"61372","E01027706",2011,976,239,737,233
"61373","E01027707",2011,792,114,678,119
"61374","E01027708",2011,604,30,574,87
"61375","E01027709",2011,507,17,490,19
"61376","E01027710",2011,465,162,303,43
"61377","E01027711",2011,499,115,384,55
"61378","E01027712",2011,505,28,477,67
"61379","E01027713",2011,754,80,674,170
"61380","E01027714",2011,740,91,649,132
"61381","E01027715",2011,411,15,396,157
"61382","E01027716",2011,603,0,603,43
"61383","E01027717",2011,618,8,610,66
"61384","E01027718",2011,746,45,701,81
"61385","E01027719",2011,621,17,604,70
"61386","E01027720",2011,653,149,504,89
"61387","E01027721",2011,643,7,636,108
"61388","E01027722",2011,539,4,535,123
"61389","E01027723",2011,740,253,487,88
"61390","E01027724",2011,655,52,603,59
"61391","E01027725",2011,633,62,571,73
"61392","E01027726",2011,674,50,624,109
"61393","E01027727",2011,673,79,594,104
"61394","E01027728",2011,612,32,580,44
"61395","E01027729",2011,682,128,554,165
"61396","E01027730",2011,688,18,670,194
"61397","E01027731",2011,624,36,588,155
"61398","E01027732",2011,544,1,543,124
"61399","E01027733",2011,518,5,513,35
"61400","E01027734",2011,647,22,625,101
"61401","E01027735",2011,667,19,648,152
"61402","E01027736",2011,658,55,603,146
"61403","E01027737",2011,606,43,563,210
"61404","E01027738",2011,579,13,566,91
"61405","E01027739",2011,458,13,445,95
"61406","E01027740",2011,940,592,348,50
"61407","E01027741",2011,622,66,556,49
"61408","E01027742",2011,631,91,540,87
"61409","E01027743",2011,536,39,497,76
"61410","E01027744",2011,590,31,559,141
"61411","E01027745",2011,624,70,554,90
"61412","E01027746",2011,648,78,570,76
"61413","E01027747",2011,580,62,518,210
"61414","E01027748",2011,530,60,470,58
"61415","E01027749",2011,786,357,429,73
"61416","E01027750",2011,998,83,915,322
"61417","E01027751",2011,530,28,502,80
"61418","E01027752",2011,548,33,515,130
"61419","E01027753",2011,606,50,556,111
"61420","E01027754",2011,454,72,382,209
"61421","E01027756",2011,716,66,650,134
"61422","E01027758",2011,591,24,567,122
"61423","E01027759",2011,615,53,562,118
"61424","E01027760",2011,587,55,532,155
"61425","E01027761",2011,525,28,497,67
"61426","E01027762",2011,571,40,531,97
"61427","E01027763",2011,550,17,533,92
"61428","E01027764",2011,542,47,495,106
"61429","E01027765",2011,670,96,574,69
"61430","E01027766",2011,581,141,440,96
"61431","E01027767",2011,625,39,586,70
"61432","E01027768",2011,496,11,485,45
"61433","E01027769",2011,567,136,431,75
"61434","E01027770",2011,836,114,722,244
"61435","E01027771",2011,484,49,435,354
"61436","E01027772",2011,544,17,527,103
"61437","E01027773",2011,493,15,478,102
"61438","E01027774",2011,832,55,777,139
"61439","E01027775",2011,635,56,579,101
"61440","E01027776",2011,651,33,618,65
"61441","E01027777",2011,606,20,586,117
"61442","E01027778",2011,1000,102,898,213
"61443","E01027779",2011,475,63,412,141
"61444","E01027780",2011,788,58,730,216
"61445","E01027781",2011,637,117,520,97
"61446","E01027782",2011,766,69,697,176
"61447","E01027783",2011,817,20,797,146
"61448","E01027784",2011,772,183,589,115
"61449","E01027785",2011,811,193,618,242
"61450","E01027786",2011,688,16,672,88
"61451","E01027787",2011,744,216,528,114
"61452","E01027788",2011,658,138,520,44
"61453","E01027789",2011,1063,377,686,138
"61454","E01027790",2011,819,80,739,189
"61455","E01027791",2011,646,15,631,47
"61456","E01027792",2011,875,17,858,151
"61457","E01027793",2011,658,184,474,50
"61458","E01027794",2011,876,57,819,101
"61459","E01027795",2011,719,230,489,94
"61460","E01027796",2011,772,114,658,149
"61461","E01027797",2011,716,56,660,165
"61462","E01027798",2011,831,138,693,137
"61463","E01027799",2011,762,58,704,95
"61464","E01027800",2011,728,49,679,98
"61465","E01027801",2011,755,47,708,87
"61466","E01027802",2011,710,42,668,126
"61467","E01027803",2011,714,93,621,132
"61468","E01027804",2011,847,55,792,537
"61469","E01027805",2011,778,180,598,210
"61470","E01027806",2011,928,245,683,469
"61471","E01027807",2011,646,70,576,60
"61472","E01027808",2011,654,17,637,58
"61473","E01027809",2011,644,4,640,34
"61474","E01027810",2011,649,6,643,224
"61475","E01027811",2011,687,34,653,219
"61476","E01027812",2011,753,51,702,314
"61477","E01027813",2011,837,99,738,119
"61478","E01027814",2011,677,40,637,138
"61479","E01027815",2011,594,34,560,76
"61480","E01027816",2011,697,49,648,42
"61481","E01027817",2011,592,296,296,29
"61482","E01027818",2011,611,64,547,61
"61483","E01027819",2011,581,330,251,36
"61484","E01027820",2011,510,209,301,41
"61485","E01027821",2011,651,19,632,55
"61486","E01027822",2011,610,37,573,123
"61487","E01027823",2011,662,116,546,51
"61488","E01027824",2011,717,274,443,60
"61489","E01027825",2011,759,175,584,182
"61490","E01027826",2011,655,45,610,180
"61491","E01027827",2011,892,46,846,281
"61492","E01027828",2011,798,88,710,51
"61493","E01027829",2011,771,25,746,98
"61494","E01027830",2011,736,170,566,99
"61495","E01027831",2011,463,27,436,47
"61496","E01027832",2011,448,42,406,42
"61497","E01027833",2011,747,96,651,100
"61498","E01027834",2011,738,12,726,71
"61499","E01027835",2011,752,68,684,82
"61500","E01027836",2011,1018,67,951,117
"61501","E01027837",2011,672,312,360,51
"61502","E01027838",2011,681,26,655,74
"61503","E01027839",2011,707,45,662,89
"61504","E01027840",2011,977,161,816,128
"61505","E01027841",2011,583,22,561,142
"61506","E01027842",2011,709,84,625,45
"61507","E01027843",2011,622,123,499,57
"61508","E01027844",2011,656,12,644,37
"61509","E01027845",2011,725,7,718,78
"61510","E01027846",2011,766,17,749,271
"61511","E01027847",2011,996,138,858,574
"61512","E01027848",2011,456,31,425,51
"61513","E01027849",2011,518,14,504,57
"61514","E01027850",2011,622,202,420,62
"61515","E01027851",2011,626,3,623,137
"61516","E01027852",2011,899,25,874,544
"61517","E01027853",2011,657,40,617,224
"61518","E01027854",2011,857,17,840,477
"61519","E01027855",2011,628,7,621,49
"61520","E01027856",2011,610,66,544,23
"61521","E01027857",2011,560,11,549,86
"61522","E01027858",2011,606,12,594,33
"61523","E01027859",2011,719,10,709,78
"61524","E01027860",2011,637,76,561,52
"61525","E01027861",2011,646,62,584,146
"61526","E01027862",2011,753,69,684,281
"61527","E01027863",2011,661,66,595,36
"61528","E01027864",2011,588,200,388,57
"61529","E01027865",2011,785,90,695,206
"61530","E01027866",2011,661,132,529,64
"61531","E01027867",2011,627,17,610,49
"61532","E01027868",2011,1173,64,1109,309
"61533","E01027869",2011,623,71,552,275
"61534","E01027870",2011,685,57,628,203
"61535","E01027871",2011,695,76,619,86
"61536","E01027872",2011,604,227,377,46
"61537","E01027873",2011,723,85,638,109
"61538","E01027874",2011,620,367,253,48
"61539","E01027875",2011,712,21,691,121
"61540","E01027876",2011,653,20,633,72
"61541","E01027877",2011,511,74,437,52
"61542","E01027878",2011,548,87,461,87
"61543","E01027879",2011,566,5,561,56
"61544","E01027880",2011,626,9,617,35
"61545","E01027881",2011,593,171,422,33
"61546","E01027882",2011,699,7,692,50
"61547","E01027883",2011,446,27,419,46
"61548","E01027884",2011,627,39,588,79
"61549","E01027885",2011,655,54,601,62
"61550","E01027886",2011,559,46,513,71
"61551","E01027887",2011,663,23,640,62
"61552","E01027888",2011,702,57,645,67
"61553","E01027889",2011,718,109,609,87
"61554","E01027890",2011,807,41,766,57
"61555","E01027891",2011,746,47,699,69
"61556","E01027892",2011,836,179,657,104
"61557","E01027893",2011,764,57,707,27
"61558","E01027894",2011,773,44,729,53
"61559","E01027895",2011,675,29,646,37
"61560","E01027896",2011,802,67,735,71
"61561","E01027897",2011,840,14,826,91
"61562","E01027898",2011,1003,86,917,119
"61563","E01027899",2011,683,57,626,65
"61564","E01027900",2011,757,35,722,88
"61565","E01027901",2011,636,9,627,53
"61566","E01027902",2011,587,99,488,36
"61567","E01027903",2011,416,5,411,75
"61568","E01027904",2011,890,65,825,100
"61569","E01027905",2011,868,162,706,187
"61570","E01027906",2011,575,148,427,61
"61571","E01027907",2011,563,355,208,42
"61572","E01027908",2011,779,268,511,227
"61573","E01027909",2011,952,223,729,280
"61574","E01027910",2011,1099,343,756,156
"61575","E01027911",2011,619,43,576,63
"61576","E01027912",2011,428,8,420,34
"61577","E01027913",2011,490,2,488,19
"61578","E01027914",2011,669,10,659,40
"61579","E01027915",2011,710,169,541,62
"61580","E01027916",2011,653,191,462,58
"61581","E01027917",2011,699,48,651,61
"61582","E01027918",2011,648,105,543,106
"61583","E01027919",2011,509,26,483,99
"61584","E01027920",2011,500,53,447,32
"61585","E01027921",2011,859,236,623,70
"61586","E01027922",2011,668,35,633,47
"61587","E01027923",2011,944,116,828,59
"61588","E01027924",2011,834,37,797,68
"61589","E01027925",2011,743,89,654,40
"61590","E01027926",2011,657,17,640,69
"61591","E01027927",2011,934,247,687,130
"61592","E01027928",2011,893,60,833,269
"61593","E01027929",2011,1052,173,879,100
"61594","E01027930",2011,717,290,427,54
"61595","E01027931",2011,899,243,656,112
"61596","E01027932",2011,898,72,826,234
"61597","E01027933",2011,661,48,613,171
"61598","E01027934",2011,582,18,564,58
"61599","E01027935",2011,503,52,451,43
"61600","E01027936",2011,650,5,645,28
"61601","E01027937",2011,648,179,469,118
"61602","E01027938",2011,489,6,483,21
"61603","E01027939",2011,601,316,285,28
"61604","E01027940",2011,562,1,561,41
"61605","E01027941",2011,571,98,473,35
"61606","E01027942",2011,524,131,393,64
"61607","E01027943",2011,592,19,573,75
"61608","E01027944",2011,655,5,650,48
"61609","E01027945",2011,726,43,683,115
"61610","E01027946",2011,621,86,535,56
"61611","E01027947",2011,692,49,643,80
"61612","E01027948",2011,792,19,773,126
"61613","E01027949",2011,646,14,632,92
"61614","E01027950",2011,918,146,772,66
"61615","E01027951",2011,648,320,328,55
"61616","E01027952",2011,808,266,542,144
"61617","E01027953",2011,636,66,570,45
"61618","E01027954",2011,664,120,544,117
"61619","E01027955",2011,512,36,476,126
"61620","E01027956",2011,686,343,343,40
"61621","E01027957",2011,524,57,467,43
"61622","E01027958",2011,596,216,380,61
"61623","E01027959",2011,527,10,517,43
"61624","E01027960",2011,740,133,607,63
"61625","E01027961",2011,792,33,759,68
"61626","E01027962",2011,608,34,574,45
"61627","E01027963",2011,645,194,451,44
"61628","E01027964",2011,617,166,451,60
"61629","E01027965",2011,563,217,346,90
"61630","E01027966",2011,636,352,284,35
"61631","E01027967",2011,756,76,680,277
"61632","E01027968",2011,573,259,314,85
"61633","E01027969",2011,575,60,515,89
"61634","E01027970",2011,609,9,600,96
"61635","E01027971",2011,602,6,596,46
"61636","E01027972",2011,874,125,749,102
"61637","E01027973",2011,647,10,637,34
"61638","E01027974",2011,671,365,306,71
"61639","E01027975",2011,708,83,625,109
"61640","E01027976",2011,790,305,485,116
"61641","E01027977",2011,782,156,626,114
"61642","E01027978",2011,805,161,644,299
"61643","E01027979",2011,699,17,682,89
"61644","E01027980",2011,649,245,404,53
"61645","E01027981",2011,678,42,636,64
"61646","E01027982",2011,666,97,569,66
"61647","E01027983",2011,642,87,555,164
"61648","E01027984",2011,636,39,597,72
"61649","E01027985",2011,757,95,662,163
"61650","E01027986",2011,624,166,458,81
"61651","E01027987",2011,746,224,522,122
"61652","E01027988",2011,693,12,681,106
"61653","E01027989",2011,736,54,682,75
"61654","E01027990",2011,789,28,761,115
"61655","E01027991",2011,539,130,409,41
"61656","E01027992",2011,846,20,826,66
"61657","E01027993",2011,655,5,650,62
"61658","E01027994",2011,640,75,565,58
"61659","E01027995",2011,681,20,661,60
"61660","E01027996",2011,859,227,632,75
"61661","E01027997",2011,740,27,713,72
"61662","E01027998",2011,836,44,792,110
"61663","E01027999",2011,994,100,894,67
"61664","E01028000",2011,951,66,885,88
"61665","E01028001",2011,593,326,267,33
"61666","E01028002",2011,600,38,562,52
"61667","E01028003",2011,600,85,515,37
"61668","E01028004",2011,681,16,665,52
"61669","E01028005",2011,822,58,764,66
"61670","E01028006",2011,535,57,478,64
"61671","E01028007",2011,455,30,425,24
"61672","E01028008",2011,508,196,312,60
"61673","E01028009",2011,630,6,624,37
"61674","E01028010",2011,547,9,538,25
"61675","E01028011",2011,794,275,519,176
"61676","E01028012",2011,618,76,542,114
"61677","E01028013",2011,783,116,667,95
"61678","E01028014",2011,767,376,391,48
"61679","E01028015",2011,628,47,581,66
"61680","E01028016",2011,615,65,550,52
"61681","E01028017",2011,620,229,391,63
"61682","E01028018",2011,625,46,579,63
"61683","E01028019",2011,628,206,422,52
"61684","E01028020",2011,864,91,773,348
"61685","E01028021",2011,674,73,601,69
"61686","E01028022",2011,659,87,572,126
"61687","E01028023",2011,947,75,872,105
"61688","E01028024",2011,775,117,658,79
"61689","E01028025",2011,633,95,538,125
"61690","E01028026",2011,661,205,456,69
"61691","E01028027",2011,592,66,526,87
"61692","E01028028",2011,677,167,510,56
"61693","E01028029",2011,524,131,393,85
"61694","E01028030",2011,497,50,447,49
"61695","E01028031",2011,473,104,369,19
"61696","E01028032",2011,559,24,535,35
"61697","E01028033",2011,840,51,789,91
"61698","E01028034",2011,1010,144,866,75
"61699","E01028035",2011,961,77,884,95
"61700","E01028036",2011,868,55,813,116
"61701","E01028037",2011,687,28,659,115
"61702","E01028038",2011,641,181,460,53
"61703","E01028039",2011,504,31,473,41
"61704","E01028040",2011,434,64,370,82
"61705","E01028041",2011,453,46,407,163
"61706","E01028042",2011,568,51,517,47
"61707","E01028043",2011,601,34,567,48
"61708","E01028044",2011,755,382,373,62
"61709","E01028045",2011,857,248,609,81
"61710","E01028046",2011,673,22,651,92
"61711","E01028047",2011,739,15,724,85
"61712","E01028048",2011,611,28,583,42
"61713","E01028049",2011,749,203,546,63
"61714","E01028050",2011,729,27,702,105
"61715","E01028051",2011,737,137,600,72
"61716","E01028052",2011,689,16,673,43
"61717","E01028053",2011,782,281,501,61
"61718","E01028054",2011,569,13,556,27
"61719","E01028055",2011,774,250,524,182
"61720","E01028056",2011,507,101,406,77
"61721","E01028057",2011,602,48,554,249
"61722","E01028058",2011,741,50,691,75
"61723","E01028059",2011,640,4,636,64
"61724","E01028060",2011,727,7,720,63
"61725","E01028061",2011,639,10,629,79
"61726","E01028062",2011,912,67,845,345
"61727","E01028063",2011,730,14,716,49
"61728","E01028064",2011,533,123,410,54
"61729","E01028065",2011,726,403,323,102
"61730","E01028066",2011,684,296,388,106
"61731","E01028067",2011,643,171,472,54
"61732","E01028068",2011,823,193,630,231
"61733","E01028069",2011,525,3,522,83
"61734","E01028070",2011,483,2,481,27
"61735","E01028073",2011,775,219,556,234
"61736","E01028074",2011,711,196,515,230
"61737","E01028075",2011,694,58,636,278
"61738","E01028076",2011,592,90,502,111
"61739","E01028077",2011,587,206,381,104
"61740","E01028078",2011,624,123,501,131
"61741","E01028079",2011,538,26,512,190
"61742","E01028080",2011,773,56,717,161
"61743","E01028081",2011,574,42,532,131
"61744","E01028082",2011,507,4,503,59
"61745","E01028083",2011,599,159,440,159
"61746","E01028084",2011,744,9,735,106
"61747","E01028085",2011,902,112,790,306
"61748","E01028086",2011,727,36,691,208
"61749","E01028087",2011,688,7,681,67
"61750","E01028088",2011,634,1,633,66
"61751","E01028089",2011,537,3,534,34
"61752","E01028090",2011,628,139,489,58
"61753","E01028091",2011,617,2,615,56
"61754","E01028092",2011,529,73,456,49
"61755","E01028093",2011,454,0,454,19
"61756","E01028094",2011,742,84,658,91
"61757","E01028095",2011,616,79,537,69
"61758","E01028096",2011,766,10,756,140
"61759","E01028097",2011,615,5,610,49
"61760","E01028098",2011,735,272,463,188
"61761","E01028099",2011,628,34,594,59
"61762","E01028100",2011,782,130,652,69
"61763","E01028101",2011,596,253,343,52
"61764","E01028102",2011,582,44,538,69
"61765","E01028103",2011,532,176,356,50
"61766","E01028104",2011,616,26,590,56
"61767","E01028105",2011,503,53,450,55
"61768","E01028106",2011,672,45,627,93
"61769","E01028107",2011,638,31,607,54
"61770","E01028108",2011,657,23,634,58
"61771","E01028109",2011,749,67,682,80
"61772","E01028110",2011,625,255,370,70
"61773","E01028111",2011,635,101,534,75
"61774","E01028112",2011,742,185,557,134
"61775","E01028113",2011,612,210,402,42
"61776","E01028114",2011,664,34,630,106
"61777","E01028115",2011,666,2,664,35
"61778","E01028116",2011,692,43,649,71
"61779","E01028117",2011,553,3,550,43
"61780","E01028118",2011,766,36,730,41
"61781","E01028119",2011,798,3,795,117
"61782","E01028120",2011,643,0,643,33
"61783","E01028121",2011,581,2,579,72
"61784","E01028122",2011,739,235,504,70
"61785","E01028123",2011,767,35,732,77
"61786","E01028124",2011,640,31,609,46
"61787","E01028125",2011,695,41,654,94
"61788","E01028126",2011,576,91,485,68
"61789","E01028127",2011,759,291,468,66
"61790","E01028128",2011,730,5,725,63
"61791","E01028129",2011,630,126,504,29
"61792","E01028130",2011,802,225,577,119
"61793","E01028131",2011,621,20,601,62
"61794","E01028132",2011,432,104,328,40
"61795","E01028133",2011,638,37,601,189
"61796","E01028134",2011,636,44,592,140
"61797","E01028135",2011,569,1,568,26
"61798","E01028136",2011,665,5,660,61
"61799","E01028137",2011,984,16,968,198
"61800","E01028138",2011,559,44,515,77
"61801","E01028139",2011,573,10,563,62
"61802","E01028142",2011,849,53,796,86
"61803","E01028143",2011,633,136,497,71
"61804","E01028144",2011,663,51,612,153
"61805","E01028146",2011,653,27,626,90
"61806","E01028147",2011,474,187,287,59
"61807","E01028148",2011,836,4,832,75
"61808","E01028149",2011,749,47,702,80
"61809","E01028150",2011,615,19,596,50
"61810","E01028151",2011,467,6,461,50
"61811","E01028152",2011,625,30,595,68
"61812","E01028153",2011,585,196,389,54
"61813","E01028154",2011,695,75,620,91
"61814","E01028155",2011,626,87,539,112
"61815","E01028156",2011,655,84,571,89
"61816","E01028157",2011,493,2,491,44
"61817","E01028158",2011,761,117,644,180
"61818","E01028159",2011,600,108,492,113
"61819","E01028160",2011,657,28,629,116
"61820","E01028161",2011,654,36,618,139
"61821","E01028162",2011,631,54,577,76
"61822","E01028163",2011,639,8,631,77
"61823","E01028164",2011,570,160,410,69
"61824","E01028165",2011,747,165,582,148
"61825","E01028166",2011,715,189,526,64
"61826","E01028167",2011,832,118,714,193
"61827","E01028168",2011,541,15,526,52
"61828","E01028169",2011,604,17,587,52
"61829","E01028170",2011,619,89,530,72
"61830","E01028171",2011,563,54,509,91
"61831","E01028172",2011,462,39,423,25
"61832","E01028173",2011,441,282,159,24
"61833","E01028174",2011,585,157,428,63
"61834","E01028175",2011,804,95,709,96
"61835","E01028176",2011,613,5,608,61
"61836","E01028177",2011,750,9,741,132
"61837","E01028178",2011,927,51,876,96
"61838","E01028179",2011,588,5,583,52
"61839","E01028180",2011,648,34,614,72
"61840","E01028181",2011,666,5,661,123
"61841","E01028182",2011,653,77,576,89
"61842","E01028183",2011,598,15,583,35
"61843","E01028184",2011,481,8,473,54
"61844","E01028185",2011,885,113,772,209
"61845","E01028186",2011,761,180,581,201
"61846","E01028187",2011,676,107,569,223
"61847","E01028188",2011,648,69,579,153
"61848","E01028189",2011,949,116,833,99
"61849","E01028190",2011,646,17,629,61
"61850","E01028191",2011,735,60,675,95
"61851","E01028192",2011,638,79,559,109
"61852","E01028193",2011,672,133,539,82
"61853","E01028194",2011,644,16,628,129
"61854","E01028195",2011,621,7,614,89
"61855","E01028196",2011,580,9,571,40
"61856","E01028197",2011,608,36,572,55
"61857","E01028198",2011,621,5,616,34
"61858","E01028199",2011,657,5,652,29
"61859","E01028200",2011,692,22,670,50
"61860","E01028201",2011,495,2,493,20
"61861","E01028202",2011,649,90,559,48
"61862","E01028203",2011,606,61,545,65
"61863","E01028204",2011,583,15,568,60
"61864","E01028205",2011,523,97,426,41
"61865","E01028206",2011,633,26,607,57
"61866","E01028207",2011,524,14,510,31
"61867","E01028208",2011,485,74,411,57
"61868","E01028209",2011,616,146,470,99
"61869","E01028210",2011,688,183,505,114
"61870","E01028211",2011,588,78,510,82
"61871","E01028212",2011,620,162,458,55
"61872","E01028213",2011,886,39,847,191
"61873","E01028214",2011,633,2,631,71
"61874","E01028215",2011,510,2,508,36
"61875","E01028216",2011,516,2,514,22
"61876","E01028217",2011,585,3,582,152
"61877","E01028218",2011,665,1,664,55
"61878","E01028219",2011,626,3,623,45
"61879","E01028220",2011,781,10,771,142
"61880","E01028222",2011,680,2,678,41
"61881","E01028223",2011,436,123,313,53
"61882","E01028224",2011,647,177,470,50
"61883","E01028225",2011,640,124,516,54
"61884","E01028226",2011,604,122,482,163
"61885","E01028227",2011,608,123,485,146
"61886","E01028228",2011,511,49,462,151
"61887","E01028229",2011,720,195,525,52
"61888","E01028230",2011,584,182,402,60
"61889","E01028231",2011,652,235,417,50
"61890","E01028232",2011,656,84,572,65
"61891","E01028233",2011,806,125,681,235
"61892","E01028234",2011,797,306,491,149
"61893","E01028235",2011,678,8,670,43
"61894","E01028236",2011,715,15,700,93
"61895","E01028237",2011,659,25,634,58
"61896","E01028238",2011,594,136,458,64
"61897","E01028239",2011,657,26,631,102
"61898","E01028240",2011,628,17,611,44
"61899","E01028241",2011,884,10,874,81
"61900","E01028242",2011,695,10,685,108
"61901","E01028243",2011,809,172,637,55
"61902","E01028244",2011,666,58,608,78
"61903","E01028245",2011,589,226,363,38
"61904","E01028246",2011,720,24,696,73
"61905","E01028247",2011,789,200,589,296
"61906","E01028248",2011,634,105,529,81
"61907","E01028249",2011,561,71,490,38
"61908","E01028250",2011,605,15,590,78
"61909","E01028251",2011,649,9,640,20
"61910","E01028252",2011,826,231,595,50
"61911","E01028253",2011,713,13,700,40
"61912","E01028254",2011,561,57,504,57
"61913","E01028255",2011,594,24,570,25
"61914","E01028256",2011,807,482,325,54
"61915","E01028257",2011,596,93,503,98
"61916","E01028258",2011,721,163,558,54
"61917","E01028259",2011,563,133,430,61
"61918","E01028260",2011,728,90,638,77
"61919","E01028261",2011,686,325,361,36
"61920","E01028262",2011,618,5,613,42
"61921","E01028263",2011,785,610,175,34
"61922","E01028264",2011,779,19,760,46
"61923","E01028267",2011,726,272,454,49
"61924","E01028268",2011,770,73,697,349
"61925","E01028269",2011,656,26,630,256
"61926","E01028270",2011,651,14,637,75
"61927","E01028271",2011,792,253,539,160
"61928","E01028272",2011,729,47,682,163
"61929","E01028273",2011,624,26,598,93
"61930","E01028274",2011,691,156,535,200
"61931","E01028275",2011,665,299,366,81
"61932","E01028276",2011,767,480,287,106
"61933","E01028277",2011,526,11,515,28
"61934","E01028278",2011,641,92,549,55
"61935","E01028279",2011,663,260,403,43
"61936","E01028280",2011,547,191,356,36
"61937","E01028281",2011,573,211,362,83
"61938","E01028282",2011,515,148,367,61
"61939","E01028283",2011,772,42,730,124
"61940","E01028284",2011,714,131,583,236
"61941","E01028285",2011,527,5,522,83
"61942","E01028286",2011,598,139,459,39
"61943","E01028287",2011,640,33,607,62
"61944","E01028288",2011,644,19,625,74
"61945","E01028289",2011,642,8,634,96
"61946","E01028290",2011,614,108,506,52
"61947","E01028291",2011,638,120,518,66
"61948","E01028292",2011,902,12,890,81
"61949","E01028293",2011,851,34,817,211
"61950","E01028294",2011,820,141,679,224
"61951","E01028295",2011,801,35,766,70
"61952","E01028296",2011,554,42,512,69
"61953","E01028297",2011,815,294,521,70
"61954","E01028298",2011,664,44,620,74
"61955","E01028299",2011,525,136,389,72
"61956","E01028300",2011,681,193,488,75
"61957","E01028301",2011,727,308,419,85
"61958","E01028302",2011,690,118,572,65
"61959","E01028303",2011,669,45,624,45
"61960","E01028304",2011,648,257,391,92
"61961","E01028305",2011,568,45,523,157
"61962","E01028306",2011,688,173,515,69
"61963","E01028307",2011,500,32,468,87
"61964","E01028308",2011,736,57,679,82
"61965","E01028309",2011,632,15,617,65
"61966","E01028310",2011,888,195,693,342
"61967","E01028311",2011,843,243,600,274
"61968","E01028312",2011,937,65,872,159
"61969","E01028313",2011,849,296,553,62
"61970","E01028314",2011,978,102,876,126
"61971","E01028315",2011,653,3,650,64
"61972","E01028316",2011,702,128,574,66
"61973","E01028317",2011,642,38,604,57
"61974","E01028318",2011,621,226,395,33
"61975","E01028319",2011,848,340,508,59
"61976","E01028320",2011,765,410,355,44
"61977","E01028321",2011,717,74,643,64
"61978","E01028322",2011,884,198,686,64
"61979","E01028323",2011,667,47,620,109
"61980","E01028325",2011,515,33,482,49
"61981","E01028326",2011,583,122,461,36
"61982","E01028327",2011,672,103,569,72
"61983","E01028328",2011,738,36,702,45
"61984","E01028329",2011,626,33,593,61
"61985","E01028330",2011,689,18,671,52
"61986","E01028331",2011,598,82,516,63
"61987","E01028332",2011,692,30,662,26
"61988","E01028333",2011,614,37,577,111
"61989","E01028334",2011,595,221,374,52
"61990","E01028335",2011,865,121,744,284
"61991","E01028336",2011,474,37,437,63
"61992","E01028337",2011,621,7,614,45
"61993","E01028338",2011,665,184,481,77
"61994","E01028339",2011,727,92,635,165
"61995","E01028340",2011,710,225,485,62
"61996","E01028341",2011,758,16,742,124
"61997","E01028342",2011,622,46,576,125
"61998","E01028343",2011,899,219,680,70
"61999","E01028344",2011,610,12,598,59
"62000","E01028345",2011,999,109,890,156
"62001","E01028346",2011,925,60,865,97
"62002","E01028347",2011,638,27,611,99
"62003","E01028348",2011,507,104,403,66
"62004","E01028349",2011,631,50,581,64
"62005","E01028350",2011,498,70,428,49
"62006","E01028351",2011,481,25,456,22
"62007","E01028352",2011,468,4,464,29
"62008","E01028353",2011,1159,105,1054,101
"62009","E01028354",2011,598,6,592,76
"62010","E01028355",2011,658,64,594,88
"62011","E01028356",2011,606,16,590,57
"62012","E01028357",2011,631,9,622,45
"62013","E01028358",2011,628,124,504,76
"62014","E01028359",2011,667,13,654,62
"62015","E01028360",2011,766,68,698,123
"62016","E01028361",2011,604,9,595,75
"62017","E01028362",2011,593,221,372,33
"62018","E01028363",2011,510,0,510,54
"62019","E01028364",2011,676,6,670,92
"62020","E01028365",2011,681,9,672,156
"62021","E01028366",2011,515,142,373,40
"62022","E01028367",2011,549,26,523,55
"62023","E01028368",2011,632,19,613,45
"62024","E01028369",2011,592,155,437,57
"62025","E01028370",2011,640,112,528,56
"62026","E01028371",2011,820,62,758,70
"62027","E01028372",2011,557,140,417,72
"62028","E01028373",2011,562,33,529,36
"62029","E01028374",2011,580,189,391,46
"62030","E01028375",2011,794,79,715,193
"62031","E01028376",2011,670,7,663,141
"62032","E01028377",2011,735,13,722,60
"62033","E01028378",2011,892,71,821,103
"62034","E01028379",2011,719,6,713,36
"62035","E01028380",2011,530,193,337,42
"62036","E01028381",2011,597,5,592,30
"62037","E01028382",2011,628,6,622,70
"62038","E01028383",2011,505,32,473,54
"62039","E01028384",2011,667,3,664,164
"62040","E01028385",2011,674,41,633,85
"62041","E01028386",2011,632,6,626,143
"62042","E01028387",2011,672,153,519,63
"62043","E01028388",2011,622,6,616,58
"62044","E01028389",2011,669,18,651,49
"62045","E01028390",2011,686,63,623,41
"62046","E01028391",2011,826,23,803,58
"62047","E01028392",2011,934,211,723,134
"62048","E01028393",2011,502,5,497,32
"62049","E01028394",2011,693,59,634,64
"62050","E01028395",2011,571,16,555,41
"62051","E01028396",2011,641,8,633,156
"62052","E01028397",2011,696,45,651,76
"62053","E01028398",2011,690,36,654,199
"62054","E01028399",2011,498,26,472,130
"62055","E01028400",2011,584,3,581,43
"62056","E01028401",2011,481,36,445,46
"62057","E01028402",2011,772,22,750,63
"62058","E01028403",2011,944,88,856,85
"62059","E01028404",2011,674,5,669,108
"62060","E01028405",2011,899,219,680,91
"62061","E01028406",2011,710,113,597,84
"62062","E01028407",2011,863,24,839,106
"62063","E01028408",2011,861,60,801,136
"62064","E01028409",2011,508,10,498,44
"62065","E01028410",2011,530,27,503,71
"62066","E01028411",2011,851,37,814,105
"62067","E01028412",2011,793,7,786,40
"62068","E01028413",2011,754,175,579,70
"62069","E01028414",2011,692,14,678,81
"62070","E01028415",2011,628,34,594,68
"62071","E01028416",2011,691,119,572,337
"62072","E01028417",2011,622,15,607,356
"62073","E01028418",2011,679,139,540,277
"62074","E01028419",2011,1046,99,947,97
"62075","E01028420",2011,579,33,546,77
"62076","E01028421",2011,866,21,845,61
"62077","E01028422",2011,621,64,557,59
"62078","E01028423",2011,612,12,600,84
"62079","E01028424",2011,639,38,601,84
"62080","E01028425",2011,687,59,628,261
"62081","E01028426",2011,562,43,519,66
"62082","E01028427",2011,668,51,617,270
"62083","E01028428",2011,518,18,500,38
"62084","E01028429",2011,471,64,407,27
"62085","E01028430",2011,659,52,607,243
"62086","E01028431",2011,650,38,612,78
"62087","E01028432",2011,637,79,558,52
"62088","E01028433",2011,751,26,725,55
"62089","E01028434",2011,513,7,506,46
"62090","E01028435",2011,922,242,680,394
"62091","E01028437",2011,568,23,545,161
"62092","E01028438",2011,773,39,734,332
"62093","E01028439",2011,569,28,541,128
"62094","E01028440",2011,734,87,647,344
"62095","E01028441",2011,997,248,749,198
"62096","E01028443",2011,586,28,558,84
"62097","E01028444",2011,586,17,569,68
"62098","E01028445",2011,510,133,377,65
"62099","E01028446",2011,619,89,530,75
"62100","E01028447",2011,541,101,440,160
"62101","E01028448",2011,631,250,381,81
"62102","E01028449",2011,529,225,304,42
"62103","E01028450",2011,533,286,247,42
"62104","E01028451",2011,478,97,381,36
"62105","E01028452",2011,493,167,326,53
"62106","E01028453",2011,498,173,325,45
"62107","E01028454",2011,608,311,297,34
"62108","E01028455",2011,529,20,509,48
"62109","E01028456",2011,601,139,462,58
"62110","E01028457",2011,503,10,493,35
"62111","E01028458",2011,613,166,447,85
"62112","E01028459",2011,652,23,629,169
"62113","E01028460",2011,726,54,672,105
"62114","E01028461",2011,678,48,630,153
"62115","E01028462",2011,627,83,544,82
"62116","E01028463",2011,1029,85,944,276
"62117","E01028464",2011,576,22,554,125
"62118","E01028465",2011,531,8,523,81
"62119","E01028466",2011,690,241,449,41
"62120","E01028467",2011,704,75,629,139
"62121","E01028468",2011,986,189,797,229
"62122","E01028469",2011,596,15,581,32
"62123","E01028470",2011,676,88,588,51
"62124","E01028471",2011,481,167,314,41
"62125","E01028472",2011,481,13,468,52
"62126","E01028473",2011,607,11,596,72
"62127","E01028474",2011,657,97,560,67
"62128","E01028475",2011,872,57,815,83
"62129","E01028476",2011,870,32,838,74
"62130","E01028477",2011,581,32,549,76
"62131","E01028478",2011,483,20,463,76
"62132","E01028479",2011,552,16,536,74
"62133","E01028480",2011,609,62,547,87
"62134","E01028481",2011,617,72,545,86
"62135","E01028482",2011,490,8,482,37
"62136","E01028483",2011,501,18,483,74
"62137","E01028484",2011,455,54,401,62
"62138","E01028485",2011,531,58,473,35
"62139","E01028486",2011,540,18,522,68
"62140","E01028487",2011,532,4,528,105
"62141","E01028488",2011,625,16,609,157
"62142","E01028489",2011,617,10,607,55
"62143","E01028490",2011,496,87,409,44
"62144","E01028491",2011,665,54,611,79
"62145","E01028492",2011,600,11,589,71
"62146","E01028493",2011,531,81,450,48
"62147","E01028494",2011,458,146,312,66
"62148","E01028495",2011,517,27,490,68
"62149","E01028496",2011,501,96,405,44
"62150","E01028497",2011,589,16,573,102
"62151","E01028498",2011,638,142,496,60
"62152","E01028499",2011,618,36,582,67
"62153","E01028500",2011,505,83,422,38
"62154","E01028501",2011,467,21,446,39
"62155","E01028502",2011,497,17,480,51
"62156","E01028503",2011,496,36,460,45
"62157","E01028504",2011,590,42,548,69
"62158","E01028505",2011,713,65,648,325
"62159","E01028506",2011,721,82,639,87
"62160","E01028507",2011,582,17,565,86
"62161","E01028508",2011,442,20,422,45
"62162","E01028509",2011,645,41,604,71
"62163","E01028510",2011,636,13,623,57
"62164","E01028511",2011,716,43,673,77
"62165","E01028512",2011,603,46,557,59
"62166","E01028513",2011,929,393,536,212
"62167","E01028514",2011,551,285,266,66
"62168","E01028515",2011,667,57,610,164
"62169","E01028516",2011,703,231,472,125
"62170","E01028517",2011,509,202,307,66
"62171","E01028518",2011,676,449,227,43
"62172","E01028519",2011,544,211,333,62
"62173","E01028520",2011,632,372,260,52
"62174","E01028521",2011,668,50,618,393
"62175","E01028522",2011,746,304,442,332
"62176","E01028523",2011,638,293,345,173
"62177","E01028524",2011,632,324,308,92
"62178","E01028525",2011,706,348,358,114
"62179","E01028526",2011,551,86,465,272
"62180","E01028527",2011,685,43,642,144
"62181","E01028528",2011,537,24,513,190
"62182","E01028529",2011,632,236,396,117
"62183","E01028530",2011,633,80,553,156
"62184","E01028531",2011,867,90,777,311
"62185","E01028532",2011,1004,221,783,399
"62186","E01028533",2011,820,172,648,280
"62187","E01028534",2011,459,13,446,96
"62188","E01028535",2011,661,45,616,235
"62189","E01028536",2011,627,127,500,175
"62190","E01028537",2011,809,187,622,303
"62191","E01028538",2011,630,248,382,105
"62192","E01028539",2011,666,63,603,244
"62193","E01028540",2011,550,84,466,122
"62194","E01028541",2011,616,86,530,197
"62195","E01028542",2011,755,121,634,246
"62196","E01028543",2011,621,233,388,152
"62197","E01028544",2011,600,22,578,263
"62198","E01028545",2011,612,33,579,218
"62199","E01028546",2011,745,301,444,125
"62200","E01028547",2011,830,34,796,344
"62201","E01028548",2011,760,83,677,262
"62202","E01028549",2011,778,129,649,303
"62203","E01028550",2011,695,138,557,400
"62204","E01028551",2011,623,73,550,338
"62205","E01028552",2011,731,326,405,96
"62206","E01028553",2011,752,127,625,171
"62207","E01028554",2011,546,69,477,126
"62208","E01028555",2011,665,60,605,139
"62209","E01028556",2011,696,168,528,208
"62210","E01028557",2011,699,182,517,155
"62211","E01028558",2011,588,49,539,142
"62212","E01028559",2011,643,63,580,214
"62213","E01028560",2011,672,104,568,127
"62214","E01028561",2011,645,8,637,95
"62215","E01028562",2011,612,116,496,169
"62216","E01028563",2011,587,17,570,159
"62217","E01028565",2011,511,3,508,142
"62218","E01028567",2011,661,305,356,90
"62219","E01028568",2011,623,456,167,29
"62220","E01028569",2011,664,433,231,52
"62221","E01028570",2011,773,131,642,145
"62222","E01028571",2011,676,95,581,142
"62223","E01028572",2011,669,22,647,164
"62224","E01028573",2011,674,17,657,175
"62225","E01028574",2011,620,153,467,143
"62226","E01028575",2011,675,130,545,117
"62227","E01028576",2011,489,260,229,79
"62228","E01028577",2011,753,346,407,82
"62229","E01028578",2011,638,85,553,118
"62230","E01028579",2011,529,73,456,288
"62231","E01028580",2011,573,88,485,294
"62232","E01028581",2011,484,36,448,150
"62233","E01028582",2011,588,199,389,236
"62234","E01028583",2011,443,7,436,144
"62235","E01028584",2011,1101,83,1018,308
"62236","E01028585",2011,403,6,397,150
"62237","E01028586",2011,684,101,583,371
"62238","E01028587",2011,755,130,625,381
"62239","E01028588",2011,467,35,432,284
"62240","E01028591",2011,548,32,516,170
"62241","E01028592",2011,504,7,497,202
"62242","E01028594",2011,661,43,618,115
"62243","E01028595",2011,622,92,530,84
"62244","E01028596",2011,673,58,615,155
"62245","E01028597",2011,637,139,498,132
"62246","E01028598",2011,951,85,866,82
"62247","E01028599",2011,598,52,546,87
"62248","E01028600",2011,629,21,608,38
"62249","E01028601",2011,469,40,429,141
"62250","E01028602",2011,519,28,491,397
"62251","E01028603",2011,458,33,425,55
"62252","E01028604",2011,552,199,353,34
"62253","E01028605",2011,637,190,447,36
"62254","E01028606",2011,756,58,698,107
"62255","E01028607",2011,496,39,457,46
"62256","E01028608",2011,465,50,415,23
"62257","E01028609",2011,490,40,450,25
"62258","E01028610",2011,601,81,520,50
"62259","E01028611",2011,445,36,409,47
"62260","E01028612",2011,511,49,462,66
"62261","E01028613",2011,523,22,501,34
"62262","E01028614",2011,601,69,532,30
"62263","E01028615",2011,677,16,661,35
"62264","E01028616",2011,533,14,519,40
"62265","E01028617",2011,789,61,728,93
"62266","E01028618",2011,702,45,657,104
"62267","E01028619",2011,740,138,602,51
"62268","E01028620",2011,973,82,891,185
"62269","E01028621",2011,508,174,334,74
"62270","E01028622",2011,529,46,483,36
"62271","E01028623",2011,656,98,558,104
"62272","E01028624",2011,572,45,527,32
"62273","E01028625",2011,772,12,760,194
"62274","E01028626",2011,618,4,614,115
"62275","E01028627",2011,611,53,558,131
"62276","E01028628",2011,540,19,521,96
"62277","E01028629",2011,632,39,593,147
"62278","E01028630",2011,703,54,649,215
"62279","E01028631",2011,458,58,400,77
"62280","E01028632",2011,534,167,367,42
"62281","E01028633",2011,689,173,516,138
"62282","E01028634",2011,509,13,496,25
"62283","E01028635",2011,616,140,476,42
"62284","E01028636",2011,566,216,350,56
"62285","E01028637",2011,620,30,590,40
"62286","E01028638",2011,563,48,515,57
"62287","E01028639",2011,500,45,455,87
"62288","E01028640",2011,583,88,495,63
"62289","E01028641",2011,503,8,495,49
"62290","E01028642",2011,492,53,439,35
"62291","E01028643",2011,560,51,509,62
"62292","E01028644",2011,701,81,620,90
"62293","E01028645",2011,627,14,613,58
"62294","E01028646",2011,466,96,370,58
"62295","E01028647",2011,617,43,574,87
"62296","E01028648",2011,472,69,403,23
"62297","E01028649",2011,595,76,519,55
"62298","E01028650",2011,820,88,732,102
"62299","E01028651",2011,754,213,541,93
"62300","E01028652",2011,1042,49,993,291
"62301","E01028653",2011,633,168,465,106
"62302","E01028654",2011,615,105,510,52
"62303","E01028655",2011,860,59,801,283
"62304","E01028656",2011,533,6,527,41
"62305","E01028657",2011,548,23,525,86
"62306","E01028658",2011,490,24,466,100
"62307","E01028659",2011,624,35,589,65
"62308","E01028660",2011,687,55,632,116
"62309","E01028661",2011,577,39,538,35
"62310","E01028662",2011,503,20,483,33
"62311","E01028663",2011,611,148,463,48
"62312","E01028664",2011,543,39,504,22
"62313","E01028665",2011,527,12,515,27
"62314","E01028666",2011,685,90,595,147
"62315","E01028667",2011,525,11,514,80
"62316","E01028668",2011,552,41,511,45
"62317","E01028669",2011,539,33,506,76
"62318","E01028670",2011,554,23,531,35
"62319","E01028671",2011,669,146,523,103
"62320","E01028672",2011,695,45,650,42
"62321","E01028673",2011,504,85,419,43
"62322","E01028674",2011,542,56,486,28
"62323","E01028675",2011,505,125,380,37
"62324","E01028676",2011,826,240,586,104
"62325","E01028677",2011,774,177,597,168
"62326","E01028678",2011,631,56,575,99
"62327","E01028679",2011,853,129,724,172
"62328","E01028680",2011,768,67,701,124
"62329","E01028681",2011,522,12,510,43
"62330","E01028682",2011,503,88,415,37
"62331","E01028683",2011,568,27,541,35
"62332","E01028684",2011,637,54,583,128
"62333","E01028685",2011,485,49,436,24
"62334","E01028686",2011,473,65,408,47
"62335","E01028688",2011,507,58,449,63
"62336","E01028689",2011,637,105,532,130
"62337","E01028690",2011,712,147,565,102
"62338","E01028691",2011,611,180,431,45
"62339","E01028692",2011,507,275,232,30
"62340","E01028693",2011,603,4,599,47
"62341","E01028694",2011,607,8,599,112
"62342","E01028695",2011,656,10,646,78
"62343","E01028696",2011,519,14,505,27
"62344","E01028697",2011,674,206,468,88
"62345","E01028698",2011,669,82,587,115
"62346","E01028699",2011,650,21,629,76
"62347","E01028700",2011,699,306,393,58
"62348","E01028701",2011,638,88,550,53
"62349","E01028702",2011,518,43,475,25
"62350","E01028703",2011,816,230,586,165
"62351","E01028704",2011,853,152,701,122
"62352","E01028705",2011,490,6,484,27
"62353","E01028706",2011,599,2,597,72
"62354","E01028707",2011,607,8,599,43
"62355","E01028708",2011,747,97,650,90
"62356","E01028709",2011,658,5,653,76
"62357","E01028710",2011,667,8,659,54
"62358","E01028711",2011,667,82,585,67
"62359","E01028712",2011,880,80,800,90
"62360","E01028713",2011,972,125,847,153
"62361","E01028714",2011,958,114,844,87
"62362","E01028715",2011,554,107,447,115
"62363","E01028716",2011,749,138,611,132
"62364","E01028717",2011,820,211,609,183
"62365","E01028718",2011,609,184,425,58
"62366","E01028719",2011,654,51,603,54
"62367","E01028720",2011,910,143,767,82
"62368","E01028721",2011,517,25,492,54
"62369","E01028722",2011,690,45,645,129
"62370","E01028723",2011,590,94,496,25
"62371","E01028724",2011,505,17,488,35
"62372","E01028725",2011,616,137,479,49
"62373","E01028726",2011,929,69,860,125
"62374","E01028727",2011,661,28,633,71
"62375","E01028728",2011,479,128,351,38
"62376","E01028729",2011,437,43,394,36
"62377","E01028730",2011,648,59,589,166
"62378","E01028731",2011,542,149,393,36
"62379","E01028732",2011,502,75,427,80
"62380","E01028733",2011,547,43,504,64
"62381","E01028734",2011,655,7,648,76
"62382","E01028735",2011,641,75,566,71
"62383","E01028736",2011,935,45,890,93
"62384","E01028737",2011,948,67,881,111
"62385","E01028738",2011,474,36,438,283
"62386","E01028739",2011,699,107,592,59
"62387","E01028740",2011,657,8,649,77
"62388","E01028741",2011,502,13,489,75
"62389","E01028742",2011,726,131,595,159
"62390","E01028743",2011,478,22,456,12
"62391","E01028744",2011,524,33,491,47
"62392","E01028745",2011,546,42,504,128
"62393","E01028746",2011,510,67,443,43
"62394","E01028747",2011,450,32,418,207
"62395","E01028748",2011,423,88,335,163
"62396","E01028749",2011,990,113,877,102
"62397","E01028750",2011,589,174,415,71
"62398","E01028751",2011,585,28,557,70
"62399","E01028752",2011,656,54,602,67
"62400","E01028753",2011,585,147,438,47
"62401","E01028754",2011,569,40,529,92
"62402","E01028755",2011,686,120,566,44
"62403","E01028756",2011,1167,169,998,278
"62404","E01028757",2011,643,196,447,76
"62405","E01028758",2011,609,15,594,28
"62406","E01028759",2011,623,150,473,52
"62407","E01028760",2011,479,72,407,43
"62408","E01028761",2011,510,77,433,41
"62409","E01028762",2011,749,79,670,120
"62410","E01028763",2011,831,107,724,83
"62411","E01028764",2011,760,28,732,101
"62412","E01028765",2011,822,218,604,65
"62413","E01028766",2011,834,51,783,147
"62414","E01028767",2011,863,161,702,104
"62415","E01028771",2011,653,160,493,89
"62416","E01028772",2011,748,13,735,127
"62417","E01028773",2011,578,52,526,108
"62418","E01028774",2011,531,79,452,202
"62419","E01028775",2011,559,15,544,122
"62420","E01028776",2011,809,62,747,126
"62421","E01028777",2011,530,37,493,84
"62422","E01028778",2011,658,131,527,48
"62423","E01028779",2011,452,42,410,42
"62424","E01028780",2011,909,68,841,146
"62425","E01028781",2011,516,239,277,21
"62426","E01028782",2011,643,38,605,63
"62427","E01028783",2011,747,141,606,152
"62428","E01028784",2011,853,76,777,71
"62429","E01028785",2011,658,62,596,79
"62430","E01028786",2011,518,7,511,32
"62431","E01028787",2011,542,178,364,67
"62432","E01028788",2011,700,44,656,140
"62433","E01028789",2011,605,15,590,66
"62434","E01028790",2011,465,71,394,32
"62435","E01028791",2011,587,14,573,46
"62436","E01028792",2011,459,18,441,37
"62437","E01028793",2011,620,92,528,58
"62438","E01028794",2011,578,27,551,41
"62439","E01028795",2011,658,64,594,139
"62440","E01028796",2011,518,60,458,72
"62441","E01028797",2011,453,54,399,51
"62442","E01028798",2011,871,86,785,113
"62443","E01028799",2011,779,73,706,59
"62444","E01028800",2011,518,73,445,80
"62445","E01028801",2011,545,62,483,59
"62446","E01028802",2011,600,14,586,53
"62447","E01028804",2011,544,33,511,68
"62448","E01028806",2011,816,74,742,95
"62449","E01028807",2011,1005,116,889,210
"62450","E01028808",2011,725,147,578,95
"62451","E01028809",2011,522,381,141,25
"62452","E01028810",2011,587,8,579,86
"62453","E01028811",2011,592,204,388,38
"62454","E01028813",2011,489,158,331,37
"62455","E01028814",2011,606,18,588,73
"62456","E01028815",2011,497,10,487,25
"62457","E01028816",2011,491,43,448,61
"62458","E01028817",2011,591,74,517,70
"62459","E01028818",2011,836,75,761,178
"62460","E01028819",2011,732,303,429,51
"62461","E01028820",2011,525,20,505,64
"62462","E01028821",2011,626,93,533,100
"62463","E01028822",2011,578,9,569,76
"62464","E01028823",2011,634,64,570,148
"62465","E01028824",2011,664,83,581,77
"62466","E01028825",2011,497,32,465,81
"62467","E01028826",2011,760,145,615,103
"62468","E01028827",2011,598,146,452,78
"62469","E01028828",2011,673,98,575,107
"62470","E01028829",2011,579,36,543,34
"62471","E01028830",2011,702,23,679,161
"62472","E01028831",2011,635,33,602,57
"62473","E01028832",2011,871,105,766,228
"62474","E01028833",2011,670,68,602,108
"62475","E01028834",2011,645,86,559,60
"62476","E01028835",2011,632,72,560,68
"62477","E01028836",2011,686,245,441,58
"62478","E01028837",2011,660,24,636,81
"62479","E01028838",2011,649,223,426,76
"62480","E01028839",2011,555,8,547,54
"62481","E01028840",2011,534,53,481,43
"62482","E01028841",2011,681,133,548,176
"62483","E01028842",2011,665,50,615,126
"62484","E01028843",2011,681,65,616,145
"62485","E01028844",2011,478,40,438,292
"62486","E01028845",2011,881,31,850,94
"62487","E01028846",2011,729,60,669,94
"62488","E01028847",2011,617,52,565,150
"62489","E01028848",2011,690,10,680,61
"62490","E01028849",2011,893,232,661,148
"62491","E01028850",2011,931,136,795,183
"62492","E01028851",2011,741,79,662,117
"62493","E01028852",2011,708,137,571,124
"62494","E01028853",2011,641,286,355,59
"62495","E01028854",2011,665,71,594,84
"62496","E01028855",2011,656,12,644,99
"62497","E01028856",2011,602,107,495,113
"62498","E01028857",2011,752,127,625,109
"62499","E01028858",2011,839,42,797,124
"62500","E01028859",2011,661,52,609,168
"62501","E01028860",2011,720,52,668,57
"62502","E01028861",2011,526,43,483,121
"62503","E01028862",2011,650,47,603,63
"62504","E01028863",2011,497,60,437,50
"62505","E01028864",2011,611,64,547,65
"62506","E01028865",2011,722,46,676,80
"62507","E01028866",2011,593,27,566,187
"62508","E01028867",2011,612,163,449,76
"62509","E01028868",2011,592,71,521,41
"62510","E01028869",2011,555,66,489,62
"62511","E01028870",2011,578,38,540,66
"62512","E01028871",2011,484,76,408,91
"62513","E01028872",2011,560,28,532,97
"62514","E01028873",2011,835,256,579,197
"62515","E01028874",2011,615,41,574,61
"62516","E01028875",2011,984,94,890,91
"62517","E01028876",2011,841,187,654,159
"62518","E01028877",2011,534,5,529,41
"62519","E01028878",2011,683,67,616,115
"62520","E01028879",2011,652,152,500,78
"62521","E01028880",2011,638,84,554,56
"62522","E01028881",2011,523,11,512,45
"62523","E01028882",2011,605,41,564,148
"62524","E01028883",2011,524,32,492,211
"62525","E01028884",2011,647,135,512,61
"62526","E01028885",2011,791,71,720,206
"62527","E01028886",2011,757,171,586,142
"62528","E01028887",2011,596,28,568,55
"62529","E01028888",2011,593,32,561,62
"62530","E01028889",2011,622,40,582,68
"62531","E01028890",2011,651,122,529,134
"62532","E01028891",2011,850,158,692,290
"62533","E01028892",2011,593,13,580,73
"62534","E01028893",2011,605,55,550,45
"62535","E01028894",2011,649,185,464,53
"62536","E01028895",2011,684,116,568,141
"62537","E01028896",2011,889,76,813,203
"62538","E01028897",2011,617,111,506,51
"62539","E01028898",2011,555,36,519,55
"62540","E01028899",2011,648,58,590,78
"62541","E01028902",2011,498,19,479,53
"62542","E01028903",2011,636,223,413,40
"62543","E01028904",2011,577,112,465,53
"62544","E01028905",2011,730,229,501,108
"62545","E01028906",2011,668,167,501,265
"62546","E01028907",2011,809,27,782,159
"62547","E01028908",2011,755,190,565,256
"62548","E01028909",2011,607,184,423,64
"62549","E01028910",2011,507,14,493,63
"62550","E01028911",2011,539,30,509,26
"62551","E01028912",2011,499,208,291,49
"62552","E01028913",2011,641,47,594,52
"62553","E01028914",2011,460,49,411,37
"62554","E01028915",2011,586,57,529,51
"62555","E01028916",2011,699,34,665,40
"62556","E01028917",2011,642,32,610,137
"62557","E01028918",2011,580,53,527,91
"62558","E01028919",2011,493,44,449,62
"62559","E01028920",2011,525,130,395,42
"62560","E01028921",2011,632,58,574,49
"62561","E01028922",2011,494,11,483,87
"62562","E01028923",2011,648,37,611,56
"62563","E01028924",2011,632,142,490,59
"62564","E01028925",2011,531,6,525,49
"62565","E01028926",2011,596,182,414,60
"62566","E01028927",2011,427,28,399,61
"62567","E01028928",2011,644,108,536,53
"62568","E01028929",2011,593,12,581,89
"62569","E01028930",2011,678,54,624,119
"62570","E01028931",2011,925,140,785,225
"62571","E01028932",2011,784,31,753,116
"62572","E01028933",2011,655,88,567,73
"62573","E01028934",2011,614,243,371,52
"62574","E01028935",2011,630,14,616,28
"62575","E01028936",2011,858,12,846,73
"62576","E01028937",2011,637,78,559,54
"62577","E01028938",2011,874,76,798,231
"62578","E01028939",2011,772,40,732,227
"62579","E01028940",2011,678,74,604,70
"62580","E01028941",2011,835,135,700,183
"62581","E01028942",2011,514,18,496,75
"62582","E01028943",2011,1076,33,1043,231
"62583","E01028944",2011,836,194,642,130
"62584","E01028945",2011,1032,214,818,289
"62585","E01028946",2011,1126,73,1053,560
"62586","E01028947",2011,637,15,622,24
"62587","E01028948",2011,636,166,470,23
"62588","E01028949",2011,648,32,616,69
"62589","E01028950",2011,978,79,899,137
"62590","E01028951",2011,674,122,552,56
"62591","E01028952",2011,800,13,787,167
"62592","E01028953",2011,647,10,637,63
"62593","E01028954",2011,522,33,489,53
"62594","E01028955",2011,494,140,354,34
"62595","E01028956",2011,642,61,581,27
"62596","E01028957",2011,641,402,239,28
"62597","E01028958",2011,764,222,542,53
"62598","E01028959",2011,1098,160,938,206
"62599","E01028960",2011,540,20,520,71
"62600","E01028961",2011,525,29,496,137
"62601","E01028962",2011,676,363,313,43
"62602","E01028963",2011,663,17,646,44
"62603","E01028964",2011,675,13,662,52
"62604","E01028965",2011,641,198,443,53
"62605","E01028966",2011,494,11,483,16
"62606","E01028967",2011,655,377,278,19
"62607","E01028968",2011,537,170,367,46
"62608","E01028969",2011,541,53,488,91
"62609","E01028970",2011,493,31,462,79
"62610","E01028971",2011,910,104,806,157
"62611","E01028972",2011,738,3,735,74
"62612","E01028973",2011,969,135,834,329
"62613","E01028974",2011,507,33,474,71
"62614","E01028975",2011,720,137,583,65
"62615","E01028976",2011,684,15,669,56
"62616","E01028977",2011,819,119,700,96
"62617","E01028978",2011,616,88,528,58
"62618","E01028979",2011,508,71,437,74
"62619","E01028980",2011,938,97,841,190
"62620","E01028981",2011,668,38,630,84
"62621","E01028982",2011,642,138,504,47
"62622","E01028983",2011,810,366,444,47
"62623","E01028984",2011,689,169,520,76
"62624","E01028985",2011,632,13,619,84
"62625","E01028986",2011,634,29,605,51
"62626","E01028987",2011,1056,160,896,318
"62627","E01028988",2011,710,104,606,98
"62628","E01028989",2011,658,210,448,48
"62629","E01028990",2011,467,46,421,55
"62630","E01028991",2011,519,45,474,105
"62631","E01028992",2011,691,136,555,118
"62632","E01028993",2011,618,34,584,141
"62633","E01028994",2011,557,74,483,71
"62634","E01028995",2011,641,77,564,92
"62635","E01028996",2011,573,29,544,59
"62636","E01028997",2011,1075,132,943,95
"62637","E01028998",2011,1105,92,1013,132
"62638","E01028999",2011,654,65,589,81
"62639","E01029000",2011,477,24,453,43
"62640","E01029001",2011,798,66,732,77
"62641","E01029002",2011,551,127,424,97
"62642","E01029003",2011,1040,70,970,145
"62643","E01029004",2011,447,18,429,128
"62644","E01029005",2011,558,31,527,126
"62645","E01029006",2011,753,133,620,61
"62646","E01029007",2011,504,216,288,55
"62647","E01029009",2011,554,4,550,75
"62648","E01029010",2011,582,144,438,78
"62649","E01029011",2011,683,138,545,82
"62650","E01029012",2011,796,83,713,115
"62651","E01029013",2011,780,59,721,162
"62652","E01029014",2011,504,215,289,55
"62653","E01029015",2011,597,31,566,136
"62654","E01029016",2011,595,20,575,87
"62655","E01029018",2011,921,42,879,116
"62656","E01029019",2011,973,38,935,115
"62657","E01029020",2011,592,90,502,76
"62658","E01029021",2011,488,14,474,46
"62659","E01029022",2011,584,28,556,72
"62660","E01029023",2011,481,55,426,65
"62661","E01029024",2011,823,96,727,87
"62662","E01029025",2011,544,142,402,52
"62663","E01029026",2011,417,14,403,38
"62664","E01029027",2011,490,25,465,62
"62665","E01029028",2011,552,69,483,96
"62666","E01029029",2011,708,225,483,87
"62667","E01029030",2011,784,5,779,71
"62668","E01029031",2011,676,10,666,66
"62669","E01029032",2011,497,3,494,23
"62670","E01029033",2011,628,6,622,116
"62671","E01029034",2011,582,6,576,109
"62672","E01029035",2011,623,14,609,137
"62673","E01029036",2011,713,117,596,190
"62674","E01029037",2011,597,85,512,91
"62675","E01029038",2011,568,142,426,67
"62676","E01029039",2011,635,71,564,60
"62677","E01029040",2011,717,65,652,110
"62678","E01029041",2011,950,287,663,185
"62679","E01029042",2011,673,271,402,134
"62680","E01029043",2011,620,107,513,82
"62681","E01029044",2011,570,72,498,101
"62682","E01029045",2011,657,91,566,125
"62683","E01029046",2011,771,135,636,291
"62684","E01029047",2011,626,73,553,120
"62685","E01029050",2011,965,168,797,120
"62686","E01029051",2011,707,45,662,90
"62687","E01029052",2011,862,128,734,83
"62688","E01029053",2011,953,47,906,185
"62689","E01029054",2011,624,42,582,83
"62690","E01029055",2011,499,20,479,52
"62691","E01029056",2011,963,12,951,210
"62692","E01029057",2011,830,62,768,110
"62693","E01029058",2011,946,97,849,122
"62694","E01029059",2011,872,61,811,93
"62695","E01029060",2011,764,40,724,92
"62696","E01029061",2011,930,74,856,101
"62697","E01029062",2011,685,192,493,292
"62698","E01029063",2011,995,108,887,175
"62699","E01029064",2011,633,29,604,141
"62700","E01029065",2011,660,15,645,67
"62701","E01029066",2011,739,72,667,150
"62702","E01029067",2011,665,195,470,60
"62703","E01029068",2011,485,105,380,107
"62704","E01029069",2011,445,42,403,51
"62705","E01029070",2011,825,65,760,227
"62706","E01029071",2011,683,144,539,117
"62707","E01029072",2011,767,278,489,126
"62708","E01029073",2011,545,108,437,99
"62709","E01029074",2011,513,13,500,52
"62710","E01029075",2011,612,93,519,83
"62711","E01029076",2011,823,28,795,60
"62712","E01029077",2011,828,38,790,119
"62713","E01029078",2011,929,101,828,179
"62714","E01029079",2011,763,232,531,110
"62715","E01029080",2011,634,65,569,71
"62716","E01029081",2011,728,65,663,173
"62717","E01029082",2011,645,15,630,92
"62718","E01029083",2011,543,12,531,52
"62719","E01029084",2011,670,106,564,65
"62720","E01029085",2011,878,110,768,149
"62721","E01029086",2011,864,18,846,71
"62722","E01029089",2011,846,52,794,60
"62723","E01029090",2011,656,22,634,117
"62724","E01029091",2011,740,5,735,195
"62725","E01029092",2011,615,2,613,97
"62726","E01029093",2011,728,140,588,231
"62727","E01029094",2011,722,11,711,230
"62728","E01029095",2011,741,121,620,308
"62729","E01029096",2011,597,66,531,148
"62730","E01029097",2011,596,178,418,124
"62731","E01029098",2011,638,131,507,124
"62732","E01029099",2011,507,192,315,43
"62733","E01029100",2011,491,175,316,55
"62734","E01029101",2011,462,68,394,36
"62735","E01029102",2011,626,94,532,97
"62736","E01029103",2011,629,1,628,44
"62737","E01029104",2011,618,32,586,30
"62738","E01029105",2011,728,367,361,89
"62739","E01029106",2011,617,359,258,55
"62740","E01029107",2011,633,269,364,54
"62741","E01029108",2011,944,85,859,137
"62742","E01029109",2011,517,166,351,54
"62743","E01029110",2011,999,250,749,226
"62744","E01029111",2011,966,223,743,214
"62745","E01029112",2011,1007,101,906,377
"62746","E01029113",2011,736,36,700,49
"62747","E01029114",2011,710,24,686,70
"62748","E01029115",2011,734,7,727,69
"62749","E01029116",2011,817,83,734,272
"62750","E01029117",2011,791,10,781,219
"62751","E01029118",2011,717,23,694,82
"62752","E01029119",2011,764,173,591,89
"62753","E01029120",2011,658,5,653,124
"62754","E01029121",2011,535,17,518,47
"62755","E01029122",2011,589,21,568,83
"62756","E01029123",2011,488,112,376,53
"62757","E01029124",2011,792,89,703,72
"62758","E01029125",2011,568,34,534,62
"62759","E01029126",2011,658,51,607,74
"62760","E01029127",2011,782,115,667,140
"62761","E01029128",2011,754,15,739,53
"62762","E01029129",2011,719,37,682,56
"62763","E01029130",2011,862,59,803,80
"62764","E01029131",2011,936,208,728,299
"62765","E01029132",2011,636,339,297,38
"62766","E01029133",2011,597,41,556,57
"62767","E01029134",2011,857,145,712,95
"62768","E01029135",2011,716,34,682,56
"62769","E01029136",2011,809,95,714,59
"62770","E01029137",2011,631,32,599,39
"62771","E01029138",2011,584,49,535,56
"62772","E01029139",2011,607,25,582,57
"62773","E01029140",2011,1140,85,1055,130
"62774","E01029142",2011,642,7,635,73
"62775","E01029143",2011,630,165,465,73
"62776","E01029144",2011,498,21,477,48
"62777","E01029145",2011,843,43,800,68
"62778","E01029147",2011,679,19,660,45
"62779","E01029148",2011,651,47,604,64
"62780","E01029149",2011,554,27,527,43
"62781","E01029150",2011,514,11,503,53
"62782","E01029151",2011,560,43,517,46
"62783","E01029152",2011,941,174,767,47
"62784","E01029153",2011,1067,71,996,132
"62785","E01029154",2011,773,149,624,101
"62786","E01029155",2011,789,46,743,76
"62787","E01029156",2011,816,109,707,101
"62788","E01029157",2011,577,133,444,99
"62789","E01029158",2011,505,37,468,62
"62790","E01029159",2011,634,11,623,94
"62791","E01029160",2011,960,49,911,156
"62792","E01029161",2011,660,82,578,121
"62793","E01029162",2011,754,61,693,211
"62794","E01029163",2011,946,89,857,105
"62795","E01029164",2011,613,64,549,80
"62796","E01029165",2011,522,52,470,52
"62797","E01029166",2011,946,40,906,128
"62798","E01029167",2011,740,222,518,126
"62799","E01029168",2011,742,18,724,91
"62800","E01029169",2011,621,50,571,69
"62801","E01029170",2011,493,181,312,61
"62802","E01029171",2011,995,204,791,127
"62803","E01029172",2011,624,25,599,37
"62804","E01029173",2011,522,79,443,66
"62805","E01029174",2011,501,55,446,40
"62806","E01029175",2011,944,296,648,165
"62807","E01029176",2011,556,17,539,64
"62808","E01029177",2011,526,240,286,44
"62809","E01029178",2011,642,44,598,58
"62810","E01029179",2011,504,138,366,54
"62811","E01029180",2011,591,88,503,62
"62812","E01029181",2011,620,62,558,70
"62813","E01029182",2011,618,44,574,47
"62814","E01029183",2011,602,122,480,51
"62815","E01029184",2011,831,30,801,86
"62816","E01029185",2011,812,78,734,203
"62817","E01029186",2011,722,200,522,91
"62818","E01029187",2011,443,99,344,40
"62819","E01029188",2011,654,12,642,56
"62820","E01029189",2011,481,105,376,26
"62821","E01029190",2011,584,19,565,89
"62822","E01029191",2011,548,106,442,61
"62823","E01029192",2011,621,93,528,73
"62824","E01029193",2011,911,156,755,187
"62825","E01029194",2011,1080,83,997,137
"62826","E01029195",2011,704,146,558,67
"62827","E01029196",2011,619,77,542,55
"62828","E01029197",2011,537,44,493,51
"62829","E01029198",2011,486,82,404,254
"62830","E01029199",2011,881,81,800,139
"62831","E01029200",2011,640,116,524,141
"62832","E01029201",2011,611,33,578,63
"62833","E01029202",2011,557,187,370,43
"62834","E01029203",2011,645,47,598,65
"62835","E01029204",2011,537,25,512,63
"62836","E01029205",2011,765,85,680,116
"62837","E01029206",2011,645,128,517,75
"62838","E01029207",2011,606,40,566,54
"62839","E01029208",2011,488,102,386,45
"62840","E01029209",2011,564,7,557,60
"62841","E01029210",2011,639,25,614,77
"62842","E01029211",2011,593,61,532,52
"62843","E01029212",2011,479,21,458,41
"62844","E01029213",2011,552,86,466,44
"62845","E01029214",2011,483,44,439,53
"62846","E01029215",2011,506,140,366,45
"62847","E01029216",2011,660,31,629,73
"62848","E01029217",2011,679,60,619,72
"62849","E01029218",2011,880,202,678,75
"62850","E01029219",2011,583,15,568,59
"62851","E01029220",2011,525,81,444,23
"62852","E01029221",2011,1017,38,979,146
"62853","E01029222",2011,646,57,589,49
"62854","E01029223",2011,513,36,477,41
"62855","E01029224",2011,702,31,671,64
"62856","E01029225",2011,933,75,858,87
"62857","E01029226",2011,809,200,609,131
"62858","E01029227",2011,658,90,568,63
"62859","E01029228",2011,719,74,645,99
"62860","E01029229",2011,948,174,774,260
"62861","E01029230",2011,983,79,904,109
"62862","E01029231",2011,676,120,556,97
"62863","E01029232",2011,620,49,571,165
"62864","E01029233",2011,571,186,385,74
"62865","E01029234",2011,995,202,793,371
"62866","E01029235",2011,625,133,492,95
"62867","E01029236",2011,613,287,326,41
"62868","E01029237",2011,664,302,362,55
"62869","E01029238",2011,651,193,458,60
"62870","E01029239",2011,700,194,506,167
"62871","E01029240",2011,624,29,595,133
"62872","E01029241",2011,813,126,687,176
"62873","E01029242",2011,631,45,586,81
"62874","E01029243",2011,775,61,714,66
"62875","E01029244",2011,619,3,616,47
"62876","E01029245",2011,925,75,850,134
"62877","E01029246",2011,612,26,586,88
"62878","E01029247",2011,626,362,264,49
"62879","E01029248",2011,641,168,473,95
"62880","E01029249",2011,635,176,459,70
"62881","E01029250",2011,549,9,540,53
"62882","E01029251",2011,556,31,525,41
"62883","E01029252",2011,601,24,577,104
"62884","E01029253",2011,704,125,579,95
"62885","E01029254",2011,593,9,584,25
"62886","E01029255",2011,600,83,517,137
"62887","E01029256",2011,625,115,510,42
"62888","E01029257",2011,867,230,637,84
"62889","E01029258",2011,605,18,587,84
"62890","E01029259",2011,610,140,470,84
"62891","E01029260",2011,863,52,811,152
"62892","E01029261",2011,846,57,789,86
"62893","E01029262",2011,971,48,923,108
"62894","E01029263",2011,593,12,581,118
"62895","E01029264",2011,575,5,570,40
"62896","E01029265",2011,611,3,608,52
"62897","E01029266",2011,586,59,527,107
"62898","E01029267",2011,744,102,642,85
"62899","E01029268",2011,658,47,611,103
"62900","E01029269",2011,859,42,817,90
"62901","E01029270",2011,921,64,857,157
"62902","E01029271",2011,769,56,713,105
"62903","E01029273",2011,497,26,471,42
"62904","E01029274",2011,647,28,619,32
"62905","E01029275",2011,565,46,519,49
"62906","E01029276",2011,584,43,541,85
"62907","E01029277",2011,473,73,400,78
"62908","E01029278",2011,540,56,484,95
"62909","E01029279",2011,601,66,535,60
"62910","E01029280",2011,690,266,424,62
"62911","E01029281",2011,758,250,508,77
"62912","E01029282",2011,639,28,611,185
"62913","E01029283",2011,769,273,496,50
"62914","E01029284",2011,881,246,635,299
"62915","E01029285",2011,1066,31,1035,490
"62916","E01029286",2011,710,109,601,260
"62917","E01029287",2011,678,18,660,260
"62918","E01029288",2011,655,22,633,143
"62919","E01029289",2011,897,46,851,315
"62920","E01029290",2011,632,76,556,107
"62921","E01029291",2011,763,208,555,132
"62922","E01029292",2011,630,357,273,72
"62923","E01029293",2011,611,457,154,28
"62924","E01029294",2011,716,9,707,133
"62925","E01029295",2011,699,8,691,110
"62926","E01029296",2011,628,56,572,40
"62927","E01029297",2011,606,310,296,50
"62928","E01029298",2011,610,191,419,47
"62929","E01029299",2011,718,130,588,177
"62930","E01029300",2011,666,53,613,183
"62931","E01029301",2011,1016,167,849,247
"62932","E01029302",2011,716,22,694,80
"62933","E01029303",2011,836,4,832,104
"62934","E01029304",2011,658,323,335,50
"62935","E01029305",2011,599,129,470,48
"62936","E01029306",2011,617,120,497,42
"62937","E01029307",2011,610,311,299,35
"62938","E01029308",2011,860,36,824,71
"62939","E01029309",2011,899,328,571,116
"62940","E01029310",2011,785,7,778,115
"62941","E01029311",2011,593,285,308,68
"62942","E01029312",2011,600,103,497,57
"62943","E01029313",2011,560,67,493,93
"62944","E01029314",2011,1059,203,856,120
"62945","E01029315",2011,648,10,638,46
"62946","E01029316",2011,789,121,668,157
"62947","E01029317",2011,523,121,402,43
"62948","E01029318",2011,623,9,614,61
"62949","E01029319",2011,582,42,540,136
"62950","E01029320",2011,704,161,543,101
"62951","E01029321",2011,972,31,941,138
"62952","E01029322",2011,625,159,466,95
"62953","E01029324",2011,687,154,533,75
"62954","E01029325",2011,887,131,756,106
"62955","E01029326",2011,539,115,424,73
"62956","E01029327",2011,875,71,804,110
"62957","E01029328",2011,971,200,771,132
"62958","E01029329",2011,735,30,705,196
"62959","E01029330",2011,993,28,965,266
"62960","E01029331",2011,722,30,692,60
"62961","E01029333",2011,557,175,382,75
"62962","E01029334",2011,530,77,453,73
"62963","E01029335",2011,497,30,467,77
"62964","E01029336",2011,983,219,764,180
"62965","E01029337",2011,931,116,815,150
"62966","E01029338",2011,765,75,690,129
"62967","E01029339",2011,671,209,462,80
"62968","E01029341",2011,619,69,550,134
"62969","E01029342",2011,530,7,523,88
"62970","E01029343",2011,686,57,629,167
"62971","E01029345",2011,658,78,580,92
"62972","E01029346",2011,743,294,449,111
"62973","E01029347",2011,642,7,635,36
"62974","E01029348",2011,700,113,587,73
"62975","E01029349",2011,615,201,414,57
"62976","E01029350",2011,678,217,461,110
"62977","E01029351",2011,651,328,323,61
"62978","E01029352",2011,548,31,517,111
"62979","E01029353",2011,690,140,550,83
"62980","E01029354",2011,647,135,512,53
"62981","E01029355",2011,657,226,431,59
"62982","E01029356",2011,638,274,364,51
"62983","E01029357",2011,551,139,412,82
"62984","E01029358",2011,499,262,237,37
"62985","E01029359",2011,744,229,515,181
"62986","E01029360",2011,734,170,564,139
"62987","E01029361",2011,628,157,471,70
"62988","E01029362",2011,685,316,369,67
"62989","E01029363",2011,670,166,504,46
"62990","E01029364",2011,724,35,689,102
"62991","E01029365",2011,652,59,593,88
"62992","E01029366",2011,735,23,712,28
"62993","E01029367",2011,944,202,742,107
"62994","E01029368",2011,510,0,510,20
"62995","E01029369",2011,496,0,496,67
"62996","E01029370",2011,577,3,574,29
"62997","E01029371",2011,610,42,568,69
"62998","E01029372",2011,527,235,292,48
"62999","E01029373",2011,881,180,701,134
"63000","E01029374",2011,955,30,925,187
"63001","E01029375",2011,893,60,833,100
"63002","E01029376",2011,732,60,672,135
"63003","E01029377",2011,513,3,510,49
"63004","E01029378",2011,659,11,648,69
"63005","E01029379",2011,643,85,558,56
"63006","E01029380",2011,565,9,556,53
"63007","E01029381",2011,692,184,508,87
"63008","E01029382",2011,726,83,643,134
"63009","E01029383",2011,617,41,576,59
"63010","E01029384",2011,813,60,753,129
"63011","E01029385",2011,608,16,592,59
"63012","E01029386",2011,603,137,466,68
"63013","E01029387",2011,639,148,491,89
"63014","E01029388",2011,615,229,386,68
"63015","E01029389",2011,784,42,742,199
"63016","E01029390",2011,453,187,266,48
"63017","E01029391",2011,673,37,636,61
"63018","E01029392",2011,716,15,701,60
"63019","E01029393",2011,756,76,680,74
"63020","E01029394",2011,634,73,561,32
"63021","E01029395",2011,683,9,674,80
"63022","E01029396",2011,721,75,646,75
"63023","E01029397",2011,1052,314,738,92
"63024","E01029398",2011,690,105,585,41
"63025","E01029399",2011,647,53,594,113
"63026","E01029400",2011,636,134,502,43
"63027","E01029401",2011,653,35,618,77
"63028","E01029402",2011,839,10,829,86
"63029","E01029403",2011,620,119,501,66
"63030","E01029404",2011,800,178,622,238
"63031","E01029405",2011,638,38,600,55
"63032","E01029406",2011,474,10,464,44
"63033","E01029407",2011,544,25,519,163
"63034","E01029408",2011,825,95,730,330
"63035","E01029409",2011,667,45,622,289
"63036","E01029410",2011,601,50,551,180
"63037","E01029411",2011,519,38,481,44
"63038","E01029412",2011,576,37,539,60
"63039","E01029413",2011,655,107,548,91
"63040","E01029414",2011,686,17,669,126
"63041","E01029415",2011,627,7,620,132
"63042","E01029416",2011,538,13,525,71
"63043","E01029417",2011,527,44,483,39
"63044","E01029418",2011,823,7,816,47
"63045","E01029419",2011,651,6,645,56
"63046","E01029420",2011,737,13,724,57
"63047","E01029422",2011,470,30,440,41
"63048","E01029423",2011,670,142,528,84
"63049","E01029424",2011,433,43,390,63
"63050","E01029425",2011,601,31,570,45
"63051","E01029426",2011,713,93,620,236
"63052","E01029427",2011,653,289,364,79
"63053","E01029428",2011,645,62,583,151
"63054","E01029429",2011,491,15,476,139
"63055","E01029430",2011,603,43,560,41
"63056","E01029431",2011,686,201,485,31
"63057","E01029432",2011,632,42,590,45
"63058","E01029433",2011,614,169,445,42
"63059","E01029434",2011,628,66,562,143
"63060","E01029435",2011,641,23,618,76
"63061","E01029436",2011,842,294,548,153
"63062","E01029437",2011,924,369,555,124
"63063","E01029438",2011,638,41,597,43
"63064","E01029439",2011,633,4,629,59
"63065","E01029440",2011,526,15,511,100
"63066","E01029441",2011,670,80,590,57
"63067","E01029442",2011,556,18,538,30
"63068","E01029443",2011,707,8,699,39
"63069","E01029444",2011,726,95,631,54
"63070","E01029445",2011,849,227,622,294
"63071","E01029446",2011,743,63,680,164
"63072","E01029447",2011,605,42,563,258
"63073","E01029448",2011,734,155,579,180
"63074","E01029449",2011,698,49,649,103
"63075","E01029450",2011,617,277,340,62
"63076","E01029451",2011,849,147,702,122
"63077","E01029452",2011,769,314,455,44
"63078","E01029453",2011,703,387,316,75
"63079","E01029454",2011,642,3,639,19
"63080","E01029455",2011,747,2,745,45
"63081","E01029456",2011,747,53,694,113
"63082","E01029457",2011,533,3,530,51
"63083","E01029458",2011,616,52,564,35
"63084","E01029459",2011,624,19,605,93
"63085","E01029460",2011,786,112,674,130
"63086","E01029461",2011,843,139,704,152
"63087","E01029462",2011,689,56,633,96
"63088","E01029463",2011,508,17,491,52
"63089","E01029464",2011,693,214,479,54
"63090","E01029465",2011,702,35,667,79
"63091","E01029466",2011,615,9,606,35
"63092","E01029467",2011,900,63,837,128
"63093","E01029468",2011,693,417,276,47
"63094","E01029469",2011,763,49,714,60
"63095","E01029470",2011,635,105,530,98
"63096","E01029471",2011,685,20,665,110
"63097","E01029472",2011,654,220,434,37
"63098","E01029473",2011,562,31,531,70
"63099","E01029474",2011,517,14,503,37
"63100","E01029475",2011,842,27,815,57
"63101","E01029476",2011,607,38,569,39
"63102","E01029477",2011,647,13,634,65
"63103","E01029478",2011,645,94,551,46
"63104","E01029479",2011,1040,110,930,92
"63105","E01029480",2011,746,17,729,99
"63106","E01029481",2011,804,110,694,77
"63107","E01029482",2011,635,104,531,59
"63108","E01029483",2011,617,8,609,20
"63109","E01029484",2011,824,40,784,156
"63110","E01029485",2011,650,5,645,62
"63111","E01029486",2011,615,40,575,32
"63112","E01029487",2011,704,284,420,55
"63113","E01029488",2011,695,52,643,85
"63114","E01029489",2011,653,6,647,22
"63115","E01029490",2011,607,41,566,40
"63116","E01029491",2011,775,123,652,114
"63117","E01029492",2011,767,484,283,50
"63118","E01029493",2011,810,54,756,72
"63119","E01029494",2011,646,71,575,78
"63120","E01029495",2011,671,37,634,51
"63121","E01029496",2011,753,311,442,70
"63122","E01029497",2011,862,128,734,85
"63123","E01029498",2011,711,69,642,56
"63124","E01029499",2011,736,403,333,45
"63125","E01029500",2011,734,93,641,28
"63126","E01029501",2011,613,187,426,43
"63127","E01029502",2011,644,181,463,48
"63128","E01029503",2011,644,85,559,43
"63129","E01029504",2011,704,163,541,140
"63130","E01029505",2011,649,31,618,59
"63131","E01029506",2011,757,9,748,37
"63132","E01029507",2011,636,11,625,31
"63133","E01029508",2011,919,71,848,71
"63134","E01029509",2011,668,52,616,54
"63135","E01029511",2011,682,21,661,61
"63136","E01029512",2011,762,54,708,107
"63137","E01029513",2011,491,4,487,17
"63138","E01029514",2011,613,9,604,40
"63139","E01029515",2011,775,45,730,61
"63140","E01029516",2011,743,72,671,93
"63141","E01029517",2011,669,55,614,62
"63142","E01029518",2011,1114,54,1060,114
"63143","E01029519",2011,935,196,739,110
"63144","E01029520",2011,602,6,596,15
"63145","E01029521",2011,692,19,673,47
"63146","E01029522",2011,625,96,529,52
"63147","E01029523",2011,625,31,594,16
"63148","E01029524",2011,725,128,597,104
"63149","E01029525",2011,750,82,668,30
"63150","E01029526",2011,851,260,591,179
"63151","E01029527",2011,548,231,317,33
"63152","E01029528",2011,523,59,464,58
"63153","E01029529",2011,491,32,459,63
"63154","E01029530",2011,676,67,609,132
"63155","E01029531",2011,679,15,664,42
"63156","E01029532",2011,642,72,570,67
"63157","E01029533",2011,651,110,541,23
"63158","E01029534",2011,673,20,653,67
"63159","E01029535",2011,601,220,381,69
"63160","E01029536",2011,644,6,638,32
"63161","E01029537",2011,626,123,503,48
"63162","E01029538",2011,715,317,398,31
"63163","E01029539",2011,618,76,542,23
"63164","E01029540",2011,636,159,477,22
"63165","E01029541",2011,624,195,429,66
"63166","E01029542",2011,641,62,579,102
"63167","E01029543",2011,474,221,253,20
"63168","E01029544",2011,517,41,476,39
"63169","E01029545",2011,616,55,561,52
"63170","E01029546",2011,484,6,478,44
"63171","E01029547",2011,626,238,388,136
"63172","E01029548",2011,662,313,349,79
"63173","E01029549",2011,798,280,518,53
"63174","E01029551",2011,660,54,606,60
"63175","E01029552",2011,629,134,495,43
"63176","E01029553",2011,605,262,343,51
"63177","E01029554",2011,637,414,223,35
"63178","E01029555",2011,758,195,563,148
"63179","E01029556",2011,1111,136,975,78
"63180","E01029557",2011,551,34,517,65
"63181","E01029558",2011,638,216,422,69
"63182","E01029559",2011,588,94,494,57
"63183","E01029560",2011,672,320,352,59
"63184","E01029561",2011,602,190,412,39
"63185","E01029562",2011,528,33,495,34
"63186","E01029563",2011,601,82,519,31
"63187","E01029564",2011,542,46,496,206
"63188","E01029565",2011,468,7,461,17
"63189","E01029566",2011,504,326,178,22
"63190","E01029567",2011,725,163,562,82
"63191","E01029568",2011,631,157,474,69
"63192","E01029569",2011,595,52,543,85
"63193","E01029570",2011,1035,41,994,92
"63194","E01029571",2011,561,47,514,31
"63195","E01029572",2011,650,15,635,37
"63196","E01029573",2011,640,28,612,70
"63197","E01029574",2011,610,45,565,58
"63198","E01029575",2011,435,133,302,45
"63199","E01029576",2011,550,100,450,72
"63200","E01029577",2011,683,9,674,93
"63201","E01029578",2011,806,266,540,108
"63202","E01029579",2011,766,64,702,70
"63203","E01029580",2011,574,5,569,60
"63204","E01029581",2011,675,16,659,55
"63205","E01029582",2011,792,36,756,60
"63206","E01029583",2011,682,123,559,86
"63207","E01029584",2011,538,46,492,45
"63208","E01029585",2011,661,30,631,118
"63209","E01029586",2011,541,0,541,15
"63210","E01029587",2011,539,5,534,36
"63211","E01029588",2011,735,180,555,98
"63212","E01029589",2011,522,9,513,18
"63213","E01029590",2011,613,73,540,25
"63214","E01029591",2011,738,317,421,59
"63215","E01029593",2011,745,256,489,115
"63216","E01029594",2011,872,124,748,116
"63217","E01029595",2011,591,47,544,34
"63218","E01029596",2011,522,27,495,22
"63219","E01029597",2011,622,268,354,45
"63220","E01029598",2011,737,275,462,111
"63221","E01029599",2011,734,299,435,69
"63222","E01029600",2011,623,18,605,37
"63223","E01029601",2011,690,56,634,53
"63224","E01029602",2011,946,123,823,379
"63225","E01029603",2011,739,239,500,161
"63226","E01029604",2011,940,429,511,222
"63227","E01029605",2011,542,25,517,39
"63228","E01029606",2011,587,1,586,23
"63229","E01029607",2011,639,162,477,32
"63230","E01029608",2011,646,60,586,27
"63231","E01029609",2011,767,45,722,175
"63232","E01029610",2011,585,19,566,65
"63233","E01029611",2011,800,290,510,93
"63234","E01029612",2011,495,8,487,48
"63235","E01029613",2011,628,41,587,35
"63236","E01029614",2011,700,191,509,26
"63237","E01029615",2011,574,265,309,37
"63238","E01029616",2011,681,14,667,67
"63239","E01029617",2011,681,24,657,106
"63240","E01029618",2011,737,172,565,97
"63241","E01029619",2011,841,123,718,44
"63242","E01029620",2011,505,56,449,49
"63243","E01029621",2011,607,52,555,47
"63244","E01029622",2011,633,96,537,54
"63245","E01029623",2011,487,138,349,18
"63246","E01029624",2011,549,59,490,19
"63247","E01029625",2011,481,14,467,22
"63248","E01029626",2011,612,57,555,43
"63249","E01029627",2011,665,272,393,54
"63250","E01029628",2011,512,12,500,23
"63251","E01029629",2011,500,8,492,17
"63252","E01029630",2011,547,17,530,55
"63253","E01029631",2011,580,27,553,61
"63254","E01029632",2011,606,15,591,42
"63255","E01029633",2011,667,67,600,22
"63256","E01029634",2011,593,205,388,42
"63257","E01029635",2011,724,259,465,56
"63258","E01029636",2011,592,53,539,47
"63259","E01029637",2011,673,51,622,39
"63260","E01029638",2011,885,183,702,65
"63261","E01029639",2011,516,110,406,18
"63262","E01029640",2011,562,33,529,67
"63263","E01029641",2011,685,25,660,42
"63264","E01029642",2011,628,54,574,38
"63265","E01029643",2011,635,248,387,31
"63266","E01029644",2011,600,53,547,36
"63267","E01029645",2011,875,102,773,72
"63268","E01029646",2011,568,151,417,64
"63269","E01029647",2011,877,173,704,61
"63270","E01029648",2011,589,138,451,48
"63271","E01029649",2011,601,168,433,57
"63272","E01029650",2011,660,18,642,54
"63273","E01029651",2011,620,19,601,67
"63274","E01029652",2011,672,5,667,68
"63275","E01029653",2011,521,103,418,29
"63276","E01029654",2011,953,125,828,78
"63277","E01029655",2011,890,162,728,75
"63278","E01029656",2011,729,20,709,116
"63279","E01029657",2011,622,30,592,48
"63280","E01029658",2011,566,107,459,63
"63281","E01029659",2011,578,23,555,33
"63282","E01029660",2011,879,124,755,103
"63283","E01029661",2011,776,9,767,85
"63284","E01029662",2011,831,16,815,60
"63285","E01029663",2011,597,4,593,65
"63286","E01029664",2011,675,70,605,87
"63287","E01029665",2011,764,9,755,111
"63288","E01029666",2011,768,419,349,64
"63289","E01029667",2011,887,96,791,160
"63290","E01029668",2011,524,12,512,58
"63291","E01029669",2011,564,108,456,41
"63292","E01029670",2011,640,32,608,140
"63293","E01029671",2011,662,148,514,36
"63294","E01029672",2011,626,33,593,60
"63295","E01029673",2011,672,127,545,87
"63296","E01029674",2011,689,24,665,25
"63297","E01029675",2011,678,56,622,9
"63298","E01029676",2011,524,116,408,79
"63299","E01029677",2011,557,42,515,36
"63300","E01029678",2011,683,8,675,39
"63301","E01029679",2011,623,314,309,35
"63302","E01029680",2011,632,88,544,40
"63303","E01029681",2011,497,150,347,46
"63304","E01029682",2011,711,87,624,56
"63305","E01029683",2011,552,47,505,61
"63306","E01029684",2011,596,3,593,54
"63307","E01029685",2011,637,1,636,24
"63308","E01029686",2011,607,4,603,43
"63309","E01029687",2011,823,37,786,107
"63310","E01029688",2011,914,74,840,84
"63311","E01029689",2011,835,41,794,334
"63312","E01029690",2011,637,16,621,91
"63313","E01029691",2011,693,274,419,187
"63314","E01029692",2011,669,258,411,81
"63315","E01029693",2011,805,150,655,443
"63316","E01029694",2011,619,19,600,270
"63317","E01029695",2011,924,140,784,116
"63318","E01029696",2011,644,60,584,102
"63319","E01029697",2011,536,39,497,70
"63320","E01029698",2011,689,25,664,62
"63321","E01029699",2011,955,174,781,251
"63322","E01029700",2011,536,4,532,76
"63323","E01029701",2011,1131,204,927,519
"63324","E01029702",2011,667,154,513,43
"63325","E01029703",2011,624,32,592,61
"63326","E01029704",2011,602,38,564,28
"63327","E01029705",2011,628,12,616,30
"63328","E01029706",2011,660,27,633,63
"63329","E01029707",2011,674,127,547,56
"63330","E01029708",2011,773,57,716,90
"63331","E01029709",2011,620,22,598,44
"63332","E01029710",2011,640,15,625,59
"63333","E01029711",2011,612,44,568,38
"63334","E01029712",2011,774,74,700,36
"63335","E01029713",2011,694,88,606,51
"63336","E01029714",2011,647,6,641,53
"63337","E01029715",2011,785,290,495,98
"63338","E01029716",2011,681,279,402,41
"63339","E01029717",2011,770,447,323,33
"63340","E01029718",2011,805,12,793,57
"63341","E01029719",2011,730,125,605,69
"63342","E01029720",2011,670,319,351,81
"63343","E01029721",2011,641,27,614,81
"63344","E01029722",2011,687,111,576,141
"63345","E01029723",2011,687,16,671,95
"63346","E01029724",2011,680,4,676,77
"63347","E01029725",2011,695,255,440,171
"63348","E01029726",2011,702,107,595,43
"63349","E01029727",2011,689,366,323,62
"63350","E01029728",2011,621,107,514,34
"63351","E01029729",2011,868,310,558,112
"63352","E01029730",2011,445,2,443,28
"63353","E01029731",2011,638,24,614,39
"63354","E01029732",2011,601,20,581,112
"63355","E01029733",2011,765,50,715,113
"63356","E01029734",2011,949,495,454,74
"63357","E01029735",2011,948,138,810,108
"63358","E01029736",2011,602,16,586,68
"63359","E01029737",2011,666,132,534,49
"63360","E01029738",2011,583,5,578,67
"63361","E01029739",2011,603,2,601,39
"63362","E01029740",2011,697,217,480,67
"63363","E01029741",2011,688,28,660,83
"63364","E01029742",2011,861,46,815,74
"63365","E01029743",2011,614,20,594,56
"63366","E01029744",2011,989,42,947,191
"63367","E01029745",2011,903,203,700,216
"63368","E01029746",2011,674,139,535,84
"63369","E01029747",2011,595,52,543,42
"63370","E01029748",2011,588,3,585,38
"63371","E01029749",2011,738,60,678,102
"63372","E01029750",2011,660,147,513,92
"63373","E01029751",2011,724,75,649,40
"63374","E01029752",2011,521,217,304,41
"63375","E01029753",2011,654,111,543,77
"63376","E01029754",2011,565,16,549,49
"63377","E01029755",2011,647,14,633,31
"63378","E01029756",2011,759,59,700,141
"63379","E01029757",2011,640,1,639,58
"63380","E01029758",2011,656,0,656,28
"63381","E01029759",2011,726,5,721,57
"63382","E01029760",2011,668,1,667,18
"63383","E01029761",2011,596,48,548,62
"63384","E01029762",2011,669,24,645,49
"63385","E01029763",2011,682,294,388,64
"63386","E01029764",2011,651,101,550,92
"63387","E01029765",2011,541,178,363,83
"63388","E01029766",2011,631,156,475,61
"63389","E01029767",2011,727,13,714,49
"63390","E01029768",2011,621,23,598,34
"63391","E01029769",2011,753,6,747,31
"63392","E01029770",2011,839,4,835,45
"63393","E01029771",2011,724,11,713,28
"63394","E01029772",2011,777,47,730,60
"63395","E01029773",2011,663,2,661,27
"63396","E01029774",2011,919,110,809,174
"63397","E01029775",2011,670,2,668,29
"63398","E01029776",2011,737,3,734,32
"63399","E01029777",2011,632,61,571,49
"63400","E01029778",2011,707,17,690,49
"63401","E01029779",2011,726,2,724,34
"63402","E01029780",2011,650,48,602,25
"63403","E01029781",2011,662,39,623,57
"63404","E01029782",2011,839,180,659,93
"63405","E01029783",2011,652,181,471,67
"63406","E01029784",2011,898,7,891,43
"63407","E01029785",2011,728,1,727,35
"63408","E01029786",2011,589,15,574,51
"63409","E01029787",2011,782,133,649,139
"63410","E01029788",2011,547,3,544,58
"63411","E01029789",2011,449,17,432,28
"63412","E01029790",2011,785,107,678,37
"63413","E01029791",2011,612,11,601,110
"63414","E01029792",2011,996,14,982,133
"63415","E01029793",2011,687,44,643,46
"63416","E01029794",2011,584,11,573,56
"63417","E01029795",2011,767,82,685,76
"63418","E01029796",2011,642,79,563,38
"63419","E01029797",2011,623,41,582,75
"63420","E01029798",2011,749,76,673,89
"63421","E01029799",2011,807,22,785,50
"63422","E01029800",2011,670,5,665,55
"63423","E01029801",2011,776,47,729,100
"63424","E01029802",2011,739,14,725,56
"63425","E01029803",2011,778,27,751,71
"63426","E01029804",2011,923,43,880,340
"63427","E01029805",2011,731,92,639,67
"63428","E01029806",2011,677,35,642,61
"63429","E01029807",2011,547,139,408,75
"63430","E01029808",2011,663,90,573,98
"63431","E01029809",2011,618,261,357,29
"63432","E01029810",2011,546,172,374,36
"63433","E01029811",2011,658,150,508,60
"63434","E01029812",2011,993,138,855,261
"63435","E01029813",2011,896,35,861,60
"63436","E01029814",2011,790,66,724,145
"63437","E01029815",2011,676,60,616,33
"63438","E01029816",2011,608,22,586,17
"63439","E01029817",2011,823,82,741,119
"63440","E01029818",2011,618,4,614,32
"63441","E01029819",2011,729,4,725,30
"63442","E01029820",2011,585,120,465,45
"63443","E01029821",2011,648,33,615,70
"63444","E01029822",2011,526,29,497,38
"63445","E01029823",2011,657,21,636,52
"63446","E01029824",2011,734,382,352,67
"63447","E01029825",2011,512,15,497,39
"63448","E01029826",2011,640,43,597,50
"63449","E01029827",2011,541,222,319,61
"63450","E01029828",2011,480,198,282,60
"63451","E01029829",2011,781,125,656,76
"63452","E01029830",2011,543,116,427,119
"63453","E01029831",2011,634,144,490,65
"63454","E01029832",2011,700,101,599,56
"63455","E01029833",2011,684,52,632,88
"63456","E01029834",2011,680,215,465,65
"63457","E01029835",2011,1048,552,496,240
"63458","E01029836",2011,587,124,463,122
"63459","E01029837",2011,697,119,578,113
"63460","E01029838",2011,714,29,685,213
"63461","E01029839",2011,445,5,440,32
"63462","E01029840",2011,460,222,238,56
"63463","E01029841",2011,608,63,545,42
"63464","E01029842",2011,518,247,271,42
"63465","E01029843",2011,552,180,372,53
"63466","E01029844",2011,496,10,486,50
"63467","E01029845",2011,472,408,64,11
"63468","E01029846",2011,521,62,459,37
"63469","E01029847",2011,537,5,532,30
"63470","E01029848",2011,515,24,491,31
"63471","E01029849",2011,683,290,393,47
"63472","E01029850",2011,574,158,416,76
"63473","E01029851",2011,985,146,839,260
"63474","E01029852",2011,763,222,541,43
"63475","E01029853",2011,672,125,547,76
"63476","E01029854",2011,641,8,633,36
"63477","E01029855",2011,547,110,437,32
"63478","E01029856",2011,595,28,567,56
"63479","E01029857",2011,567,158,409,41
"63480","E01029858",2011,635,26,609,56
"63481","E01029859",2011,754,368,386,73
"63482","E01029860",2011,536,5,531,43
"63483","E01029861",2011,595,99,496,50
"63484","E01029862",2011,480,5,475,29
"63485","E01029863",2011,756,11,745,96
"63486","E01029864",2011,646,28,618,58
"63487","E01029865",2011,602,8,594,56
"63488","E01029867",2011,679,179,500,72
"63489","E01029868",2011,500,11,489,23
"63490","E01029869",2011,660,161,499,17
"63491","E01029870",2011,479,87,392,47
"63492","E01029871",2011,622,79,543,68
"63493","E01029872",2011,585,17,568,39
"63494","E01029873",2011,965,132,833,136
"63495","E01029874",2011,727,17,710,80
"63496","E01029875",2011,901,99,802,78
"63497","E01029876",2011,899,144,755,105
"63498","E01029877",2011,513,28,485,56
"63499","E01029878",2011,514,35,479,69
"63500","E01029879",2011,624,65,559,75
"63501","E01029880",2011,743,91,652,76
"63502","E01029881",2011,833,75,758,84
"63503","E01029882",2011,621,93,528,49
"63504","E01029883",2011,850,32,818,92
"63505","E01029884",2011,666,104,562,114
"63506","E01029885",2011,939,34,905,99
"63507","E01029886",2011,507,144,363,37
"63508","E01029887",2011,792,33,759,122
"63509","E01029888",2011,495,154,341,45
"63510","E01029889",2011,503,190,313,47
"63511","E01029890",2011,485,12,473,49
"63512","E01029891",2011,782,87,695,107
"63513","E01029892",2011,848,274,574,147
"63514","E01029893",2011,1018,113,905,237
"63515","E01029894",2011,517,34,483,79
"63516","E01029895",2011,476,12,464,30
"63517","E01029896",2011,615,181,434,61
"63518","E01029897",2011,803,74,729,91
"63519","E01029898",2011,884,177,707,101
"63520","E01029899",2011,764,34,730,54
"63521","E01029900",2011,734,227,507,48
"63522","E01029901",2011,1025,43,982,222
"63523","E01029902",2011,896,69,827,100
"63524","E01029903",2011,561,7,554,29
"63525","E01029904",2011,608,28,580,37
"63526","E01029905",2011,464,22,442,44
"63527","E01029906",2011,819,100,719,111
"63528","E01029907",2011,955,130,825,103
"63529","E01029908",2011,686,18,668,118
"63530","E01029909",2011,733,13,720,137
"63531","E01029910",2011,504,217,287,36
"63532","E01029911",2011,918,93,825,95
"63533","E01029912",2011,726,199,527,122
"63534","E01029913",2011,546,17,529,39
"63535","E01029914",2011,666,154,512,138
"63536","E01029915",2011,514,70,444,70
"63537","E01029916",2011,506,216,290,47
"63538","E01029917",2011,812,103,709,62
"63539","E01029918",2011,544,115,429,153
"63540","E01029919",2011,668,42,626,118
"63541","E01029920",2011,1004,222,782,275
"63542","E01029921",2011,537,21,516,36
"63543","E01029922",2011,544,111,433,41
"63544","E01029923",2011,582,24,558,59
"63545","E01029925",2011,870,66,804,290
"63546","E01029926",2011,796,15,781,100
"63547","E01029927",2011,1015,233,782,279
"63548","E01029928",2011,804,90,714,190
"63549","E01029929",2011,1019,217,802,158
"63550","E01029930",2011,644,25,619,144
"63551","E01029937",2011,871,149,722,147
"63552","E01029938",2011,528,204,324,104
"63553","E01029939",2011,640,29,611,152
"63554","E01029940",2011,617,220,397,73
"63555","E01029941",2011,775,93,682,191
"63556","E01029942",2011,660,21,639,158
"63557","E01029944",2011,752,75,677,126
"63558","E01029945",2011,796,83,713,155
"63559","E01029946",2011,906,241,665,213
"63560","E01029947",2011,1064,116,948,286
"63561","E01029949",2011,637,188,449,115
"63562","E01029950",2011,795,309,486,172
"63563","E01029951",2011,616,36,580,85
"63564","E01029952",2011,524,48,476,95
"63565","E01029953",2011,613,120,493,156
"63566","E01029954",2011,1122,387,735,210
"63567","E01029955",2011,874,157,717,176
"63568","E01029956",2011,544,20,524,215
"63569","E01029957",2011,728,38,690,97
"63570","E01029958",2011,645,52,593,162
"63571","E01029960",2011,839,52,787,269
"63572","E01029961",2011,603,27,576,185
"63573","E01029962",2011,696,34,662,298
"63574","E01029963",2011,640,8,632,35
"63575","E01029964",2011,522,13,509,103
"63576","E01029965",2011,621,4,617,56
"63577","E01029966",2011,621,71,550,104
"63578","E01029967",2011,613,4,609,31
"63579","E01029968",2011,674,99,575,209
"63580","E01029969",2011,555,95,460,100
"63581","E01029970",2011,757,177,580,94
"63582","E01029971",2011,637,313,324,51
"63583","E01029973",2011,631,10,621,40
"63584","E01029974",2011,613,10,603,67
"63585","E01029975",2011,518,84,434,50
"63586","E01029976",2011,639,69,570,55
"63587","E01029977",2011,633,10,623,45
"63588","E01029978",2011,547,113,434,64
"63589","E01029979",2011,645,381,264,46
"63590","E01029980",2011,701,399,302,62
"63591","E01029981",2011,513,43,470,52
"63592","E01029982",2011,526,267,259,22
"63593","E01029983",2011,656,18,638,123
"63594","E01029984",2011,613,204,409,66
"63595","E01029985",2011,1078,223,855,312
"63596","E01029986",2011,665,371,294,53
"63597","E01029987",2011,622,287,335,47
"63598","E01029988",2011,920,330,590,350
"63599","E01029990",2011,713,9,704,234
"63600","E01029991",2011,675,9,666,59
"63601","E01029992",2011,608,18,590,137
"63602","E01029994",2011,636,365,271,38
"63603","E01029995",2011,654,24,630,90
"63604","E01029996",2011,637,195,442,63
"63605","E01029997",2011,630,96,534,51
"63606","E01029998",2011,758,295,463,49
"63607","E01029999",2011,624,34,590,50
"63608","E01030000",2011,637,32,605,125
"63609","E01030001",2011,647,166,481,44
"63610","E01030002",2011,937,115,822,247
"63611","E01030003",2011,713,19,694,159
"63612","E01030004",2011,498,4,494,54
"63613","E01030005",2011,930,110,820,266
"63614","E01030006",2011,843,169,674,222
"63615","E01030007",2011,662,11,651,191
"63616","E01030008",2011,520,16,504,90
"63617","E01030009",2011,591,5,586,128
"63618","E01030010",2011,955,132,823,414
"63619","E01030011",2011,675,49,626,45
"63620","E01030012",2011,624,352,272,29
"63621","E01030013",2011,604,239,365,47
"63622","E01030014",2011,602,219,383,30
"63623","E01030015",2011,530,11,519,48
"63624","E01030016",2011,633,101,532,144
"63625","E01030017",2011,633,277,356,30
"63626","E01030018",2011,667,437,230,38
"63627","E01030019",2011,644,71,573,49
"63628","E01030020",2011,609,95,514,46
"63629","E01030021",2011,673,418,255,47
"63630","E01030022",2011,930,98,832,314
"63631","E01030023",2011,835,132,703,394
"63632","E01030024",2011,1057,381,676,430
"63633","E01030025",2011,834,148,686,316
"63634","E01030026",2011,707,77,630,203
"63635","E01030027",2011,906,78,828,245
"63636","E01030028",2011,668,160,508,61
"63637","E01030029",2011,658,237,421,66
"63638","E01030030",2011,898,199,699,169
"63639","E01030031",2011,647,328,319,38
"63640","E01030032",2011,511,300,211,33
"63641","E01030033",2011,654,26,628,44
"63642","E01030034",2011,630,14,616,33
"63643","E01030035",2011,647,303,344,39
"63644","E01030036",2011,776,414,362,32
"63645","E01030037",2011,512,56,456,48
"63646","E01030038",2011,499,20,479,52
"63647","E01030039",2011,557,38,519,55
"63648","E01030040",2011,489,61,428,61
"63649","E01030041",2011,921,84,837,93
"63650","E01030042",2011,667,13,654,67
"63651","E01030043",2011,536,24,512,61
"63652","E01030044",2011,563,109,454,49
"63653","E01030045",2011,706,27,679,53
"63654","E01030046",2011,647,51,596,59
"63655","E01030047",2011,555,94,461,58
"63656","E01030048",2011,1029,125,904,126
"63657","E01030049",2011,673,84,589,67
"63658","E01030050",2011,836,16,820,102
"63659","E01030051",2011,726,189,537,29
"63660","E01030052",2011,969,184,785,102
"63661","E01030053",2011,985,119,866,100
"63662","E01030054",2011,508,31,477,49
"63663","E01030055",2011,577,46,531,59
"63664","E01030056",2011,949,180,769,50
"63665","E01030057",2011,910,65,845,165
"63666","E01030058",2011,868,107,761,103
"63667","E01030059",2011,961,123,838,85
"63668","E01030060",2011,738,84,654,108
"63669","E01030061",2011,761,167,594,103
"63670","E01030062",2011,624,13,611,85
"63671","E01030063",2011,903,104,799,70
"63672","E01030064",2011,922,82,840,72
"63673","E01030065",2011,866,99,767,72
"63674","E01030066",2011,680,94,586,49
"63675","E01030067",2011,566,8,558,93
"63676","E01030068",2011,717,95,622,78
"63677","E01030069",2011,543,25,518,47
"63678","E01030070",2011,539,45,494,226
"63679","E01030071",2011,684,23,661,137
"63680","E01030072",2011,747,41,706,120
"63681","E01030073",2011,747,189,558,33
"63682","E01030075",2011,618,3,615,49
"63683","E01030076",2011,640,81,559,133
"63684","E01030077",2011,680,277,403,60
"63685","E01030078",2011,724,8,716,96
"63686","E01030079",2011,642,301,341,39
"63687","E01030080",2011,667,94,573,57
"63688","E01030081",2011,1008,175,833,57
"63689","E01030082",2011,1136,162,974,123
"63690","E01030083",2011,918,48,870,76
"63691","E01030084",2011,646,6,640,48
"63692","E01030085",2011,681,48,633,68
"63693","E01030086",2011,472,60,412,38
"63694","E01030087",2011,514,51,463,56
"63695","E01030088",2011,475,35,440,52
"63696","E01030089",2011,835,116,719,50
"63697","E01030090",2011,969,79,890,136
"63698","E01030091",2011,950,110,840,388
"63699","E01030092",2011,813,182,631,169
"63700","E01030093",2011,776,94,682,240
"63701","E01030094",2011,594,82,512,156
"63702","E01030095",2011,485,48,437,62
"63703","E01030096",2011,608,48,560,54
"63704","E01030097",2011,504,102,402,39
"63705","E01030098",2011,966,121,845,105
"63706","E01030099",2011,863,72,791,95
"63707","E01030100",2011,868,76,792,69
"63708","E01030101",2011,950,149,801,129
"63709","E01030103",2011,861,105,756,54
"63710","E01030104",2011,894,53,841,63
"63711","E01030105",2011,713,111,602,147
"63712","E01030106",2011,1018,298,720,142
"63713","E01030107",2011,638,15,623,34
"63714","E01030108",2011,710,162,548,99
"63715","E01030109",2011,753,298,455,54
"63716","E01030110",2011,1152,329,823,109
"63717","E01030111",2011,530,9,521,27
"63718","E01030112",2011,741,85,656,137
"63719","E01030113",2011,828,154,674,150
"63720","E01030114",2011,546,208,338,74
"63721","E01030115",2011,877,305,572,102
"63722","E01030116",2011,828,48,780,78
"63723","E01030117",2011,652,53,599,84
"63724","E01030118",2011,654,191,463,61
"63725","E01030119",2011,934,96,838,90
"63726","E01030120",2011,923,74,849,89
"63727","E01030121",2011,889,142,747,102
"63728","E01030122",2011,798,57,741,66
"63729","E01030123",2011,646,244,402,46
"63730","E01030124",2011,731,12,719,117
"63731","E01030125",2011,635,136,499,44
"63732","E01030127",2011,514,4,510,137
"63733","E01030128",2011,610,10,600,154
"63734","E01030129",2011,581,4,577,81
"63735","E01030130",2011,543,129,414,57
"63736","E01030131",2011,507,323,184,25
"63737","E01030132",2011,438,26,412,263
"63738","E01030133",2011,606,78,528,188
"63739","E01030134",2011,470,86,384,66
"63740","E01030135",2011,538,15,523,59
"63741","E01030137",2011,737,55,682,204
"63742","E01030138",2011,975,146,829,126
"63743","E01030139",2011,765,429,336,62
"63744","E01030140",2011,503,137,366,38
"63745","E01030141",2011,638,189,449,64
"63746","E01030142",2011,736,37,699,52
"63747","E01030143",2011,661,146,515,102
"63748","E01030144",2011,535,67,468,34
"63749","E01030145",2011,598,40,558,50
"63750","E01030146",2011,500,89,411,62
"63751","E01030147",2011,681,20,661,63
"63752","E01030148",2011,515,1,514,45
"63753","E01030149",2011,625,10,615,52
"63754","E01030150",2011,909,133,776,101
"63755","E01030151",2011,822,44,778,142
"63756","E01030152",2011,1043,98,945,84
"63757","E01030153",2011,665,120,545,90
"63758","E01030154",2011,877,71,806,106
"63759","E01030155",2011,855,113,742,91
"63760","E01030158",2011,679,5,674,41
"63761","E01030159",2011,648,35,613,97
"63762","E01030160",2011,699,245,454,79
"63763","E01030161",2011,611,130,481,109
"63764","E01030162",2011,634,111,523,203
"63765","E01030163",2011,656,123,533,209
"63766","E01030164",2011,650,17,633,52
"63767","E01030165",2011,762,66,696,232
"63768","E01030166",2011,674,5,669,51
"63769","E01030167",2011,609,18,591,107
"63770","E01030168",2011,662,305,357,73
"63771","E01030169",2011,746,160,586,198
"63772","E01030170",2011,759,310,449,59
"63773","E01030171",2011,784,56,728,97
"63774","E01030172",2011,713,34,679,112
"63775","E01030173",2011,686,157,529,74
"63776","E01030174",2011,545,53,492,81
"63777","E01030175",2011,967,110,857,80
"63778","E01030176",2011,852,87,765,156
"63779","E01030179",2011,1015,104,911,167
"63780","E01030180",2011,553,8,545,70
"63781","E01030181",2011,724,15,709,162
"63782","E01030183",2011,883,5,878,56
"63783","E01030184",2011,818,145,673,50
"63784","E01030185",2011,886,262,624,79
"63785","E01030186",2011,598,82,516,42
"63786","E01030187",2011,656,181,475,82
"63787","E01030188",2011,783,96,687,232
"63788","E01030189",2011,712,186,526,81
"63789","E01030190",2011,806,23,783,68
"63790","E01030191",2011,783,53,730,190
"63791","E01030192",2011,609,2,607,59
"63792","E01030193",2011,677,48,629,65
"63793","E01030194",2011,812,175,637,122
"63794","E01030195",2011,670,11,659,51
"63795","E01030196",2011,677,6,671,99
"63796","E01030197",2011,691,23,668,83
"63797","E01030198",2011,570,43,527,64
"63798","E01030199",2011,836,92,744,140
"63799","E01030200",2011,894,87,807,71
"63800","E01030201",2011,913,93,820,108
"63801","E01030203",2011,948,103,845,98
"63802","E01030204",2011,728,6,722,28
"63803","E01030205",2011,463,2,461,23
"63804","E01030206",2011,634,6,628,34
"63805","E01030207",2011,673,45,628,49
"63806","E01030208",2011,586,125,461,76
"63807","E01030209",2011,763,78,685,108
"63808","E01030210",2011,860,268,592,67
"63809","E01030211",2011,1103,104,999,229
"63810","E01030212",2011,863,78,785,118
"63811","E01030214",2011,531,11,520,87
"63812","E01030215",2011,633,127,506,110
"63813","E01030216",2011,627,13,614,60
"63814","E01030217",2011,564,58,506,55
"63815","E01030218",2011,625,50,575,97
"63816","E01030219",2011,903,83,820,88
"63817","E01030220",2011,959,233,726,86
"63818","E01030221",2011,833,65,768,70
"63819","E01030222",2011,905,69,836,111
"63820","E01030223",2011,816,190,626,122
"63821","E01030224",2011,770,85,685,114
"63822","E01030225",2011,846,61,785,311
"63823","E01030226",2011,774,103,671,97
"63824","E01030227",2011,620,280,340,45
"63825","E01030228",2011,776,78,698,68
"63826","E01030229",2011,949,151,798,97
"63827","E01030230",2011,926,121,805,232
"63828","E01030231",2011,657,151,506,62
"63829","E01030232",2011,682,88,594,63
"63830","E01030233",2011,641,2,639,26
"63831","E01030234",2011,662,147,515,138
"63832","E01030235",2011,631,29,602,47
"63833","E01030236",2011,793,102,691,91
"63834","E01030237",2011,1118,17,1101,136
"63835","E01030238",2011,717,12,705,69
"63836","E01030239",2011,727,19,708,99
"63837","E01030240",2011,745,33,712,98
"63838","E01030241",2011,659,76,583,52
"63839","E01030242",2011,594,7,587,25
"63840","E01030243",2011,656,79,577,79
"63841","E01030244",2011,879,174,705,154
"63842","E01030245",2011,763,63,700,66
"63843","E01030246",2011,609,25,584,190
"63844","E01030247",2011,859,398,461,270
"63845","E01030248",2011,618,59,559,161
"63846","E01030249",2011,747,97,650,277
"63847","E01030250",2011,881,98,783,425
"63848","E01030251",2011,700,40,660,75
"63849","E01030252",2011,815,58,757,89
"63850","E01030253",2011,787,221,566,92
"63851","E01030254",2011,615,67,548,187
"63852","E01030255",2011,503,66,437,77
"63853","E01030256",2011,623,60,563,207
"63854","E01030257",2011,637,103,534,79
"63855","E01030258",2011,809,146,663,415
"63856","E01030259",2011,470,36,434,51
"63857","E01030260",2011,427,12,415,111
"63858","E01030261",2011,606,341,265,54
"63859","E01030262",2011,566,144,422,79
"63860","E01030263",2011,666,86,580,42
"63861","E01030264",2011,612,64,548,177
"63862","E01030265",2011,612,39,573,175
"63863","E01030266",2011,711,122,589,105
"63864","E01030267",2011,570,138,432,30
"63865","E01030268",2011,529,2,527,36
"63866","E01030269",2011,752,15,737,113
"63867","E01030270",2011,683,91,592,127
"63868","E01030271",2011,687,16,671,39
"63869","E01030272",2011,752,16,736,98
"63870","E01030273",2011,739,5,734,60
"63871","E01030274",2011,619,330,289,38
"63872","E01030275",2011,487,30,457,45
"63873","E01030276",2011,590,14,576,168
"63874","E01030277",2011,480,265,215,30
"63875","E01030278",2011,714,100,614,38
"63876","E01030279",2011,591,335,256,41
"63877","E01030280",2011,624,31,593,32
"63878","E01030281",2011,948,201,747,95
"63879","E01030282",2011,661,122,539,64
"63880","E01030283",2011,577,125,452,56
"63881","E01030284",2011,609,17,592,31
"63882","E01030285",2011,925,75,850,80
"63883","E01030286",2011,896,63,833,138
"63884","E01030287",2011,657,156,501,44
"63885","E01030288",2011,619,4,615,19
"63886","E01030289",2011,674,142,532,100
"63887","E01030290",2011,677,31,646,51
"63888","E01030291",2011,589,197,392,47
"63889","E01030292",2011,645,9,636,58
"63890","E01030293",2011,693,36,657,51
"63891","E01030294",2011,641,103,538,55
"63892","E01030295",2011,981,129,852,165
"63893","E01030296",2011,649,5,644,52
"63894","E01030297",2011,823,13,810,111
"63895","E01030298",2011,679,158,521,49
"63896","E01030299",2011,637,85,552,45
"63897","E01030300",2011,756,195,561,155
"63898","E01030301",2011,601,60,541,81
"63899","E01030302",2011,711,25,686,156
"63900","E01030303",2011,690,8,682,81
"63901","E01030304",2011,696,227,469,101
"63902","E01030305",2011,520,9,511,111
"63903","E01030306",2011,481,11,470,83
"63904","E01030307",2011,646,17,629,86
"63905","E01030308",2011,645,36,609,106
"63906","E01030309",2011,619,28,591,95
"63907","E01030310",2011,728,185,543,129
"63908","E01030311",2011,662,186,476,70
"63909","E01030312",2011,518,107,411,57
"63910","E01030313",2011,644,95,549,74
"63911","E01030314",2011,645,78,567,92
"63912","E01030315",2011,636,52,584,62
"63913","E01030316",2011,635,5,630,79
"63914","E01030317",2011,749,97,652,101
"63915","E01030318",2011,644,270,374,77
"63916","E01030319",2011,608,26,582,36
"63917","E01030320",2011,678,39,639,106
"63918","E01030321",2011,573,6,567,35
"63919","E01030322",2011,751,111,640,123
"63920","E01030323",2011,524,50,474,55
"63921","E01030324",2011,639,48,591,57
"63922","E01030325",2011,590,72,518,35
"63923","E01030326",2011,785,44,741,231
"63924","E01030327",2011,642,14,628,138
"63925","E01030328",2011,630,6,624,52
"63926","E01030329",2011,628,2,626,77
"63927","E01030330",2011,655,12,643,91
"63928","E01030331",2011,679,35,644,75
"63929","E01030332",2011,593,130,463,46
"63930","E01030333",2011,582,30,552,76
"63931","E01030334",2011,543,26,517,64
"63932","E01030335",2011,755,116,639,67
"63933","E01030336",2011,795,153,642,88
"63934","E01030337",2011,731,235,496,96
"63935","E01030338",2011,619,11,608,73
"63936","E01030339",2011,683,54,629,167
"63937","E01030340",2011,620,53,567,98
"63938","E01030341",2011,740,4,736,120
"63939","E01030342",2011,613,10,603,74
"63940","E01030343",2011,637,50,587,67
"63941","E01030344",2011,526,6,520,64
"63942","E01030345",2011,646,69,577,48
"63943","E01030346",2011,519,5,514,115
"63944","E01030347",2011,681,58,623,154
"63945","E01030348",2011,664,7,657,150
"63946","E01030349",2011,703,4,699,160
"63947","E01030350",2011,686,30,656,107
"63948","E01030351",2011,634,31,603,76
"63949","E01030352",2011,581,65,516,62
"63950","E01030353",2011,550,5,545,88
"63951","E01030354",2011,541,227,314,61
"63952","E01030355",2011,515,34,481,32
"63953","E01030356",2011,507,39,468,38
"63954","E01030357",2011,729,9,720,126
"63955","E01030358",2011,618,9,609,98
"63956","E01030359",2011,1054,175,879,322
"63957","E01030360",2011,662,14,648,170
"63958","E01030361",2011,811,74,737,80
"63959","E01030362",2011,481,135,346,47
"63960","E01030363",2011,785,191,594,115
"63961","E01030364",2011,710,249,461,128
"63962","E01030365",2011,603,12,591,69
"63963","E01030366",2011,815,34,781,253
"63964","E01030367",2011,618,7,611,97
"63965","E01030368",2011,607,15,592,54
"63966","E01030369",2011,775,17,758,63
"63967","E01030370",2011,592,8,584,65
"63968","E01030371",2011,711,151,560,148
"63969","E01030372",2011,546,71,475,110
"63970","E01030373",2011,657,89,568,85
"63971","E01030374",2011,771,33,738,244
"63972","E01030375",2011,781,52,729,244
"63973","E01030376",2011,536,4,532,133
"63974","E01030377",2011,901,4,897,33
"63975","E01030378",2011,611,11,600,65
"63976","E01030379",2011,502,20,482,57
"63977","E01030380",2011,509,2,507,42
"63978","E01030381",2011,646,65,581,126
"63979","E01030382",2011,591,23,568,141
"63980","E01030383",2011,903,280,623,99
"63981","E01030384",2011,980,106,874,201
"63982","E01030385",2011,684,308,376,79
"63983","E01030386",2011,533,0,533,25
"63984","E01030387",2011,643,15,628,85
"63985","E01030388",2011,520,15,505,45
"63986","E01030389",2011,670,101,569,122
"63987","E01030390",2011,811,128,683,122
"63988","E01030391",2011,829,49,780,168
"63989","E01030392",2011,799,11,788,117
"63990","E01030393",2011,821,46,775,91
"63991","E01030394",2011,636,6,630,33
"63992","E01030395",2011,763,4,759,46
"63993","E01030396",2011,646,5,641,39
"63994","E01030398",2011,626,9,617,11
"63995","E01030399",2011,911,132,779,93
"63996","E01030400",2011,599,277,322,37
"63997","E01030401",2011,1015,25,990,105
"63998","E01030402",2011,481,76,405,50
"63999","E01030403",2011,591,25,566,71
"64000","E01030404",2011,626,8,618,56
"64001","E01030405",2011,650,41,609,66
"64002","E01030406",2011,613,34,579,104
"64003","E01030407",2011,537,1,536,25
"64004","E01030408",2011,641,2,639,10
"64005","E01030409",2011,524,16,508,140
"64006","E01030410",2011,592,36,556,187
"64007","E01030411",2011,1077,162,915,404
"64008","E01030412",2011,961,43,918,321
"64009","E01030413",2011,743,85,658,100
"64010","E01030414",2011,524,71,453,35
"64011","E01030415",2011,607,12,595,54
"64012","E01030416",2011,525,9,516,43
"64013","E01030417",2011,523,1,522,54
"64014","E01030418",2011,566,9,557,45
"64015","E01030419",2011,708,31,677,142
"64016","E01030420",2011,489,84,405,59
"64017","E01030421",2011,617,15,602,35
"64018","E01030422",2011,650,99,551,58
"64019","E01030423",2011,712,144,568,43
"64020","E01030424",2011,661,215,446,45
"64021","E01030425",2011,657,10,647,45
"64022","E01030426",2011,614,108,506,80
"64023","E01030427",2011,610,12,598,43
"64024","E01030428",2011,510,20,490,63
"64025","E01030429",2011,718,21,697,193
"64026","E01030430",2011,627,8,619,76
"64027","E01030431",2011,627,43,584,39
"64028","E01030432",2011,630,172,458,53
"64029","E01030433",2011,694,221,473,59
"64030","E01030434",2011,738,7,731,216
"64031","E01030435",2011,647,51,596,44
"64032","E01030436",2011,982,8,974,203
"64033","E01030437",2011,694,16,678,105
"64034","E01030438",2011,730,59,671,182
"64035","E01030439",2011,639,7,632,68
"64036","E01030440",2011,617,94,523,48
"64037","E01030441",2011,514,32,482,43
"64038","E01030442",2011,557,2,555,13
"64039","E01030443",2011,534,2,532,32
"64040","E01030444",2011,597,29,568,39
"64041","E01030445",2011,606,72,534,74
"64042","E01030446",2011,508,2,506,48
"64043","E01030447",2011,546,54,492,33
"64044","E01030448",2011,614,2,612,92
"64045","E01030449",2011,674,116,558,183
"64046","E01030450",2011,993,107,886,344
"64047","E01030451",2011,864,191,673,311
"64048","E01030452",2011,834,103,731,290
"64049","E01030453",2011,774,12,762,353
"64050","E01030454",2011,729,66,663,143
"64051","E01030455",2011,836,101,735,345
"64052","E01030456",2011,542,7,535,43
"64053","E01030457",2011,780,106,674,360
"64054","E01030458",2011,524,10,514,113
"64055","E01030459",2011,485,105,380,70
"64056","E01030460",2011,633,36,597,52
"64057","E01030461",2011,651,14,637,67
"64058","E01030462",2011,746,130,616,122
"64059","E01030463",2011,628,22,606,101
"64060","E01030464",2011,645,238,407,57
"64061","E01030465",2011,584,76,508,47
"64062","E01030466",2011,726,34,692,52
"64063","E01030467",2011,633,7,626,55
"64064","E01030468",2011,497,112,385,172
"64065","E01030469",2011,508,115,393,61
"64066","E01030470",2011,514,45,469,142
"64067","E01030471",2011,482,7,475,61
"64068","E01030472",2011,508,62,446,84
"64069","E01030473",2011,655,37,618,118
"64070","E01030474",2011,446,72,374,315
"64071","E01030475",2011,505,12,493,27
"64072","E01030476",2011,456,4,452,18
"64073","E01030477",2011,704,138,566,60
"64074","E01030478",2011,686,83,603,77
"64075","E01030479",2011,759,201,558,58
"64076","E01030480",2011,785,36,749,72
"64077","E01030481",2011,632,185,447,71
"64078","E01030482",2011,513,129,384,61
"64079","E01030483",2011,587,328,259,47
"64080","E01030484",2011,668,207,461,95
"64081","E01030485",2011,741,95,646,184
"64082","E01030486",2011,611,15,596,72
"64083","E01030487",2011,638,12,626,163
"64084","E01030488",2011,780,139,641,73
"64085","E01030489",2011,947,87,860,128
"64086","E01030490",2011,662,40,622,102
"64087","E01030491",2011,789,132,657,157
"64088","E01030492",2011,796,34,762,61
"64089","E01030493",2011,510,211,299,63
"64090","E01030494",2011,651,255,396,85
"64091","E01030495",2011,643,51,592,161
"64092","E01030496",2011,597,299,298,93
"64093","E01030497",2011,606,377,229,86
"64094","E01030498",2011,510,11,499,61
"64095","E01030499",2011,645,16,629,38
"64096","E01030500",2011,605,28,577,86
"64097","E01030501",2011,642,51,591,51
"64098","E01030502",2011,500,46,454,39
"64099","E01030503",2011,572,225,347,75
"64100","E01030504",2011,492,5,487,25
"64101","E01030505",2011,630,106,524,46
"64102","E01030506",2011,486,6,480,9
"64103","E01030507",2011,501,5,496,57
"64104","E01030508",2011,513,19,494,18
"64105","E01030509",2011,519,75,444,74
"64106","E01030510",2011,622,38,584,34
"64107","E01030511",2011,545,12,533,23
"64108","E01030512",2011,664,48,616,71
"64109","E01030513",2011,520,81,439,26
"64110","E01030514",2011,639,64,575,69
"64111","E01030515",2011,863,147,716,67
"64112","E01030516",2011,644,207,437,82
"64113","E01030517",2011,634,8,626,54
"64114","E01030518",2011,544,7,537,12
"64115","E01030519",2011,622,117,505,34
"64116","E01030520",2011,655,172,483,39
"64117","E01030521",2011,684,46,638,98
"64118","E01030522",2011,524,5,519,25
"64119","E01030523",2011,533,36,497,42
"64120","E01030524",2011,1013,43,970,142
"64121","E01030525",2011,643,30,613,37
"64122","E01030526",2011,548,83,465,48
"64123","E01030527",2011,662,59,603,117
"64124","E01030528",2011,597,58,539,57
"64125","E01030529",2011,684,124,560,69
"64126","E01030530",2011,497,43,454,37
"64127","E01030531",2011,911,94,817,104
"64128","E01030532",2011,639,18,621,103
"64129","E01030533",2011,517,33,484,40
"64130","E01030534",2011,686,135,551,149
"64131","E01030535",2011,802,63,739,183
"64132","E01030536",2011,786,108,678,111
"64133","E01030537",2011,745,136,609,60
"64134","E01030538",2011,692,113,579,181
"64135","E01030539",2011,694,94,600,83
"64136","E01030540",2011,814,5,809,28
"64137","E01030541",2011,515,2,513,12
"64138","E01030542",2011,485,5,480,21
"64139","E01030543",2011,604,18,586,50
"64140","E01030544",2011,643,59,584,77
"64141","E01030545",2011,695,59,636,100
"64142","E01030546",2011,679,200,479,41
"64143","E01030547",2011,686,402,284,55
"64144","E01030548",2011,709,119,590,149
"64145","E01030549",2011,826,100,726,213
"64146","E01030550",2011,958,268,690,222
"64147","E01030551",2011,684,311,373,53
"64148","E01030552",2011,680,17,663,199
"64149","E01030553",2011,786,96,690,104
"64150","E01030554",2011,447,4,443,29
"64151","E01030555",2011,680,57,623,163
"64152","E01030556",2011,804,35,769,111
"64153","E01030557",2011,757,55,702,145
"64154","E01030558",2011,918,128,790,97
"64155","E01030559",2011,503,17,486,33
"64156","E01030560",2011,764,34,730,135
"64157","E01030561",2011,591,55,536,43
"64158","E01030562",2011,567,91,476,53
"64159","E01030563",2011,408,2,406,13
"64160","E01030564",2011,516,56,460,18
"64161","E01030565",2011,567,80,487,36
"64162","E01030566",2011,550,20,530,24
"64163","E01030567",2011,615,18,597,44
"64164","E01030568",2011,568,13,555,34
"64165","E01030569",2011,1025,108,917,127
"64166","E01030570",2011,643,85,558,87
"64167","E01030571",2011,600,23,577,50
"64168","E01030572",2011,872,236,636,140
"64169","E01030573",2011,719,59,660,95
"64170","E01030574",2011,719,46,673,156
"64171","E01030575",2011,975,57,918,298
"64172","E01030576",2011,664,38,626,155
"64173","E01030577",2011,734,31,703,193
"64174","E01030578",2011,611,232,379,53
"64175","E01030579",2011,603,43,560,119
"64176","E01030580",2011,764,55,709,149
"64177","E01030581",2011,493,5,488,35
"64178","E01030582",2011,523,3,520,172
"64179","E01030583",2011,556,3,553,29
"64180","E01030584",2011,636,27,609,32
"64181","E01030585",2011,627,37,590,46
"64182","E01030586",2011,654,130,524,67
"64183","E01030587",2011,603,104,499,45
"64184","E01030588",2011,614,230,384,64
"64185","E01030589",2011,646,5,641,50
"64186","E01030590",2011,740,17,723,69
"64187","E01030591",2011,538,45,493,17
"64188","E01030592",2011,843,80,763,103
"64189","E01030593",2011,594,69,525,106
"64190","E01030594",2011,704,211,493,55
"64191","E01030595",2011,603,72,531,59
"64192","E01030596",2011,518,16,502,29
"64193","E01030597",2011,616,8,608,79
"64194","E01030598",2011,651,67,584,105
"64195","E01030599",2011,670,388,282,38
"64196","E01030600",2011,603,115,488,55
"64197","E01030601",2011,591,190,401,31
"64198","E01030602",2011,710,38,672,87
"64199","E01030603",2011,549,8,541,17
"64200","E01030604",2011,636,84,552,63
"64201","E01030605",2011,528,35,493,45
"64202","E01030606",2011,507,6,501,30
"64203","E01030607",2011,668,18,650,22
"64204","E01030608",2011,587,230,357,36
"64205","E01030609",2011,589,179,410,45
"64206","E01030610",2011,543,113,430,80
"64207","E01030611",2011,1097,87,1010,235
"64208","E01030612",2011,1182,33,1149,423
"64209","E01030613",2011,856,47,809,363
"64210","E01030614",2011,606,29,577,56
"64211","E01030615",2011,650,261,389,194
"64212","E01030616",2011,685,14,671,70
"64213","E01030617",2011,697,53,644,116
"64214","E01030618",2011,765,128,637,136
"64215","E01030619",2011,624,290,334,44
"64216","E01030620",2011,792,53,739,190
"64217","E01030621",2011,644,200,444,67
"64218","E01030622",2011,776,46,730,194
"64219","E01030623",2011,904,20,884,133
"64220","E01030624",2011,523,10,513,77
"64221","E01030625",2011,470,8,462,40
"64222","E01030626",2011,442,1,441,66
"64223","E01030627",2011,846,5,841,266
"64224","E01030628",2011,561,34,527,35
"64225","E01030629",2011,514,8,506,64
"64226","E01030630",2011,629,110,519,36
"64227","E01030631",2011,649,199,450,57
"64228","E01030632",2011,532,15,517,47
"64229","E01030633",2011,564,154,410,60
"64230","E01030634",2011,576,252,324,35
"64231","E01030635",2011,643,32,611,81
"64232","E01030636",2011,449,40,409,11
"64233","E01030637",2011,458,4,454,19
"64234","E01030638",2011,602,4,598,40
"64235","E01030639",2011,646,20,626,76
"64236","E01030640",2011,722,289,433,40
"64237","E01030641",2011,625,47,578,32
"64238","E01030642",2011,650,53,597,46
"64239","E01030643",2011,621,114,507,33
"64240","E01030644",2011,505,13,492,21
"64241","E01030645",2011,911,330,581,106
"64242","E01030646",2011,928,18,910,180
"64243","E01030647",2011,763,18,745,80
"64244","E01030648",2011,628,40,588,62
"64245","E01030649",2011,807,79,728,198
"64246","E01030650",2011,519,147,372,49
"64247","E01030651",2011,562,52,510,55
"64248","E01030652",2011,708,83,625,92
"64249","E01030653",2011,633,148,485,124
"64250","E01030654",2011,622,42,580,102
"64251","E01030655",2011,688,82,606,57
"64252","E01030656",2011,588,161,427,45
"64253","E01030657",2011,648,315,333,69
"64254","E01030658",2011,738,20,718,103
"64255","E01030659",2011,737,77,660,126
"64256","E01030660",2011,799,53,746,64
"64257","E01030661",2011,669,10,659,30
"64258","E01030662",2011,607,77,530,48
"64259","E01030663",2011,642,209,433,49
"64260","E01030664",2011,706,274,432,76
"64261","E01030665",2011,624,100,524,126
"64262","E01030666",2011,741,42,699,137
"64263","E01030667",2011,751,191,560,220
"64264","E01030668",2011,869,37,832,278
"64265","E01030669",2011,599,75,524,158
"64266","E01030670",2011,490,20,470,133
"64267","E01030671",2011,424,27,397,150
"64268","E01030672",2011,789,21,768,194
"64269","E01030673",2011,426,14,412,98
"64270","E01030674",2011,651,275,376,138
"64271","E01030675",2011,547,101,446,156
"64272","E01030676",2011,496,226,270,153
"64273","E01030677",2011,677,147,530,103
"64274","E01030678",2011,583,149,434,82
"64275","E01030679",2011,480,3,477,71
"64276","E01030680",2011,634,15,619,53
"64277","E01030681",2011,650,55,595,46
"64278","E01030682",2011,515,24,491,53
"64279","E01030683",2011,551,27,524,67
"64280","E01030684",2011,651,98,553,100
"64281","E01030685",2011,511,13,498,51
"64282","E01030686",2011,589,3,586,65
"64283","E01030687",2011,483,11,472,54
"64284","E01030688",2011,604,46,558,41
"64285","E01030689",2011,575,22,553,114
"64286","E01030690",2011,662,38,624,143
"64287","E01030691",2011,600,14,586,73
"64288","E01030692",2011,486,4,482,68
"64289","E01030693",2011,507,26,481,20
"64290","E01030694",2011,530,97,433,37
"64291","E01030695",2011,496,9,487,19
"64292","E01030696",2011,620,45,575,58
"64293","E01030697",2011,639,12,627,63
"64294","E01030698",2011,655,34,621,53
"64295","E01030699",2011,627,81,546,45
"64296","E01030700",2011,778,71,707,141
"64297","E01030701",2011,625,58,567,70
"64298","E01030702",2011,489,157,332,67
"64299","E01030703",2011,627,30,597,55
"64300","E01030704",2011,647,52,595,95
"64301","E01030705",2011,643,13,630,59
"64302","E01030706",2011,553,11,542,57
"64303","E01030707",2011,674,24,650,162
"64304","E01030708",2011,618,43,575,68
"64305","E01030709",2011,562,97,465,67
"64306","E01030710",2011,648,174,474,67
"64307","E01030711",2011,638,188,450,77
"64308","E01030712",2011,545,8,537,109
"64309","E01030713",2011,489,13,476,51
"64310","E01030714",2011,476,13,463,34
"64311","E01030715",2011,600,10,590,64
"64312","E01030716",2011,593,31,562,36
"64313","E01030717",2011,730,56,674,88
"64314","E01030718",2011,506,55,451,30
"64315","E01030719",2011,619,112,507,29
"64316","E01030720",2011,641,90,551,30
"64317","E01030721",2011,619,82,537,45
"64318","E01030722",2011,656,14,642,48
"64319","E01030723",2011,617,35,582,29
"64320","E01030724",2011,647,175,472,34
"64321","E01030725",2011,787,87,700,208
"64322","E01030726",2011,638,15,623,21
"64323","E01030727",2011,862,39,823,164
"64324","E01030728",2011,723,4,719,57
"64325","E01030729",2011,623,111,512,43
"64326","E01030730",2011,783,4,779,62
"64327","E01030731",2011,767,29,738,74
"64328","E01030732",2011,689,16,673,79
"64329","E01030733",2011,808,34,774,170
"64330","E01030734",2011,551,38,513,74
"64331","E01030735",2011,670,41,629,153
"64332","E01030736",2011,937,64,873,459
"64333","E01030737",2011,681,125,556,159
"64334","E01030738",2011,689,150,539,140
"64335","E01030739",2011,690,235,455,38
"64336","E01030740",2011,745,242,503,46
"64337","E01030741",2011,654,94,560,68
"64338","E01030742",2011,810,53,757,84
"64339","E01030743",2011,651,112,539,75
"64340","E01030744",2011,844,330,514,128
"64341","E01030745",2011,577,205,372,53
"64342","E01030746",2011,628,176,452,66
"64343","E01030747",2011,550,37,513,102
"64344","E01030748",2011,669,83,586,80
"64345","E01030749",2011,608,202,406,47
"64346","E01030750",2011,618,136,482,70
"64347","E01030751",2011,653,90,563,105
"64348","E01030752",2011,615,223,392,89
"64349","E01030753",2011,746,46,700,113
"64350","E01030754",2011,625,20,605,45
"64351","E01030755",2011,794,122,672,96
"64352","E01030756",2011,666,9,657,63
"64353","E01030757",2011,675,14,661,134
"64354","E01030758",2011,439,15,424,53
"64355","E01030759",2011,725,218,507,79
"64356","E01030760",2011,493,18,475,37
"64357","E01030761",2011,575,19,556,25
"64358","E01030762",2011,735,11,724,90
"64359","E01030763",2011,509,20,489,43
"64360","E01030764",2011,506,2,504,45
"64361","E01030765",2011,601,142,459,36
"64362","E01030766",2011,662,86,576,102
"64363","E01030767",2011,609,186,423,59
"64364","E01030768",2011,513,89,424,31
"64365","E01030769",2011,570,6,564,34
"64366","E01030770",2011,616,3,613,64
"64367","E01030771",2011,485,4,481,48
"64368","E01030772",2011,623,103,520,60
"64369","E01030773",2011,542,13,529,53
"64370","E01030774",2011,531,4,527,87
"64371","E01030775",2011,556,2,554,43
"64372","E01030776",2011,616,5,611,43
"64373","E01030777",2011,641,39,602,83
"64374","E01030778",2011,741,6,735,66
"64375","E01030779",2011,745,6,739,47
"64376","E01030780",2011,652,8,644,75
"64377","E01030781",2011,640,96,544,57
"64378","E01030782",2011,659,92,567,58
"64379","E01030783",2011,636,20,616,78
"64380","E01030784",2011,803,69,734,309
"64381","E01030785",2011,640,7,633,64
"64382","E01030786",2011,754,339,415,57
"64383","E01030787",2011,528,169,359,29
"64384","E01030788",2011,487,247,240,22
"64385","E01030789",2011,562,6,556,41
"64386","E01030790",2011,663,57,606,55
"64387","E01030791",2011,643,3,640,47
"64388","E01030792",2011,492,1,491,37
"64389","E01030793",2011,608,240,368,123
"64390","E01030794",2011,613,44,569,125
"64391","E01030795",2011,960,71,889,212
"64392","E01030796",2011,522,1,521,36
"64393","E01030797",2011,519,1,518,53
"64394","E01030798",2011,547,9,538,37
"64395","E01030799",2011,501,2,499,38
"64396","E01030800",2011,699,23,676,216
"64397","E01030801",2011,638,105,533,228
"64398","E01030802",2011,672,18,654,123
"64399","E01030803",2011,656,100,556,145
"64400","E01030804",2011,668,13,655,65
"64401","E01030805",2011,606,212,394,43
"64402","E01030806",2011,544,9,535,26
"64403","E01030807",2011,510,33,477,37
"64404","E01030808",2011,634,5,629,79
"64405","E01030809",2011,643,64,579,84
"64406","E01030810",2011,542,7,535,49
"64407","E01030811",2011,597,7,590,63
"64408","E01030812",2011,633,166,467,68
"64409","E01030813",2011,652,55,597,81
"64410","E01030814",2011,473,63,410,45
"64411","E01030815",2011,603,96,507,59
"64412","E01030816",2011,609,39,570,84
"64413","E01030817",2011,582,23,559,49
"64414","E01030818",2011,522,111,411,54
"64415","E01030819",2011,609,10,599,94
"64416","E01030820",2011,644,10,634,21
"64417","E01030821",2011,772,94,678,115
"64418","E01030822",2011,678,9,669,76
"64419","E01030823",2011,829,55,774,52
"64420","E01030824",2011,612,172,440,63
"64421","E01030825",2011,594,56,538,71
"64422","E01030826",2011,567,103,464,32
"64423","E01030827",2011,613,70,543,55
"64424","E01030828",2011,494,4,490,67
"64425","E01030829",2011,672,59,613,138
"64426","E01030830",2011,513,7,506,55
"64427","E01030831",2011,875,21,854,94
"64428","E01030832",2011,555,44,511,60
"64429","E01030833",2011,602,106,496,70
"64430","E01030834",2011,566,128,438,41
"64431","E01030835",2011,581,37,544,49
"64432","E01030836",2011,728,127,601,121
"64433","E01030837",2011,549,39,510,60
"64434","E01030838",2011,507,36,471,66
"64435","E01030839",2011,546,15,531,52
"64436","E01030840",2011,572,118,454,41
"64437","E01030841",2011,489,20,469,20
"64438","E01030842",2011,687,190,497,42
"64439","E01030843",2011,610,169,441,64
"64440","E01030844",2011,679,55,624,46
"64441","E01030845",2011,497,63,434,35
"64442","E01030846",2011,550,31,519,28
"64443","E01030847",2011,698,94,604,59
"64444","E01030848",2011,851,65,786,124
"64445","E01030850",2011,1031,107,924,207
"64446","E01030851",2011,811,123,688,75
"64447","E01030852",2011,801,194,607,86
"64448","E01030853",2011,703,60,643,60
"64449","E01030854",2011,804,38,766,46
"64450","E01030855",2011,753,9,744,52
"64451","E01030856",2011,613,25,588,53
"64452","E01030857",2011,876,224,652,79
"64453","E01030858",2011,871,86,785,123
"64454","E01030859",2011,848,40,808,143
"64455","E01030860",2011,935,76,859,246
"64456","E01030861",2011,744,17,727,79
"64457","E01030862",2011,861,85,776,77
"64458","E01030863",2011,748,34,714,56
"64459","E01030864",2011,545,23,522,91
"64460","E01030865",2011,622,174,448,76
"64461","E01030866",2011,629,14,615,58
"64462","E01030867",2011,596,66,530,56
"64463","E01030868",2011,487,35,452,33
"64464","E01030869",2011,477,92,385,47
"64465","E01030870",2011,645,7,638,32
"64466","E01030871",2011,658,73,585,38
"64467","E01030872",2011,812,302,510,56
"64468","E01030873",2011,608,82,526,53
"64469","E01030874",2011,511,22,489,80
"64470","E01030875",2011,601,55,546,152
"64471","E01030876",2011,537,0,537,39
"64472","E01030877",2011,517,132,385,55
"64473","E01030878",2011,635,33,602,44
"64474","E01030879",2011,459,17,442,54
"64475","E01030880",2011,814,84,730,45
"64476","E01030881",2011,544,3,541,30
"64477","E01030882",2011,519,5,514,36
"64478","E01030883",2011,522,27,495,47
"64479","E01030884",2011,707,187,520,136
"64480","E01030885",2011,682,101,581,193
"64481","E01030886",2011,490,37,453,41
"64482","E01030887",2011,529,47,482,42
"64483","E01030888",2011,627,37,590,111
"64484","E01030889",2011,634,157,477,85
"64485","E01030890",2011,647,106,541,54
"64486","E01030891",2011,637,6,631,51
"64487","E01030892",2011,522,4,518,84
"64488","E01030893",2011,777,150,627,112
"64489","E01030894",2011,597,4,593,34
"64490","E01030895",2011,640,164,476,169
"64491","E01030896",2011,514,158,356,59
"64492","E01030897",2011,522,48,474,36
"64493","E01030898",2011,626,5,621,49
"64494","E01030899",2011,672,10,662,50
"64495","E01030900",2011,501,49,452,26
"64496","E01030901",2011,512,225,287,51
"64497","E01030902",2011,534,17,517,37
"64498","E01030903",2011,670,46,624,82
"64499","E01030904",2011,639,135,504,37
"64500","E01030905",2011,606,115,491,76
"64501","E01030906",2011,709,53,656,73
"64502","E01030907",2011,471,7,464,28
"64503","E01030908",2011,590,13,577,59
"64504","E01030909",2011,499,50,449,43
"64505","E01030910",2011,494,87,407,31
"64506","E01030911",2011,618,103,515,43
"64507","E01030912",2011,547,189,358,28
"64508","E01030913",2011,506,214,292,26
"64509","E01030914",2011,531,198,333,72
"64510","E01030915",2011,654,137,517,38
"64511","E01030916",2011,799,29,770,271
"64512","E01030917",2011,518,11,507,160
"64513","E01030918",2011,536,66,470,130
"64514","E01030919",2011,521,4,517,60
"64515","E01030920",2011,636,50,586,124
"64516","E01030921",2011,834,210,624,140
"64517","E01030922",2011,621,12,609,107
"64518","E01030923",2011,558,17,541,48
"64519","E01030924",2011,504,3,501,52
"64520","E01030925",2011,571,18,553,23
"64521","E01030926",2011,604,66,538,41
"64522","E01030927",2011,528,117,411,36
"64523","E01030928",2011,819,143,676,204
"64524","E01030929",2011,494,12,482,56
"64525","E01030930",2011,642,28,614,59
"64526","E01030931",2011,761,53,708,98
"64527","E01030932",2011,591,121,470,30
"64528","E01030933",2011,772,190,582,79
"64529","E01030934",2011,568,88,480,73
"64530","E01030935",2011,505,18,487,44
"64531","E01030937",2011,653,76,577,82
"64532","E01030938",2011,621,162,459,57
"64533","E01030939",2011,468,36,432,19
"64534","E01030940",2011,731,83,648,56
"64535","E01030941",2011,488,18,470,31
"64536","E01030942",2011,557,30,527,66
"64537","E01030943",2011,514,140,374,37
"64538","E01030944",2011,497,9,488,53
"64539","E01030945",2011,463,9,454,54
"64540","E01030946",2011,607,219,388,52
"64541","E01030947",2011,532,25,507,31
"64542","E01030948",2011,620,17,603,68
"64543","E01030949",2011,705,64,641,99
"64544","E01030950",2011,710,53,657,65
"64545","E01030951",2011,611,43,568,123
"64546","E01030952",2011,602,380,222,52
"64547","E01030953",2011,650,24,626,97
"64548","E01030954",2011,979,76,903,383
"64549","E01030955",2011,578,5,573,82
"64550","E01030956",2011,509,92,417,58
"64551","E01030957",2011,493,133,360,39
"64552","E01030958",2011,609,19,590,86
"64553","E01030959",2011,471,52,419,48
"64554","E01030960",2011,742,73,669,90
"64555","E01030961",2011,717,30,687,42
"64556","E01030962",2011,768,317,451,88
"64557","E01030963",2011,530,5,525,15
"64558","E01030964",2011,741,65,676,164
"64559","E01030965",2011,556,10,546,44
"64560","E01030966",2011,507,36,471,32
"64561","E01030967",2011,631,18,613,48
"64562","E01030968",2011,533,135,398,63
"64563","E01030969",2011,539,8,531,59
"64564","E01030970",2011,628,125,503,111
"64565","E01030971",2011,737,196,541,36
"64566","E01030972",2011,688,97,591,83
"64567","E01030973",2011,694,153,541,56
"64568","E01030974",2011,629,115,514,88
"64569","E01030975",2011,554,24,530,62
"64570","E01030976",2011,631,17,614,74
"64571","E01030977",2011,693,73,620,83
"64572","E01030978",2011,510,59,451,27
"64573","E01030979",2011,832,90,742,190
"64574","E01030980",2011,556,82,474,206
"64575","E01030981",2011,464,112,352,67
"64576","E01030982",2011,596,100,496,120
"64577","E01030983",2011,681,155,526,263
"64578","E01030984",2011,694,227,467,63
"64579","E01030985",2011,627,373,254,58
"64580","E01030986",2011,449,4,445,28
"64581","E01030987",2011,524,9,515,38
"64582","E01030988",2011,821,14,807,311
"64583","E01030989",2011,604,41,563,108
"64584","E01030990",2011,581,40,541,69
"64585","E01030991",2011,1031,24,1007,361
"64586","E01030992",2011,698,9,689,156
"64587","E01030993",2011,1216,97,1119,603
"64588","E01030994",2011,687,115,572,81
"64589","E01030995",2011,549,130,419,63
"64590","E01030996",2011,577,6,571,23
"64591","E01030997",2011,690,26,664,45
"64592","E01030998",2011,718,3,715,40
"64593","E01030999",2011,495,3,492,31
"64594","E01031000",2011,655,26,629,87
"64595","E01031001",2011,738,123,615,107
"64596","E01031002",2011,678,4,674,54
"64597","E01031003",2011,648,4,644,103
"64598","E01031004",2011,994,111,883,256
"64599","E01031005",2011,578,132,446,71
"64600","E01031006",2011,635,89,546,91
"64601","E01031007",2011,489,21,468,36
"64602","E01031008",2011,578,148,430,71
"64603","E01031009",2011,971,129,842,164
"64604","E01031010",2011,847,377,470,209
"64605","E01031011",2011,788,48,740,79
"64606","E01031012",2011,631,204,427,32
"64607","E01031013",2011,484,7,477,60
"64608","E01031014",2011,505,29,476,28
"64609","E01031015",2011,598,309,289,39
"64610","E01031016",2011,678,167,511,54
"64611","E01031017",2011,524,23,501,45
"64612","E01031018",2011,461,28,433,76
"64613","E01031019",2011,668,42,626,47
"64614","E01031020",2011,700,14,686,128
"64615","E01031021",2011,779,182,597,123
"64616","E01031022",2011,687,41,646,89
"64617","E01031023",2011,639,22,617,46
"64618","E01031024",2011,675,35,640,68
"64619","E01031025",2011,690,117,573,86
"64620","E01031026",2011,596,154,442,109
"64621","E01031027",2011,580,24,556,61
"64622","E01031028",2011,761,78,683,169
"64623","E01031029",2011,578,41,537,50
"64624","E01031030",2011,984,205,779,101
"64625","E01031031",2011,1015,197,818,90
"64626","E01031032",2011,528,103,425,101
"64627","E01031033",2011,783,158,625,52
"64628","E01031034",2011,767,22,745,41
"64629","E01031035",2011,749,79,670,81
"64630","E01031036",2011,619,55,564,52
"64631","E01031037",2011,645,153,492,68
"64632","E01031038",2011,751,90,661,45
"64633","E01031039",2011,656,13,643,35
"64634","E01031040",2011,754,75,679,96
"64635","E01031041",2011,720,22,698,66
"64636","E01031042",2011,721,86,635,54
"64637","E01031043",2011,906,349,557,225
"64638","E01031044",2011,752,157,595,170
"64639","E01031045",2011,763,97,666,142
"64640","E01031046",2011,716,74,642,266
"64641","E01031047",2011,845,59,786,304
"64642","E01031048",2011,511,4,507,74
"64643","E01031049",2011,929,99,830,150
"64644","E01031050",2011,776,67,709,188
"64645","E01031051",2011,581,18,563,32
"64646","E01031052",2011,639,33,606,204
"64647","E01031053",2011,713,249,464,112
"64648","E01031054",2011,661,112,549,67
"64649","E01031055",2011,664,61,603,101
"64650","E01031056",2011,615,133,482,62
"64651","E01031057",2011,687,430,257,58
"64652","E01031058",2011,623,125,498,56
"64653","E01031059",2011,637,55,582,136
"64654","E01031060",2011,635,98,537,60
"64655","E01031061",2011,602,76,526,85
"64656","E01031062",2011,494,40,454,14
"64657","E01031063",2011,660,277,383,37
"64658","E01031064",2011,571,154,417,68
"64659","E01031065",2011,623,115,508,63
"64660","E01031066",2011,637,273,364,57
"64661","E01031067",2011,733,209,524,76
"64662","E01031068",2011,739,27,712,41
"64663","E01031069",2011,667,2,665,38
"64664","E01031070",2011,655,5,650,44
"64665","E01031073",2011,821,103,718,109
"64666","E01031074",2011,723,138,585,160
"64667","E01031075",2011,709,232,477,95
"64668","E01031077",2011,612,104,508,74
"64669","E01031078",2011,811,8,803,98
"64670","E01031079",2011,642,115,527,41
"64671","E01031080",2011,669,110,559,109
"64672","E01031081",2011,655,107,548,99
"64673","E01031082",2011,504,8,496,30
"64674","E01031083",2011,626,20,606,58
"64675","E01031084",2011,868,9,859,142
"64676","E01031085",2011,523,2,521,24
"64677","E01031086",2011,773,52,721,87
"64678","E01031087",2011,890,182,708,98
"64679","E01031088",2011,772,104,668,87
"64680","E01031089",2011,639,6,633,39
"64681","E01031090",2011,620,278,342,60
"64682","E01031091",2011,599,22,577,83
"64683","E01031092",2011,622,132,490,125
"64684","E01031093",2011,538,27,511,57
"64685","E01031094",2011,506,28,478,107
"64686","E01031095",2011,496,101,395,74
"64687","E01031096",2011,600,41,559,127
"64688","E01031097",2011,751,284,467,75
"64689","E01031098",2011,559,15,544,88
"64690","E01031099",2011,935,26,909,173
"64691","E01031100",2011,503,5,498,22
"64692","E01031101",2011,516,3,513,32
"64693","E01031102",2011,582,33,549,96
"64694","E01031103",2011,490,6,484,16
"64695","E01031104",2011,642,3,639,22
"64696","E01031105",2011,590,5,585,74
"64697","E01031106",2011,624,77,547,44
"64698","E01031107",2011,469,12,457,57
"64699","E01031108",2011,545,14,531,41
"64700","E01031109",2011,738,199,539,77
"64701","E01031110",2011,655,9,646,60
"64702","E01031111",2011,412,1,411,15
"64703","E01031112",2011,661,2,659,61
"64704","E01031113",2011,607,3,604,31
"64705","E01031114",2011,745,247,498,52
"64706","E01031115",2011,713,101,612,175
"64707","E01031116",2011,719,382,337,56
"64708","E01031117",2011,589,184,405,46
"64709","E01031118",2011,483,127,356,36
"64710","E01031119",2011,731,229,502,126
"64711","E01031120",2011,585,3,582,56
"64712","E01031121",2011,454,1,453,11
"64713","E01031122",2011,623,3,620,33
"64714","E01031123",2011,507,1,506,18
"64715","E01031124",2011,638,1,637,24
"64716","E01031125",2011,658,7,651,92
"64717","E01031127",2011,624,256,368,58
"64718","E01031129",2011,510,61,449,44
"64719","E01031130",2011,764,38,726,264
"64720","E01031131",2011,687,41,646,264
"64721","E01031132",2011,867,82,785,346
"64722","E01031133",2011,715,190,525,138
"64723","E01031134",2011,732,8,724,48
"64724","E01031135",2011,777,56,721,46
"64725","E01031136",2011,722,75,647,90
"64726","E01031137",2011,561,76,485,97
"64727","E01031138",2011,450,41,409,41
"64728","E01031139",2011,686,19,667,66
"64729","E01031140",2011,537,52,485,34
"64730","E01031141",2011,749,189,560,163
"64731","E01031142",2011,688,360,328,73
"64732","E01031143",2011,649,9,640,70
"64733","E01031144",2011,576,68,508,169
"64734","E01031145",2011,503,169,334,122
"64735","E01031146",2011,630,192,438,60
"64736","E01031147",2011,671,18,653,37
"64737","E01031148",2011,740,138,602,75
"64738","E01031149",2011,626,39,587,66
"64739","E01031150",2011,493,43,450,29
"64740","E01031151",2011,620,3,617,28
"64741","E01031152",2011,495,24,471,37
"64742","E01031153",2011,589,138,451,44
"64743","E01031154",2011,763,31,732,81
"64744","E01031155",2011,545,1,544,36
"64745","E01031156",2011,647,2,645,52
"64746","E01031157",2011,791,39,752,83
"64747","E01031158",2011,480,8,472,28
"64748","E01031159",2011,691,48,643,48
"64749","E01031160",2011,905,115,790,121
"64750","E01031161",2011,874,64,810,77
"64751","E01031162",2011,732,86,646,79
"64752","E01031163",2011,743,281,462,46
"64753","E01031164",2011,849,46,803,84
"64754","E01031165",2011,690,231,459,60
"64755","E01031166",2011,779,41,738,62
"64756","E01031167",2011,551,48,503,68
"64757","E01031168",2011,1157,278,879,303
"64758","E01031169",2011,923,77,846,275
"64759","E01031170",2011,757,183,574,154
"64760","E01031171",2011,607,107,500,82
"64761","E01031172",2011,735,288,447,82
"64762","E01031173",2011,994,441,553,227
"64763","E01031174",2011,739,185,554,202
"64764","E01031175",2011,575,10,565,42
"64765","E01031176",2011,590,202,388,60
"64766","E01031177",2011,609,221,388,63
"64767","E01031178",2011,643,93,550,60
"64768","E01031179",2011,690,4,686,59
"64769","E01031180",2011,856,100,756,99
"64770","E01031181",2011,728,84,644,45
"64771","E01031182",2011,839,53,786,178
"64772","E01031183",2011,809,41,768,209
"64773","E01031184",2011,650,48,602,84
"64774","E01031185",2011,628,262,366,46
"64775","E01031186",2011,665,232,433,30
"64776","E01031187",2011,813,60,753,81
"64777","E01031188",2011,912,57,855,83
"64778","E01031189",2011,621,107,514,94
"64779","E01031190",2011,669,161,508,49
"64780","E01031191",2011,707,43,664,52
"64781","E01031192",2011,859,34,825,118
"64782","E01031193",2011,948,107,841,125
"64783","E01031194",2011,969,95,874,188
"64784","E01031195",2011,918,103,815,49
"64785","E01031196",2011,975,81,894,119
"64786","E01031197",2011,513,33,480,98
"64787","E01031198",2011,521,77,444,51
"64788","E01031199",2011,598,120,478,58
"64789","E01031200",2011,652,43,609,71
"64790","E01031201",2011,671,24,647,40
"64791","E01031202",2011,788,10,778,135
"64792","E01031203",2011,706,239,467,57
"64793","E01031204",2011,632,17,615,47
"64794","E01031205",2011,659,46,613,95
"64795","E01031206",2011,607,167,440,43
"64796","E01031207",2011,540,104,436,50
"64797","E01031208",2011,881,35,846,65
"64798","E01031209",2011,975,133,842,111
"64799","E01031210",2011,516,36,480,48
"64800","E01031211",2011,449,87,362,39
"64801","E01031212",2011,1105,174,931,179
"64802","E01031213",2011,757,73,684,75
"64803","E01031214",2011,776,47,729,46
"64804","E01031215",2011,865,139,726,138
"64805","E01031216",2011,677,196,481,64
"64806","E01031217",2011,513,50,463,26
"64807","E01031218",2011,452,33,419,67
"64808","E01031219",2011,639,150,489,39
"64809","E01031220",2011,601,68,533,28
"64810","E01031221",2011,695,196,499,49
"64811","E01031222",2011,843,35,808,132
"64812","E01031223",2011,526,73,453,50
"64813","E01031224",2011,455,31,424,70
"64814","E01031225",2011,708,11,697,86
"64815","E01031227",2011,904,89,815,123
"64816","E01031228",2011,713,17,696,86
"64817","E01031229",2011,1005,83,922,383
"64818","E01031230",2011,972,150,822,163
"64819","E01031231",2011,1020,323,697,237
"64820","E01031232",2011,993,72,921,186
"64821","E01031233",2011,731,120,611,127
"64822","E01031234",2011,971,137,834,305
"64823","E01031235",2011,941,65,876,182
"64824","E01031236",2011,650,109,541,66
"64825","E01031237",2011,590,50,540,41
"64826","E01031238",2011,640,265,375,77
"64827","E01031239",2011,688,19,669,115
"64828","E01031240",2011,579,124,455,56
"64829","E01031241",2011,593,64,529,45
"64830","E01031242",2011,653,167,486,68
"64831","E01031243",2011,788,26,762,50
"64832","E01031244",2011,742,63,679,85
"64833","E01031245",2011,544,66,478,49
"64834","E01031246",2011,464,43,421,53
"64835","E01031247",2011,965,124,841,109
"64836","E01031248",2011,913,83,830,77
"64837","E01031249",2011,509,160,349,43
"64838","E01031250",2011,662,27,635,92
"64839","E01031251",2011,504,11,493,15
"64840","E01031252",2011,514,97,417,78
"64841","E01031253",2011,661,172,489,63
"64842","E01031254",2011,624,28,596,51
"64843","E01031255",2011,627,5,622,46
"64844","E01031256",2011,795,28,767,123
"64845","E01031257",2011,666,93,573,135
"64846","E01031258",2011,775,82,693,191
"64847","E01031259",2011,509,16,493,28
"64848","E01031260",2011,512,90,422,35
"64849","E01031261",2011,589,238,351,139
"64850","E01031262",2011,637,190,447,157
"64851","E01031263",2011,641,98,543,243
"64852","E01031264",2011,621,230,391,97
"64853","E01031265",2011,516,151,365,119
"64854","E01031266",2011,861,215,646,404
"64855","E01031267",2011,736,18,718,55
"64856","E01031268",2011,1087,98,989,134
"64857","E01031269",2011,743,62,681,115
"64858","E01031271",2011,874,225,649,166
"64859","E01031272",2011,784,49,735,266
"64860","E01031273",2011,656,417,239,43
"64861","E01031274",2011,621,215,406,55
"64862","E01031275",2011,529,45,484,21
"64863","E01031276",2011,636,251,385,46
"64864","E01031277",2011,642,35,607,61
"64865","E01031278",2011,566,6,560,65
"64866","E01031279",2011,622,69,553,47
"64867","E01031280",2011,524,45,479,48
"64868","E01031281",2011,626,29,597,67
"64869","E01031282",2011,669,84,585,78
"64870","E01031283",2011,526,20,506,95
"64871","E01031284",2011,506,21,485,43
"64872","E01031285",2011,1043,71,972,312
"64873","E01031286",2011,695,249,446,86
"64874","E01031287",2011,583,14,569,40
"64875","E01031288",2011,713,56,657,92
"64876","E01031289",2011,569,29,540,47
"64877","E01031290",2011,833,55,778,297
"64878","E01031291",2011,788,148,640,358
"64879","E01031292",2011,649,9,640,121
"64880","E01031293",2011,702,108,594,148
"64881","E01031294",2011,646,93,553,155
"64882","E01031295",2011,497,14,483,30
"64883","E01031296",2011,718,6,712,121
"64884","E01031297",2011,876,141,735,144
"64885","E01031298",2011,796,19,777,97
"64886","E01031299",2011,560,6,554,21
"64887","E01031300",2011,708,14,694,58
"64888","E01031301",2011,590,4,586,81
"64889","E01031302",2011,434,69,365,37
"64890","E01031303",2011,714,151,563,113
"64891","E01031304",2011,603,52,551,20
"64892","E01031305",2011,654,3,651,16
"64893","E01031306",2011,601,78,523,53
"64894","E01031307",2011,664,8,656,67
"64895","E01031308",2011,850,87,763,192
"64896","E01031309",2011,764,204,560,111
"64897","E01031310",2011,559,50,509,68
"64898","E01031311",2011,569,162,407,45
"64899","E01031312",2011,542,169,373,66
"64900","E01031313",2011,591,10,581,32
"64901","E01031314",2011,605,11,594,66
"64902","E01031315",2011,800,122,678,97
"64903","E01031316",2011,767,129,638,121
"64904","E01031317",2011,749,24,725,144
"64905","E01031318",2011,677,4,673,76
"64906","E01031319",2011,855,62,793,152
"64907","E01031320",2011,632,122,510,123
"64908","E01031321",2011,506,266,240,34
"64909","E01031322",2011,851,124,727,170
"64910","E01031323",2011,805,125,680,188
"64911","E01031324",2011,1245,186,1059,462
"64912","E01031325",2011,617,197,420,67
"64913","E01031327",2011,628,178,450,75
"64914","E01031328",2011,885,46,839,95
"64915","E01031329",2011,985,86,899,155
"64916","E01031330",2011,599,39,560,74
"64917","E01031331",2011,751,35,716,81
"64918","E01031332",2011,519,161,358,86
"64919","E01031333",2011,482,60,422,118
"64920","E01031334",2011,657,94,563,104
"64921","E01031335",2011,627,45,582,251
"64922","E01031336",2011,832,122,710,406
"64923","E01031337",2011,702,98,604,186
"64924","E01031338",2011,497,3,494,39
"64925","E01031339",2011,519,5,514,56
"64926","E01031340",2011,628,2,626,21
"64927","E01031341",2011,629,175,454,109
"64928","E01031342",2011,829,65,764,99
"64929","E01031343",2011,611,9,602,73
"64930","E01031344",2011,608,163,445,40
"64931","E01031345",2011,648,30,618,34
"64932","E01031346",2011,640,16,624,68
"64933","E01031347",2011,656,218,438,74
"64934","E01031348",2011,675,276,399,80
"64935","E01031349",2011,552,28,524,29
"64936","E01031350",2011,496,134,362,43
"64937","E01031351",2011,647,34,613,37
"64938","E01031352",2011,635,70,565,48
"64939","E01031353",2011,469,1,468,39
"64940","E01031354",2011,543,17,526,41
"64941","E01031355",2011,692,75,617,67
"64942","E01031356",2011,1035,25,1010,171
"64943","E01031357",2011,1035,27,1008,250
"64944","E01031358",2011,647,256,391,50
"64945","E01031359",2011,523,16,507,55
"64946","E01031360",2011,649,152,497,55
"64947","E01031361",2011,631,236,395,45
"64948","E01031362",2011,507,21,486,62
"64949","E01031363",2011,746,84,662,65
"64950","E01031364",2011,797,141,656,239
"64951","E01031365",2011,639,56,583,58
"64952","E01031366",2011,495,165,330,49
"64953","E01031367",2011,546,4,542,22
"64954","E01031368",2011,552,76,476,33
"64955","E01031369",2011,640,20,620,97
"64956","E01031370",2011,568,115,453,40
"64957","E01031371",2011,610,265,345,47
"64958","E01031372",2011,539,164,375,37
"64959","E01031373",2011,628,100,528,83
"64960","E01031374",2011,646,16,630,98
"64961","E01031375",2011,701,91,610,111
"64962","E01031376",2011,630,11,619,81
"64963","E01031377",2011,807,108,699,192
"64964","E01031378",2011,663,37,626,79
"64965","E01031379",2011,749,16,733,63
"64966","E01031380",2011,749,4,745,64
"64967","E01031381",2011,768,6,762,94
"64968","E01031382",2011,795,5,790,60
"64969","E01031383",2011,745,9,736,40
"64970","E01031384",2011,774,1,773,64
"64971","E01031385",2011,763,190,573,57
"64972","E01031386",2011,592,78,514,73
"64973","E01031387",2011,696,62,634,78
"64974","E01031388",2011,1067,83,984,141
"64975","E01031389",2011,912,28,884,70
"64976","E01031390",2011,591,111,480,58
"64977","E01031391",2011,730,31,699,123
"64978","E01031392",2011,730,54,676,155
"64979","E01031393",2011,751,13,738,55
"64980","E01031394",2011,680,112,568,97
"64981","E01031395",2011,637,22,615,56
"64982","E01031396",2011,791,95,696,78
"64983","E01031397",2011,679,21,658,69
"64984","E01031398",2011,604,28,576,45
"64985","E01031399",2011,753,39,714,34
"64986","E01031400",2011,839,32,807,335
"64987","E01031401",2011,666,33,633,80
"64988","E01031402",2011,713,15,698,59
"64989","E01031403",2011,634,87,547,92
"64990","E01031404",2011,490,225,265,52
"64991","E01031405",2011,626,10,616,78
"64992","E01031406",2011,500,27,473,70
"64993","E01031407",2011,611,58,553,61
"64994","E01031408",2011,823,37,786,142
"64995","E01031409",2011,510,102,408,55
"64996","E01031410",2011,600,54,546,91
"64997","E01031411",2011,674,96,578,19
"64998","E01031412",2011,638,2,636,24
"64999","E01031413",2011,640,8,632,92
"65000","E01031414",2011,636,74,562,33
"65001","E01031415",2011,776,161,615,53
"65002","E01031416",2011,643,6,637,28
"65003","E01031417",2011,693,18,675,95
"65004","E01031418",2011,766,29,737,48
"65005","E01031419",2011,784,5,779,164
"65006","E01031420",2011,736,3,733,64
"65007","E01031421",2011,730,12,718,54
"65008","E01031422",2011,764,3,761,59
"65009","E01031423",2011,776,28,748,62
"65010","E01031424",2011,686,1,685,56
"65011","E01031425",2011,610,4,606,59
"65012","E01031426",2011,534,89,445,66
"65013","E01031427",2011,615,236,379,65
"65014","E01031428",2011,654,49,605,220
"65015","E01031429",2011,558,269,289,70
"65016","E01031430",2011,602,82,520,90
"65017","E01031431",2011,488,47,441,172
"65018","E01031432",2011,937,87,850,474
"65019","E01031433",2011,610,120,490,69
"65020","E01031434",2011,711,109,602,187
"65021","E01031435",2011,724,15,709,240
"65022","E01031436",2011,998,102,896,574
"65023","E01031437",2011,991,32,959,514
"65024","E01031438",2011,739,105,634,116
"65025","E01031439",2011,938,49,889,61
"65026","E01031440",2011,770,5,765,71
"65027","E01031441",2011,746,181,565,129
"65028","E01031442",2011,607,34,573,160
"65029","E01031443",2011,507,115,392,64
"65030","E01031444",2011,654,78,576,216
"65031","E01031445",2011,766,34,732,72
"65032","E01031446",2011,623,7,616,43
"65033","E01031447",2011,733,7,726,50
"65034","E01031448",2011,766,12,754,72
"65035","E01031449",2011,670,77,593,55
"65036","E01031450",2011,518,220,298,76
"65037","E01031451",2011,621,224,397,62
"65038","E01031452",2011,528,52,476,81
"65039","E01031453",2011,712,100,612,205
"65040","E01031454",2011,999,80,919,475
"65041","E01031455",2011,644,80,564,89
"65042","E01031456",2011,970,57,913,503
"65043","E01031457",2011,868,49,819,124
"65044","E01031458",2011,909,5,904,33
"65045","E01031459",2011,810,223,587,104
"65046","E01031460",2011,958,8,950,142
"65047","E01031461",2011,848,8,840,74
"65048","E01031462",2011,636,56,580,86
"65049","E01031463",2011,650,12,638,38
"65050","E01031464",2011,813,29,784,120
"65051","E01031465",2011,578,41,537,97
"65052","E01031466",2011,590,39,551,43
"65053","E01031467",2011,743,59,684,85
"65054","E01031468",2011,940,108,832,106
"65055","E01031469",2011,759,75,684,86
"65056","E01031470",2011,629,65,564,52
"65057","E01031471",2011,520,4,516,50
"65058","E01031472",2011,658,77,581,54
"65059","E01031473",2011,493,152,341,40
"65060","E01031474",2011,636,95,541,81
"65061","E01031475",2011,505,20,485,48
"65062","E01031476",2011,692,25,667,122
"65063","E01031477",2011,1002,185,817,222
"65064","E01031478",2011,464,19,445,97
"65065","E01031479",2011,442,51,391,65
"65066","E01031480",2011,605,106,499,168
"65067","E01031481",2011,740,151,589,216
"65068","E01031482",2011,683,287,396,145
"65069","E01031483",2011,1006,506,500,170
"65070","E01031484",2011,905,233,672,209
"65071","E01031485",2011,675,3,672,53
"65072","E01031486",2011,841,58,783,235
"65073","E01031487",2011,675,59,616,52
"65074","E01031488",2011,771,179,592,264
"65075","E01031489",2011,645,63,582,79
"65076","E01031490",2011,956,89,867,237
"65077","E01031491",2011,924,159,765,232
"65078","E01031492",2011,614,317,297,73
"65079","E01031493",2011,786,90,696,93
"65080","E01031494",2011,730,392,338,64
"65081","E01031495",2011,760,72,688,162
"65082","E01031496",2011,933,39,894,104
"65083","E01031497",2011,565,115,450,71
"65084","E01031498",2011,482,32,450,116
"65085","E01031499",2011,797,126,671,135
"65086","E01031500",2011,766,26,740,86
"65087","E01031501",2011,692,63,629,136
"65088","E01031502",2011,592,26,566,45
"65089","E01031503",2011,567,66,501,41
"65090","E01031504",2011,935,185,750,89
"65091","E01031505",2011,988,56,932,113
"65092","E01031506",2011,529,50,479,33
"65093","E01031507",2011,588,27,561,147
"65094","E01031508",2011,874,120,754,132
"65095","E01031509",2011,1004,234,770,112
"65096","E01031511",2011,749,50,699,99
"65097","E01031512",2011,882,329,553,89
"65098","E01031513",2011,907,160,747,123
"65099","E01031514",2011,758,78,680,181
"65100","E01031515",2011,702,258,444,74
"65101","E01031516",2011,654,70,584,116
"65102","E01031517",2011,734,64,670,37
"65103","E01031518",2011,619,35,584,31
"65104","E01031519",2011,542,104,438,73
"65105","E01031520",2011,548,101,447,56
"65106","E01031521",2011,453,23,430,52
"65107","E01031522",2011,925,234,691,110
"65108","E01031523",2011,697,11,686,84
"65109","E01031524",2011,712,14,698,61
"65110","E01031525",2011,627,35,592,61
"65111","E01031526",2011,543,65,478,46
"65112","E01031527",2011,678,28,650,59
"65113","E01031528",2011,681,13,668,154
"65114","E01031529",2011,479,40,439,56
"65115","E01031530",2011,535,132,403,39
"65116","E01031531",2011,524,11,513,26
"65117","E01031532",2011,456,22,434,221
"65118","E01031533",2011,508,126,382,28
"65119","E01031534",2011,867,99,768,155
"65120","E01031535",2011,677,58,619,88
"65121","E01031536",2011,517,72,445,63
"65122","E01031538",2011,615,180,435,40
"65123","E01031539",2011,491,72,419,107
"65124","E01031540",2011,664,54,610,73
"65125","E01031541",2011,688,17,671,78
"65126","E01031542",2011,785,51,734,65
"65127","E01031543",2011,1000,163,837,90
"65128","E01031544",2011,519,74,445,58
"65129","E01031545",2011,515,61,454,51
"65130","E01031546",2011,477,87,390,80
"65131","E01031547",2011,518,204,314,55
"65132","E01031548",2011,698,331,367,86
"65133","E01031549",2011,523,188,335,66
"65134","E01031550",2011,522,206,316,53
"65135","E01031551",2011,496,115,381,85
"65136","E01031552",2011,753,280,473,141
"65137","E01031553",2011,504,229,275,45
"65138","E01031554",2011,700,127,573,129
"65139","E01031555",2011,485,173,312,55
"65140","E01031556",2011,663,319,344,71
"65141","E01031557",2011,862,63,799,226
"65142","E01031558",2011,648,514,134,36
"65143","E01031559",2011,514,179,335,69
"65144","E01031560",2011,624,78,546,33
"65145","E01031561",2011,597,73,524,46
"65146","E01031562",2011,604,260,344,72
"65147","E01031563",2011,484,19,465,37
"65148","E01031564",2011,614,97,517,48
"65149","E01031565",2011,846,257,589,84
"65150","E01031566",2011,668,135,533,46
"65151","E01031567",2011,518,78,440,47
"65152","E01031568",2011,635,87,548,129
"65153","E01031569",2011,639,255,384,50
"65154","E01031570",2011,510,116,394,47
"65155","E01031571",2011,674,216,458,59
"65156","E01031572",2011,637,208,429,51
"65157","E01031573",2011,642,250,392,67
"65158","E01031574",2011,649,138,511,59
"65159","E01031575",2011,647,226,421,83
"65160","E01031576",2011,564,193,371,79
"65161","E01031577",2011,440,75,365,67
"65162","E01031578",2011,743,13,730,156
"65163","E01031579",2011,701,148,553,167
"65164","E01031580",2011,860,64,796,129
"65165","E01031581",2011,619,5,614,79
"65166","E01031582",2011,799,34,765,233
"65167","E01031583",2011,931,277,654,296
"65168","E01031584",2011,655,152,503,106
"65169","E01031585",2011,673,163,510,148
"65170","E01031586",2011,726,138,588,125
"65171","E01031587",2011,650,23,627,55
"65172","E01031588",2011,606,39,567,69
"65173","E01031589",2011,707,23,684,111
"65174","E01031590",2011,649,7,642,68
"65175","E01031591",2011,766,168,598,193
"65176","E01031592",2011,786,24,762,95
"65177","E01031593",2011,597,17,580,93
"65178","E01031594",2011,577,190,387,43
"65179","E01031595",2011,642,205,437,75
"65180","E01031596",2011,788,289,499,126
"65181","E01031597",2011,587,22,565,77
"65182","E01031598",2011,765,227,538,178
"65183","E01031599",2011,772,97,675,204
"65184","E01031600",2011,624,160,464,109
"65185","E01031601",2011,487,109,378,53
"65186","E01031603",2011,595,96,499,111
"65187","E01031604",2011,674,208,466,63
"65188","E01031605",2011,599,185,414,43
"65189","E01031606",2011,611,167,444,37
"65190","E01031607",2011,570,147,423,37
"65191","E01031608",2011,738,192,546,155
"65192","E01031609",2011,684,316,368,46
"65193","E01031610",2011,796,248,548,181
"65194","E01031611",2011,669,36,633,118
"65195","E01031612",2011,874,88,786,51
"65196","E01031613",2011,842,55,787,114
"65197","E01031614",2011,839,247,592,98
"65198","E01031615",2011,721,75,646,72
"65199","E01031616",2011,685,68,617,103
"65200","E01031617",2011,993,48,945,101
"65201","E01031618",2011,542,29,513,70
"65202","E01031619",2011,643,10,633,103
"65203","E01031620",2011,680,145,535,81
"65204","E01031621",2011,793,2,791,20
"65205","E01031622",2011,637,15,622,104
"65206","E01031623",2011,752,51,701,57
"65207","E01031624",2011,599,55,544,69
"65208","E01031625",2011,547,14,533,45
"65209","E01031626",2011,669,69,600,76
"65210","E01031627",2011,838,18,820,54
"65211","E01031628",2011,507,88,419,56
"65212","E01031629",2011,631,39,592,43
"65213","E01031630",2011,825,98,727,87
"65214","E01031631",2011,791,328,463,78
"65215","E01031632",2011,615,13,602,93
"65216","E01031633",2011,524,35,489,42
"65217","E01031634",2011,493,66,427,57
"65218","E01031635",2011,552,35,517,50
"65219","E01031636",2011,1091,187,904,308
"65220","E01031637",2011,812,244,568,58
"65221","E01031638",2011,796,45,751,103
"65222","E01031639",2011,798,48,750,109
"65223","E01031640",2011,713,6,707,28
"65224","E01031641",2011,749,32,717,116
"65225","E01031642",2011,772,56,716,70
"65226","E01031643",2011,725,246,479,54
"65227","E01031644",2011,559,4,555,57
"65228","E01031645",2011,550,11,539,72
"65229","E01031646",2011,603,41,562,73
"65230","E01031647",2011,508,150,358,34
"65231","E01031648",2011,783,83,700,145
"65232","E01031649",2011,455,4,451,39
"65233","E01031650",2011,490,5,485,39
"65234","E01031651",2011,646,146,500,81
"65235","E01031652",2011,631,280,351,45
"65236","E01031653",2011,779,94,685,184
"65237","E01031654",2011,650,64,586,49
"65238","E01031655",2011,619,23,596,123
"65239","E01031656",2011,817,288,529,151
"65240","E01031657",2011,789,147,642,91
"65241","E01031658",2011,874,119,755,119
"65242","E01031659",2011,555,25,530,37
"65243","E01031660",2011,515,11,504,39
"65244","E01031661",2011,630,59,571,75
"65245","E01031662",2011,719,70,649,131
"65246","E01031663",2011,777,245,532,57
"65247","E01031664",2011,666,24,642,52
"65248","E01031665",2011,543,52,491,69
"65249","E01031666",2011,646,5,641,29
"65250","E01031667",2011,652,119,533,44
"65251","E01031668",2011,654,51,603,37
"65252","E01031669",2011,685,153,532,100
"65253","E01031670",2011,702,42,660,138
"65254","E01031671",2011,798,302,496,75
"65255","E01031672",2011,822,12,810,249
"65256","E01031673",2011,645,125,520,62
"65257","E01031674",2011,545,37,508,65
"65258","E01031675",2011,541,41,500,40
"65259","E01031676",2011,1053,62,991,209
"65260","E01031677",2011,604,112,492,38
"65261","E01031678",2011,571,23,548,30
"65262","E01031679",2011,498,21,477,99
"65263","E01031680",2011,493,4,489,28
"65264","E01031681",2011,581,54,527,53
"65265","E01031682",2011,470,11,459,48
"65266","E01031683",2011,623,66,557,60
"65267","E01031684",2011,631,7,624,55
"65268","E01031685",2011,842,52,790,127
"65269","E01031686",2011,633,10,623,47
"65270","E01031687",2011,676,207,469,95
"65271","E01031688",2011,603,192,411,30
"65272","E01031689",2011,663,17,646,135
"65273","E01031690",2011,641,5,636,29
"65274","E01031691",2011,776,81,695,108
"65275","E01031692",2011,897,136,761,152
"65276","E01031693",2011,755,111,644,128
"65277","E01031694",2011,689,103,586,93
"65278","E01031695",2011,565,6,559,61
"65279","E01031696",2011,563,59,504,59
"65280","E01031697",2011,488,49,439,58
"65281","E01031698",2011,624,47,577,77
"65282","E01031699",2011,685,14,671,94
"65283","E01031700",2011,607,8,599,53
"65284","E01031701",2011,752,105,647,83
"65285","E01031702",2011,527,5,522,20
"65286","E01031703",2011,646,13,633,26
"65287","E01031704",2011,717,29,688,73
"65288","E01031705",2011,658,196,462,71
"65289","E01031706",2011,669,33,636,41
"65290","E01031707",2011,647,78,569,35
"65291","E01031708",2011,751,95,656,245
"65292","E01031709",2011,779,196,583,111
"65293","E01031710",2011,592,2,590,26
"65294","E01031711",2011,683,53,630,45
"65295","E01031712",2011,639,143,496,60
"65296","E01031713",2011,556,7,549,23
"65297","E01031714",2011,564,87,477,35
"65298","E01031715",2011,612,1,611,73
"65299","E01031716",2011,476,160,316,47
"65300","E01031717",2011,566,21,545,96
"65301","E01031718",2011,685,14,671,64
"65302","E01031719",2011,722,68,654,99
"65303","E01031720",2011,548,5,543,57
"65304","E01031721",2011,698,80,618,30
"65305","E01031722",2011,474,69,405,106
"65306","E01031723",2011,551,13,538,47
"65307","E01031724",2011,506,5,501,21
"65308","E01031725",2011,588,33,555,41
"65309","E01031726",2011,596,123,473,56
"65310","E01031727",2011,644,22,622,106
"65311","E01031728",2011,840,59,781,131
"65312","E01031729",2011,706,10,696,48
"65313","E01031730",2011,781,21,760,167
"65314","E01031731",2011,860,364,496,55
"65315","E01031732",2011,699,186,513,87
"65316","E01031733",2011,755,85,670,145
"65317","E01031734",2011,620,23,597,41
"65318","E01031735",2011,695,3,692,70
"65319","E01031736",2011,620,11,609,58
"65320","E01031737",2011,580,63,517,51
"65321","E01031738",2011,512,2,510,18
"65322","E01031739",2011,724,12,712,88
"65323","E01031740",2011,545,18,527,45
"65324","E01031741",2011,819,58,761,204
"65325","E01031742",2011,971,94,877,252
"65326","E01031743",2011,769,215,554,182
"65327","E01031744",2011,587,9,578,24
"65328","E01031745",2011,788,53,735,61
"65329","E01031746",2011,727,204,523,98
"65330","E01031747",2011,670,21,649,46
"65331","E01031748",2011,569,6,563,45
"65332","E01031749",2011,603,14,589,59
"65333","E01031750",2011,637,193,444,40
"65334","E01031751",2011,1156,83,1073,328
"65335","E01031752",2011,558,305,253,26
"65336","E01031753",2011,590,87,503,69
"65337","E01031754",2011,646,74,572,84
"65338","E01031755",2011,533,49,484,62
"65339","E01031756",2011,778,142,636,108
"65340","E01031757",2011,701,268,433,58
"65341","E01031758",2011,507,2,505,30
"65342","E01031759",2011,710,68,642,135
"65343","E01031760",2011,683,17,666,108
"65344","E01031761",2011,1103,84,1019,473
"65345","E01031763",2011,695,12,683,59
"65346","E01031764",2011,596,88,508,55
"65347","E01031765",2011,611,61,550,60
"65348","E01031766",2011,833,46,787,106
"65349","E01031767",2011,537,21,516,40
"65350","E01031768",2011,683,35,648,54
"65351","E01031769",2011,707,124,583,77
"65352","E01031770",2011,719,44,675,156
"65353","E01031771",2011,605,203,402,41
"65354","E01031772",2011,724,135,589,68
"65355","E01031773",2011,815,13,802,70
"65356","E01031774",2011,661,7,654,28
"65357","E01031775",2011,775,23,752,79
"65358","E01031776",2011,690,12,678,133
"65359","E01031777",2011,725,40,685,131
"65360","E01031778",2011,677,5,672,139
"65361","E01031779",2011,536,220,316,55
"65362","E01031780",2011,553,9,544,49
"65363","E01031781",2011,632,39,593,68
"65364","E01031782",2011,776,66,710,35
"65365","E01031783",2011,614,267,347,25
"65366","E01031784",2011,780,80,700,118
"65367","E01031785",2011,647,72,575,79
"65368","E01031786",2011,626,112,514,78
"65369","E01031787",2011,1086,92,994,566
"65370","E01031788",2011,1011,157,854,330
"65371","E01031789",2011,1025,55,970,474
"65372","E01031790",2011,963,218,745,364
"65373","E01031791",2011,1002,281,721,287
"65374","E01031792",2011,621,76,545,53
"65375","E01031793",2011,604,2,602,25
"65376","E01031794",2011,660,114,546,52
"65377","E01031795",2011,647,133,514,91
"65378","E01031796",2011,667,61,606,157
"65379","E01031797",2011,512,6,506,41
"65380","E01031798",2011,695,65,630,168
"65381","E01031799",2011,666,97,569,109
"65382","E01031800",2011,629,1,628,62
"65383","E01031801",2011,823,35,788,286
"65384","E01031802",2011,836,4,832,79
"65385","E01031803",2011,648,4,644,27
"65386","E01031804",2011,732,7,725,51
"65387","E01031805",2011,802,5,797,59
"65388","E01031806",2011,722,136,586,106
"65389","E01031807",2011,853,119,734,217
"65390","E01031808",2011,856,87,769,484
"65391","E01031809",2011,887,16,871,351
"65392","E01031810",2011,787,33,754,303
"65393","E01031811",2011,674,52,622,278
"65394","E01031812",2011,813,16,797,186
"65395","E01031813",2011,799,74,725,188
"65396","E01031814",2011,729,8,721,118
"65397","E01031815",2011,790,7,783,138
"65398","E01031816",2011,652,3,649,104
"65399","E01031817",2011,640,117,523,96
"65400","E01031818",2011,758,135,623,96
"65401","E01031819",2011,474,298,176,32
"65402","E01031820",2011,796,3,793,40
"65403","E01031821",2011,771,50,721,65
"65404","E01031822",2011,657,6,651,58
"65405","E01031823",2011,533,3,530,22
"65406","E01031824",2011,511,1,510,33
"65407","E01031825",2011,784,78,706,70
"65408","E01031826",2011,613,72,541,55
"65409","E01031827",2011,650,81,569,112
"65410","E01031828",2011,538,2,536,18
"65411","E01031829",2011,621,3,618,37
"65412","E01031830",2011,654,162,492,69
"65413","E01031831",2011,667,26,641,157
"65414","E01031832",2011,866,161,705,138
"65415","E01031833",2011,664,93,571,199
"65416","E01031834",2011,658,99,559,82
"65417","E01031835",2011,967,36,931,460
"65418","E01031836",2011,772,210,562,88
"65419","E01031837",2011,811,22,789,216
"65420","E01031838",2011,659,31,628,95
"65421","E01031839",2011,762,96,666,106
"65422","E01031840",2011,771,24,747,94
"65423","E01031841",2011,783,110,673,91
"65424","E01031842",2011,768,98,670,99
"65425","E01031843",2011,774,144,630,114
"65426","E01031844",2011,830,140,690,128
"65427","E01031845",2011,666,72,594,60
"65428","E01031846",2011,704,164,540,84
"65429","E01031847",2011,728,100,628,78
"65430","E01031848",2011,724,89,635,67
"65431","E01031849",2011,672,97,575,114
"65432","E01031850",2011,938,214,724,106
"65433","E01031851",2011,630,245,385,65
"65434","E01031852",2011,824,54,770,133
"65435","E01031853",2011,657,198,459,50
"65436","E01031854",2011,1024,403,621,187
"65437","E01031855",2011,645,49,596,40
"65438","E01031856",2011,750,290,460,71
"65439","E01031857",2011,640,174,466,63
"65440","E01031858",2011,713,35,678,93
"65441","E01031859",2011,744,269,475,143
"65442","E01031860",2011,634,153,481,91
"65443","E01031861",2011,1024,202,822,112
"65444","E01031862",2011,722,335,387,96
"65445","E01031863",2011,576,83,493,161
"65446","E01031864",2011,522,24,498,52
"65447","E01031865",2011,571,89,482,75
"65448","E01031866",2011,687,77,610,104
"65449","E01031867",2011,795,167,628,108
"65450","E01031868",2011,683,60,623,126
"65451","E01031869",2011,850,335,515,64
"65452","E01031870",2011,810,34,776,123
"65453","E01031871",2011,712,90,622,96
"65454","E01031872",2011,675,174,501,57
"65455","E01031873",2011,738,110,628,106
"65456","E01031874",2011,654,120,534,58
"65457","E01031876",2011,622,89,533,59
"65458","E01031877",2011,767,67,700,120
"65459","E01031878",2011,763,101,662,224
"65460","E01031879",2011,597,110,487,427
"65461","E01031880",2011,582,49,533,374
"65462","E01031882",2011,849,115,734,211
"65463","E01031883",2011,785,94,691,54
"65464","E01031884",2011,675,81,594,106
"65465","E01031885",2011,634,64,570,85
"65466","E01031886",2011,566,16,550,54
"65467","E01031887",2011,714,63,651,49
"65468","E01031888",2011,574,39,535,69
"65469","E01031889",2011,762,140,622,176
"65470","E01031890",2011,628,52,576,67
"65471","E01031891",2011,883,55,828,123
"65472","E01031892",2011,558,46,512,56
"65473","E01031893",2011,612,31,581,58
"65474","E01031894",2011,601,31,570,80
"65475","E01031895",2011,628,141,487,58
"65476","E01031896",2011,571,274,297,60
"65477","E01031897",2011,842,83,759,107
"65478","E01031898",2011,656,95,561,104
"65479","E01031900",2011,1043,100,943,99
"65480","E01031901",2011,645,170,475,92
"65481","E01031902",2011,475,54,421,55
"65482","E01031903",2011,999,39,960,104
"65483","E01031904",2011,808,63,745,130
"65484","E01031905",2011,497,8,489,29
"65485","E01031906",2011,643,16,627,160
"65486","E01031907",2011,921,11,910,151
"65487","E01031908",2011,706,165,541,95
"65488","E01031909",2011,526,51,475,31
"65489","E01031910",2011,586,79,507,57
"65490","E01031911",2011,572,246,326,55
"65491","E01031912",2011,739,217,522,187
"65492","E01031913",2011,556,27,529,70
"65493","E01031914",2011,495,254,241,37
"65494","E01031915",2011,603,36,567,70
"65495","E01031916",2011,538,123,415,34
"65496","E01031917",2011,673,207,466,148
"65497","E01031918",2011,1138,120,1018,88
"65498","E01031919",2011,593,49,544,26
"65499","E01031920",2011,505,22,483,100
"65500","E01031921",2011,533,18,515,62
"65501","E01031922",2011,594,11,583,151
"65502","E01031923",2011,536,18,518,81
"65503","E01031924",2011,666,39,627,114
"65504","E01031925",2011,495,169,326,25
"65505","E01031926",2011,620,89,531,68
"65506","E01031927",2011,502,7,495,26
"65507","E01031928",2011,613,324,289,38
"65508","E01031929",2011,548,46,502,45
"65509","E01031930",2011,485,30,455,218
"65510","E01031931",2011,729,34,695,94
"65511","E01031932",2011,667,86,581,48
"65512","E01031933",2011,620,167,453,53
"65513","E01031934",2011,698,17,681,50
"65514","E01031935",2011,736,34,702,103
"65515","E01031936",2011,634,191,443,67
"65516","E01031937",2011,444,49,395,65
"65517","E01031938",2011,568,22,546,66
"65518","E01031939",2011,842,68,774,70
"65519","E01031940",2011,917,76,841,113
"65520","E01031941",2011,637,63,574,112
"65521","E01031942",2011,549,98,451,96
"65522","E01031944",2011,457,25,432,93
"65523","E01031946",2011,482,45,437,355
"65524","E01031947",2011,697,245,452,51
"65525","E01031948",2011,828,54,774,123
"65526","E01031949",2011,833,52,781,209
"65527","E01031950",2011,536,17,519,74
"65528","E01031951",2011,465,55,410,78
"65529","E01031952",2011,1094,341,753,233
"65530","E01031953",2011,1185,150,1035,143
"65531","E01031954",2011,530,16,514,44
"65532","E01031955",2011,659,36,623,51
"65533","E01031956",2011,512,157,355,57
"65534","E01031957",2011,619,75,544,93
"65535","E01031958",2011,563,18,545,89
"65536","E01031959",2011,690,56,634,79
"65537","E01031960",2011,526,72,454,149
"65538","E01031961",2011,526,28,498,51
"65539","E01031962",2011,541,20,521,28
"65540","E01031963",2011,737,324,413,62
"65541","E01031964",2011,776,15,761,128
"65542","E01031965",2011,620,55,565,48
"65543","E01031966",2011,628,9,619,56
"65544","E01031967",2011,880,179,701,133
"65545","E01031968",2011,678,24,654,80
"65546","E01031969",2011,586,11,575,82
"65547","E01031970",2011,658,9,649,77
"65548","E01031971",2011,512,66,446,75
"65549","E01031972",2011,598,66,532,65
"65550","E01031973",2011,720,14,706,80
"65551","E01031974",2011,586,59,527,56
"65552","E01031975",2011,531,274,257,27
"65553","E01031976",2011,490,92,398,161
"65554","E01031977",2011,1083,109,974,217
"65555","E01031978",2011,693,170,523,109
"65556","E01031979",2011,881,157,724,153
"65557","E01031980",2011,600,201,399,77
"65558","E01031981",2011,619,335,284,38
"65559","E01031982",2011,567,161,406,44
"65560","E01031983",2011,723,413,310,63
"65561","E01031984",2011,602,32,570,56
"65562","E01031985",2011,524,134,390,61
"65563","E01031986",2011,603,219,384,60
"65564","E01031988",2011,561,45,516,452
"65565","E01031989",2011,577,156,421,141
"65566","E01031990",2011,809,112,697,171
"65567","E01031991",2011,845,101,744,136
"65568","E01031992",2011,623,11,612,67
"65569","E01031993",2011,625,101,524,40
"65570","E01031994",2011,512,85,427,45
"65571","E01031995",2011,721,38,683,151
"65572","E01031996",2011,556,191,365,40
"65573","E01031997",2011,584,33,551,83
"65574","E01031998",2011,719,79,640,578
"65575","E01031999",2011,650,39,611,69
"65576","E01032000",2011,947,96,851,200
"65577","E01032001",2011,609,32,577,104
"65578","E01032002",2011,600,67,533,132
"65579","E01032003",2011,734,103,631,208
"65580","E01032004",2011,999,148,851,209
"65581","E01032005",2011,532,41,491,64
"65582","E01032006",2011,510,16,494,100
"65583","E01032007",2011,543,112,431,86
"65584","E01032008",2011,668,237,431,36
"65585","E01032009",2011,836,69,767,79
"65586","E01032010",2011,931,92,839,147
"65587","E01032011",2011,1022,207,815,134
"65588","E01032012",2011,759,16,743,43
"65589","E01032013",2011,829,126,703,180
"65590","E01032014",2011,865,113,752,320
"65591","E01032015",2011,602,133,469,137
"65592","E01032016",2011,624,33,591,178
"65593","E01032017",2011,609,19,590,36
"65594","E01032018",2011,634,33,601,45
"65595","E01032019",2011,623,251,372,37
"65596","E01032020",2011,634,79,555,63
"65597","E01032021",2011,700,19,681,199
"65598","E01032022",2011,931,178,753,287
"65599","E01032023",2011,840,394,446,129
"65600","E01032024",2011,1125,128,997,386
"65601","E01032025",2011,626,84,542,69
"65602","E01032026",2011,670,56,614,83
"65603","E01032027",2011,612,62,550,112
"65604","E01032029",2011,605,41,564,98
"65605","E01032030",2011,718,211,507,108
"65606","E01032031",2011,490,53,437,55
"65607","E01032032",2011,662,24,638,58
"65608","E01032033",2011,609,53,556,91
"65609","E01032034",2011,583,59,524,91
"65610","E01032035",2011,686,26,660,87
"65611","E01032036",2011,638,104,534,120
"65612","E01032037",2011,698,203,495,91
"65613","E01032038",2011,639,87,552,114
"65614","E01032039",2011,674,116,558,182
"65615","E01032040",2011,625,173,452,82
"65616","E01032041",2011,784,17,767,41
"65617","E01032042",2011,677,50,627,65
"65618","E01032043",2011,513,58,455,65
"65619","E01032044",2011,555,40,515,38
"65620","E01032045",2011,604,16,588,50
"65621","E01032046",2011,708,129,579,66
"65622","E01032047",2011,608,66,542,32
"65623","E01032048",2011,754,243,511,75
"65624","E01032049",2011,701,77,624,69
"65625","E01032050",2011,911,59,852,179
"65626","E01032051",2011,582,28,554,61
"65627","E01032052",2011,562,23,539,55
"65628","E01032053",2011,583,21,562,44
"65629","E01032054",2011,519,101,418,71
"65630","E01032055",2011,542,8,534,35
"65631","E01032056",2011,548,86,462,48
"65632","E01032057",2011,492,30,462,46
"65633","E01032058",2011,595,87,508,68
"65634","E01032059",2011,728,46,682,75
"65635","E01032060",2011,701,53,648,49
"65636","E01032061",2011,514,58,456,38
"65637","E01032062",2011,766,253,513,171
"65638","E01032063",2011,776,89,687,88
"65639","E01032064",2011,508,220,288,48
"65640","E01032065",2011,646,89,557,70
"65641","E01032066",2011,626,148,478,71
"65642","E01032067",2011,653,47,606,80
"65643","E01032068",2011,707,98,609,125
"65644","E01032069",2011,499,24,475,38
"65645","E01032070",2011,685,187,498,55
"65646","E01032071",2011,889,42,847,82
"65647","E01032072",2011,738,50,688,91
"65648","E01032073",2011,571,13,558,82
"65649","E01032074",2011,532,21,511,37
"65650","E01032075",2011,584,84,500,76
"65651","E01032076",2011,533,72,461,145
"65652","E01032077",2011,671,41,630,62
"65653","E01032078",2011,1173,222,951,163
"65654","E01032079",2011,633,73,560,48
"65655","E01032080",2011,617,8,609,58
"65656","E01032081",2011,540,20,520,170
"65657","E01032082",2011,523,37,486,81
"65658","E01032083",2011,916,44,872,117
"65659","E01032084",2011,1085,59,1026,112
"65660","E01032085",2011,670,18,652,140
"65661","E01032086",2011,1172,341,831,392
"65662","E01032087",2011,936,103,833,155
"65663","E01032088",2011,632,9,623,58
"65664","E01032089",2011,655,11,644,202
"65665","E01032090",2011,616,121,495,74
"65666","E01032091",2011,544,53,491,83
"65667","E01032092",2011,621,12,609,95
"65668","E01032093",2011,718,291,427,63
"65669","E01032094",2011,1009,261,748,202
"65670","E01032095",2011,669,34,635,93
"65671","E01032096",2011,758,435,323,66
"65672","E01032097",2011,740,13,727,43
"65673","E01032098",2011,632,51,581,48
"65674","E01032099",2011,1131,99,1032,151
"65675","E01032100",2011,654,31,623,99
"65676","E01032101",2011,792,159,633,205
"65677","E01032102",2011,657,7,650,61
"65678","E01032103",2011,874,96,778,267
"65679","E01032104",2011,510,258,252,38
"65680","E01032105",2011,667,7,660,79
"65681","E01032106",2011,595,9,586,43
"65682","E01032107",2011,493,38,455,394
"65683","E01032108",2011,620,30,590,110
"65684","E01032109",2011,676,145,531,84
"65685","E01032110",2011,696,20,676,62
"65686","E01032111",2011,547,136,411,53
"65687","E01032112",2011,618,25,593,125
"65688","E01032113",2011,601,146,455,64
"65689","E01032114",2011,646,94,552,152
"65690","E01032115",2011,825,208,617,146
"65691","E01032116",2011,1063,78,985,132
"65692","E01032117",2011,1014,153,861,121
"65693","E01032118",2011,564,256,308,56
"65694","E01032119",2011,926,65,861,310
"65695","E01032121",2011,694,18,676,79
"65696","E01032122",2011,771,46,725,79
"65697","E01032123",2011,657,16,641,54
"65698","E01032124",2011,674,114,560,75
"65699","E01032125",2011,615,47,568,36
"65700","E01032126",2011,856,81,775,24
"65701","E01032127",2011,686,55,631,64
"65702","E01032128",2011,616,91,525,52
"65703","E01032129",2011,522,162,360,23
"65704","E01032130",2011,1148,176,972,185
"65705","E01032131",2011,664,312,352,51
"65706","E01032132",2011,960,382,578,85
"65707","E01032133",2011,740,241,499,37
"65708","E01032134",2011,626,15,611,39
"65709","E01032135",2011,638,7,631,52
"65710","E01032136",2011,506,6,500,51
"65711","E01032137",2011,650,66,584,93
"65712","E01032138",2011,549,8,541,37
"65713","E01032139",2011,662,5,657,59
"65714","E01032140",2011,705,27,678,62
"65715","E01032141",2011,588,12,576,65
"65716","E01032142",2011,607,6,601,44
"65717","E01032143",2011,534,3,531,27
"65718","E01032144",2011,764,4,760,86
"65719","E01032145",2011,626,7,619,22
"65720","E01032146",2011,670,12,658,37
"65721","E01032147",2011,565,86,479,22
"65722","E01032148",2011,437,4,433,43
"65723","E01032149",2011,478,1,477,17
"65724","E01032150",2011,621,6,615,30
"65725","E01032151",2011,573,3,570,40
"65726","E01032152",2011,603,164,439,49
"65727","E01032153",2011,609,86,523,55
"65728","E01032154",2011,663,12,651,68
"65729","E01032155",2011,651,3,648,31
"65730","E01032156",2011,722,121,601,197
"65731","E01032157",2011,1033,308,725,129
"65732","E01032158",2011,651,3,648,32
"65733","E01032159",2011,774,145,629,69
"65734","E01032160",2011,762,67,695,106
"65735","E01032161",2011,620,216,404,62
"65736","E01032162",2011,752,33,719,40
"65737","E01032166",2011,955,120,835,117
"65738","E01032168",2011,477,66,411,33
"65739","E01032169",2011,494,17,477,42
"65740","E01032170",2011,556,19,537,58
"65741","E01032171",2011,624,19,605,17
"65742","E01032172",2011,638,42,596,95
"65743","E01032173",2011,648,27,621,31
"65744","E01032174",2011,646,140,506,66
"65745","E01032175",2011,659,87,572,23
"65746","E01032176",2011,903,38,865,84
"65747","E01032177",2011,469,7,462,40
"65748","E01032178",2011,543,4,539,20
"65749","E01032179",2011,704,73,631,77
"65750","E01032180",2011,767,65,702,80
"65751","E01032181",2011,891,60,831,113
"65752","E01032182",2011,801,22,779,63
"65753","E01032183",2011,570,25,545,52
"65754","E01032184",2011,799,68,731,59
"65755","E01032185",2011,620,34,586,33
"65756","E01032186",2011,526,53,473,111
"65757","E01032187",2011,785,296,489,54
"65758","E01032188",2011,799,177,622,77
"65759","E01032189",2011,837,92,745,52
"65760","E01032190",2011,783,98,685,56
"65761","E01032191",2011,946,56,890,87
"65762","E01032192",2011,688,129,559,40
"65763","E01032193",2011,912,93,819,92
"65764","E01032194",2011,665,249,416,47
"65765","E01032195",2011,752,56,696,119
"65766","E01032196",2011,750,86,664,113
"65767","E01032197",2011,714,83,631,125
"65768","E01032198",2011,821,45,776,102
"65769","E01032199",2011,737,107,630,92
"65770","E01032200",2011,833,80,753,64
"65771","E01032201",2011,648,213,435,39
"65772","E01032202",2011,739,360,379,48
"65773","E01032203",2011,698,213,485,38
"65774","E01032204",2011,655,477,178,26
"65775","E01032205",2011,471,49,422,77
"65776","E01032206",2011,556,44,512,65
"65777","E01032207",2011,622,45,577,48
"65778","E01032208",2011,737,7,730,239
"65779","E01032209",2011,571,11,560,182
"65780","E01032210",2011,498,89,409,43
"65781","E01032211",2011,792,51,741,63
"65782","E01032212",2011,812,67,745,104
"65783","E01032213",2011,660,25,635,75
"65784","E01032214",2011,1018,233,785,191
"65785","E01032215",2011,556,206,350,27
"65786","E01032216",2011,769,77,692,159
"65787","E01032217",2011,644,61,583,100
"65788","E01032218",2011,654,27,627,86
"65789","E01032219",2011,769,11,758,91
"65790","E01032220",2011,668,46,622,116
"65791","E01032221",2011,548,37,511,61
"65792","E01032222",2011,603,105,498,71
"65793","E01032223",2011,824,46,778,63
"65794","E01032224",2011,689,145,544,206
"65795","E01032225",2011,503,270,233,50
"65796","E01032226",2011,814,77,737,47
"65797","E01032227",2011,467,4,463,12
"65798","E01032228",2011,566,21,545,83
"65799","E01032229",2011,634,129,505,104
"65800","E01032230",2011,596,52,544,48
"65801","E01032231",2011,763,62,701,103
"65802","E01032232",2011,781,497,284,52
"65803","E01032233",2011,1171,87,1084,116
"65804","E01032234",2011,734,348,386,75
"65805","E01032235",2011,755,362,393,49
"65806","E01032236",2011,807,213,594,224
"65807","E01032237",2011,635,41,594,102
"65808","E01032238",2011,511,27,484,108
"65809","E01032239",2011,690,140,550,239
"65810","E01032240",2011,554,210,344,71
"65811","E01032241",2011,503,202,301,57
"65812","E01032242",2011,590,147,443,66
"65813","E01032243",2011,579,7,572,15
"65814","E01032244",2011,541,94,447,46
"65815","E01032245",2011,665,382,283,76
"65816","E01032246",2011,558,14,544,40
"65817","E01032247",2011,637,133,504,99
"65818","E01032248",2011,543,20,523,16
"65819","E01032249",2011,686,26,660,124
"65820","E01032250",2011,514,222,292,69
"65821","E01032251",2011,702,205,497,117
"65822","E01032252",2011,569,309,260,76
"65823","E01032253",2011,476,12,464,39
"65824","E01032254",2011,606,137,469,58
"65825","E01032255",2011,557,47,510,50
"65826","E01032256",2011,644,162,482,52
"65827","E01032257",2011,573,38,535,27
"65828","E01032258",2011,705,96,609,123
"65829","E01032259",2011,621,42,579,74
"65830","E01032260",2011,675,382,293,71
"65831","E01032261",2011,583,10,573,28
"65832","E01032262",2011,860,322,538,168
"65833","E01032263",2011,725,89,636,74
"65834","E01032264",2011,641,102,539,71
"65835","E01032265",2011,643,229,414,63
"65836","E01032266",2011,675,71,604,65
"65837","E01032267",2011,637,169,468,60
"65838","E01032268",2011,480,24,456,26
"65839","E01032269",2011,758,121,637,116
"65840","E01032270",2011,525,3,522,46
"65841","E01032271",2011,522,25,497,19
"65842","E01032272",2011,535,72,463,55
"65843","E01032273",2011,565,15,550,34
"65844","E01032274",2011,518,5,513,36
"65845","E01032275",2011,606,157,449,46
"65846","E01032276",2011,595,8,587,43
"65847","E01032277",2011,514,176,338,48
"65848","E01032278",2011,726,391,335,77
"65849","E01032279",2011,532,74,458,61
"65850","E01032280",2011,800,49,751,265
"65851","E01032281",2011,632,19,613,201
"65852","E01032282",2011,897,102,795,440
"65853","E01032283",2011,694,71,623,89
"65854","E01032284",2011,826,18,808,94
"65855","E01032285",2011,739,68,671,167
"65856","E01032286",2011,650,46,604,77
"65857","E01032287",2011,664,7,657,115
"65858","E01032288",2011,647,72,575,63
"65859","E01032289",2011,625,18,607,13
"65860","E01032290",2011,666,21,645,65
"65861","E01032292",2011,616,49,567,207
"65862","E01032294",2011,580,61,519,120
"65863","E01032295",2011,1157,143,1014,284
"65864","E01032296",2011,724,71,653,164
"65865","E01032297",2011,663,9,654,48
"65866","E01032298",2011,777,6,771,31
"65867","E01032299",2011,675,35,640,102
"65868","E01032300",2011,655,8,647,40
"65869","E01032301",2011,623,104,519,62
"65870","E01032302",2011,544,186,358,158
"65871","E01032303",2011,478,236,242,35
"65872","E01032304",2011,627,301,326,41
"65873","E01032305",2011,688,59,629,89
"65874","E01032306",2011,608,108,500,69
"65875","E01032307",2011,642,258,384,81
"65876","E01032308",2011,620,13,607,55
"65877","E01032309",2011,641,171,470,55
"65878","E01032310",2011,596,125,471,96
"65879","E01032311",2011,626,268,358,81
"65880","E01032312",2011,669,47,622,197
"65881","E01032313",2011,500,250,250,63
"65882","E01032314",2011,448,15,433,125
"65883","E01032315",2011,512,11,501,135
"65884","E01032316",2011,498,5,493,37
"65885","E01032317",2011,648,71,577,85
"65886","E01032318",2011,628,373,255,46
"65887","E01032319",2011,703,41,662,85
"65888","E01032320",2011,655,31,624,165
"65889","E01032321",2011,601,190,411,68
"65890","E01032322",2011,957,289,668,282
"65891","E01032323",2011,606,21,585,38
"65892","E01032324",2011,613,17,596,111
"65893","E01032325",2011,659,13,646,154
"65894","E01032326",2011,604,4,600,59
"65895","E01032327",2011,767,77,690,158
"65896","E01032328",2011,625,160,465,59
"65897","E01032329",2011,871,40,831,92
"65898","E01032330",2011,602,54,548,124
"65899","E01032331",2011,663,350,313,39
"65900","E01032332",2011,611,428,183,42
"65901","E01032333",2011,760,387,373,52
"65902","E01032334",2011,1008,75,933,251
"65903","E01032335",2011,575,4,571,65
"65904","E01032336",2011,644,7,637,130
"65905","E01032337",2011,729,14,715,109
"65906","E01032338",2011,804,69,735,212
"65907","E01032339",2011,618,7,611,76
"65908","E01032340",2011,585,135,450,50
"65909","E01032341",2011,522,14,508,31
"65910","E01032342",2011,601,109,492,78
"65911","E01032343",2011,1139,210,929,375
"65912","E01032344",2011,606,26,580,54
"65913","E01032345",2011,585,23,562,76
"65914","E01032346",2011,539,24,515,37
"65915","E01032347",2011,547,35,512,56
"65916","E01032348",2011,513,23,490,39
"65917","E01032349",2011,631,85,546,66
"65918","E01032350",2011,465,81,384,53
"65919","E01032351",2011,748,11,737,96
"65920","E01032352",2011,653,82,571,61
"65921","E01032353",2011,763,202,561,98
"65922","E01032354",2011,987,152,835,83
"65923","E01032355",2011,493,72,421,40
"65924","E01032356",2011,459,7,452,24
"65925","E01032357",2011,510,113,397,53
"65926","E01032358",2011,650,221,429,63
"65927","E01032359",2011,1034,268,766,201
"65928","E01032360",2011,811,214,597,68
"65929","E01032361",2011,742,17,725,84
"65930","E01032362",2011,748,36,712,41
"65931","E01032363",2011,606,3,603,21
"65932","E01032364",2011,643,3,640,29
"65933","E01032365",2011,765,267,498,36
"65934","E01032366",2011,733,101,632,52
"65935","E01032367",2011,636,48,588,51
"65936","E01032368",2011,505,240,265,31
"65937","E01032369",2011,601,250,351,86
"65938","E01032370",2011,498,106,392,47
"65939","E01032371",2011,581,194,387,48
"65940","E01032372",2011,610,73,537,48
"65941","E01032373",2011,533,26,507,46
"65942","E01032374",2011,532,66,466,54
"65943","E01032375",2011,509,69,440,44
"65944","E01032376",2011,631,6,625,96
"65945","E01032377",2011,889,347,542,221
"65946","E01032378",2011,748,187,561,153
"65947","E01032379",2011,729,53,676,64
"65948","E01032380",2011,683,27,656,52
"65949","E01032381",2011,798,266,532,88
"65950","E01032382",2011,532,69,463,52
"65951","E01032383",2011,594,31,563,77
"65952","E01032384",2011,546,151,395,52
"65953","E01032385",2011,622,61,561,58
"65954","E01032386",2011,533,15,518,55
"65955","E01032387",2011,598,101,497,57
"65956","E01032388",2011,555,43,512,44
"65957","E01032389",2011,535,159,376,41
"65958","E01032390",2011,538,64,474,49
"65959","E01032391",2011,444,100,344,31
"65960","E01032392",2011,653,22,631,55
"65961","E01032393",2011,639,45,594,50
"65962","E01032394",2011,487,18,469,47
"65963","E01032395",2011,502,39,463,58
"65964","E01032396",2011,623,6,617,109
"65965","E01032397",2011,748,210,538,57
"65966","E01032398",2011,664,79,585,147
"65967","E01032399",2011,713,91,622,75
"65968","E01032400",2011,879,38,841,60
"65969","E01032401",2011,647,33,614,73
"65970","E01032402",2011,538,14,524,54
"65971","E01032403",2011,595,50,545,80
"65972","E01032404",2011,1003,94,909,101
"65973","E01032405",2011,600,68,532,46
"65974","E01032406",2011,781,269,512,182
"65975","E01032407",2011,618,113,505,53
"65976","E01032408",2011,613,22,591,42
"65977","E01032409",2011,673,185,488,80
"65978","E01032410",2011,570,37,533,33
"65979","E01032411",2011,649,89,560,52
"65980","E01032412",2011,557,85,472,131
"65981","E01032413",2011,454,51,403,47
"65982","E01032414",2011,647,126,521,34
"65983","E01032415",2011,505,28,477,38
"65984","E01032416",2011,433,14,419,31
"65985","E01032417",2011,617,54,563,74
"65986","E01032418",2011,604,21,583,119
"65987","E01032419",2011,576,6,570,29
"65988","E01032420",2011,511,28,483,32
"65989","E01032421",2011,482,28,454,12
"65990","E01032422",2011,644,207,437,141
"65991","E01032423",2011,669,90,579,43
"65992","E01032424",2011,638,281,357,32
"65993","E01032425",2011,644,76,568,31
"65994","E01032426",2011,666,77,589,62
"65995","E01032427",2011,676,68,608,42
"65996","E01032428",2011,880,26,854,214
"65997","E01032429",2011,679,27,652,54
"65998","E01032430",2011,731,89,642,65
"65999","E01032431",2011,656,67,589,115
"66000","E01032432",2011,556,115,441,66
"66001","E01032433",2011,526,8,518,65
"66002","E01032434",2011,711,352,359,125
"66003","E01032435",2011,649,136,513,158
"66004","E01032436",2011,660,7,653,82
"66005","E01032437",2011,735,166,569,113
"66006","E01032438",2011,657,1,656,66
"66007","E01032439",2011,599,61,538,46
"66008","E01032440",2011,532,132,400,41
"66009","E01032441",2011,527,6,521,47
"66010","E01032442",2011,596,8,588,64
"66011","E01032443",2011,619,5,614,48
"66012","E01032444",2011,511,51,460,75
"66013","E01032445",2011,657,174,483,60
"66014","E01032446",2011,615,32,583,81
"66015","E01032447",2011,639,7,632,174
"66016","E01032448",2011,476,4,472,28
"66017","E01032449",2011,721,28,693,259
"66018","E01032450",2011,1101,246,855,354
"66019","E01032451",2011,658,23,635,33
"66020","E01032452",2011,636,27,609,26
"66021","E01032453",2011,755,382,373,52
"66022","E01032454",2011,766,79,687,120
"66023","E01032455",2011,631,19,612,34
"66024","E01032456",2011,514,72,442,77
"66025","E01032457",2011,530,110,420,27
"66026","E01032458",2011,611,8,603,33
"66027","E01032459",2011,608,31,577,44
"66028","E01032460",2011,885,117,768,173
"66029","E01032461",2011,926,58,868,311
"66030","E01032462",2011,942,70,872,141
"66031","E01032463",2011,744,60,684,66
"66032","E01032464",2011,762,363,399,43
"66033","E01032465",2011,613,299,314,49
"66034","E01032466",2011,661,19,642,107
"66035","E01032467",2011,523,15,508,53
"66036","E01032468",2011,510,25,485,28
"66037","E01032469",2011,652,278,374,62
"66038","E01032470",2011,784,193,591,109
"66039","E01032471",2011,634,446,188,27
"66040","E01032472",2011,500,4,496,35
"66041","E01032473",2011,513,55,458,47
"66042","E01032474",2011,832,135,697,324
"66043","E01032475",2011,729,30,699,160
"66044","E01032476",2011,624,48,576,87
"66045","E01032477",2011,519,3,516,31
"66046","E01032478",2011,643,176,467,80
"66047","E01032479",2011,935,164,771,62
"66048","E01032480",2011,780,38,742,89
"66049","E01032481",2011,796,213,583,91
"66050","E01032482",2011,626,15,611,96
"66051","E01032483",2011,728,110,618,119
"66052","E01032484",2011,572,64,508,56
"66053","E01032485",2011,719,5,714,83
"66054","E01032486",2011,606,20,586,39
"66055","E01032487",2011,448,178,270,23
"66056","E01032488",2011,735,42,693,34
"66057","E01032489",2011,894,73,821,243
"66058","E01032490",2011,570,30,540,70
"66059","E01032491",2011,489,25,464,46
"66060","E01032492",2011,997,257,740,303
"66061","E01032493",2011,619,22,597,85
"66062","E01032494",2011,716,350,366,92
"66063","E01032495",2011,922,153,769,115
"66064","E01032496",2011,878,100,778,123
"66065","E01032497",2011,640,268,372,94
"66066","E01032498",2011,697,35,662,87
"66067","E01032499",2011,702,32,670,87
"66068","E01032500",2011,568,91,477,255
"66069","E01032501",2011,498,37,461,36
"66070","E01032502",2011,801,365,436,77
"66071","E01032503",2011,600,13,587,55
"66072","E01032504",2011,673,3,670,27
"66073","E01032505",2011,563,118,445,88
"66074","E01032506",2011,656,98,558,164
"66075","E01032507",2011,666,36,630,213
"66076","E01032508",2011,847,384,463,185
"66077","E01032509",2011,665,114,551,211
"66078","E01032510",2011,776,124,652,177
"66079","E01032511",2011,616,155,461,60
"66080","E01032512",2011,989,577,412,216
"66081","E01032513",2011,567,333,234,109
"66082","E01032514",2011,899,659,240,31
"66083","E01032515",2011,629,201,428,45
"66084","E01032516",2011,830,125,705,88
"66085","E01032517",2011,694,229,465,89
"66086","E01032518",2011,737,319,418,76
"66087","E01032519",2011,500,35,465,92
"66088","E01032520",2011,1058,33,1025,541
"66089","E01032522",2011,1002,42,960,551
"66090","E01032523",2011,426,13,413,216
"66091","E01032524",2011,411,30,381,146
"66092","E01032525",2011,1003,61,942,400
"66093","E01032526",2011,701,39,662,160
"66094","E01032527",2011,631,161,470,69
"66095","E01032528",2011,697,260,437,55
"66096","E01032529",2011,693,9,684,221
"66097","E01032530",2011,817,56,761,136
"66098","E01032531",2011,1147,619,528,123
"66099","E01032532",2011,533,35,498,54
"66100","E01032533",2011,643,46,597,50
"66101","E01032534",2011,756,182,574,92
"66102","E01032535",2011,485,7,478,78
"66103","E01032536",2011,852,138,714,167
"66104","E01032537",2011,831,67,764,157
"66105","E01032538",2011,994,140,854,343
"66106","E01032540",2011,441,136,305,29
"66107","E01032541",2011,985,365,620,85
"66108","E01032542",2011,446,241,205,42
"66109","E01032543",2011,877,448,429,96
"66110","E01032544",2011,751,162,589,91
"66111","E01032545",2011,525,51,474,78
"66112","E01032546",2011,702,5,697,49
"66113","E01032548",2011,715,7,708,28
"66114","E01032549",2011,659,12,647,54
"66115","E01032550",2011,1177,291,886,120
"66116","E01032551",2011,1084,148,936,118
"66117","E01032552",2011,631,203,428,35
"66118","E01032553",2011,598,53,545,65
"66119","E01032554",2011,991,57,934,254
"66120","E01032555",2011,792,284,508,162
"66121","E01032556",2011,662,32,630,112
"66122","E01032557",2011,745,495,250,49
"66123","E01032558",2011,641,423,218,35
"66124","E01032559",2011,1005,96,909,117
"66125","E01032560",2011,457,40,417,27
"66126","E01032561",2011,659,301,358,62
"66127","E01032562",2011,623,267,356,47
"66128","E01032563",2011,568,12,556,47
"66129","E01032564",2011,508,215,293,55
"66130","E01032565",2011,644,323,321,64
"66131","E01032566",2011,747,191,556,71
"66132","E01032567",2011,589,89,500,54
"66133","E01032568",2011,647,193,454,80
"66134","E01032569",2011,660,401,259,54
"66135","E01032570",2011,669,37,632,51
"66136","E01032571",2011,739,51,688,66
"66137","E01032572",2011,758,96,662,303
"66138","E01032573",2011,860,53,807,399
"66139","E01032574",2011,695,145,550,188
"66140","E01032575",2011,672,343,329,144
"66141","E01032576",2011,520,6,514,68
"66142","E01032577",2011,601,59,542,47
"66143","E01032579",2011,711,359,352,201
"66144","E01032580",2011,471,144,327,149
"66145","E01032581",2011,699,134,565,201
"66146","E01032582",2011,920,376,544,342
"66147","E01032583",2011,644,320,324,184
"66148","E01032584",2011,577,277,300,123
"66149","E01032585",2011,663,8,655,47
"66150","E01032586",2011,743,269,474,60
"66151","E01032587",2011,670,160,510,101
"66152","E01032588",2011,571,1,570,55
"66153","E01032589",2011,578,34,544,81
"66154","E01032590",2011,668,6,662,109
"66155","E01032591",2011,483,2,481,42
"66156","E01032592",2011,714,106,608,71
"66157","E01032593",2011,728,30,698,38
"66158","E01032594",2011,637,61,576,35
"66159","E01032595",2011,772,295,477,42
"66160","E01032596",2011,599,9,590,87
"66161","E01032597",2011,655,341,314,40
"66162","E01032598",2011,861,46,815,84
"66163","E01032599",2011,580,9,571,54
"66164","E01032600",2011,794,2,792,67
"66165","E01032601",2011,569,3,566,34
"66166","E01032602",2011,601,270,331,57
"66167","E01032603",2011,649,6,643,34
"66168","E01032604",2011,605,18,587,67
"66169","E01032605",2011,547,9,538,21
"66170","E01032606",2011,906,257,649,65
"66171","E01032607",2011,547,99,448,187
"66172","E01032608",2011,500,24,476,182
"66173","E01032609",2011,518,104,414,40
"66174","E01032610",2011,652,30,622,49
"66175","E01032611",2011,751,11,740,61
"66176","E01032612",2011,939,111,828,326
"66177","E01032613",2011,532,112,420,29
"66178","E01032614",2011,493,9,484,39
"66179","E01032615",2011,466,5,461,16
"66180","E01032616",2011,632,5,627,38
"66181","E01032617",2011,661,6,655,31
"66182","E01032618",2011,618,73,545,45
"66183","E01032619",2011,636,12,624,64
"66184","E01032620",2011,904,68,836,80
"66185","E01032621",2011,704,226,478,43
"66186","E01032622",2011,544,11,533,38
"66187","E01032623",2011,619,3,616,30
"66188","E01032624",2011,657,2,655,14
"66189","E01032625",2011,455,6,449,26
"66190","E01032626",2011,615,43,572,83
"66191","E01032627",2011,967,158,809,137
"66192","E01032628",2011,851,38,813,91
"66193","E01032629",2011,624,80,544,79
"66194","E01032630",2011,611,46,565,58
"66195","E01032631",2011,543,6,537,217
"66196","E01032632",2011,491,23,468,66
"66197","E01032633",2011,967,33,934,158
"66198","E01032634",2011,501,4,497,30
"66199","E01032635",2011,895,292,603,53
"66200","E01032636",2011,925,44,881,191
"66201","E01032637",2011,641,5,636,367
"66202","E01032638",2011,653,9,644,312
"66203","E01032639",2011,688,228,460,274
"66204","E01032640",2011,672,5,667,359
"66205","E01032641",2011,694,158,536,128
"66206","E01032642",2011,1021,128,893,132
"66207","E01032643",2011,704,74,630,132
"66208","E01032644",2011,669,168,501,168
"66209","E01032645",2011,560,182,378,89
"66210","E01032646",2011,737,155,582,341
"66211","E01032647",2011,667,28,639,122
"66212","E01032648",2011,657,244,413,93
"66213","E01032649",2011,612,279,333,89
"66214","E01032650",2011,594,354,240,39
"66215","E01032651",2011,536,53,483,68
"66216","E01032652",2011,490,136,354,73
"66217","E01032653",2011,662,25,637,138
"66218","E01032654",2011,709,45,664,93
"66219","E01032655",2011,586,17,569,83
"66220","E01032656",2011,571,62,509,52
"66221","E01032657",2011,754,94,660,364
"66222","E01032658",2011,808,311,497,316
"66223","E01032659",2011,619,263,356,183
"66224","E01032660",2011,657,94,563,176
"66225","E01032661",2011,679,22,657,270
"66226","E01032662",2011,633,288,345,162
"66227","E01032663",2011,966,149,817,108
"66228","E01032664",2011,656,87,569,178
"66229","E01032665",2011,658,95,563,225
"66230","E01032666",2011,482,20,462,81
"66231","E01032667",2011,429,24,405,81
"66232","E01032668",2011,602,38,564,195
"66233","E01032669",2011,561,5,556,252
"66234","E01032670",2011,586,31,555,182
"66235","E01032671",2011,496,34,462,171
"66236","E01032672",2011,586,9,577,123
"66237","E01032673",2011,622,123,499,159
"66238","E01032674",2011,948,71,877,76
"66239","E01032675",2011,637,19,618,186
"66240","E01032676",2011,726,32,694,235
"66241","E01032677",2011,573,113,460,65
"66242","E01032678",2011,553,4,549,71
"66243","E01032679",2011,551,7,544,192
"66244","E01032680",2011,797,20,777,54
"66245","E01032681",2011,628,73,555,73
"66246","E01032682",2011,425,23,402,70
"66247","E01032683",2011,998,75,923,120
"66248","E01032684",2011,631,146,485,313
"66249","E01032685",2011,945,21,924,605
"66250","E01032686",2011,880,36,844,706
"66251","E01032687",2011,716,89,627,443
"66252","E01032688",2011,501,73,428,83
"66253","E01032689",2011,532,69,463,78
"66254","E01032690",2011,659,81,578,104
"66255","E01032691",2011,595,113,482,83
"66256","E01032692",2011,509,80,429,99
"66257","E01032693",2011,571,133,438,63
"66258","E01032694",2011,601,93,508,104
"66259","E01032695",2011,602,17,585,64
"66260","E01032696",2011,858,154,704,229
"66261","E01032697",2011,574,188,386,291
"66262","E01032698",2011,618,209,409,148
"66263","E01032699",2011,996,91,905,257
"66264","E01032700",2011,583,5,578,95
"66265","E01032701",2011,543,12,531,193
"66266","E01032702",2011,573,18,555,132
"66267","E01032703",2011,555,34,521,88
"66268","E01032704",2011,584,82,502,158
"66269","E01032705",2011,582,32,550,140
"66270","E01032706",2011,710,57,653,257
"66271","E01032707",2011,736,5,731,81
"66272","E01032708",2011,769,12,757,429
"66273","E01032709",2011,545,36,509,133
"66274","E01032710",2011,525,5,520,105
"66275","E01032711",2011,603,28,575,213
"66276","E01032712",2011,589,70,519,157
"66277","E01032713",2011,622,10,612,100
"66278","E01032714",2011,670,50,620,411
"66279","E01032715",2011,540,48,492,252
"66280","E01032716",2011,644,40,604,143
"66281","E01032717",2011,1228,179,1049,232
"66282","E01032719",2011,623,308,315,183
"66283","E01032720",2011,681,336,345,203
"66284","E01032722",2011,932,416,516,369
"66285","E01032724",2011,630,279,351,123
"66286","E01032725",2011,604,104,500,57
"66287","E01032726",2011,548,168,380,43
"66288","E01032727",2011,1308,42,1266,121
"66289","E01032728",2011,641,170,471,123
"66290","E01032729",2011,603,197,406,199
"66291","E01032730",2011,620,120,500,297
"66292","E01032731",2011,507,101,406,116
"66293","E01032732",2011,660,174,486,145
"66294","E01032733",2011,617,267,350,115
"66295","E01032734",2011,650,185,465,184
"66296","E01032735",2011,595,30,565,28
"66297","E01032737",2011,583,104,479,47
"66298","E01032738",2011,630,74,556,449
"66299","E01032739",2011,676,11,665,387
"66300","E01032740",2011,719,18,701,425
"66301","E01032741",2011,663,98,565,255
"66302","E01032742",2011,644,75,569,154
"66303","E01032743",2011,818,216,602,294
"66304","E01032744",2011,486,89,397,166
"66305","E01032745",2011,577,240,337,182
"66306","E01032746",2011,713,47,666,435
"66307","E01032748",2011,635,80,555,262
"66308","E01032750",2011,621,191,430,346
"66309","E01032751",2011,565,143,422,242
"66310","E01032753",2011,788,10,778,294
"66311","E01032755",2011,493,344,149,107
"66312","E01032756",2011,963,159,804,558
"66313","E01032758",2011,608,87,521,75
"66314","E01032759",2011,580,35,545,67
"66315","E01032761",2011,970,11,959,52
"66316","E01032763",2011,905,55,850,64
"66317","E01032764",2011,643,253,390,252
"66318","E01032765",2011,645,305,340,172
"66319","E01032766",2011,601,137,464,293
"66320","E01032767",2011,767,54,713,534
"66321","E01032768",2011,696,54,642,381
"66322","E01032769",2011,593,97,496,275
"66323","E01032770",2011,572,153,419,267
"66324","E01032771",2011,546,115,431,283
"66325","E01032772",2011,544,148,396,284
"66326","E01032773",2011,852,217,635,374
"66327","E01032774",2011,583,255,328,219
"66328","E01032775",2011,600,44,556,342
"66329","E01032776",2011,631,65,566,430
"66330","E01032777",2011,514,154,360,182
"66331","E01032778",2011,564,86,478,332
"66332","E01032779",2011,565,93,472,359
"66333","E01032780",2011,647,20,627,375
"66334","E01032781",2011,771,78,693,425
"66335","E01032782",2011,776,199,577,403
"66336","E01032783",2011,661,173,488,296
"66337","E01032784",2011,692,166,526,324
"66338","E01032785",2011,616,200,416,172
"66339","E01032786",2011,674,374,300,121
"66340","E01032787",2011,793,427,366,194
"66341","E01032788",2011,496,177,319,142
"66342","E01032789",2011,586,180,406,194
"66343","E01032790",2011,557,170,387,188
"66344","E01032792",2011,617,118,499,170
"66345","E01032794",2011,644,123,521,145
"66346","E01032795",2011,681,174,507,189
"66347","E01032797",2011,755,112,643,392
"66348","E01032798",2011,1228,391,837,463
"66349","E01032799",2011,660,125,535,332
"66350","E01032800",2011,689,80,609,358
"66351","E01032802",2011,656,148,508,216
"66352","E01032803",2011,658,84,574,332
"66353","E01032805",2011,940,484,456,187
"66354","E01032807",2011,755,47,708,385
"66355","E01032808",2011,715,196,519,278
"66356","E01032809",2011,958,39,919,121
"66357","E01032810",2011,596,152,444,129
"66358","E01032811",2011,596,77,519,120
"66359","E01032812",2011,669,17,652,104
"66360","E01032813",2011,730,28,702,200
"66361","E01032814",2011,740,63,677,113
"66362","E01032815",2011,420,132,288,115
"66363","E01032816",2011,672,23,649,97
"66364","E01032817",2011,449,50,399,136
"66365","E01032818",2011,553,13,540,149
"66366","E01032819",2011,648,56,592,131
"66367","E01032820",2011,625,45,580,173
"66368","E01032821",2011,619,11,608,79
"66369","E01032822",2011,563,83,480,34
"66370","E01032823",2011,607,93,514,80
"66371","E01032824",2011,588,48,540,116
"66372","E01032825",2011,564,125,439,54
"66373","E01032826",2011,572,15,557,79
"66374","E01032827",2011,571,46,525,32
"66375","E01032828",2011,438,4,434,57
"66376","E01032829",2011,541,63,478,49
"66377","E01032830",2011,1011,423,588,92
"66378","E01032831",2011,701,9,692,168
"66379","E01032832",2011,672,189,483,169
"66380","E01032833",2011,679,10,669,307
"66381","E01032834",2011,666,22,644,348
"66382","E01032835",2011,758,151,607,151
"66383","E01032836",2011,637,114,523,101
"66384","E01032837",2011,552,94,458,104
"66385","E01032838",2011,562,66,496,132
"66386","E01032839",2011,573,28,545,185
"66387","E01032840",2011,708,218,490,94
"66388","E01032841",2011,702,123,579,94
"66389","E01032842",2011,679,114,565,355
"66390","E01032843",2011,695,144,551,75
"66391","E01032844",2011,685,245,440,76
"66392","E01032845",2011,720,85,635,146
"66393","E01032846",2011,742,170,572,285
"66394","E01032847",2011,651,226,425,161
"66395","E01032848",2011,573,69,504,103
"66396","E01032849",2011,564,90,474,68
"66397","E01032850",2011,607,19,588,115
"66398","E01032851",2011,825,301,524,86
"66399","E01032852",2011,619,65,554,76
"66400","E01032853",2011,616,9,607,115
"66401","E01032854",2011,604,18,586,141
"66402","E01032855",2011,440,52,388,71
"66403","E01032856",2011,456,36,420,324
"66404","E01032857",2011,410,2,408,93
"66405","E01032858",2011,864,313,551,132
"66406","E01032859",2011,645,26,619,101
"66407","E01032860",2011,635,10,625,222
"66408","E01032862",2011,693,69,624,253
"66409","E01032863",2011,612,41,571,195
"66410","E01032865",2011,681,17,664,120
"66411","E01032867",2011,813,148,665,558
"66412","E01032868",2011,483,58,425,358
"66413","E01032870",2011,732,26,706,108
"66414","E01032871",2011,637,136,501,77
"66415","E01032872",2011,778,108,670,590
"66416","E01032873",2011,887,328,559,485
"66417","E01032875",2011,423,153,270,215
"66418","E01032876",2011,533,16,517,117
"66419","E01032877",2011,919,87,832,45
"66420","E01032878",2011,607,195,412,238
"66421","E01032879",2011,766,289,477,176
"66422","E01032880",2011,506,35,471,30
"66423","E01032881",2011,595,61,534,56
"66424","E01032882",2011,755,312,443,146
"66425","E01032883",2011,632,164,468,63
"66426","E01032884",2011,976,32,944,216
"66427","E01032885",2011,665,3,662,316
"66428","E01032886",2011,775,11,764,192
"66429","E01032887",2011,979,390,589,134
"66430","E01032888",2011,1013,552,461,71
"66431","E01032889",2011,696,342,354,58
"66432","E01032890",2011,822,329,493,98
"66433","E01032891",2011,694,28,666,212
"66434","E01032892",2011,766,78,688,91
"66435","E01032893",2011,589,43,546,29
"66436","E01032894",2011,483,57,426,62
"66437","E01032895",2011,542,28,514,52
"66438","E01032896",2011,564,99,465,271
"66439","E01032897",2011,577,57,520,148
"66440","E01032898",2011,599,192,407,231
"66441","E01032899",2011,831,224,607,130
"66442","E01032900",2011,792,134,658,185
"66443","E01032901",2011,634,66,568,98
"66444","E01032902",2011,598,30,568,115
"66445","E01032903",2011,1081,270,811,291
"66446","E01032904",2011,688,16,672,59
"66447","E01032905",2011,671,108,563,59
"66448","E01032906",2011,712,311,401,306
"66449","E01032907",2011,659,333,326,225
"66450","E01032909",2011,837,15,822,688
"66451","E01032911",2011,731,85,646,502
"66452","E01032912",2011,779,403,376,180
"66453","E01032914",2011,943,98,845,657
"66454","E01032915",2011,693,374,319,170
"66455","E01032917",2011,591,145,446,302
"66456","E01032919",2011,976,273,703,367
"66457","E01032920",2011,880,233,647,145
"66458","E01032921",2011,771,276,495,114
"66459","E01032922",2011,1071,139,932,94
"66460","E01032923",2011,1126,332,794,202
"66461","E01032924",2011,602,30,572,136
"66462","E01032925",2011,603,136,467,86
"66463","E01032926",2011,642,5,637,94
"66464","E01032927",2011,634,30,604,105
"66465","E01032928",2011,826,76,750,228
"66466","E01032929",2011,497,51,446,40
"66467","E01032930",2011,1122,349,773,433
"66468","E01032931",2011,581,54,527,256
"66469","E01032932",2011,628,153,475,89
"66470","E01032933",2011,535,95,440,117
"66471","E01032934",2011,573,17,556,82
"66472","E01032935",2011,556,61,495,97
"66473","E01032936",2011,623,200,423,124
"66474","E01032937",2011,604,264,340,212
"66475","E01032938",2011,608,56,552,139
"66476","E01032939",2011,584,33,551,130
"66477","E01032940",2011,541,28,513,118
"66478","E01032941",2011,629,272,357,132
"66479","E01032942",2011,657,135,522,265
"66480","E01032943",2011,623,70,553,159
"66481","E01032944",2011,612,47,565,157
"66482","E01032945",2011,848,56,792,617
"66483","E01032946",2011,778,123,655,447
"66484","E01032947",2011,693,99,594,138
"66485","E01032948",2011,706,43,663,88
"66486","E01032949",2011,577,65,512,146
"66487","E01032950",2011,679,49,630,139
"66488","E01032951",2011,710,115,595,280
"66489","E01032952",2011,620,29,591,110
"66490","E01032953",2011,850,71,779,447
"66491","E01032954",2011,1130,160,970,172
"66492","E01032955",2011,722,151,571,176
"66493","E01032956",2011,670,3,667,142
"66494","E01032957",2011,598,11,587,197
"66495","E01032958",2011,622,66,556,75
"66496","E01032959",2011,628,236,392,38
"66497","E01032960",2011,954,89,865,122
"66498","E01032961",2011,503,100,403,204
"66499","E01032962",2011,656,7,649,158
"66500","E01032963",2011,613,16,597,146
"66501","E01032964",2011,584,5,579,160
"66502","E01032965",2011,492,22,470,131
"66503","E01032966",2011,603,17,586,169
"66504","E01032967",2011,540,11,529,197
"66505","E01032968",2011,909,63,846,44
"66506","E01032969",2011,490,46,444,70
"66507","E01032970",2011,571,82,489,63
"66508","E01032971",2011,508,42,466,126
"66509","E01032972",2011,578,39,539,44
"66510","E01032973",2011,596,39,557,65
"66511","E01032974",2011,535,45,490,60
"66512","E01032975",2011,651,13,638,119
"66513","E01032976",2011,651,129,522,104
"66514","E01032977",2011,707,114,593,165
"66515","E01032978",2011,799,471,328,188
"66516","E01032979",2011,743,499,244,161
"66517","E01032980",2011,732,103,629,427
"66518","E01032981",2011,669,44,625,275
"66519","E01032982",2011,500,28,472,116
"66520","E01032983",2011,523,16,507,90
"66521","E01032984",2011,539,7,532,82
"66522","E01032985",2011,611,59,552,69
"66523","E01032986",2011,593,68,525,216
"66524","E01032987",2011,640,51,589,157
"66525","E01032988",2011,599,172,427,95
"66526","E01032989",2011,551,46,505,116
"66527","E01032990",2011,919,16,903,252
"66528","E01032991",2011,630,30,600,86
"66529","E01032992",2011,600,37,563,65
"66530","E01032993",2011,623,8,615,39
"66531","E01032994",2011,556,30,526,81
"66532","E01032995",2011,692,107,585,235
"66533","E01032996",2011,542,35,507,50
"66534","E01032997",2011,472,50,422,75
"66535","E01032998",2011,482,29,453,120
"66536","E01032999",2011,521,27,494,77
"66537","E01033000",2011,663,491,172,61
"66538","E01033002",2011,761,272,489,338
"66539","E01033003",2011,1109,607,502,421
"66540","E01033005",2011,876,429,447,342
"66541","E01033006",2011,1016,170,846,748
"66542","E01033008",2011,704,21,683,557
"66543","E01033010",2011,690,38,652,513
"66544","E01033011",2011,761,30,731,587
"66545","E01033013",2011,647,171,476,355
"66546","E01033015",2011,705,36,669,532
"66547","E01033016",2011,709,44,665,469
"66548","E01033018",2011,729,23,706,658
"66549","E01033019",2011,766,15,751,638
"66550","E01033021",2011,697,372,325,162
"66551","E01033022",2011,663,66,597,256
"66552","E01033023",2011,736,137,599,207
"66553","E01033024",2011,535,5,530,38
"66554","E01033025",2011,519,35,484,66
"66555","E01033026",2011,573,34,539,112
"66556","E01033027",2011,605,88,517,94
"66557","E01033028",2011,515,67,448,46
"66558","E01033029",2011,584,89,495,96
"66559","E01033030",2011,773,128,645,331
"66560","E01033031",2011,782,333,449,339
"66561","E01033032",2011,789,115,674,492
"66562","E01033033",2011,740,200,540,480
"66563","E01033034",2011,645,31,614,426
"66564","E01033035",2011,752,634,118,45
"66565","E01033036",2011,621,57,564,84
"66566","E01033037",2011,608,126,482,117
"66567","E01033038",2011,779,149,630,216
"66568","E01033039",2011,467,74,393,80
"66569","E01033040",2011,398,118,280,49
"66570","E01033041",2011,400,40,360,87
"66571","E01033042",2011,864,79,785,176
"66572","E01033043",2011,616,134,482,174
"66573","E01033044",2011,520,59,461,116
"66574","E01033045",2011,402,34,368,66
"66575","E01033046",2011,605,196,409,202
"66576","E01033047",2011,500,51,449,136
"66577","E01033048",2011,650,211,439,125
"66578","E01033049",2011,653,99,554,166
"66579","E01033050",2011,521,50,471,111
"66580","E01033051",2011,1096,139,957,197
"66581","E01033052",2011,621,123,498,82
"66582","E01033053",2011,622,44,578,92
"66583","E01033054",2011,468,150,318,35
"66584","E01033055",2011,542,14,528,52
"66585","E01033056",2011,521,116,405,58
"66586","E01033057",2011,950,146,804,48
"66587","E01033058",2011,911,160,751,194
"66588","E01033059",2011,582,17,565,76
"66589","E01033060",2011,439,7,432,60
"66590","E01033061",2011,653,3,650,31
"66591","E01033062",2011,914,38,876,37
"66592","E01033063",2011,569,63,506,123
"66593","E01033064",2011,686,184,502,144
"66594","E01033065",2011,473,32,441,138
"66595","E01033066",2011,548,46,502,301
"66596","E01033067",2011,733,316,417,254
"66597","E01033068",2011,683,73,610,406
"66598","E01033069",2011,645,72,573,279
"66599","E01033070",2011,702,145,557,365
"66600","E01033071",2011,572,49,523,346
"66601","E01033072",2011,1070,22,1048,118
"66602","E01033073",2011,695,75,620,270
"66603","E01033074",2011,887,370,517,55
"66604","E01033075",2011,950,490,460,166
"66605","E01033076",2011,596,333,263,42
"66606","E01033077",2011,741,299,442,34
"66607","E01033078",2011,706,19,687,116
"66608","E01033079",2011,471,50,421,48
"66609","E01033080",2011,1187,227,960,567
"66610","E01033081",2011,649,182,467,248
"66611","E01033082",2011,659,167,492,174
"66612","E01033083",2011,643,62,581,422
"66613","E01033084",2011,648,95,553,310
"66614","E01033085",2011,908,211,697,391
"66615","E01033086",2011,488,344,144,65
"66616","E01033087",2011,699,159,540,279
"66617","E01033088",2011,549,29,520,149
"66618","E01033089",2011,575,143,432,125
"66619","E01033090",2011,632,157,475,214
"66620","E01033091",2011,715,39,676,221
"66621","E01033092",2011,631,176,455,249
"66622","E01033093",2011,766,16,750,292
"66623","E01033094",2011,565,54,511,291
"66624","E01033095",2011,747,52,695,51
"66625","E01033096",2011,989,34,955,58
"66626","E01033097",2011,600,51,549,309
"66627","E01033098",2011,629,44,585,300
"66628","E01033099",2011,456,118,338,133
"66629","E01033100",2011,612,245,367,210
"66630","E01033101",2011,663,15,648,290
"66631","E01033102",2011,649,58,591,117
"66632","E01033103",2011,638,9,629,50
"66633","E01033104",2011,911,200,711,559
"66634","E01033105",2011,556,9,547,76
"66635","E01033106",2011,495,12,483,84
"66636","E01033107",2011,492,11,481,53
"66637","E01033108",2011,554,6,548,59
"66638","E01033109",2011,834,290,544,351
"66639","E01033110",2011,728,365,363,122
"66640","E01033111",2011,656,102,554,131
"66641","E01033112",2011,594,170,424,225
"66642","E01033113",2011,452,119,333,53
"66643","E01033114",2011,561,87,474,109
"66644","E01033115",2011,467,61,406,86
"66645","E01033116",2011,641,104,537,71
"66646","E01033117",2011,468,72,396,79
"66647","E01033118",2011,575,56,519,77
"66648","E01033119",2011,660,90,570,81
"66649","E01033120",2011,530,204,326,91
"66650","E01033121",2011,558,185,373,131
"66651","E01033122",2011,664,235,429,258
"66652","E01033123",2011,809,115,694,309
"66653","E01033124",2011,440,63,377,302
"66654","E01033125",2011,632,146,486,379
"66655","E01033126",2011,768,67,701,518
"66656","E01033127",2011,604,167,437,169
"66657","E01033128",2011,485,92,393,105
"66658","E01033129",2011,646,267,379,235
"66659","E01033130",2011,633,203,430,255
"66660","E01033131",2011,554,260,294,59
"66661","E01033132",2011,619,154,465,222
"66662","E01033133",2011,636,105,531,269
"66663","E01033135",2011,475,13,462,174
"66664","E01033137",2011,647,72,575,133
"66665","E01033138",2011,638,98,540,119
"66666","E01033139",2011,639,113,526,247
"66667","E01033140",2011,627,59,568,283
"66668","E01033141",2011,604,62,542,212
"66669","E01033142",2011,747,97,650,58
"66670","E01033143",2011,1176,38,1138,90
"66671","E01033144",2011,619,114,505,58
"66672","E01033145",2011,575,121,454,28
"66673","E01033146",2011,593,257,336,152
"66674","E01033148",2011,661,253,408,107
"66675","E01033150",2011,702,136,566,269
"66676","E01033151",2011,541,288,253,88
"66677","E01033153",2011,936,600,336,155
"66678","E01033154",2011,469,34,435,324
"66679","E01033156",2011,656,45,611,112
"66680","E01033158",2011,564,28,536,69
"66681","E01033159",2011,429,31,398,157
"66682","E01033160",2011,888,250,638,60
"66683","E01033161",2011,616,17,599,96
"66684","E01033163",2011,820,46,774,88
"66685","E01033164",2011,436,27,409,231
"66686","E01033166",2011,584,277,307,194
"66687","E01033167",2011,621,326,295,175
"66688","E01033168",2011,494,32,462,44
"66689","E01033169",2011,558,21,537,74
"66690","E01033170",2011,566,22,544,92
"66691","E01033171",2011,655,49,606,202
"66692","E01033172",2011,730,103,627,290
"66693","E01033173",2011,733,27,706,194
"66694","E01033174",2011,549,170,379,167
"66695","E01033175",2011,529,43,486,101
"66696","E01033176",2011,575,76,499,182
"66697","E01033177",2011,546,88,458,133
"66698","E01033178",2011,559,156,403,128
"66699","E01033179",2011,620,146,474,50
"66700","E01033180",2011,581,128,453,183
"66701","E01033181",2011,564,59,505,142
"66702","E01033182",2011,636,129,507,202
"66703","E01033183",2011,421,40,381,354
"66704","E01033184",2011,496,42,454,248
"66705","E01033185",2011,611,70,541,126
"66706","E01033186",2011,625,29,596,79
"66707","E01033187",2011,837,525,312,41
"66708","E01033188",2011,577,71,506,20
"66709","E01033189",2011,611,35,576,74
"66710","E01033190",2011,596,52,544,103
"66711","E01033191",2011,564,66,498,91
"66712","E01033192",2011,571,58,513,103
"66713","E01033193",2011,602,45,557,72
"66714","E01033194",2011,775,72,703,185
"66715","E01033195",2011,411,36,375,128
"66716","E01033197",2011,401,69,332,202
"66717","E01033198",2011,639,55,584,184
"66718","E01033200",2011,938,91,847,231
"66719","E01033202",2011,524,115,409,63
"66720","E01033203",2011,1254,193,1061,228
"66721","E01033205",2011,625,75,550,79
"66722","E01033206",2011,652,181,471,64
"66723","E01033207",2011,766,420,346,160
"66724","E01033208",2011,1018,199,819,378
"66725","E01033209",2011,574,8,566,250
"66726","E01033210",2011,961,43,918,85
"66727","E01033211",2011,668,149,519,233
"66728","E01033212",2011,913,125,788,632
"66729","E01033213",2011,643,75,568,135
"66730","E01033214",2011,619,16,603,63
"66731","E01033215",2011,791,61,730,407
"66732","E01033216",2011,1186,189,997,306
"66733","E01033217",2011,658,345,313,214
"66734","E01033218",2011,648,33,615,138
"66735","E01033219",2011,593,10,583,46
"66736","E01033220",2011,745,468,277,114
"66737","E01033221",2011,420,125,295,178
"66738","E01033223",2011,606,289,317,278
"66739","E01033224",2011,600,236,364,213
"66740","E01033226",2011,567,314,253,109
"66741","E01033228",2011,810,512,298,43
"66742","E01033229",2011,647,29,618,77
"66743","E01033231",2011,880,147,733,206
"66744","E01033232",2011,619,76,543,163
"66745","E01033233",2011,969,72,897,88
"66746","E01033234",2011,608,38,570,123
"66747","E01033235",2011,711,49,662,163
"66748","E01033236",2011,559,48,511,102
"66749","E01033237",2011,559,281,278,44
"66750","E01033239",2011,1135,24,1111,97
"66751","E01033241",2011,679,17,662,403
"66752","E01033242",2011,590,35,555,330
"66753","E01033243",2011,542,9,533,111
"66754","E01033244",2011,925,8,917,104
"66755","E01033245",2011,423,18,405,71
"66756","E01033246",2011,625,128,497,173
"66757","E01033247",2011,600,117,483,350
"66758","E01033248",2011,658,178,480,320
"66759","E01033249",2011,669,189,480,275
"66760","E01033250",2011,552,22,530,132
"66761","E01033251",2011,458,74,384,89
"66762","E01033252",2011,546,13,533,17
"66763","E01033253",2011,751,49,702,429
"66764","E01033254",2011,574,23,551,117
"66765","E01033255",2011,640,109,531,72
"66766","E01033256",2011,707,117,590,363
"66767","E01033257",2011,1113,52,1061,71
"66768","E01033258",2011,795,144,651,148
"66769","E01033259",2011,655,25,630,163
"66770","E01033260",2011,632,41,591,173
"66771","E01033261",2011,718,121,597,544
"66772","E01033262",2011,608,76,532,433
"66773","E01033263",2011,626,83,543,445
"66774","E01033264",2011,632,27,605,477
"66775","E01033265",2011,600,168,432,325
"66776","E01033266",2011,609,77,532,421
"66777","E01033267",2011,567,114,453,384
"66778","E01033268",2011,1054,627,427,257
"66779","E01033269",2011,666,425,241,111
"66780","E01033270",2011,787,225,562,420
"66781","E01033271",2011,778,550,228,169
"66782","E01033272",2011,675,258,417,323
"66783","E01033273",2011,550,122,428,302
"66784","E01033274",2011,569,73,496,410
"66785","E01033275",2011,655,83,572,111
"66786","E01033276",2011,686,112,574,526
"66787","E01033277",2011,954,526,428,71
"66788","E01033278",2011,1173,541,632,58
"66789","E01033279",2011,1014,471,543,74
"66790","E01033280",2011,601,11,590,35
"66791","E01033281",2011,1111,152,959,212
"66792","E01033282",2011,1291,142,1149,584
"66793","E01033283",2011,715,15,700,343
"66794","E01033285",2011,624,99,525,375
"66795","E01033286",2011,611,34,577,248
"66796","E01033288",2011,615,43,572,180
"66797","E01033289",2011,999,135,864,150
"66798","E01033291",2011,660,17,643,85
"66799","E01033292",2011,576,182,394,116
"66800","E01033294",2011,1017,68,949,138
"66801","E01033296",2011,601,31,570,52
"66802","E01033297",2011,652,6,646,194
"66803","E01033299",2011,971,114,857,359
"66804","E01033300",2011,613,163,450,344
"66805","E01033302",2011,740,200,540,178
"66806","E01033303",2011,591,56,535,210
"66807","E01033305",2011,664,92,572,264
"66808","E01033306",2011,804,161,643,227
"66809","E01033308",2011,649,174,475,303
"66810","E01033310",2011,630,79,551,104
"66811","E01033311",2011,614,215,399,79
"66812","E01033313",2011,534,62,472,71
"66813","E01033314",2011,645,184,461,262
"66814","E01033316",2011,624,49,575,100
"66815","E01033317",2011,651,24,627,162
"66816","E01033319",2011,726,12,714,129
"66817","E01033320",2011,645,131,514,184
"66818","E01033322",2011,594,100,494,249
"66819","E01033324",2011,642,277,365,124
"66820","E01033325",2011,706,11,695,445
"66821","E01033327",2011,679,83,596,304
"66822","E01033328",2011,717,109,608,298
"66823","E01033329",2011,798,131,667,283
"66824","E01033330",2011,875,688,187,59
"66825","E01033331",2011,588,45,543,226
"66826","E01033333",2011,552,48,504,112
"66827","E01033334",2011,639,6,633,331
"66828","E01033336",2011,607,27,580,64
"66829","E01033338",2011,630,37,593,57
"66830","E01033339",2011,607,135,472,104
"66831","E01033341",2011,551,194,357,178
"66832","E01033342",2011,887,200,687,567
"66833","E01033344",2011,646,155,491,274
"66834","E01033345",2011,661,61,600,396
"66835","E01033347",2011,608,222,386,243
"66836","E01033348",2011,537,232,305,197
"66837","E01033350",2011,635,66,569,262
"66838","E01033352",2011,678,129,549,282
"66839","E01033353",2011,713,290,423,322
"66840","E01033355",2011,606,74,532,349
"66841","E01033356",2011,693,450,243,117
"66842","E01033358",2011,689,458,231,165
"66843","E01033359",2011,704,201,503,377
"66844","E01033361",2011,717,264,453,266
"66845","E01033362",2011,685,92,593,355
"66846","E01033364",2011,780,103,677,258
"66847","E01033366",2011,575,385,190,88
"66848","E01033367",2011,666,270,396,262
"66849","E01033369",2011,601,393,208,65
"66850","E01033370",2011,694,403,291,214
"66851","E01033372",2011,605,23,582,168
"66852","E01033373",2011,631,174,457,127
"66853","E01033375",2011,444,2,442,65
"66854","E01033376",2011,447,3,444,98
"66855","E01033378",2011,529,14,515,41
"66856","E01033380",2011,850,25,825,413
"66857","E01033381",2011,724,220,504,247
"66858","E01033383",2011,594,369,225,81
"66859","E01033384",2011,803,57,746,228
"66860","E01033386",2011,943,168,775,84
"66861","E01033387",2011,621,32,589,335
"66862","E01033388",2011,631,130,501,141
"66863","E01033389",2011,594,3,591,168
"66864","E01033390",2011,584,3,581,121
"66865","E01033391",2011,511,11,500,23
"66866","E01033392",2011,960,218,742,125
"66867","E01033393",2011,865,20,845,207
"66868","E01033394",2011,561,24,537,59
"66869","E01033395",2011,549,212,337,296
"66870","E01033396",2011,552,325,227,154
"66871","E01033397",2011,694,208,486,161
"66872","E01033398",2011,637,248,389,206
"66873","E01033399",2011,569,296,273,169
"66874","E01033400",2011,599,241,358,221
"66875","E01033401",2011,559,96,463,379
"66876","E01033402",2011,623,170,453,394
"66877","E01033403",2011,639,189,450,306
"66878","E01033404",2011,1219,315,904,742
"66879","E01033405",2011,711,165,546,484
"66880","E01033406",2011,602,93,509,421
"66881","E01033407",2011,640,76,564,466
"66882","E01033408",2011,1014,123,891,620
"66883","E01033409",2011,619,496,123,93
"66884","E01033410",2011,820,58,762,550
"66885","E01033411",2011,578,374,204,69
"66886","E01033412",2011,1007,33,974,56
"66887","E01033413",2011,950,52,898,113
"66888","E01033414",2011,970,63,907,120
"66889","E01033415",2011,766,81,685,485
"66890","E01033417",2011,598,83,515,287
"66891","E01033418",2011,625,80,545,345
"66892","E01033420",2011,645,87,558,396
"66893","E01033421",2011,868,376,492,301
"66894","E01033422",2011,613,105,508,328
"66895","E01033423",2011,609,44,565,337
"66896","E01033424",2011,638,265,373,216
"66897","E01033425",2011,700,44,656,112
"66898","E01033426",2011,514,48,466,64
"66899","E01033427",2011,482,72,410,59
"66900","E01033428",2011,627,51,576,120
"66901","E01033429",2011,811,59,752,117
"66902","E01033430",2011,597,244,353,53
"66903","E01033431",2011,482,120,362,23
"66904","E01033432",2011,925,76,849,71
"66905","E01033433",2011,808,99,709,105
"66906","E01033434",2011,615,75,540,243
"66907","E01033435",2011,705,134,571,239
"66908","E01033436",2011,596,319,277,79
"66909","E01033437",2011,786,480,306,122
"66910","E01033438",2011,878,227,651,314
"66911","E01033439",2011,763,41,722,393
"66912","E01033440",2011,662,280,382,221
"66913","E01033441",2011,773,101,672,415
"66914","E01033442",2011,546,16,530,101
"66915","E01033443",2011,527,22,505,197
"66916","E01033444",2011,512,12,500,104
"66917","E01033445",2011,649,61,588,98
"66918","E01033446",2011,871,65,806,139
"66919","E01033447",2011,585,11,574,47
"66920","E01033448",2011,544,61,483,112
"66921","E01033449",2011,662,32,630,181
"66922","E01033450",2011,1119,93,1026,72
"66923","E01033451",2011,622,94,528,215
"66924","E01033452",2011,583,47,536,159
"66925","E01033453",2011,938,109,829,335
"66926","E01033454",2011,543,55,488,151
"66927","E01033455",2011,501,117,384,266
"66928","E01033456",2011,743,589,154,63
"66929","E01033457",2011,562,24,538,281
"66930","E01033458",2011,691,87,604,373
"66931","E01033459",2011,876,48,828,322
"66932","E01033460",2011,567,84,483,112
"66933","E01033461",2011,580,57,523,114
"66934","E01033462",2011,479,56,423,119
"66935","E01033463",2011,848,49,799,153
"66936","E01033464",2011,813,103,710,196
"66937","E01033465",2011,699,28,671,73
"66938","E01033466",2011,877,399,478,135
"66939","E01033467",2011,615,231,384,59
"66940","E01033468",2011,1253,661,592,292
"66941","E01033469",2011,811,357,454,107
"66942","E01033470",2011,809,332,477,114
"66943","E01033471",2011,874,469,405,113
"66944","E01033472",2011,1063,93,970,124
"66945","E01033473",2011,910,324,586,135
"66946","E01033474",2011,619,2,617,108
"66947","E01033475",2011,575,2,573,51
"66948","E01033476",2011,597,5,592,44
"66949","E01033477",2011,1136,235,901,551
"66950","E01033478",2011,582,0,582,39
"66951","E01033479",2011,616,1,615,74
"66952","E01033480",2011,630,7,623,38
"66953","E01033481",2011,554,18,536,158
"66954","E01033482",2011,650,6,644,102
"66955","E01033483",2011,552,210,342,218
"66956","E01033484",2011,696,156,540,325
"66957","E01033485",2011,789,307,482,303
"66958","E01033486",2011,425,213,212,97
"66959","E01033487",2011,595,116,479,276
"66960","E01033488",2011,557,321,236,135
"66961","E01033489",2011,776,81,695,357
"66962","E01033490",2011,703,219,484,312
"66963","E01033491",2011,869,248,621,391
"66964","E01033492",2011,687,174,513,321
"66965","E01033493",2011,701,30,671,473
"66966","E01033494",2011,630,128,502,186
"66967","E01033495",2011,580,12,568,165
"66968","E01033496",2011,651,4,647,35
"66969","E01033497",2011,592,142,450,119
"66970","E01033498",2011,643,279,364,80
"66971","E01033499",2011,757,228,529,352
"66972","E01033500",2011,795,66,729,461
"66973","E01033501",2011,704,134,570,173
"66974","E01033503",2011,588,41,547,90
"66975","E01033505",2011,514,27,487,81
"66976","E01033506",2011,703,97,606,114
"66977","E01033508",2011,627,81,546,73
"66978","E01033509",2011,602,129,473,135
"66979","E01033511",2011,595,88,507,208
"66980","E01033512",2011,606,51,555,75
"66981","E01033514",2011,511,68,443,72
"66982","E01033515",2011,620,87,533,61
"66983","E01033517",2011,548,14,534,88
"66984","E01033519",2011,701,69,632,107
"66985","E01033520",2011,631,38,593,81
"66986","E01033522",2011,548,75,473,80
"66987","E01033523",2011,528,68,460,108
"66988","E01033525",2011,582,138,444,94
"66989","E01033526",2011,615,153,462,162
"66990","E01033527",2011,686,51,635,125
"66991","E01033528",2011,1050,83,967,136
"66992","E01033529",2011,431,5,426,42
"66993","E01033530",2011,831,86,745,167
"66994","E01033531",2011,672,34,638,155
"66995","E01033532",2011,554,4,550,101
"66996","E01033533",2011,599,30,569,79
"66997","E01033534",2011,493,6,487,131
"66998","E01033535",2011,553,14,539,74
"66999","E01033536",2011,672,35,637,142
"67000","E01033537",2011,703,43,660,147
"67001","E01033538",2011,860,94,766,181
"67002","E01033539",2011,620,57,563,158
"67003","E01033540",2011,666,116,550,52
"67004","E01033541",2011,657,73,584,146
"67005","E01033542",2011,995,85,910,224
"67006","E01033543",2011,751,103,648,528
"67007","E01033545",2011,760,196,564,409
"67008","E01033547",2011,949,623,326,92
"67009","E01033548",2011,677,243,434,236
"67010","E01033550",2011,694,8,686,97
"67011","E01033551",2011,736,10,726,76
"67012","E01033553",2011,675,211,464,373
"67013","E01033554",2011,736,214,522,336
"67014","E01033556",2011,950,250,700,443
"67015","E01033557",2011,836,57,779,556
"67016","E01033559",2011,769,140,629,475
"67017","E01033561",2011,492,319,173,119
"67018","E01033562",2011,1045,258,787,365
"67019","E01033564",2011,770,58,712,529
"67020","E01033565",2011,623,52,571,392
"67021","E01033567",2011,712,50,662,525
"67022","E01033568",2011,718,108,610,352
"67023","E01033569",2011,696,53,643,296
"67024","E01033570",2011,709,115,594,284
"67025","E01033571",2011,624,160,464,82
"67026","E01033572",2011,571,36,535,185
"67027","E01033573",2011,607,100,507,275
"67028","E01033574",2011,579,21,558,405
"67029","E01033575",2011,545,30,515,425
"67030","E01033576",2011,618,169,449,246
"67031","E01033577",2011,608,143,465,299
"67032","E01033578",2011,603,148,455,363
"67033","E01033579",2011,618,129,489,366
"67034","E01033580",2011,659,30,629,382
"67035","E01033581",2011,714,315,399,203
"67036","E01033582",2011,631,23,608,376
"67037","E01033583",2011,1205,369,836,501
"67038","E01033584",2011,564,369,195,86
"67039","E01033585",2011,954,496,458,288
"67040","E01033586",2011,597,270,327,170
"67041","E01033587",2011,631,246,385,218
"67042","E01033588",2011,618,309,309,154
"67043","E01033589",2011,660,83,577,454
"67044","E01033590",2011,434,86,348,157
"67045","E01033591",2011,630,92,538,273
"67046","E01033592",2011,633,42,591,128
"67047","E01033593",2011,645,110,535,341
"67048","E01033594",2011,711,226,485,323
"67049","E01033595",2011,755,235,520,401
"67050","E01033596",2011,745,326,419,252
"67051","E01033597",2011,621,298,323,191
"67052","E01033598",2011,502,301,201,116
"67053","E01033599",2011,630,423,207,80
"67054","E01033600",2011,644,122,522,257
"67055","E01033601",2011,589,381,208,75
"67056","E01033602",2011,645,411,234,126
"67057","E01033603",2011,600,213,387,217
"67058","E01033604",2011,620,174,446,372
"67059","E01033605",2011,815,415,400,180
"67060","E01033606",2011,614,123,491,325
"67061","E01033607",2011,616,247,369,179
"67062","E01033608",2011,735,119,616,357
"67063","E01033609",2011,971,146,825,149
"67064","E01033610",2011,563,5,558,132
"67065","E01033611",2011,637,9,628,248
"67066","E01033612",2011,595,16,579,124
"67067","E01033613",2011,585,7,578,130
"67068","E01033614",2011,613,4,609,67
"67069","E01033615",2011,616,33,583,482
"67070","E01033616",2011,714,398,316,229
"67071","E01033617",2011,407,87,320,260
"67072","E01033618",2011,745,17,728,517
"67073","E01033619",2011,605,71,534,301
"67074","E01033620",2011,702,75,627,542
"67075","E01033621",2011,866,280,586,171
"67076","E01033622",2011,901,125,776,574
"67077","E01033623",2011,772,222,550,403
"67078","E01033624",2011,498,181,317,165
"67079","E01033625",2011,1058,18,1040,798
"67080","E01033626",2011,556,198,358,228
"67081","E01033627",2011,573,244,329,169
"67082","E01033628",2011,754,377,377,102
"67083","E01033629",2011,1071,468,603,103
"67084","E01033630",2011,595,192,403,229
"67085","E01033631",2011,836,33,803,266
"67086","E01033632",2011,1018,395,623,145
"67087","E01033633",2011,986,466,520,50
"67088","E01033634",2011,800,118,682,616
"67089","E01033635",2011,947,163,784,248
"67090","E01033636",2011,845,166,679,175
"67091","E01033637",2011,850,400,450,73
"67092","E01033638",2011,668,444,224,54
"67093","E01033639",2011,828,409,419,254
"67094","E01033640",2011,564,417,147,72
"67095","E01033641",2011,891,84,807,229
"67096","E01033642",2011,820,115,705,189
"67097","E01033643",2011,814,193,621,173
"67098","E01033644",2011,810,269,541,164
"67099","E01033645",2011,863,173,690,215
"67100","E01033646",2011,772,248,524,290
"67101","E01033647",2011,403,74,329,87
"67102","E01033648",2011,826,290,536,188
"67103","E01033649",2011,465,104,361,86
"67104","E01033650",2011,671,170,501,117
"67105","E01033651",2011,630,41,589,534
"67106","E01033652",2011,411,136,275,219
"67107","E01033653",2011,1036,149,887,558
"67108","E01033654",2011,617,41,576,441
"67109","E01033655",2011,694,20,674,586
"67110","E01033656",2011,761,69,692,609
"67111","E01033657",2011,435,158,277,216
"67112","E01033658",2011,711,33,678,451
"67113","E01033659",2011,760,10,750,541
"67114","E01033660",2011,698,10,688,535
"67115","E01033661",2011,706,144,562,408
"67116","E01033662",2011,842,147,695,461
"67117","E01033663",2011,712,144,568,409
"67118","E01033664",2011,607,12,595,457
"67119","E01033665",2011,723,139,584,458
"67120","E01033666",2011,1103,279,824,234
"67121","E01033667",2011,653,108,545,320
"67122","E01033668",2011,598,143,455,328
"67123","E01033669",2011,677,375,302,134
"67124","E01033670",2011,655,8,647,368
"67125","E01033671",2011,793,14,779,345
"67126","E01033672",2011,725,409,316,202
"67127","E01033673",2011,673,7,666,511
"67128","E01033674",2011,647,124,523,380
"67129","E01033675",2011,757,245,512,262
"67130","E01033676",2011,730,510,220,76
"67131","E01033677",2011,699,14,685,476
"67132","E01033678",2011,688,445,243,89
"67133","E01033679",2011,643,484,159,76
"67134","E01033680",2011,646,139,507,376
"67135","E01033681",2011,844,6,838,564
"67136","E01033682",2011,797,12,785,460
"67137","E01033683",2011,747,13,734,561
"67138","E01033684",2011,649,12,637,571
"67139","E01033685",2011,652,119,533,168
"67140","E01033686",2011,608,184,424,209
"67141","E01033687",2011,802,459,343,112
"67142","E01033688",2011,691,449,242,82
"67143","E01033689",2011,727,170,557,428
"67144","E01033690",2011,694,45,649,582
"67145","E01033691",2011,620,238,382,234
"67146","E01033692",2011,595,181,414,345
"67147","E01033693",2011,659,167,492,234
"67148","E01033694",2011,518,18,500,181
"67149","E01033695",2011,701,83,618,124
"67150","E01033696",2011,652,45,607,129
"67151","E01033697",2011,791,19,772,197
"67152","E01033698",2011,613,416,197,130
"67153","E01033699",2011,585,130,455,311
"67154","E01033700",2011,697,153,544,375
"67155","E01033701",2011,760,532,228,136
"67156","E01033702",2011,480,194,286,151
"67157","E01033703",2011,625,224,401,269
"67158","E01033704",2011,763,157,606,327
"67159","E01033705",2011,576,308,268,157
"67160","E01033706",2011,764,134,630,474
"67161","E01033707",2011,614,249,365,301
"67162","E01033708",2011,862,41,821,622
"67163","E01033709",2011,789,451,338,228
"67164","E01033710",2011,532,108,424,325
"67165","E01033711",2011,501,130,371,241
"67166","E01033712",2011,661,282,379,225
"67167","E01033713",2011,601,177,424,224
"67168","E01033714",2011,972,10,962,89
"67169","E01033715",2011,577,194,383,127
"67170","E01033716",2011,1050,342,708,102
"67171","E01033717",2011,636,88,548,70
"67172","E01033718",2011,1010,332,678,81
"67173","E01033719",2011,544,56,488,383
"67174","E01033720",2011,775,102,673,195
"67175","E01033721",2011,654,33,621,111
"67176","E01033722",2011,586,184,402,204
"67177","E01033723",2011,863,181,682,573
"67178","E01033724",2011,1051,165,886,287
"67179","E01033725",2011,945,219,726,287
"67180","E01033726",2011,818,408,410,51
"67181","E01033727",2011,802,407,395,193
"67182","E01033728",2011,641,64,577,297
"67183","E01033729",2011,802,442,360,89
"67184","E01033730",2011,653,239,414,253
"67185","E01033731",2011,559,177,382,141
"67186","E01033732",2011,472,114,358,180
"67187","E01033733",2011,548,24,524,296
"67188","E01033734",2011,579,124,455,178
"67189","E01033735",2011,555,202,353,300
"67190","E01033736",2011,608,37,571,356
"67191","E01033737",2011,602,357,245,147
"67192","E01033738",2011,519,65,454,190
"67193","E01033739",2011,571,106,465,270
"67194","E01033740",2011,550,80,470,204
"67195","E01033741",2011,559,90,469,184
"67196","E01033742",2011,581,56,525,296
"67197","E01033743",2011,663,187,476,218
"67198","E01033744",2011,646,237,409,175
"67199","E01033745",2011,591,114,477,172
"67200","E01033746",2011,715,228,487,170
"67201","E01033747",2011,496,298,198,101
"67202","E01033748",2011,772,19,753,501
"67203","E01033749",2011,1039,228,811,743
"67204","E01033750",2011,905,22,883,629
"67205","E01033751",2011,603,134,469,266
"67206","E01033752",2011,790,12,778,673
"67207","E01033753",2011,714,8,706,623
"67208","E01033754",2011,838,173,665,514
"67209","E01033755",2011,675,14,661,496
"67210","E01033756",2011,733,51,682,486
"67211","E01033757",2011,715,343,372,328
"67212","E01033758",2011,475,221,254,225
"67213","E01033759",2011,480,192,288,70
"67214","E01033760",2011,529,77,452,378
"67215","E01033761",2011,832,53,779,650
"67216","E01033762",2011,456,102,354,290
"67217","E01033763",2011,820,476,344,223
"67218","E01033764",2011,1172,738,434,191
"67219","E01033765",2011,659,329,330,136
"67220","E01033766",2011,424,25,399,160
"67221","E01033767",2011,562,175,387,182
"67222","E01033768",2011,835,570,265,195
"67223","W01000001",2011,559,90,469,108
"67224","W01000002",2011,559,48,511,90
"67225","W01000003",2011,1131,235,896,200
"67226","W01000004",2011,555,59,496,53
"67227","W01000005",2011,980,142,838,200
"67228","W01000006",2011,654,68,586,74
"67229","W01000007",2011,717,62,655,115
"67230","W01000008",2011,617,49,568,82
"67231","W01000009",2011,778,127,651,102
"67232","W01000010",2011,899,31,868,129
"67233","W01000011",2011,609,62,547,164
"67234","W01000012",2011,665,81,584,42
"67235","W01000013",2011,942,42,900,83
"67236","W01000014",2011,891,176,715,105
"67237","W01000015",2011,653,49,604,74
"67238","W01000016",2011,579,69,510,228
"67239","W01000017",2011,642,116,526,90
"67240","W01000018",2011,646,77,569,96
"67241","W01000019",2011,691,34,657,88
"67242","W01000020",2011,558,18,540,68
"67243","W01000021",2011,968,91,877,112
"67244","W01000022",2011,689,69,620,90
"67245","W01000023",2011,599,107,492,79
"67246","W01000024",2011,508,49,459,204
"67247","W01000025",2011,859,80,779,91
"67248","W01000026",2011,580,59,521,66
"67249","W01000027",2011,773,106,667,129
"67250","W01000028",2011,802,167,635,88
"67251","W01000029",2011,718,209,509,126
"67252","W01000030",2011,997,309,688,174
"67253","W01000031",2011,659,67,592,81
"67254","W01000032",2011,491,48,443,44
"67255","W01000033",2011,697,342,355,47
"67256","W01000034",2011,520,82,438,45
"67257","W01000035",2011,804,81,723,110
"67258","W01000036",2011,522,163,359,95
"67259","W01000037",2011,518,84,434,72
"67260","W01000038",2011,986,131,855,126
"67261","W01000039",2011,472,15,457,51
"67262","W01000040",2011,537,2,535,78
"67263","W01000041",2011,637,345,292,47
"67264","W01000042",2011,910,128,782,101
"67265","W01000043",2011,528,109,419,47
"67266","W01000044",2011,495,9,486,30
"67267","W01000047",2011,586,75,511,78
"67268","W01000048",2011,625,164,461,65
"67269","W01000049",2011,620,91,529,226
"67270","W01000050",2011,580,49,531,126
"67271","W01000051",2011,936,228,708,145
"67272","W01000052",2011,461,38,423,35
"67273","W01000053",2011,497,21,476,71
"67274","W01000054",2011,472,54,418,41
"67275","W01000056",2011,869,157,712,144
"67276","W01000057",2011,635,63,572,68
"67277","W01000059",2011,954,384,570,78
"67278","W01000060",2011,624,62,562,107
"67279","W01000061",2011,801,92,709,116
"67280","W01000062",2011,553,101,452,316
"67281","W01000063",2011,802,162,640,102
"67282","W01000064",2011,693,154,539,113
"67283","W01000065",2011,584,90,494,97
"67284","W01000066",2011,513,52,461,71
"67285","W01000067",2011,592,57,535,118
"67286","W01000068",2011,688,179,509,82
"67287","W01000069",2011,751,64,687,83
"67288","W01000070",2011,543,53,490,66
"67289","W01000071",2011,1016,121,895,171
"67290","W01000072",2011,700,141,559,74
"67291","W01000073",2011,729,78,651,54
"67292","W01000074",2011,946,66,880,135
"67293","W01000075",2011,622,209,413,159
"67294","W01000076",2011,439,68,371,127
"67295","W01000077",2011,586,171,415,182
"67296","W01000078",2011,722,122,600,86
"67297","W01000079",2011,528,49,479,62
"67298","W01000080",2011,915,190,725,115
"67299","W01000081",2011,896,165,731,119
"67300","W01000082",2011,436,53,383,87
"67301","W01000083",2011,560,28,532,71
"67302","W01000084",2011,556,43,513,101
"67303","W01000085",2011,978,76,902,155
"67304","W01000086",2011,952,182,770,83
"67305","W01000087",2011,756,103,653,65
"67306","W01000088",2011,817,86,731,48
"67307","W01000089",2011,849,84,765,99
"67308","W01000090",2011,519,297,222,26
"67309","W01000091",2011,510,285,225,53
"67310","W01000092",2011,697,62,635,405
"67311","W01000093",2011,1037,65,972,151
"67312","W01000094",2011,574,34,540,87
"67313","W01000095",2011,618,127,491,73
"67314","W01000096",2011,513,137,376,55
"67315","W01000097",2011,529,86,443,100
"67316","W01000098",2011,925,528,397,54
"67317","W01000099",2011,724,62,662,72
"67318","W01000100",2011,466,55,411,67
"67319","W01000101",2011,656,97,559,88
"67320","W01000102",2011,477,24,453,78
"67321","W01000103",2011,527,55,472,86
"67322","W01000104",2011,793,180,613,93
"67323","W01000105",2011,779,116,663,150
"67324","W01000106",2011,872,37,835,103
"67325","W01000107",2011,588,138,450,53
"67326","W01000108",2011,1048,198,850,238
"67327","W01000109",2011,871,234,637,165
"67328","W01000110",2011,592,119,473,24
"67329","W01000111",2011,763,180,583,165
"67330","W01000112",2011,861,131,730,104
"67331","W01000113",2011,830,106,724,86
"67332","W01000114",2011,714,108,606,60
"67333","W01000115",2011,908,109,799,85
"67334","W01000116",2011,864,10,854,168
"67335","W01000117",2011,737,193,544,155
"67336","W01000118",2011,715,78,637,60
"67337","W01000119",2011,1006,66,940,233
"67338","W01000121",2011,548,58,490,64
"67339","W01000122",2011,882,78,804,157
"67340","W01000123",2011,744,81,663,123
"67341","W01000124",2011,887,70,817,95
"67342","W01000125",2011,690,43,647,78
"67343","W01000126",2011,743,39,704,117
"67344","W01000127",2011,578,171,407,68
"67345","W01000128",2011,677,104,573,102
"67346","W01000129",2011,497,116,381,80
"67347","W01000130",2011,767,30,737,186
"67348","W01000131",2011,604,98,506,52
"67349","W01000132",2011,708,26,682,271
"67350","W01000133",2011,873,21,852,88
"67351","W01000134",2011,988,218,770,144
"67352","W01000135",2011,1009,6,1003,94
"67353","W01000136",2011,852,108,744,134
"67354","W01000137",2011,630,25,605,96
"67355","W01000138",2011,886,234,652,71
"67356","W01000139",2011,691,57,634,90
"67357","W01000140",2011,651,98,553,134
"67358","W01000141",2011,802,19,783,84
"67359","W01000142",2011,715,6,709,36
"67360","W01000143",2011,649,37,612,181
"67361","W01000144",2011,712,126,586,328
"67362","W01000145",2011,578,167,411,74
"67363","W01000146",2011,1016,48,968,499
"67364","W01000147",2011,760,49,711,159
"67365","W01000148",2011,484,100,384,53
"67366","W01000149",2011,677,10,667,111
"67367","W01000150",2011,632,9,623,64
"67368","W01000151",2011,621,98,523,88
"67369","W01000152",2011,614,28,586,115
"67370","W01000153",2011,713,48,665,67
"67371","W01000154",2011,610,2,608,62
"67372","W01000155",2011,673,13,660,168
"67373","W01000156",2011,819,59,760,186
"67374","W01000157",2011,731,233,498,128
"67375","W01000158",2011,779,82,697,57
"67376","W01000159",2011,564,38,526,115
"67377","W01000162",2011,762,80,682,94
"67378","W01000163",2011,503,240,263,40
"67379","W01000164",2011,549,40,509,82
"67380","W01000165",2011,865,3,862,75
"67381","W01000166",2011,813,117,696,73
"67382","W01000167",2011,815,158,657,106
"67383","W01000168",2011,757,131,626,111
"67384","W01000169",2011,916,217,699,275
"67385","W01000170",2011,783,70,713,78
"67386","W01000171",2011,690,127,563,136
"67387","W01000172",2011,595,101,494,116
"67388","W01000173",2011,652,1,651,108
"67389","W01000174",2011,745,4,741,78
"67390","W01000175",2011,799,4,795,65
"67391","W01000176",2011,718,112,606,166
"67392","W01000177",2011,489,39,450,33
"67393","W01000178",2011,839,241,598,129
"67394","W01000179",2011,775,10,765,80
"67395","W01000180",2011,599,5,594,88
"67396","W01000181",2011,610,8,602,86
"67397","W01000182",2011,950,86,864,438
"67398","W01000183",2011,585,37,548,128
"67399","W01000184",2011,1062,72,990,185
"67400","W01000185",2011,563,53,510,62
"67401","W01000186",2011,828,334,494,142
"67402","W01000187",2011,633,388,245,43
"67403","W01000188",2011,780,75,705,63
"67404","W01000189",2011,644,85,559,110
"67405","W01000190",2011,599,78,521,107
"67406","W01000191",2011,881,100,781,167
"67407","W01000192",2011,451,69,382,53
"67408","W01000193",2011,572,135,437,85
"67409","W01000194",2011,951,90,861,288
"67410","W01000195",2011,622,18,604,55
"67411","W01000196",2011,563,26,537,73
"67412","W01000197",2011,697,105,592,73
"67413","W01000198",2011,639,409,230,42
"67414","W01000199",2011,715,150,565,94
"67415","W01000200",2011,524,8,516,54
"67416","W01000201",2011,660,127,533,122
"67417","W01000202",2011,654,39,615,37
"67418","W01000203",2011,986,67,919,93
"67419","W01000204",2011,622,43,579,96
"67420","W01000205",2011,489,64,425,39
"67421","W01000206",2011,852,92,760,126
"67422","W01000207",2011,946,90,856,134
"67423","W01000208",2011,561,58,503,172
"67424","W01000209",2011,678,173,505,62
"67425","W01000210",2011,607,41,566,74
"67426","W01000211",2011,749,54,695,87
"67427","W01000212",2011,919,16,903,80
"67428","W01000213",2011,588,195,393,89
"67429","W01000214",2011,475,15,460,96
"67430","W01000215",2011,582,8,574,37
"67431","W01000216",2011,572,123,449,83
"67432","W01000217",2011,862,123,739,92
"67433","W01000218",2011,686,69,617,115
"67434","W01000219",2011,1058,17,1041,257
"67435","W01000220",2011,878,7,871,100
"67436","W01000221",2011,672,16,656,137
"67437","W01000222",2011,800,3,797,102
"67438","W01000223",2011,580,10,570,94
"67439","W01000224",2011,610,76,534,57
"67440","W01000225",2011,718,77,641,141
"67441","W01000226",2011,709,92,617,102
"67442","W01000227",2011,732,67,665,135
"67443","W01000228",2011,534,37,497,200
"67444","W01000229",2011,772,109,663,80
"67445","W01000230",2011,888,15,873,99
"67446","W01000231",2011,615,63,552,107
"67447","W01000232",2011,680,6,674,84
"67448","W01000233",2011,568,30,538,73
"67449","W01000234",2011,567,186,381,73
"67450","W01000235",2011,563,11,552,72
"67451","W01000236",2011,774,297,477,127
"67452","W01000237",2011,639,345,294,63
"67453","W01000238",2011,645,65,580,115
"67454","W01000239",2011,897,235,662,395
"67455","W01000240",2011,720,219,501,350
"67456","W01000241",2011,492,77,415,146
"67457","W01000242",2011,881,242,639,115
"67458","W01000243",2011,792,111,681,166
"67459","W01000244",2011,733,14,719,52
"67460","W01000245",2011,737,111,626,90
"67461","W01000246",2011,711,149,562,85
"67462","W01000247",2011,815,74,741,112
"67463","W01000248",2011,663,57,606,99
"67464","W01000249",2011,510,2,508,32
"67465","W01000250",2011,647,16,631,46
"67466","W01000251",2011,597,156,441,45
"67467","W01000252",2011,723,20,703,44
"67468","W01000253",2011,784,97,687,82
"67469","W01000254",2011,920,227,693,124
"67470","W01000255",2011,955,138,817,121
"67471","W01000256",2011,660,128,532,80
"67472","W01000257",2011,900,18,882,78
"67473","W01000258",2011,918,81,837,53
"67474","W01000259",2011,751,181,570,115
"67475","W01000260",2011,763,7,756,52
"67476","W01000261",2011,644,15,629,72
"67477","W01000262",2011,652,153,499,106
"67478","W01000263",2011,639,308,331,39
"67479","W01000264",2011,655,92,563,90
"67480","W01000265",2011,596,27,569,66
"67481","W01000266",2011,599,41,558,111
"67482","W01000267",2011,694,59,635,62
"67483","W01000268",2011,681,30,651,40
"67484","W01000269",2011,735,129,606,112
"67485","W01000270",2011,521,22,499,58
"67486","W01000271",2011,569,60,509,81
"67487","W01000272",2011,767,61,706,54
"67488","W01000273",2011,645,150,495,55
"67489","W01000274",2011,837,320,517,143
"67490","W01000275",2011,496,23,473,59
"67491","W01000276",2011,517,38,479,88
"67492","W01000277",2011,522,8,514,79
"67493","W01000278",2011,618,291,327,40
"67494","W01000279",2011,515,20,495,21
"67495","W01000280",2011,566,75,491,44
"67496","W01000281",2011,515,18,497,35
"67497","W01000282",2011,561,4,557,32
"67498","W01000283",2011,931,39,892,128
"67499","W01000284",2011,668,4,664,67
"67500","W01000285",2011,608,5,603,50
"67501","W01000286",2011,882,6,876,105
"67502","W01000287",2011,828,94,734,126
"67503","W01000288",2011,1027,527,500,95
"67504","W01000289",2011,493,19,474,32
"67505","W01000290",2011,633,332,301,60
"67506","W01000291",2011,573,79,494,72
"67507","W01000292",2011,546,132,414,66
"67508","W01000293",2011,656,125,531,77
"67509","W01000294",2011,709,9,700,40
"67510","W01000295",2011,625,39,586,42
"67511","W01000296",2011,638,224,414,45
"67512","W01000297",2011,500,79,421,63
"67513","W01000298",2011,675,117,558,74
"67514","W01000299",2011,842,47,795,50
"67515","W01000300",2011,743,44,699,88
"67516","W01000301",2011,731,64,667,64
"67517","W01000302",2011,830,16,814,111
"67518","W01000303",2011,660,24,636,57
"67519","W01000304",2011,896,350,546,139
"67520","W01000305",2011,753,131,622,56
"67521","W01000306",2011,972,159,813,89
"67522","W01000307",2011,524,10,514,38
"67523","W01000308",2011,510,81,429,38
"67524","W01000309",2011,906,129,777,122
"67525","W01000310",2011,767,58,709,56
"67526","W01000311",2011,748,193,555,92
"67527","W01000312",2011,775,135,640,66
"67528","W01000313",2011,650,146,504,75
"67529","W01000314",2011,562,86,476,110
"67530","W01000315",2011,898,124,774,99
"67531","W01000316",2011,516,7,509,34
"67532","W01000317",2011,508,3,505,14
"67533","W01000318",2011,453,251,202,22
"67534","W01000319",2011,726,165,561,107
"67535","W01000320",2011,762,207,555,82
"67536","W01000321",2011,685,7,678,43
"67537","W01000322",2011,563,59,504,27
"67538","W01000323",2011,665,55,610,69
"67539","W01000324",2011,608,21,587,48
"67540","W01000325",2011,644,45,599,49
"67541","W01000326",2011,686,60,626,36
"67542","W01000327",2011,878,41,837,87
"67543","W01000328",2011,930,131,799,216
"67544","W01000329",2011,605,159,446,108
"67545","W01000330",2011,913,322,591,128
"67546","W01000331",2011,635,65,570,43
"67547","W01000332",2011,645,124,521,69
"67548","W01000333",2011,614,316,298,61
"67549","W01000334",2011,871,106,765,169
"67550","W01000335",2011,491,215,276,32
"67551","W01000336",2011,575,330,245,30
"67552","W01000337",2011,954,100,854,184
"67553","W01000338",2011,788,97,691,106
"67554","W01000339",2011,678,105,573,34
"67555","W01000340",2011,957,18,939,80
"67556","W01000341",2011,684,146,538,68
"67557","W01000342",2011,727,278,449,72
"67558","W01000343",2011,463,2,461,18
"67559","W01000344",2011,586,3,583,17
"67560","W01000345",2011,684,28,656,94
"67561","W01000346",2011,632,43,589,87
"67562","W01000347",2011,1047,72,975,214
"67563","W01000348",2011,622,275,347,44
"67564","W01000349",2011,840,203,637,114
"67565","W01000350",2011,716,125,591,329
"67566","W01000351",2011,882,170,712,71
"67567","W01000352",2011,408,134,274,33
"67568","W01000353",2011,552,343,209,27
"67569","W01000354",2011,719,75,644,54
"67570","W01000355",2011,770,299,471,70
"67571","W01000356",2011,645,278,367,27
"67572","W01000359",2011,507,57,450,45
"67573","W01000360",2011,532,171,361,29
"67574","W01000361",2011,893,238,655,87
"67575","W01000362",2011,622,271,351,41
"67576","W01000363",2011,689,121,568,45
"67577","W01000364",2011,688,63,625,80
"67578","W01000365",2011,822,88,734,138
"67579","W01000366",2011,619,196,423,57
"67580","W01000367",2011,543,40,503,59
"67581","W01000368",2011,918,7,911,74
"67582","W01000369",2011,594,64,530,35
"67583","W01000370",2011,630,17,613,94
"67584","W01000371",2011,527,35,492,157
"67585","W01000372",2011,598,151,447,190
"67586","W01000373",2011,753,287,466,59
"67587","W01000374",2011,604,183,421,28
"67588","W01000375",2011,822,148,674,103
"67589","W01000376",2011,555,54,501,27
"67590","W01000377",2011,602,68,534,64
"67591","W01000378",2011,532,205,327,55
"67592","W01000379",2011,708,323,385,35
"67593","W01000380",2011,489,12,477,45
"67594","W01000381",2011,534,145,389,95
"67595","W01000382",2011,545,290,255,96
"67596","W01000383",2011,922,58,864,118
"67597","W01000384",2011,485,32,453,45
"67598","W01000385",2011,750,28,722,48
"67599","W01000386",2011,661,225,436,83
"67600","W01000387",2011,508,11,497,34
"67601","W01000388",2011,470,72,398,22
"67602","W01000389",2011,869,145,724,65
"67603","W01000390",2011,670,38,632,48
"67604","W01000391",2011,610,81,529,39
"67605","W01000392",2011,696,359,337,45
"67606","W01000393",2011,828,175,653,68
"67607","W01000394",2011,506,19,487,113
"67608","W01000395",2011,475,82,393,47
"67609","W01000396",2011,500,9,491,32
"67610","W01000397",2011,412,3,409,25
"67611","W01000398",2011,571,87,484,40
"67612","W01000399",2011,465,23,442,26
"67613","W01000400",2011,742,164,578,87
"67614","W01000401",2011,794,228,566,95
"67615","W01000402",2011,1137,118,1019,502
"67616","W01000403",2011,555,43,512,95
"67617","W01000404",2011,826,112,714,120
"67618","W01000405",2011,919,340,579,62
"67619","W01000406",2011,880,322,558,45
"67620","W01000407",2011,596,17,579,114
"67621","W01000408",2011,506,134,372,34
"67622","W01000409",2011,815,636,179,29
"67623","W01000410",2011,724,85,639,109
"67624","W01000411",2011,796,340,456,101
"67625","W01000412",2011,703,80,623,131
"67626","W01000413",2011,553,472,81,5
"67627","W01000414",2011,515,315,200,36
"67628","W01000415",2011,683,74,609,64
"67629","W01000416",2011,508,2,506,49
"67630","W01000417",2011,640,10,630,54
"67631","W01000418",2011,724,123,601,79
"67632","W01000419",2011,619,249,370,50
"67633","W01000420",2011,630,111,519,102
"67634","W01000422",2011,944,152,792,95
"67635","W01000423",2011,886,286,600,145
"67636","W01000424",2011,556,96,460,68
"67637","W01000425",2011,910,659,251,36
"67638","W01000426",2011,643,84,559,56
"67639","W01000427",2011,604,72,532,66
"67640","W01000428",2011,593,30,563,141
"67641","W01000429",2011,951,30,921,113
"67642","W01000430",2011,554,34,520,106
"67643","W01000431",2011,586,111,475,145
"67644","W01000432",2011,532,38,494,77
"67645","W01000433",2011,1032,141,891,115
"67646","W01000434",2011,695,82,613,71
"67647","W01000438",2011,608,81,527,60
"67648","W01000439",2011,816,44,772,99
"67649","W01000440",2011,546,11,535,80
"67650","W01000441",2011,598,37,561,76
"67651","W01000442",2011,890,50,840,122
"67652","W01000443",2011,1009,51,958,144
"67653","W01000444",2011,1005,53,952,150
"67654","W01000445",2011,623,69,554,69
"67655","W01000446",2011,828,162,666,187
"67656","W01000447",2011,838,68,770,98
"67657","W01000448",2011,639,112,527,65
"67658","W01000449",2011,753,103,650,153
"67659","W01000450",2011,597,11,586,82
"67660","W01000451",2011,483,44,439,49
"67661","W01000452",2011,825,82,743,74
"67662","W01000453",2011,587,23,564,98
"67663","W01000454",2011,671,151,520,246
"67664","W01000455",2011,901,171,730,116
"67665","W01000456",2011,1011,84,927,245
"67666","W01000457",2011,867,60,807,90
"67667","W01000458",2011,769,45,724,94
"67668","W01000459",2011,519,35,484,73
"67669","W01000460",2011,728,76,652,107
"67670","W01000461",2011,675,103,572,109
"67671","W01000464",2011,534,8,526,74
"67672","W01000465",2011,426,30,396,46
"67673","W01000466",2011,621,155,466,68
"67674","W01000467",2011,795,105,690,193
"67675","W01000470",2011,828,67,761,149
"67676","W01000471",2011,838,93,745,135
"67677","W01000472",2011,511,33,478,73
"67678","W01000473",2011,1033,288,745,155
"67679","W01000474",2011,750,57,693,108
"67680","W01000475",2011,975,49,926,132
"67681","W01000476",2011,603,71,532,124
"67682","W01000477",2011,621,14,607,48
"67683","W01000478",2011,719,326,393,91
"67684","W01000479",2011,614,249,365,63
"67685","W01000480",2011,970,326,644,209
"67686","W01000481",2011,1093,145,948,192
"67687","W01000482",2011,817,85,732,157
"67688","W01000483",2011,802,408,394,69
"67689","W01000484",2011,678,23,655,105
"67690","W01000485",2011,740,29,711,108
"67691","W01000486",2011,501,144,357,78
"67692","W01000487",2011,987,182,805,225
"67693","W01000488",2011,892,30,862,127
"67694","W01000489",2011,742,175,567,132
"67695","W01000492",2011,823,110,713,242
"67696","W01000493",2011,595,66,529,105
"67697","W01000494",2011,737,133,604,99
"67698","W01000496",2011,895,110,785,54
"67699","W01000497",2011,556,27,529,64
"67700","W01000498",2011,734,315,419,165
"67701","W01000499",2011,555,142,413,120
"67702","W01000500",2011,655,77,578,79
"67703","W01000501",2011,1011,178,833,173
"67704","W01000502",2011,957,141,816,64
"67705","W01000503",2011,432,5,427,83
"67706","W01000504",2011,546,247,299,28
"67707","W01000505",2011,646,115,531,64
"67708","W01000506",2011,732,78,654,177
"67709","W01000507",2011,554,24,530,68
"67710","W01000508",2011,538,107,431,105
"67711","W01000509",2011,802,122,680,60
"67712","W01000510",2011,643,209,434,135
"67713","W01000511",2011,560,109,451,193
"67714","W01000512",2011,604,65,539,238
"67715","W01000513",2011,1022,119,903,724
"67716","W01000515",2011,608,230,378,63
"67717","W01000516",2011,674,202,472,96
"67718","W01000517",2011,589,82,507,352
"67719","W01000518",2011,627,114,513,164
"67720","W01000519",2011,720,36,684,68
"67721","W01000522",2011,553,28,525,50
"67722","W01000523",2011,834,38,796,123
"67723","W01000524",2011,831,36,795,127
"67724","W01000525",2011,500,2,498,67
"67725","W01000527",2011,461,43,418,161
"67726","W01000528",2011,641,164,477,118
"67727","W01000529",2011,664,44,620,99
"67728","W01000531",2011,800,83,717,112
"67729","W01000532",2011,838,22,816,97
"67730","W01000533",2011,660,144,516,99
"67731","W01000534",2011,655,22,633,116
"67732","W01000535",2011,885,71,814,115
"67733","W01000536",2011,663,24,639,118
"67734","W01000537",2011,664,32,632,91
"67735","W01000538",2011,654,14,640,113
"67736","W01000539",2011,506,7,499,76
"67737","W01000540",2011,534,38,496,69
"67738","W01000541",2011,781,46,735,142
"67739","W01000542",2011,937,39,898,121
"67740","W01000543",2011,880,51,829,116
"67741","W01000544",2011,517,65,452,75
"67742","W01000545",2011,902,45,857,80
"67743","W01000546",2011,532,57,475,66
"67744","W01000547",2011,536,42,494,42
"67745","W01000548",2011,764,90,674,116
"67746","W01000549",2011,744,20,724,98
"67747","W01000550",2011,565,42,523,112
"67748","W01000551",2011,575,41,534,55
"67749","W01000552",2011,827,49,778,130
"67750","W01000553",2011,546,22,524,76
"67751","W01000554",2011,752,44,708,59
"67752","W01000555",2011,579,24,555,56
"67753","W01000556",2011,509,32,477,53
"67754","W01000557",2011,612,39,573,83
"67755","W01000558",2011,887,52,835,122
"67756","W01000559",2011,611,13,598,50
"67757","W01000560",2011,521,58,463,64
"67758","W01000561",2011,502,20,482,54
"67759","W01000562",2011,736,53,683,91
"67760","W01000563",2011,484,34,450,89
"67761","W01000564",2011,523,33,490,65
"67762","W01000565",2011,891,151,740,92
"67763","W01000566",2011,736,114,622,102
"67764","W01000567",2011,901,93,808,188
"67765","W01000568",2011,1193,330,863,362
"67766","W01000569",2011,526,94,432,160
"67767","W01000570",2011,610,311,299,129
"67768","W01000571",2011,1013,156,857,115
"67769","W01000572",2011,789,93,696,113
"67770","W01000573",2011,1119,70,1049,221
"67771","W01000574",2011,791,84,707,117
"67772","W01000575",2011,985,150,835,102
"67773","W01000576",2011,955,93,862,85
"67774","W01000577",2011,634,19,615,62
"67775","W01000578",2011,740,51,689,64
"67776","W01000579",2011,985,139,846,94
"67777","W01000580",2011,961,101,860,59
"67778","W01000581",2011,648,60,588,59
"67779","W01000582",2011,711,12,699,89
"67780","W01000583",2011,592,69,523,72
"67781","W01000584",2011,876,139,737,84
"67782","W01000585",2011,540,18,522,93
"67783","W01000586",2011,888,282,606,79
"67784","W01000587",2011,1003,166,837,224
"67785","W01000588",2011,931,348,583,78
"67786","W01000589",2011,525,130,395,71
"67787","W01000590",2011,547,144,403,33
"67788","W01000591",2011,489,93,396,46
"67789","W01000592",2011,497,206,291,34
"67790","W01000593",2011,1163,294,869,89
"67791","W01000594",2011,989,342,647,149
"67792","W01000595",2011,908,148,760,168
"67793","W01000596",2011,620,22,598,78
"67794","W01000597",2011,583,96,487,53
"67795","W01000598",2011,1023,185,838,119
"67796","W01000599",2011,897,188,709,68
"67797","W01000600",2011,786,160,626,222
"67798","W01000601",2011,642,330,312,54
"67799","W01000602",2011,581,57,524,126
"67800","W01000603",2011,827,115,712,192
"67801","W01000604",2011,624,173,451,82
"67802","W01000605",2011,711,64,647,92
"67803","W01000606",2011,707,351,356,48
"67804","W01000607",2011,848,326,522,74
"67805","W01000608",2011,700,122,578,154
"67806","W01000609",2011,1090,85,1005,75
"67807","W01000610",2011,751,90,661,94
"67808","W01000611",2011,730,16,714,76
"67809","W01000612",2011,851,116,735,95
"67810","W01000613",2011,1016,63,953,137
"67811","W01000614",2011,612,68,544,63
"67812","W01000615",2011,671,33,638,67
"67813","W01000616",2011,529,53,476,130
"67814","W01000617",2011,615,79,536,68
"67815","W01000618",2011,646,124,522,67
"67816","W01000619",2011,969,131,838,125
"67817","W01000620",2011,595,90,505,218
"67818","W01000621",2011,689,143,546,134
"67819","W01000622",2011,637,48,589,88
"67820","W01000623",2011,774,60,714,94
"67821","W01000624",2011,946,46,900,94
"67822","W01000625",2011,521,162,359,56
"67823","W01000626",2011,725,105,620,137
"67824","W01000627",2011,896,130,766,89
"67825","W01000628",2011,617,21,596,61
"67826","W01000629",2011,761,112,649,141
"67827","W01000630",2011,666,77,589,100
"67828","W01000631",2011,783,349,434,61
"67829","W01000632",2011,618,69,549,95
"67830","W01000633",2011,703,150,553,133
"67831","W01000634",2011,653,9,644,55
"67832","W01000635",2011,916,49,867,76
"67833","W01000636",2011,789,244,545,39
"67834","W01000637",2011,641,218,423,70
"67835","W01000638",2011,484,198,286,52
"67836","W01000639",2011,638,128,510,110
"67837","W01000640",2011,504,6,498,51
"67838","W01000641",2011,1162,237,925,401
"67839","W01000642",2011,720,14,706,93
"67840","W01000643",2011,699,146,553,99
"67841","W01000644",2011,565,67,498,109
"67842","W01000645",2011,742,121,621,138
"67843","W01000646",2011,960,99,861,168
"67844","W01000647",2011,630,34,596,70
"67845","W01000648",2011,566,19,547,50
"67846","W01000649",2011,649,40,609,49
"67847","W01000650",2011,716,39,677,93
"67848","W01000651",2011,700,70,630,109
"67849","W01000652",2011,793,227,566,93
"67850","W01000653",2011,642,71,571,65
"67851","W01000654",2011,788,46,742,176
"67852","W01000655",2011,827,253,574,86
"67853","W01000656",2011,906,190,716,82
"67854","W01000657",2011,502,127,375,47
"67855","W01000658",2011,545,82,463,72
"67856","W01000659",2011,650,164,486,160
"67857","W01000660",2011,747,226,521,127
"67858","W01000662",2011,921,103,818,59
"67859","W01000663",2011,998,192,806,53
"67860","W01000664",2011,737,54,683,66
"67861","W01000665",2011,727,25,702,39
"67862","W01000666",2011,643,87,556,86
"67863","W01000667",2011,625,59,566,56
"67864","W01000670",2011,733,173,560,89
"67865","W01000671",2011,774,100,674,45
"67866","W01000672",2011,681,96,585,92
"67867","W01000673",2011,544,87,457,71
"67868","W01000674",2011,831,27,804,93
"67869","W01000675",2011,848,81,767,73
"67870","W01000676",2011,684,10,674,90
"67871","W01000677",2011,702,126,576,159
"67872","W01000678",2011,615,122,493,48
"67873","W01000679",2011,555,59,496,122
"67874","W01000680",2011,853,23,830,37
"67875","W01000681",2011,857,213,644,86
"67876","W01000682",2011,560,30,530,61
"67877","W01000683",2011,452,20,432,48
"67878","W01000684",2011,774,49,725,61
"67879","W01000685",2011,682,133,549,64
"67880","W01000686",2011,531,26,505,46
"67881","W01000687",2011,817,57,760,67
"67882","W01000688",2011,772,220,552,86
"67883","W01000689",2011,707,7,700,78
"67884","W01000690",2011,754,109,645,46
"67885","W01000691",2011,682,103,579,32
"67886","W01000692",2011,648,74,574,57
"67887","W01000693",2011,505,162,343,29
"67888","W01000694",2011,558,23,535,63
"67889","W01000695",2011,675,104,571,42
"67890","W01000696",2011,670,98,572,59
"67891","W01000697",2011,805,116,689,111
"67892","W01000698",2011,768,135,633,67
"67893","W01000699",2011,600,5,595,45
"67894","W01000700",2011,883,58,825,84
"67895","W01000701",2011,678,69,609,77
"67896","W01000702",2011,515,119,396,89
"67897","W01000703",2011,818,97,721,191
"67898","W01000704",2011,719,67,652,49
"67899","W01000705",2011,834,196,638,126
"67900","W01000706",2011,683,130,553,68
"67901","W01000707",2011,615,250,365,50
"67902","W01000708",2011,613,260,353,62
"67903","W01000709",2011,921,35,886,91
"67904","W01000710",2011,899,12,887,65
"67905","W01000711",2011,908,220,688,75
"67906","W01000712",2011,634,29,605,71
"67907","W01000713",2011,574,71,503,40
"67908","W01000714",2011,647,174,473,76
"67909","W01000715",2011,555,23,532,51
"67910","W01000716",2011,544,20,524,38
"67911","W01000717",2011,645,168,477,56
"67912","W01000718",2011,627,149,478,50
"67913","W01000719",2011,629,84,545,37
"67914","W01000720",2011,696,73,623,113
"67915","W01000721",2011,536,101,435,51
"67916","W01000722",2011,542,19,523,42
"67917","W01000723",2011,616,38,578,55
"67918","W01000724",2011,762,154,608,57
"67919","W01000725",2011,915,134,781,70
"67920","W01000726",2011,630,4,626,32
"67921","W01000727",2011,479,29,450,31
"67922","W01000728",2011,835,34,801,75
"67923","W01000729",2011,546,121,425,71
"67924","W01000730",2011,522,80,442,40
"67925","W01000731",2011,1039,89,950,122
"67926","W01000732",2011,623,41,582,163
"67927","W01000733",2011,654,310,344,121
"67928","W01000734",2011,651,117,534,188
"67929","W01000735",2011,978,118,860,127
"67930","W01000736",2011,763,3,760,49
"67931","W01000737",2011,700,9,691,96
"67932","W01000738",2011,753,383,370,49
"67933","W01000739",2011,863,209,654,182
"67934","W01000740",2011,658,28,630,37
"67935","W01000741",2011,706,245,461,47
"67936","W01000742",2011,800,519,281,72
"67937","W01000744",2011,755,157,598,234
"67938","W01000745",2011,1072,235,837,548
"67939","W01000746",2011,800,190,610,255
"67940","W01000747",2011,743,74,669,411
"67941","W01000749",2011,894,99,795,276
"67942","W01000750",2011,717,185,532,79
"67943","W01000751",2011,626,25,601,37
"67944","W01000752",2011,641,185,456,65
"67945","W01000753",2011,602,134,468,55
"67946","W01000754",2011,681,66,615,121
"67947","W01000755",2011,868,157,711,99
"67948","W01000756",2011,751,354,397,70
"67949","W01000757",2011,718,156,562,42
"67950","W01000758",2011,839,99,740,78
"67951","W01000759",2011,655,11,644,41
"67952","W01000760",2011,728,108,620,114
"67953","W01000761",2011,652,94,558,106
"67954","W01000762",2011,617,281,336,36
"67955","W01000763",2011,620,16,604,115
"67956","W01000764",2011,680,32,648,129
"67957","W01000765",2011,748,82,666,127
"67958","W01000766",2011,641,9,632,99
"67959","W01000767",2011,757,281,476,80
"67960","W01000768",2011,611,86,525,66
"67961","W01000769",2011,591,15,576,48
"67962","W01000770",2011,638,21,617,40
"67963","W01000771",2011,533,48,485,28
"67964","W01000772",2011,615,73,542,24
"67965","W01000773",2011,1184,298,886,172
"67966","W01000774",2011,740,103,637,96
"67967","W01000775",2011,738,44,694,63
"67968","W01000776",2011,733,43,690,34
"67969","W01000777",2011,785,66,719,76
"67970","W01000778",2011,770,14,756,133
"67971","W01000779",2011,597,122,475,45
"67972","W01000781",2011,708,6,702,42
"67973","W01000782",2011,516,5,511,32
"67974","W01000784",2011,586,78,508,61
"67975","W01000785",2011,528,5,523,16
"67976","W01000786",2011,573,5,568,30
"67977","W01000787",2011,678,66,612,139
"67978","W01000788",2011,658,68,590,148
"67979","W01000789",2011,640,96,544,162
"67980","W01000790",2011,748,110,638,171
"67981","W01000791",2011,636,19,617,69
"67982","W01000792",2011,686,4,682,62
"67983","W01000793",2011,766,4,762,111
"67984","W01000794",2011,921,48,873,165
"67985","W01000795",2011,685,8,677,91
"67986","W01000796",2011,1063,50,1013,139
"67987","W01000797",2011,652,57,595,46
"67988","W01000798",2011,627,47,580,54
"67989","W01000799",2011,782,290,492,126
"67990","W01000800",2011,604,8,596,39
"67991","W01000801",2011,635,272,363,68
"67992","W01000802",2011,1010,247,763,63
"67993","W01000803",2011,767,83,684,53
"67994","W01000804",2011,730,49,681,44
"67995","W01000805",2011,479,3,476,27
"67996","W01000806",2011,631,63,568,57
"67997","W01000807",2011,562,11,551,50
"67998","W01000808",2011,625,74,551,43
"67999","W01000809",2011,692,86,606,126
"68000","W01000810",2011,667,404,263,40
"68001","W01000811",2011,684,220,464,89
"68002","W01000812",2011,689,195,494,168
"68003","W01000813",2011,676,19,657,87
"68004","W01000814",2011,675,177,498,160
"68005","W01000815",2011,671,33,638,48
"68006","W01000816",2011,712,22,690,104
"68007","W01000817",2011,842,556,286,48
"68008","W01000818",2011,671,247,424,48
"68009","W01000819",2011,626,19,607,41
"68010","W01000820",2011,605,75,530,56
"68011","W01000821",2011,673,147,526,51
"68012","W01000822",2011,594,69,525,29
"68013","W01000823",2011,738,5,733,29
"68014","W01000824",2011,765,34,731,124
"68015","W01000825",2011,718,29,689,166
"68016","W01000826",2011,642,2,640,73
"68017","W01000827",2011,615,2,613,128
"68018","W01000828",2011,732,7,725,62
"68019","W01000829",2011,828,95,733,72
"68020","W01000830",2011,687,564,123,35
"68021","W01000831",2011,825,396,429,77
"68022","W01000832",2011,763,498,265,33
"68023","W01000833",2011,767,481,286,27
"68024","W01000834",2011,602,312,290,26
"68025","W01000835",2011,594,230,364,33
"68026","W01000836",2011,934,440,494,105
"68027","W01000837",2011,641,4,637,67
"68028","W01000838",2011,559,188,371,38
"68029","W01000839",2011,460,1,459,47
"68030","W01000840",2011,706,2,704,44
"68031","W01000841",2011,635,107,528,50
"68032","W01000842",2011,590,36,554,29
"68033","W01000843",2011,563,28,535,59
"68034","W01000844",2011,489,190,299,29
"68035","W01000845",2011,819,49,770,65
"68036","W01000846",2011,815,120,695,157
"68037","W01000847",2011,522,54,468,29
"68038","W01000848",2011,505,191,314,24
"68039","W01000849",2011,807,192,615,152
"68040","W01000850",2011,1195,237,958,410
"68041","W01000851",2011,682,88,594,152
"68042","W01000852",2011,637,50,587,116
"68043","W01000853",2011,607,38,569,65
"68044","W01000854",2011,529,14,515,46
"68045","W01000855",2011,645,51,594,43
"68046","W01000856",2011,997,511,486,81
"68047","W01000857",2011,900,302,598,114
"68048","W01000858",2011,687,20,667,141
"68049","W01000859",2011,679,44,635,49
"68050","W01000860",2011,631,2,629,52
"68051","W01000861",2011,451,24,427,127
"68052","W01000862",2011,706,495,211,51
"68053","W01000863",2011,753,496,257,59
"68054","W01000864",2011,706,501,205,28
"68055","W01000865",2011,591,227,364,33
"68056","W01000866",2011,524,254,270,46
"68057","W01000867",2011,570,328,242,39
"68058","W01000868",2011,482,10,472,31
"68059","W01000869",2011,727,128,599,228
"68060","W01000870",2011,640,63,577,268
"68061","W01000871",2011,714,140,574,340
"68062","W01000872",2011,615,8,607,85
"68063","W01000873",2011,593,92,501,352
"68064","W01000874",2011,709,25,684,331
"68065","W01000875",2011,771,105,666,437
"68066","W01000876",2011,637,40,597,334
"68067","W01000877",2011,644,7,637,58
"68068","W01000878",2011,526,57,469,48
"68069","W01000879",2011,767,12,755,54
"68070","W01000880",2011,759,42,717,65
"68071","W01000881",2011,710,269,441,67
"68072","W01000882",2011,826,272,554,59
"68073","W01000883",2011,619,17,602,24
"68074","W01000884",2011,527,40,487,141
"68075","W01000885",2011,623,244,379,67
"68076","W01000886",2011,689,109,580,207
"68077","W01000887",2011,953,212,741,71
"68078","W01000888",2011,933,121,812,71
"68079","W01000889",2011,795,54,741,68
"68080","W01000890",2011,675,6,669,27
"68081","W01000891",2011,640,119,521,60
"68082","W01000892",2011,814,61,753,35
"68083","W01000893",2011,817,120,697,120
"68084","W01000894",2011,615,79,536,64
"68085","W01000895",2011,783,156,627,183
"68086","W01000896",2011,646,299,347,70
"68087","W01000897",2011,594,95,499,74
"68088","W01000898",2011,636,91,545,40
"68089","W01000899",2011,694,58,636,30
"68090","W01000900",2011,787,318,469,72
"68091","W01000901",2011,733,173,560,53
"68092","W01000902",2011,438,19,419,23
"68093","W01000903",2011,491,1,490,13
"68094","W01000904",2011,640,1,639,65
"68095","W01000905",2011,627,77,550,54
"68096","W01000906",2011,461,39,422,16
"68097","W01000907",2011,762,293,469,51
"68098","W01000908",2011,744,74,670,51
"68099","W01000909",2011,494,82,412,27
"68100","W01000910",2011,640,10,630,43
"68101","W01000911",2011,490,5,485,24
"68102","W01000912",2011,537,97,440,57
"68103","W01000913",2011,528,42,486,108
"68104","W01000914",2011,647,240,407,54
"68105","W01000915",2011,496,58,438,51
"68106","W01000916",2011,479,12,467,58
"68107","W01000917",2011,1086,56,1030,103
"68108","W01000918",2011,842,163,679,61
"68109","W01000919",2011,504,82,422,37
"68110","W01000920",2011,518,84,434,41
"68111","W01000921",2011,666,345,321,30
"68112","W01000922",2011,721,166,555,71
"68113","W01000923",2011,651,36,615,52
"68114","W01000924",2011,463,114,349,32
"68115","W01000925",2011,657,228,429,45
"68116","W01000926",2011,862,71,791,102
"68117","W01000927",2011,704,139,565,67
"68118","W01000928",2011,698,135,563,74
"68119","W01000929",2011,562,143,419,49
"68120","W01000930",2011,617,137,480,69
"68121","W01000931",2011,560,75,485,43
"68122","W01000932",2011,491,122,369,31
"68123","W01000933",2011,741,24,717,48
"68124","W01000934",2011,628,75,553,169
"68125","W01000935",2011,842,228,614,150
"68126","W01000936",2011,628,241,387,57
"68127","W01000937",2011,950,255,695,184
"68128","W01000938",2011,611,34,577,45
"68129","W01000939",2011,690,247,443,156
"68130","W01000940",2011,596,216,380,49
"68131","W01000941",2011,639,174,465,71
"68132","W01000942",2011,782,317,465,55
"68133","W01000943",2011,614,18,596,43
"68134","W01000944",2011,524,109,415,39
"68135","W01000945",2011,492,91,401,27
"68136","W01000946",2011,616,78,538,62
"68137","W01000947",2011,866,304,562,50
"68138","W01000948",2011,842,161,681,145
"68139","W01000949",2011,572,47,525,38
"68140","W01000950",2011,676,21,655,162
"68141","W01000951",2011,650,37,613,157
"68142","W01000952",2011,484,26,458,69
"68143","W01000953",2011,727,158,569,61
"68144","W01000954",2011,633,42,591,69
"68145","W01000955",2011,526,80,446,26
"68146","W01000956",2011,522,4,518,23
"68147","W01000957",2011,852,338,514,83
"68148","W01000958",2011,650,337,313,38
"68149","W01000959",2011,760,92,668,126
"68150","W01000960",2011,783,181,602,105
"68151","W01000961",2011,726,204,522,33
"68152","W01000962",2011,606,259,347,65
"68153","W01000963",2011,776,279,497,68
"68154","W01000964",2011,774,286,488,46
"68155","W01000965",2011,866,190,676,58
"68156","W01000966",2011,637,55,582,83
"68157","W01000967",2011,681,133,548,116
"68158","W01000968",2011,803,144,659,86
"68159","W01000969",2011,515,10,505,22
"68160","W01000970",2011,500,101,399,32
"68161","W01000971",2011,599,98,501,52
"68162","W01000973",2011,681,199,482,70
"68163","W01000974",2011,900,85,815,108
"68164","W01000975",2011,884,381,503,58
"68165","W01000976",2011,450,80,370,52
"68166","W01000977",2011,579,142,437,59
"68167","W01000978",2011,774,94,680,115
"68168","W01000979",2011,694,70,624,136
"68169","W01000980",2011,555,102,453,54
"68170","W01000981",2011,489,324,165,23
"68171","W01000982",2011,627,70,557,83
"68172","W01000983",2011,638,5,633,121
"68173","W01000984",2011,931,93,838,205
"68174","W01000985",2011,512,5,507,48
"68175","W01000986",2011,573,19,554,93
"68176","W01000987",2011,962,267,695,105
"68177","W01000989",2011,574,22,552,59
"68178","W01000990",2011,660,212,448,50
"68179","W01000991",2011,475,185,290,49
"68180","W01000992",2011,636,40,596,148
"68181","W01000993",2011,625,57,568,114
"68182","W01000994",2011,576,80,496,89
"68183","W01000995",2011,654,10,644,106
"68184","W01000996",2011,638,107,531,50
"68185","W01000997",2011,690,35,655,59
"68186","W01000998",2011,513,10,503,82
"68187","W01000999",2011,614,180,434,52
"68188","W01001000",2011,726,62,664,74
"68189","W01001001",2011,623,101,522,49
"68190","W01001002",2011,1060,403,657,163
"68191","W01001003",2011,583,29,554,52
"68192","W01001004",2011,488,106,382,78
"68193","W01001005",2011,740,10,730,96
"68194","W01001006",2011,946,12,934,53
"68195","W01001007",2011,700,134,566,88
"68196","W01001008",2011,910,5,905,65
"68197","W01001009",2011,497,72,425,48
"68198","W01001010",2011,510,180,330,26
"68199","W01001011",2011,578,67,511,50
"68200","W01001012",2011,584,10,574,57
"68201","W01001013",2011,636,135,501,40
"68202","W01001014",2011,779,109,670,132
"68203","W01001015",2011,594,118,476,48
"68204","W01001016",2011,744,36,708,72
"68205","W01001017",2011,601,29,572,34
"68206","W01001018",2011,634,32,602,122
"68207","W01001019",2011,621,120,501,50
"68208","W01001020",2011,615,168,447,61
"68209","W01001021",2011,764,149,615,203
"68210","W01001022",2011,623,242,381,41
"68211","W01001023",2011,815,244,571,107
"68212","W01001024",2011,507,46,461,97
"68213","W01001025",2011,519,21,498,78
"68214","W01001026",2011,838,249,589,90
"68215","W01001027",2011,720,77,643,47
"68216","W01001028",2011,823,44,779,136
"68217","W01001029",2011,798,5,793,103
"68218","W01001030",2011,765,25,740,51
"68219","W01001031",2011,628,2,626,47
"68220","W01001032",2011,818,3,815,90
"68221","W01001033",2011,735,45,690,105
"68222","W01001034",2011,659,110,549,97
"68223","W01001035",2011,745,182,563,187
"68224","W01001036",2011,646,45,601,53
"68225","W01001037",2011,671,2,669,59
"68226","W01001038",2011,927,108,819,115
"68227","W01001039",2011,678,102,576,40
"68228","W01001040",2011,611,21,590,61
"68229","W01001041",2011,926,8,918,60
"68230","W01001042",2011,573,26,547,123
"68231","W01001043",2011,502,34,468,73
"68232","W01001044",2011,771,216,555,81
"68233","W01001045",2011,745,26,719,193
"68234","W01001046",2011,873,31,842,287
"68235","W01001047",2011,757,80,677,89
"68236","W01001048",2011,607,6,601,77
"68237","W01001049",2011,530,149,381,47
"68238","W01001050",2011,669,145,524,82
"68239","W01001051",2011,727,179,548,76
"68240","W01001052",2011,612,186,426,70
"68241","W01001053",2011,465,15,450,30
"68242","W01001054",2011,532,2,530,34
"68243","W01001055",2011,514,144,370,42
"68244","W01001056",2011,507,53,454,35
"68245","W01001057",2011,665,236,429,58
"68246","W01001058",2011,772,46,726,105
"68247","W01001059",2011,614,42,572,73
"68248","W01001060",2011,659,2,657,55
"68249","W01001061",2011,926,88,838,236
"68250","W01001062",2011,544,9,535,106
"68251","W01001063",2011,711,19,692,202
"68252","W01001064",2011,640,280,360,69
"68253","W01001065",2011,642,65,577,108
"68254","W01001066",2011,688,87,601,155
"68255","W01001067",2011,648,291,357,44
"68256","W01001068",2011,731,125,606,122
"68257","W01001069",2011,686,113,573,189
"68258","W01001070",2011,539,107,432,164
"68259","W01001071",2011,667,122,545,94
"68260","W01001072",2011,1001,27,974,83
"68261","W01001073",2011,1005,331,674,269
"68262","W01001075",2011,496,33,463,39
"68263","W01001076",2011,625,53,572,136
"68264","W01001077",2011,616,153,463,34
"68265","W01001078",2011,510,51,459,30
"68266","W01001079",2011,695,53,642,210
"68267","W01001080",2011,648,78,570,131
"68268","W01001081",2011,670,254,416,59
"68269","W01001082",2011,754,54,700,127
"68270","W01001083",2011,659,9,650,37
"68271","W01001084",2011,721,30,691,80
"68272","W01001085",2011,581,8,573,37
"68273","W01001086",2011,644,3,641,74
"68274","W01001087",2011,657,11,646,50
"68275","W01001088",2011,813,303,510,34
"68276","W01001089",2011,604,16,588,44
"68277","W01001090",2011,615,15,600,31
"68278","W01001091",2011,724,4,720,43
"68279","W01001092",2011,673,185,488,57
"68280","W01001093",2011,788,262,526,63
"68281","W01001094",2011,531,244,287,32
"68282","W01001095",2011,667,416,251,35
"68283","W01001096",2011,636,141,495,57
"68284","W01001097",2011,607,254,353,53
"68285","W01001098",2011,467,3,464,27
"68286","W01001099",2011,600,240,360,60
"68287","W01001100",2011,636,48,588,14
"68288","W01001101",2011,694,30,664,231
"68289","W01001102",2011,668,15,653,163
"68290","W01001103",2011,520,8,512,41
"68291","W01001104",2011,864,72,792,103
"68292","W01001105",2011,1024,36,988,80
"68293","W01001106",2011,582,13,569,33
"68294","W01001107",2011,712,56,656,65
"68295","W01001108",2011,728,34,694,257
"68296","W01001109",2011,625,70,555,39
"68297","W01001110",2011,529,11,518,110
"68298","W01001111",2011,594,180,414,58
"68299","W01001112",2011,595,8,587,118
"68300","W01001113",2011,913,42,871,73
"68301","W01001114",2011,661,7,654,37
"68302","W01001115",2011,872,79,793,57
"68303","W01001116",2011,833,4,829,122
"68304","W01001117",2011,585,40,545,48
"68305","W01001118",2011,959,95,864,112
"68306","W01001119",2011,678,13,665,67
"68307","W01001120",2011,589,4,585,68
"68308","W01001121",2011,644,109,535,85
"68309","W01001122",2011,802,28,774,303
"68310","W01001123",2011,850,26,824,222
"68311","W01001124",2011,683,20,663,215
"68312","W01001125",2011,618,16,602,108
"68313","W01001126",2011,1036,61,975,405
"68314","W01001127",2011,535,3,532,47
"68315","W01001128",2011,599,14,585,54
"68316","W01001129",2011,517,97,420,28
"68317","W01001130",2011,534,7,527,120
"68318","W01001131",2011,760,295,465,48
"68319","W01001132",2011,585,11,574,57
"68320","W01001133",2011,904,9,895,164
"68321","W01001134",2011,536,5,531,42
"68322","W01001135",2011,600,18,582,56
"68323","W01001136",2011,497,6,491,28
"68324","W01001137",2011,1064,128,936,205
"68325","W01001138",2011,636,174,462,73
"68326","W01001139",2011,611,21,590,89
"68327","W01001140",2011,637,76,561,109
"68328","W01001141",2011,677,142,535,115
"68329","W01001142",2011,704,106,598,130
"68330","W01001143",2011,633,23,610,96
"68331","W01001144",2011,668,164,504,102
"68332","W01001145",2011,753,121,632,116
"68333","W01001146",2011,640,41,599,117
"68334","W01001147",2011,792,106,686,83
"68335","W01001148",2011,750,24,726,177
"68336","W01001149",2011,619,93,526,60
"68337","W01001150",2011,797,47,750,243
"68338","W01001151",2011,713,42,671,55
"68339","W01001152",2011,671,80,591,58
"68340","W01001153",2011,636,111,525,110
"68341","W01001154",2011,678,157,521,85
"68342","W01001155",2011,665,22,643,156
"68343","W01001156",2011,549,3,546,23
"68344","W01001157",2011,591,26,565,64
"68345","W01001158",2011,614,76,538,76
"68346","W01001159",2011,509,17,492,74
"68347","W01001160",2011,664,9,655,49
"68348","W01001161",2011,898,157,741,75
"68349","W01001162",2011,763,210,553,74
"68350","W01001164",2011,656,16,640,90
"68351","W01001165",2011,554,69,485,45
"68352","W01001166",2011,553,37,516,115
"68353","W01001167",2011,632,21,611,127
"68354","W01001168",2011,638,82,556,65
"68355","W01001169",2011,761,320,441,67
"68356","W01001170",2011,527,14,513,31
"68357","W01001171",2011,581,22,559,81
"68358","W01001172",2011,642,37,605,119
"68359","W01001173",2011,612,170,442,62
"68360","W01001174",2011,624,237,387,65
"68361","W01001175",2011,620,56,564,77
"68362","W01001176",2011,620,26,594,107
"68363","W01001177",2011,587,26,561,101
"68364","W01001178",2011,723,96,627,106
"68365","W01001179",2011,728,267,461,56
"68366","W01001180",2011,648,279,369,48
"68367","W01001181",2011,606,144,462,36
"68368","W01001182",2011,594,25,569,129
"68369","W01001183",2011,500,114,386,147
"68370","W01001184",2011,864,60,804,98
"68371","W01001185",2011,762,238,524,68
"68372","W01001186",2011,685,98,587,47
"68373","W01001187",2011,574,63,511,71
"68374","W01001188",2011,497,142,355,60
"68375","W01001189",2011,686,166,520,83
"68376","W01001190",2011,1018,36,982,157
"68377","W01001191",2011,1011,59,952,120
"68378","W01001192",2011,626,271,355,42
"68379","W01001193",2011,489,23,466,23
"68380","W01001194",2011,878,12,866,85
"68381","W01001195",2011,685,118,567,104
"68382","W01001196",2011,630,8,622,96
"68383","W01001197",2011,481,0,481,16
"68384","W01001198",2011,662,2,660,74
"68385","W01001199",2011,694,13,681,63
"68386","W01001200",2011,420,14,406,66
"68387","W01001201",2011,537,136,401,66
"68388","W01001202",2011,839,157,682,134
"68389","W01001203",2011,594,266,328,48
"68390","W01001204",2011,584,23,561,110
"68391","W01001205",2011,728,120,608,92
"68392","W01001206",2011,635,102,533,80
"68393","W01001207",2011,585,240,345,57
"68394","W01001208",2011,750,59,691,145
"68395","W01001209",2011,567,201,366,70
"68396","W01001210",2011,625,67,558,112
"68397","W01001211",2011,650,75,575,123
"68398","W01001212",2011,585,101,484,101
"68399","W01001213",2011,618,55,563,87
"68400","W01001214",2011,531,15,516,40
"68401","W01001215",2011,519,69,450,134
"68402","W01001216",2011,654,42,612,110
"68403","W01001217",2011,483,113,370,61
"68404","W01001218",2011,643,15,628,109
"68405","W01001219",2011,624,179,445,108
"68406","W01001220",2011,623,49,574,76
"68407","W01001221",2011,602,199,403,41
"68408","W01001222",2011,649,333,316,59
"68409","W01001223",2011,702,8,694,89
"68410","W01001224",2011,779,12,767,54
"68411","W01001225",2011,653,14,639,47
"68412","W01001226",2011,722,139,583,85
"68413","W01001227",2011,543,20,523,45
"68414","W01001228",2011,662,39,623,80
"68415","W01001229",2011,648,8,640,113
"68416","W01001230",2011,612,12,600,44
"68417","W01001231",2011,696,55,641,157
"68418","W01001232",2011,609,129,480,82
"68419","W01001233",2011,735,101,634,45
"68420","W01001234",2011,632,10,622,77
"68421","W01001235",2011,718,81,637,143
"68422","W01001236",2011,645,23,622,55
"68423","W01001237",2011,633,217,416,43
"68424","W01001238",2011,672,394,278,50
"68425","W01001239",2011,633,332,301,36
"68426","W01001240",2011,845,66,779,87
"68427","W01001241",2011,756,144,612,86
"68428","W01001242",2011,569,40,529,47
"68429","W01001243",2011,672,210,462,95
"68430","W01001244",2011,612,13,599,22
"68431","W01001245",2011,518,7,511,13
"68432","W01001246",2011,625,84,541,35
"68433","W01001247",2011,755,72,683,116
"68434","W01001248",2011,864,43,821,171
"68435","W01001249",2011,645,102,543,85
"68436","W01001250",2011,562,32,530,48
"68437","W01001251",2011,675,332,343,46
"68438","W01001252",2011,619,28,591,58
"68439","W01001253",2011,596,58,538,61
"68440","W01001255",2011,691,229,462,42
"68441","W01001256",2011,522,8,514,100
"68442","W01001257",2011,520,36,484,47
"68443","W01001258",2011,636,52,584,125
"68444","W01001259",2011,684,73,611,81
"68445","W01001260",2011,476,99,377,81
"68446","W01001261",2011,541,15,526,123
"68447","W01001262",2011,546,59,487,206
"68448","W01001263",2011,600,44,556,310
"68449","W01001264",2011,519,23,496,254
"68450","W01001265",2011,667,43,624,117
"68451","W01001266",2011,636,187,449,102
"68452","W01001267",2011,634,107,527,83
"68453","W01001268",2011,636,31,605,111
"68454","W01001269",2011,626,14,612,89
"68455","W01001270",2011,622,19,603,96
"68456","W01001271",2011,724,51,673,143
"68457","W01001272",2011,632,110,522,66
"68458","W01001273",2011,758,51,707,101
"68459","W01001274",2011,577,243,334,87
"68460","W01001275",2011,792,50,742,167
"68461","W01001276",2011,668,71,597,187
"68462","W01001277",2011,456,21,435,17
"68463","W01001278",2011,464,67,397,57
"68464","W01001279",2011,532,198,334,40
"68465","W01001280",2011,752,175,577,161
"68466","W01001281",2011,741,6,735,97
"68467","W01001282",2011,867,118,749,132
"68468","W01001283",2011,639,76,563,44
"68469","W01001284",2011,423,6,417,36
"68470","W01001285",2011,605,43,562,85
"68471","W01001286",2011,643,33,610,102
"68472","W01001287",2011,623,69,554,88
"68473","W01001288",2011,640,164,476,88
"68474","W01001289",2011,619,47,572,92
"68475","W01001290",2011,768,140,628,82
"68476","W01001291",2011,679,95,584,76
"68477","W01001292",2011,692,311,381,68
"68478","W01001293",2011,734,215,519,66
"68479","W01001294",2011,649,13,636,51
"68480","W01001295",2011,683,243,440,90
"68481","W01001296",2011,651,64,587,62
"68482","W01001297",2011,775,113,662,152
"68483","W01001298",2011,780,306,474,98
"68484","W01001299",2011,686,362,324,58
"68485","W01001300",2011,654,343,311,43
"68486","W01001301",2011,751,328,423,44
"68487","W01001302",2011,472,51,421,82
"68488","W01001303",2011,506,185,321,73
"68489","W01001304",2011,614,64,550,57
"68490","W01001305",2011,517,44,473,82
"68491","W01001306",2011,644,29,615,83
"68492","W01001307",2011,731,254,477,122
"68493","W01001308",2011,445,224,221,28
"68494","W01001309",2011,496,194,302,32
"68495","W01001310",2011,659,100,559,51
"68496","W01001311",2011,500,66,434,88
"68497","W01001312",2011,643,199,444,38
"68498","W01001313",2011,658,35,623,114
"68499","W01001314",2011,895,96,799,107
"68500","W01001315",2011,809,230,579,182
"68501","W01001316",2011,1162,37,1125,148
"68502","W01001317",2011,677,139,538,54
"68503","W01001318",2011,646,20,626,76
"68504","W01001319",2011,646,17,629,33
"68505","W01001320",2011,603,89,514,49
"68506","W01001321",2011,632,103,529,80
"68507","W01001322",2011,667,80,587,98
"68508","W01001324",2011,896,123,773,112
"68509","W01001325",2011,624,209,415,51
"68510","W01001326",2011,887,239,648,110
"68511","W01001327",2011,947,115,832,132
"68512","W01001328",2011,641,151,490,67
"68513","W01001329",2011,654,113,541,75
"68514","W01001330",2011,620,123,497,58
"68515","W01001331",2011,728,67,661,134
"68516","W01001332",2011,806,187,619,138
"68517","W01001333",2011,624,131,493,87
"68518","W01001334",2011,592,225,367,61
"68519","W01001335",2011,517,34,483,65
"68520","W01001336",2011,614,116,498,59
"68521","W01001337",2011,657,36,621,105
"68522","W01001338",2011,774,41,733,169
"68523","W01001339",2011,600,330,270,40
"68524","W01001340",2011,694,54,640,29
"68525","W01001341",2011,794,261,533,81
"68526","W01001342",2011,496,49,447,39
"68527","W01001343",2011,497,27,470,40
"68528","W01001344",2011,689,100,589,67
"68529","W01001345",2011,590,343,247,30
"68530","W01001346",2011,660,83,577,92
"68531","W01001347",2011,602,68,534,43
"68532","W01001348",2011,734,284,450,74
"68533","W01001349",2011,685,46,639,50
"68534","W01001350",2011,766,47,719,137
"68535","W01001351",2011,652,38,614,33
"68536","W01001352",2011,754,230,524,67
"68537","W01001353",2011,738,234,504,41
"68538","W01001354",2011,706,43,663,95
"68539","W01001355",2011,811,273,538,92
"68540","W01001356",2011,485,17,468,36
"68541","W01001357",2011,661,90,571,50
"68542","W01001358",2011,650,238,412,37
"68543","W01001359",2011,650,40,610,79
"68544","W01001360",2011,544,34,510,62
"68545","W01001361",2011,497,154,343,36
"68546","W01001362",2011,921,139,782,120
"68547","W01001363",2011,565,90,475,70
"68548","W01001364",2011,689,218,471,76
"68549","W01001365",2011,842,170,672,60
"68550","W01001366",2011,697,50,647,63
"68551","W01001367",2011,634,28,606,94
"68552","W01001368",2011,640,177,463,89
"68553","W01001369",2011,943,121,822,78
"68554","W01001370",2011,773,139,634,66
"68555","W01001371",2011,624,237,387,63
"68556","W01001372",2011,805,64,741,86
"68557","W01001373",2011,703,43,660,109
"68558","W01001374",2011,591,121,470,55
"68559","W01001375",2011,685,202,483,75
"68560","W01001376",2011,665,337,328,23
"68561","W01001377",2011,672,45,627,55
"68562","W01001378",2011,681,174,507,46
"68563","W01001379",2011,625,63,562,43
"68564","W01001380",2011,771,92,679,70
"68565","W01001381",2011,624,262,362,50
"68566","W01001382",2011,685,76,609,73
"68567","W01001383",2011,663,95,568,106
"68568","W01001384",2011,698,35,663,135
"68569","W01001385",2011,693,133,560,104
"68570","W01001386",2011,719,289,430,65
"68571","W01001387",2011,542,138,404,82
"68572","W01001388",2011,723,197,526,67
"68573","W01001389",2011,457,48,409,54
"68574","W01001390",2011,672,28,644,53
"68575","W01001391",2011,672,116,556,69
"68576","W01001392",2011,755,29,726,49
"68577","W01001393",2011,545,152,393,50
"68578","W01001394",2011,507,12,495,24
"68579","W01001395",2011,616,161,455,48
"68580","W01001396",2011,656,254,402,70
"68581","W01001397",2011,677,62,615,66
"68582","W01001398",2011,963,95,868,114
"68583","W01001399",2011,548,29,519,56
"68584","W01001400",2011,567,258,309,31
"68585","W01001401",2011,848,224,624,90
"68586","W01001402",2011,679,202,477,67
"68587","W01001403",2011,680,71,609,115
"68588","W01001404",2011,584,16,568,24
"68589","W01001405",2011,744,208,536,59
"68590","W01001406",2011,841,227,614,81
"68591","W01001407",2011,617,67,550,56
"68592","W01001408",2011,606,197,409,60
"68593","W01001409",2011,697,71,626,49
"68594","W01001410",2011,823,196,627,68
"68595","W01001411",2011,784,184,600,71
"68596","W01001412",2011,831,63,768,194
"68597","W01001413",2011,749,157,592,66
"68598","W01001414",2011,647,178,469,63
"68599","W01001415",2011,719,96,623,104
"68600","W01001416",2011,647,54,593,76
"68601","W01001417",2011,578,15,563,47
"68602","W01001418",2011,623,159,464,68
"68603","W01001419",2011,632,85,547,53
"68604","W01001420",2011,562,30,532,86
"68605","W01001421",2011,710,494,216,53
"68606","W01001422",2011,673,243,430,49
"68607","W01001423",2011,632,4,628,63
"68608","W01001424",2011,659,112,547,96
"68609","W01001425",2011,715,9,706,103
"68610","W01001426",2011,532,3,529,29
"68611","W01001427",2011,683,4,679,91
"68612","W01001428",2011,543,310,233,19
"68613","W01001429",2011,532,75,457,56
"68614","W01001430",2011,983,153,830,137
"68615","W01001431",2011,642,41,601,88
"68616","W01001432",2011,952,129,823,185
"68617","W01001433",2011,635,30,605,125
"68618","W01001434",2011,549,6,543,36
"68619","W01001435",2011,632,32,600,163
"68620","W01001436",2011,646,64,582,183
"68621","W01001437",2011,658,36,622,84
"68622","W01001438",2011,670,212,458,33
"68623","W01001439",2011,680,91,589,41
"68624","W01001440",2011,604,165,439,41
"68625","W01001441",2011,503,254,249,24
"68626","W01001442",2011,504,15,489,52
"68627","W01001443",2011,646,177,469,113
"68628","W01001444",2011,796,215,581,61
"68629","W01001445",2011,633,101,532,97
"68630","W01001446",2011,485,68,417,42
"68631","W01001447",2011,622,237,385,74
"68632","W01001448",2011,624,80,544,162
"68633","W01001449",2011,726,200,526,100
"68634","W01001450",2011,570,111,459,52
"68635","W01001451",2011,656,69,587,148
"68636","W01001452",2011,624,40,584,86
"68637","W01001453",2011,648,262,386,29
"68638","W01001454",2011,609,160,449,57
"68639","W01001455",2011,792,178,614,114
"68640","W01001456",2011,552,137,415,81
"68641","W01001457",2011,743,409,334,59
"68642","W01001458",2011,638,51,587,79
"68643","W01001459",2011,448,171,277,63
"68644","W01001460",2011,764,54,710,215
"68645","W01001461",2011,634,124,510,106
"68646","W01001462",2011,662,182,480,62
"68647","W01001463",2011,868,30,838,151
"68648","W01001464",2011,689,223,466,83
"68649","W01001465",2011,698,225,473,63
"68650","W01001466",2011,787,79,708,198
"68651","W01001467",2011,798,288,510,74
"68652","W01001468",2011,582,138,444,59
"68653","W01001469",2011,504,204,300,29
"68654","W01001470",2011,633,82,551,37
"68655","W01001471",2011,767,396,371,50
"68656","W01001472",2011,634,51,583,44
"68657","W01001473",2011,603,364,239,26
"68658","W01001474",2011,673,226,447,31
"68659","W01001475",2011,513,49,464,58
"68660","W01001476",2011,486,88,398,109
"68661","W01001477",2011,634,20,614,102
"68662","W01001478",2011,662,24,638,108
"68663","W01001479",2011,706,407,299,61
"68664","W01001480",2011,635,275,360,30
"68665","W01001481",2011,775,220,555,158
"68666","W01001482",2011,497,168,329,35
"68667","W01001483",2011,564,247,317,37
"68668","W01001484",2011,695,73,622,47
"68669","W01001485",2011,529,227,302,33
"68670","W01001486",2011,653,114,539,78
"68671","W01001487",2011,662,168,494,67
"68672","W01001488",2011,683,302,381,40
"68673","W01001489",2011,702,197,505,89
"68674","W01001490",2011,598,33,565,72
"68675","W01001491",2011,802,198,604,76
"68676","W01001492",2011,928,186,742,51
"68677","W01001493",2011,905,207,698,116
"68678","W01001494",2011,654,69,585,40
"68679","W01001495",2011,850,146,704,77
"68680","W01001496",2011,585,128,457,55
"68681","W01001497",2011,613,187,426,42
"68682","W01001498",2011,488,150,338,34
"68683","W01001499",2011,513,91,422,44
"68684","W01001500",2011,497,5,492,37
"68685","W01001501",2011,510,196,314,49
"68686","W01001502",2011,500,40,460,24
"68687","W01001503",2011,505,192,313,59
"68688","W01001504",2011,862,229,633,61
"68689","W01001505",2011,800,78,722,65
"68690","W01001506",2011,688,259,429,89
"68691","W01001507",2011,905,148,757,63
"68692","W01001508",2011,527,35,492,33
"68693","W01001509",2011,618,23,595,28
"68694","W01001510",2011,670,137,533,67
"68695","W01001511",2011,719,164,555,49
"68696","W01001512",2011,607,9,598,19
"68697","W01001513",2011,636,19,617,30
"68698","W01001514",2011,495,22,473,49
"68699","W01001515",2011,630,56,574,108
"68700","W01001516",2011,619,210,409,32
"68701","W01001517",2011,822,80,742,98
"68702","W01001518",2011,477,33,444,20
"68703","W01001519",2011,627,326,301,66
"68704","W01001520",2011,729,135,594,95
"68705","W01001521",2011,611,120,491,79
"68706","W01001522",2011,759,324,435,54
"68707","W01001523",2011,638,76,562,96
"68708","W01001524",2011,829,156,673,133
"68709","W01001525",2011,602,208,394,31
"68710","W01001526",2011,574,240,334,35
"68711","W01001527",2011,638,244,394,71
"68712","W01001528",2011,484,125,359,32
"68713","W01001529",2011,917,291,626,79
"68714","W01001530",2011,698,421,277,34
"68715","W01001531",2011,706,200,506,57
"68716","W01001532",2011,743,284,459,53
"68717","W01001533",2011,611,25,586,38
"68718","W01001534",2011,638,136,502,48
"68719","W01001535",2011,576,119,457,37
"68720","W01001536",2011,471,263,208,43
"68721","W01001537",2011,507,37,470,38
"68722","W01001538",2011,569,250,319,42
"68723","W01001539",2011,598,173,425,47
"68724","W01001540",2011,532,35,497,55
"68725","W01001541",2011,459,86,373,39
"68726","W01001542",2011,728,74,654,57
"68727","W01001543",2011,553,10,543,38
"68728","W01001545",2011,632,14,618,63
"68729","W01001546",2011,645,242,403,65
"68730","W01001548",2011,857,45,812,111
"68731","W01001549",2011,598,26,572,52
"68732","W01001551",2011,466,124,342,23
"68733","W01001552",2011,635,18,617,31
"68734","W01001553",2011,1113,188,925,114
"68735","W01001554",2011,712,67,645,205
"68736","W01001555",2011,484,4,480,52
"68737","W01001556",2011,509,83,426,30
"68738","W01001557",2011,911,169,742,205
"68739","W01001558",2011,697,211,486,41
"68740","W01001559",2011,559,66,493,41
"68741","W01001560",2011,514,14,500,76
"68742","W01001561",2011,651,7,644,37
"68743","W01001562",2011,604,91,513,43
"68744","W01001563",2011,461,96,365,37
"68745","W01001564",2011,999,151,848,100
"68746","W01001565",2011,719,51,668,67
"68747","W01001566",2011,489,20,469,138
"68748","W01001567",2011,433,42,391,123
"68749","W01001568",2011,697,19,678,91
"68750","W01001569",2011,622,85,537,50
"68751","W01001571",2011,508,15,493,51
"68752","W01001572",2011,618,100,518,37
"68753","W01001573",2011,560,21,539,37
"68754","W01001574",2011,617,12,605,94
"68755","W01001575",2011,500,30,470,53
"68756","W01001576",2011,490,71,419,88
"68757","W01001577",2011,610,292,318,35
"68758","W01001578",2011,884,82,802,47
"68759","W01001579",2011,745,52,693,121
"68760","W01001580",2011,809,170,639,79
"68761","W01001581",2011,852,99,753,87
"68762","W01001582",2011,698,120,578,45
"68763","W01001583",2011,659,42,617,68
"68764","W01001584",2011,778,89,689,120
"68765","W01001585",2011,509,1,508,37
"68766","W01001586",2011,950,48,902,83
"68767","W01001587",2011,964,206,758,251
"68768","W01001588",2011,731,14,717,48
"68769","W01001589",2011,655,181,474,67
"68770","W01001590",2011,868,35,833,53
"68771","W01001591",2011,582,11,571,63
"68772","W01001592",2011,679,324,355,89
"68773","W01001593",2011,729,120,609,104
"68774","W01001594",2011,537,47,490,35
"68775","W01001595",2011,527,10,517,23
"68776","W01001596",2011,495,91,404,75
"68777","W01001597",2011,660,42,618,92
"68778","W01001598",2011,672,178,494,53
"68779","W01001599",2011,960,179,781,78
"68780","W01001600",2011,669,7,662,51
"68781","W01001601",2011,638,293,345,77
"68782","W01001602",2011,676,83,593,40
"68783","W01001603",2011,569,34,535,151
"68784","W01001604",2011,620,13,607,28
"68785","W01001605",2011,625,87,538,175
"68786","W01001606",2011,517,27,490,34
"68787","W01001607",2011,497,300,197,42
"68788","W01001608",2011,638,68,570,60
"68789","W01001609",2011,567,331,236,27
"68790","W01001610",2011,507,109,398,37
"68791","W01001611",2011,531,37,494,103
"68792","W01001612",2011,651,52,599,150
"68793","W01001613",2011,616,14,602,90
"68794","W01001614",2011,778,383,395,56
"68795","W01001615",2011,604,101,503,34
"68796","W01001616",2011,633,65,568,61
"68797","W01001617",2011,582,322,260,32
"68798","W01001618",2011,494,188,306,28
"68799","W01001619",2011,599,280,319,52
"68800","W01001620",2011,482,191,291,39
"68801","W01001621",2011,614,256,358,56
"68802","W01001622",2011,535,106,429,44
"68803","W01001623",2011,654,14,640,113
"68804","W01001624",2011,501,6,495,48
"68805","W01001625",2011,560,36,524,52
"68806","W01001626",2011,577,58,519,39
"68807","W01001627",2011,630,10,620,53
"68808","W01001628",2011,511,206,305,57
"68809","W01001629",2011,634,71,563,62
"68810","W01001630",2011,788,361,427,45
"68811","W01001631",2011,617,60,557,42
"68812","W01001632",2011,585,138,447,52
"68813","W01001633",2011,609,311,298,45
"68814","W01001634",2011,611,149,462,73
"68815","W01001635",2011,596,59,537,56
"68816","W01001636",2011,696,5,691,72
"68817","W01001637",2011,700,72,628,62
"68818","W01001638",2011,468,6,462,17
"68819","W01001639",2011,719,31,688,40
"68820","W01001640",2011,495,25,470,38
"68821","W01001641",2011,537,6,531,33
"68822","W01001642",2011,779,120,659,169
"68823","W01001643",2011,566,190,376,108
"68824","W01001644",2011,1136,100,1036,343
"68825","W01001645",2011,513,99,414,54
"68826","W01001646",2011,623,302,321,26
"68827","W01001647",2011,633,19,614,48
"68828","W01001648",2011,637,67,570,75
"68829","W01001649",2011,608,93,515,44
"68830","W01001650",2011,615,134,481,67
"68831","W01001651",2011,637,20,617,36
"68832","W01001652",2011,791,426,365,78
"68833","W01001653",2011,608,14,594,31
"68834","W01001654",2011,676,35,641,63
"68835","W01001655",2011,651,12,639,49
"68836","W01001657",2011,547,5,542,45
"68837","W01001658",2011,697,65,632,46
"68838","W01001659",2011,782,327,455,221
"68839","W01001660",2011,616,85,531,153
"68840","W01001661",2011,945,273,672,359
"68841","W01001662",2011,614,366,248,88
"68842","W01001663",2011,689,263,426,35
"68843","W01001664",2011,647,326,321,26
"68844","W01001665",2011,743,219,524,88
"68845","W01001666",2011,623,256,367,44
"68846","W01001667",2011,521,243,278,23
"68847","W01001668",2011,482,190,292,20
"68848","W01001669",2011,528,3,525,25
"68849","W01001670",2011,862,7,855,83
"68850","W01001671",2011,841,215,626,134
"68851","W01001672",2011,733,79,654,59
"68852","W01001673",2011,644,33,611,27
"68853","W01001674",2011,619,102,517,46
"68854","W01001675",2011,619,22,597,150
"68855","W01001676",2011,720,55,665,230
"68856","W01001677",2011,653,25,628,91
"68857","W01001678",2011,700,190,510,68
"68858","W01001679",2011,457,35,422,30
"68859","W01001680",2011,506,5,501,119
"68860","W01001681",2011,660,231,429,132
"68861","W01001682",2011,599,197,402,62
"68862","W01001683",2011,485,49,436,63
"68863","W01001684",2011,637,17,620,133
"68864","W01001685",2011,773,173,600,298
"68865","W01001686",2011,554,63,491,124
"68866","W01001687",2011,879,163,716,403
"68867","W01001688",2011,1080,244,836,183
"68868","W01001689",2011,777,617,160,19
"68869","W01001690",2011,946,104,842,320
"68870","W01001691",2011,657,111,546,175
"68871","W01001692",2011,834,49,785,309
"68872","W01001693",2011,647,57,590,259
"68873","W01001694",2011,878,215,663,333
"68874","W01001695",2011,845,360,485,348
"68875","W01001696",2011,683,285,398,174
"68876","W01001697",2011,762,133,629,196
"68877","W01001698",2011,896,95,801,500
"68878","W01001699",2011,1000,479,521,264
"68879","W01001702",2011,745,172,573,100
"68880","W01001703",2011,503,218,285,43
"68881","W01001704",2011,631,341,290,48
"68882","W01001705",2011,718,170,548,105
"68883","W01001706",2011,540,90,450,59
"68884","W01001707",2011,803,352,451,64
"68885","W01001708",2011,737,332,405,83
"68886","W01001709",2011,721,86,635,139
"68887","W01001710",2011,701,31,670,189
"68888","W01001711",2011,720,184,536,98
"68889","W01001712",2011,679,26,653,191
"68890","W01001713",2011,745,92,653,162
"68891","W01001714",2011,612,11,601,53
"68892","W01001715",2011,765,83,682,187
"68893","W01001716",2011,543,8,535,91
"68894","W01001717",2011,768,144,624,138
"68895","W01001718",2011,577,12,565,366
"68896","W01001719",2011,534,10,524,238
"68897","W01001720",2011,590,17,573,436
"68898","W01001721",2011,594,119,475,362
"68899","W01001722",2011,514,18,496,354
"68900","W01001724",2011,549,7,542,443
"68901","W01001725",2011,589,47,542,482
"68902","W01001726",2011,524,24,500,323
"68903","W01001727",2011,462,10,452,36
"68904","W01001728",2011,582,1,581,25
"68905","W01001729",2011,808,15,793,101
"68906","W01001730",2011,647,3,644,48
"68907","W01001731",2011,534,2,532,55
"68908","W01001732",2011,667,1,666,96
"68909","W01001733",2011,586,52,534,76
"68910","W01001734",2011,592,1,591,55
"68911","W01001735",2011,608,8,600,102
"68912","W01001736",2011,601,3,598,36
"68913","W01001737",2011,653,354,299,47
"68914","W01001738",2011,525,283,242,53
"68915","W01001739",2011,523,298,225,52
"68916","W01001740",2011,682,352,330,49
"68917","W01001741",2011,613,395,218,47
"68918","W01001742",2011,640,340,300,50
"68919","W01001743",2011,605,26,579,43
"68920","W01001744",2011,740,396,344,54
"68921","W01001745",2011,556,17,539,41
"68922","W01001746",2011,663,253,410,96
"68923","W01001747",2011,812,31,781,153
"68924","W01001748",2011,650,178,472,70
"68925","W01001749",2011,699,186,513,66
"68926","W01001750",2011,841,356,485,71
"68927","W01001751",2011,802,349,453,77
"68928","W01001752",2011,673,32,641,59
"68929","W01001753",2011,642,269,373,65
"68930","W01001754",2011,829,76,753,114
"68931","W01001755",2011,536,12,524,231
"68932","W01001756",2011,667,196,471,143
"68933","W01001757",2011,571,27,544,261
"68934","W01001758",2011,652,16,636,293
"68935","W01001759",2011,674,44,630,120
"68936","W01001760",2011,670,109,561,111
"68937","W01001761",2011,724,160,564,218
"68938","W01001762",2011,736,247,489,197
"68939","W01001764",2011,603,143,460,156
"68940","W01001765",2011,521,71,450,140
"68941","W01001766",2011,685,100,585,186
"68942","W01001767",2011,691,112,579,208
"68943","W01001768",2011,539,60,479,191
"68944","W01001769",2011,617,5,612,35
"68945","W01001770",2011,476,51,425,68
"68946","W01001771",2011,688,33,655,87
"68947","W01001772",2011,603,8,595,47
"68948","W01001773",2011,991,49,942,221
"68949","W01001774",2011,541,5,536,41
"68950","W01001775",2011,693,38,655,142
"68951","W01001776",2011,515,2,513,59
"68952","W01001777",2011,610,9,601,46
"68953","W01001778",2011,700,2,698,22
"68954","W01001779",2011,653,14,639,105
"68955","W01001780",2011,628,39,589,69
"68956","W01001781",2011,829,71,758,192
"68957","W01001782",2011,591,3,588,35
"68958","W01001783",2011,508,6,502,53
"68959","W01001784",2011,585,9,576,85
"68960","W01001785",2011,482,238,244,33
"68961","W01001786",2011,628,72,556,78
"68962","W01001787",2011,556,173,383,58
"68963","W01001788",2011,608,249,359,49
"68964","W01001789",2011,730,42,688,156
"68965","W01001790",2011,500,125,375,64
"68966","W01001791",2011,734,52,682,112
"68967","W01001792",2011,705,243,462,53
"68968","W01001793",2011,567,13,554,94
"68969","W01001794",2011,626,4,622,125
"68970","W01001795",2011,644,11,633,94
"68971","W01001796",2011,653,51,602,89
"68972","W01001797",2011,607,29,578,48
"68973","W01001798",2011,624,15,609,76
"68974","W01001799",2011,520,6,514,38
"68975","W01001800",2011,665,208,457,53
"68976","W01001802",2011,684,147,537,55
"68977","W01001803",2011,712,237,475,47
"68978","W01001804",2011,643,187,456,54
"68979","W01001805",2011,645,245,400,35
"68980","W01001806",2011,799,56,743,136
"68981","W01001807",2011,591,266,325,51
"68982","W01001808",2011,638,326,312,55
"68983","W01001809",2011,538,81,457,38
"68984","W01001810",2011,635,224,411,67
"68985","W01001811",2011,540,255,285,47
"68986","W01001812",2011,484,69,415,57
"68987","W01001813",2011,698,317,381,52
"68988","W01001814",2011,672,64,608,128
"68989","W01001815",2011,511,33,478,37
"68990","W01001816",2011,1065,302,763,153
"68991","W01001817",2011,553,100,453,54
"68992","W01001818",2011,625,68,557,126
"68993","W01001819",2011,912,76,836,62
"68994","W01001820",2011,508,73,435,27
"68995","W01001821",2011,548,68,480,98
"68996","W01001822",2011,739,123,616,98
"68997","W01001823",2011,521,7,514,75
"68998","W01001824",2011,693,39,654,364
"68999","W01001825",2011,774,73,701,187
"69000","W01001826",2011,561,7,554,49
"69001","W01001827",2011,619,20,599,43
"69002","W01001828",2011,637,7,630,38
"69003","W01001829",2011,663,54,609,413
"69004","W01001830",2011,883,88,795,638
"69005","W01001831",2011,620,14,606,295
"69006","W01001832",2011,741,52,689,611
"69007","W01001833",2011,716,73,643,311
"69008","W01001834",2011,691,83,608,289
"69009","W01001835",2011,908,288,620,394
"69010","W01001836",2011,580,28,552,330
"69011","W01001837",2011,510,84,426,238
"69012","W01001838",2011,640,8,632,333
"69013","W01001839",2011,613,26,587,319
"69014","W01001840",2011,755,157,598,83
"69015","W01001841",2011,740,71,669,67
"69016","W01001842",2011,726,9,717,177
"69017","W01001843",2011,808,15,793,123
"69018","W01001844",2011,841,100,741,167
"69019","W01001846",2011,641,32,609,67
"69020","W01001847",2011,637,2,635,16
"69021","W01001848",2011,618,5,613,51
"69022","W01001849",2011,651,4,647,52
"69023","W01001850",2011,790,3,787,51
"69024","W01001851",2011,697,50,647,71
"69025","W01001852",2011,723,5,718,34
"69026","W01001853",2011,749,3,746,57
"69027","W01001854",2011,834,4,830,66
"69028","W01001855",2011,685,199,486,173
"69029","W01001856",2011,776,196,580,327
"69030","W01001857",2011,843,319,524,217
"69031","W01001858",2011,869,87,782,387
"69032","W01001859",2011,722,68,654,268
"69033","W01001860",2011,799,46,753,264
"69034","W01001861",2011,757,33,724,350
"69035","W01001862",2011,707,81,626,364
"69036","W01001863",2011,637,66,571,79
"69037","W01001864",2011,623,15,608,55
"69038","W01001865",2011,515,41,474,35
"69039","W01001866",2011,606,159,447,48
"69040","W01001867",2011,545,248,297,50
"69041","W01001868",2011,609,177,432,53
"69042","W01001869",2011,623,107,516,109
"69043","W01001870",2011,580,75,505,93
"69044","W01001871",2011,679,349,330,64
"69045","W01001872",2011,662,152,510,140
"69046","W01001873",2011,778,242,536,201
"69047","W01001874",2011,723,401,322,111
"69048","W01001875",2011,1140,281,859,256
"69049","W01001876",2011,678,276,402,74
"69050","W01001877",2011,721,25,696,118
"69051","W01001878",2011,630,87,543,73
"69052","W01001879",2011,817,377,440,91
"69053","W01001880",2011,573,356,217,58
"69054","W01001881",2011,645,249,396,71
"69055","W01001882",2011,739,24,715,137
"69056","W01001883",2011,675,302,373,40
"69057","W01001884",2011,527,504,23,8
"69058","W01001885",2011,786,134,652,101
"69059","W01001886",2011,516,235,281,51
"69060","W01001887",2011,613,1,612,48
"69061","W01001888",2011,694,86,608,73
"69062","W01001889",2011,747,80,667,103
"69063","W01001890",2011,608,7,601,94
"69064","W01001891",2011,762,118,644,99
"69065","W01001892",2011,599,5,594,20
"69066","W01001893",2011,793,162,631,69
"69067","W01001894",2011,651,14,637,51
"69068","W01001895",2011,851,377,474,63
"69069","W01001896",2011,628,11,617,59
"69070","W01001897",2011,837,75,762,120
"69071","W01001898",2011,625,159,466,38
"69072","W01001899",2011,866,131,735,68
"69073","W01001900",2011,684,134,550,69
"69074","W01001901",2011,884,106,778,105
"69075","W01001902",2011,591,347,244,28
"69076","W01001903",2011,937,157,780,97
"69077","W01001904",2011,727,51,676,107
"69078","W01001905",2011,880,54,826,130
"69079","W01001906",2011,843,90,753,107
"69080","W01001907",2011,572,44,528,99
"69081","W01001908",2011,934,267,667,60
"69082","W01001909",2011,1165,422,743,67
"69083","W01001910",2011,734,144,590,239
"69084","W01001911",2011,508,39,469,147
"69085","W01001912",2011,648,10,638,71
"69086","W01001913",2011,605,46,559,154
"69087","W01001914",2011,577,14,563,18
"69088","W01001915",2011,609,1,608,38
"69089","W01001916",2011,547,5,542,85
"69090","W01001917",2011,606,64,542,59
"69091","W01001918",2011,536,14,522,44
"69092","W01001919",2011,531,23,508,78
"69093","W01001920",2011,443,6,437,56
"69094","W01001921",2011,576,139,437,65
"69095","W01001922",2011,424,39,385,336
"69096","W01001923",2011,603,154,449,178
"69097","W01001924",2011,623,238,385,100
"69098","W01001925",2011,980,134,846,86
"69099","W01001926",2011,1001,50,951,150
"69100","W01001927",2011,582,45,537,57
"69101","W01001928",2011,622,82,540,211
"69102","W01001929",2011,621,142,479,210
"69103","W01001930",2011,907,116,791,106
"69104","W01001931",2011,639,222,417,177
"69105","W01001932",2011,1227,112,1115,236
"69106","W01001933",2011,1151,107,1044,146
"69107","W01001934",2011,1106,159,947,445
"69108","W01001935",2011,469,49,420,167
"69109","W01001936",2011,462,49,413,104
"69110","W01001937",2011,949,43,906,212
"69111","W01001938",2011,807,118,689,438
"69112","W01001939",2011,627,13,614,438
"69113","W01001940",2011,728,89,639,432
"69114","W01001941",2011,670,16,654,483
"69115","W01001942",2011,647,197,450,208
"69116","W01001943",2011,635,54,581,353
"69117","W01001944",2011,580,23,557,346
"69118","W01001945",2011,838,9,829,588
"69119","W01001946",2011,707,268,439,214
"69120","W01001947",2011,873,39,834,466
"69121","W01001948",2011,637,31,606,110
"69122","W01001949",2011,635,134,501,163
"69123","W01001950",2011,609,40,569,318
"69124","W01001951",2011,548,52,496,281
"69125","W01001952",2011,621,77,544,348
"69126","W01001953",2011,643,154,489,68
"69127","W01001954",2011,637,19,618,49
"69128","W01001955",2011,1153,773,380,285
"69129","W01001956",2011,803,70,733,106
"69130","W01001957",2011,411,69,342,135
"69131","W01001958",2011,836,235,601,330
"69132","Scotland",2001,2192246,595143,1597103,294502
"69133","S01000001",2001,385,38,347,294502
"69134","S01000002",2001,267,2,265,294502
"69135","S01000003",2001,333,1,332,294502
"69136","S01000004",2001,258,0,0,294502
"69137","S01000005",2001,312,33,279,294502
"69138","S01000006",2001,269,79,190,294502
"69139","S01000007",2001,355,36,319,294502
"69140","S01000008",2001,277,78,199,294502
"69141","S01000009",2001,284,51,233,294502
"69142","S01000010",2001,244,1,243,294502
"69143","S01000011",2001,279,5,274,294502
"69144","S01000012",2001,324,5,319,294502
"69145","S01000013",2001,351,108,243,294502
"69146","S01000014",2001,369,43,326,294502
"69147","S01000015",2001,285,1,284,294502
"69148","S01000016",2001,165,0,0,294502
"69149","S01000017",2001,393,66,327,294502
"69150","S01000018",2001,241,26,215,294502
"69151","S01000019",2001,224,0,0,294502
"69152","S01000020",2001,341,35,306,294502
"69153","S01000021",2001,350,72,278,294502
"69154","S01000022",2001,271,2,269,294502
"69155","S01000023",2001,267,1,266,294502
"69156","S01000024",2001,171,4,167,294502
"69157","S01000025",2001,269,3,266,294502
"69158","S01000026",2001,417,201,216,294502
"69159","S01000027",2001,332,30,302,294502
"69160","S01000028",2001,426,170,256,294502
"69161","S01000029",2001,211,4,207,294502
"69162","S01000030",2001,231,109,122,294502
"69163","S01000031",2001,365,10,355,294502
"69164","S01000032",2001,487,183,304,294502
"69165","S01000033",2001,389,231,158,294502
"69166","S01000034",2001,339,2,337,294502
"69167","S01000035",2001,447,153,294,294502
"69168","S01000036",2001,291,156,135,294502
"69169","S01000037",2001,350,90,260,294502
"69170","S01000038",2001,340,94,246,294502
"69171","S01000039",2001,429,221,208,294502
"69172","S01000040",2001,392,136,256,294502
"69173","S01000041",2001,369,66,303,294502
"69174","S01000042",2001,342,141,201,294502
"69175","S01000043",2001,496,116,380,294502
"69176","S01000044",2001,441,216,225,294502
"69177","S01000045",2001,244,3,241,294502
"69178","S01000046",2001,332,3,329,294502
"69179","S01000047",2001,439,155,284,294502
"69180","S01000048",2001,422,6,416,294502
"69181","S01000049",2001,336,2,334,294502
"69182","S01000050",2001,262,6,256,294502
"69183","S01000051",2001,364,3,361,294502
"69184","S01000052",2001,260,146,114,294502
"69185","S01000053",2001,564,117,447,294502
"69186","S01000054",2001,387,70,317,294502
"69187","S01000055",2001,319,184,135,294502
"69188","S01000056",2001,397,38,359,294502
"69189","S01000057",2001,284,195,89,294502
"69190","S01000058",2001,268,0,0,294502
"69191","S01000059",2001,338,2,336,294502
"69192","S01000060",2001,268,196,72,294502
"69193","S01000061",2001,453,6,447,294502
"69194","S01000062",2001,547,25,522,294502
"69195","S01000063",2001,412,2,410,294502
"69196","S01000064",2001,284,85,199,294502
"69197","S01000065",2001,554,95,459,294502
"69198","S01000066",2001,457,88,369,294502
"69199","S01000067",2001,474,53,421,294502
"69200","S01000068",2001,380,7,373,294502
"69201","S01000069",2001,378,223,155,294502
"69202","S01000070",2001,284,165,119,294502
"69203","S01000071",2001,411,276,135,294502
"69204","S01000072",2001,389,129,260,294502
"69205","S01000073",2001,264,3,261,294502
"69206","S01000074",2001,380,327,53,294502
"69207","S01000075",2001,352,43,309,294502
"69208","S01000076",2001,316,1,315,294502
"69209","S01000077",2001,398,4,394,294502
"69210","S01000078",2001,567,117,450,294502
"69211","S01000079",2001,503,15,488,294502
"69212","S01000080",2001,558,10,548,294502
"69213","S01000081",2001,409,4,405,294502
"69214","S01000082",2001,491,248,243,294502
"69215","S01000083",2001,364,6,358,294502
"69216","S01000084",2001,486,141,345,294502
"69217","S01000085",2001,410,26,384,294502
"69218","S01000086",2001,367,23,344,294502
"69219","S01000087",2001,250,8,242,294502
"69220","S01000088",2001,391,28,363,294502
"69221","S01000089",2001,390,1,389,294502
"69222","S01000090",2001,428,9,419,294502
"69223","S01000091",2001,582,52,530,294502
"69224","S01000092",2001,565,13,552,294502
"69225","S01000093",2001,286,10,276,294502
"69226","S01000094",2001,349,27,322,294502
"69227","S01000095",2001,405,13,392,294502
"69228","S01000096",2001,412,238,174,294502
"69229","S01000097",2001,432,16,416,294502
"69230","S01000098",2001,585,73,512,294502
"69231","S01000099",2001,332,2,330,294502
"69232","S01000100",2001,428,53,375,294502
"69233","S01000101",2001,405,3,402,294502
"69234","S01000102",2001,465,224,241,294502
"69235","S01000103",2001,365,11,354,294502
"69236","S01000104",2001,321,3,318,294502
"69237","S01000105",2001,378,3,375,294502
"69238","S01000106",2001,278,2,276,294502
"69239","S01000107",2001,546,111,435,294502
"69240","S01000108",2001,362,130,232,294502
"69241","S01000109",2001,563,186,377,294502
"69242","S01000110",2001,401,124,277,294502
"69243","S01000111",2001,369,7,362,294502
"69244","S01000112",2001,561,184,377,294502
"69245","S01000113",2001,238,14,224,294502
"69246","S01000114",2001,305,147,158,294502
"69247","S01000115",2001,412,216,196,294502
"69248","S01000116",2001,613,19,594,294502
"69249","S01000117",2001,424,42,382,294502
"69250","S01000118",2001,300,93,207,294502
"69251","S01000119",2001,527,202,325,294502
"69252","S01000120",2001,316,34,282,294502
"69253","S01000121",2001,346,86,260,294502
"69254","S01000122",2001,345,213,132,294502
"69255","S01000123",2001,252,18,234,294502
"69256","S01000124",2001,590,121,469,294502
"69257","S01000125",2001,497,240,257,294502
"69258","S01000126",2001,569,248,321,294502
"69259","S01000127",2001,320,3,317,294502
"69260","S01000128",2001,599,174,425,294502
"69261","S01000129",2001,277,5,272,294502
"69262","S01000130",2001,536,161,375,294502
"69263","S01000131",2001,352,3,349,294502
"69264","S01000132",2001,432,14,418,294502
"69265","S01000133",2001,301,135,166,294502
"69266","S01000134",2001,331,198,133,294502
"69267","S01000135",2001,421,306,115,294502
"69268","S01000136",2001,307,158,149,294502
"69269","S01000137",2001,457,84,373,294502
"69270","S01000138",2001,494,127,367,294502
"69271","S01000139",2001,369,183,186,294502
"69272","S01000140",2001,410,178,232,294502
"69273","S01000141",2001,381,29,352,294502
"69274","S01000142",2001,338,200,138,294502
"69275","S01000143",2001,241,2,239,294502
"69276","S01000144",2001,305,34,271,294502
"69277","S01000145",2001,463,233,230,294502
"69278","S01000146",2001,692,239,453,294502
"69279","S01000147",2001,456,107,349,294502
"69280","S01000148",2001,303,188,115,294502
"69281","S01000149",2001,624,177,447,294502
"69282","S01000150",2001,278,130,148,294502
"69283","S01000151",2001,481,349,132,294502
"69284","S01000152",2001,454,62,392,294502
"69285","S01000153",2001,342,144,198,294502
"69286","S01000154",2001,250,96,154,294502
"69287","S01000155",2001,365,189,176,294502
"69288","S01000156",2001,509,239,270,294502
"69289","S01000157",2001,435,274,161,294502
"69290","S01000158",2001,454,233,221,294502
"69291","S01000159",2001,344,4,340,294502
"69292","S01000160",2001,337,134,203,294502
"69293","S01000161",2001,408,6,402,294502
"69294","S01000162",2001,433,181,252,294502
"69295","S01000163",2001,429,213,216,294502
"69296","S01000164",2001,347,130,217,294502
"69297","S01000165",2001,483,261,222,294502
"69298","S01000166",2001,560,61,499,294502
"69299","S01000167",2001,316,129,187,294502
"69300","S01000168",2001,387,186,201,294502
"69301","S01000169",2001,345,114,231,294502
"69302","S01000170",2001,506,37,469,294502
"69303","S01000171",2001,336,12,324,294502
"69304","S01000172",2001,213,53,160,294502
"69305","S01000173",2001,362,195,167,294502
"69306","S01000174",2001,286,1,285,294502
"69307","S01000175",2001,297,91,206,294502
"69308","S01000176",2001,384,63,321,294502
"69309","S01000177",2001,269,18,251,294502
"69310","S01000178",2001,308,150,158,294502
"69311","S01000179",2001,457,399,58,294502
"69312","S01000180",2001,275,90,185,294502
"69313","S01000181",2001,236,124,112,294502
"69314","S01000182",2001,334,157,177,294502
"69315","S01000183",2001,477,235,242,294502
"69316","S01000184",2001,371,49,322,294502
"69317","S01000185",2001,474,339,135,294502
"69318","S01000186",2001,499,167,332,294502
"69319","S01000187",2001,246,131,115,294502
"69320","S01000188",2001,453,231,222,294502
"69321","S01000189",2001,215,124,91,294502
"69322","S01000190",2001,363,163,200,294502
"69323","S01000191",2001,430,51,379,294502
"69324","S01000192",2001,369,210,159,294502
"69325","S01000193",2001,288,152,136,294502
"69326","S01000194",2001,365,194,171,294502
"69327","S01000195",2001,400,256,144,294502
"69328","S01000196",2001,317,227,90,294502
"69329","S01000197",2001,235,112,123,294502
"69330","S01000198",2001,334,222,112,294502
"69331","S01000199",2001,349,278,71,294502
"69332","S01000200",2001,412,176,236,294502
"69333","S01000201",2001,312,149,163,294502
"69334","S01000202",2001,461,120,341,294502
"69335","S01000203",2001,296,261,35,294502
"69336","S01000204",2001,250,128,122,294502
"69337","S01000205",2001,324,149,175,294502
"69338","S01000206",2001,270,77,193,294502
"69339","S01000207",2001,525,422,103,294502
"69340","S01000208",2001,342,255,87,294502
"69341","S01000209",2001,389,291,98,294502
"69342","S01000210",2001,355,195,160,294502
"69343","S01000211",2001,357,262,95,294502
"69344","S01000212",2001,331,135,196,294502
"69345","S01000213",2001,393,214,179,294502
"69346","S01000214",2001,231,85,146,294502
"69347","S01000215",2001,235,11,224,294502
"69348","S01000216",2001,290,22,268,294502
"69349","S01000217",2001,332,227,105,294502
"69350","S01000218",2001,336,133,203,294502
"69351","S01000219",2001,351,283,68,294502
"69352","S01000220",2001,307,130,177,294502
"69353","S01000221",2001,461,204,257,294502
"69354","S01000222",2001,330,113,217,294502
"69355","S01000223",2001,247,4,243,294502
"69356","S01000224",2001,311,102,209,294502
"69357","S01000225",2001,252,48,204,294502
"69358","S01000226",2001,279,2,277,294502
"69359","S01000227",2001,254,1,253,294502
"69360","S01000228",2001,343,45,298,294502
"69361","S01000229",2001,395,201,194,294502
"69362","S01000230",2001,306,103,203,294502
"69363","S01000231",2001,309,1,308,294502
"69364","S01000232",2001,296,153,143,294502
"69365","S01000233",2001,275,144,131,294502
"69366","S01000234",2001,328,2,326,294502
"69367","S01000235",2001,345,4,341,294502
"69368","S01000236",2001,295,44,251,294502
"69369","S01000237",2001,375,10,365,294502
"69370","S01000238",2001,229,3,226,294502
"69371","S01000239",2001,294,23,271,294502
"69372","S01000240",2001,280,40,240,294502
"69373","S01000241",2001,226,3,223,294502
"69374","S01000242",2001,300,40,260,294502
"69375","S01000243",2001,257,0,0,294502
"69376","S01000244",2001,506,115,391,294502
"69377","S01000245",2001,369,52,317,294502
"69378","S01000246",2001,284,52,232,294502
"69379","S01000247",2001,272,4,268,294502
"69380","S01000248",2001,345,1,344,294502
"69381","S01000249",2001,292,42,250,294502
"69382","S01000250",2001,275,2,273,294502
"69383","S01000251",2001,150,2,148,294502
"69384","S01000252",2001,344,4,340,294502
"69385","S01000253",2001,222,0,0,294502
"69386","S01000254",2001,316,6,310,294502
"69387","S01000255",2001,259,1,258,294502
"69388","S01000256",2001,418,72,346,294502
"69389","S01000257",2001,346,50,296,294502
"69390","S01000258",2001,239,1,238,294502
"69391","S01000259",2001,220,1,219,294502
"69392","S01000260",2001,330,3,327,294502
"69393","S01000261",2001,399,17,382,294502
"69394","S01000262",2001,405,55,350,294502
"69395","S01000263",2001,366,46,320,294502
"69396","S01000264",2001,407,119,288,294502
"69397","S01000265",2001,335,108,227,294502
"69398","S01000266",2001,392,76,316,294502
"69399","S01000267",2001,289,79,210,294502
"69400","S01000268",2001,324,123,201,294502
"69401","S01000269",2001,236,7,229,294502
"69402","S01000270",2001,388,26,362,294502
"69403","S01000271",2001,365,93,272,294502
"69404","S01000272",2001,368,33,335,294502
"69405","S01000273",2001,196,7,189,294502
"69406","S01000274",2001,256,66,190,294502
"69407","S01000275",2001,426,154,272,294502
"69408","S01000276",2001,246,4,242,294502
"69409","S01000277",2001,275,54,221,294502
"69410","S01000278",2001,248,129,119,294502
"69411","S01000279",2001,210,2,208,294502
"69412","S01000280",2001,248,40,208,294502
"69413","S01000281",2001,297,60,237,294502
"69414","S01000282",2001,257,46,211,294502
"69415","S01000283",2001,350,54,296,294502
"69416","S01000284",2001,287,12,275,294502
"69417","S01000285",2001,242,23,219,294502
"69418","S01000286",2001,476,113,363,294502
"69419","S01000287",2001,280,6,274,294502
"69420","S01000288",2001,329,56,273,294502
"69421","S01000289",2001,417,148,269,294502
"69422","S01000290",2001,332,169,163,294502
"69423","S01000291",2001,284,51,233,294502
"69424","S01000292",2001,365,18,347,294502
"69425","S01000293",2001,434,116,318,294502
"69426","S01000294",2001,243,54,189,294502
"69427","S01000295",2001,220,2,218,294502
"69428","S01000296",2001,207,13,194,294502
"69429","S01000297",2001,308,74,234,294502
"69430","S01000298",2001,194,21,173,294502
"69431","S01000299",2001,344,5,339,294502
"69432","S01000300",2001,293,9,284,294502
"69433","S01000301",2001,274,45,229,294502
"69434","S01000302",2001,207,7,200,294502
"69435","S01000303",2001,278,7,271,294502
"69436","S01000304",2001,303,1,302,294502
"69437","S01000305",2001,413,105,308,294502
"69438","S01000306",2001,279,10,269,294502
"69439","S01000307",2001,336,14,322,294502
"69440","S01000308",2001,382,12,370,294502
"69441","S01000309",2001,305,3,302,294502
"69442","S01000310",2001,341,1,340,294502
"69443","S01000311",2001,420,14,406,294502
"69444","S01000312",2001,263,22,241,294502
"69445","S01000313",2001,303,70,233,294502
"69446","S01000314",2001,242,28,214,294502
"69447","S01000315",2001,247,24,223,294502
"69448","S01000316",2001,379,143,236,294502
"69449","S01000317",2001,259,131,128,294502
"69450","S01000318",2001,212,2,210,294502
"69451","S01000319",2001,225,2,223,294502
"69452","S01000320",2001,325,3,322,294502
"69453","S01000321",2001,214,5,209,294502
"69454","S01000322",2001,377,2,375,294502
"69455","S01000323",2001,342,133,209,294502
"69456","S01000324",2001,312,1,311,294502
"69457","S01000325",2001,269,63,206,294502
"69458","S01000326",2001,292,105,187,294502
"69459","S01000327",2001,308,2,306,294502
"69460","S01000328",2001,198,40,158,294502
"69461","S01000329",2001,232,74,158,294502
"69462","S01000330",2001,260,4,256,294502
"69463","S01000331",2001,275,90,185,294502
"69464","S01000332",2001,293,3,290,294502
"69465","S01000333",2001,308,11,297,294502
"69466","S01000334",2001,386,122,264,294502
"69467","S01000335",2001,276,79,197,294502
"69468","S01000336",2001,319,4,315,294502
"69469","S01000337",2001,280,13,267,294502
"69470","S01000338",2001,191,16,175,294502
"69471","S01000339",2001,419,61,358,294502
"69472","S01000340",2001,382,32,350,294502
"69473","S01000341",2001,282,12,270,294502
"69474","S01000342",2001,255,88,167,294502
"69475","S01000343",2001,222,2,220,294502
"69476","S01000344",2001,340,47,293,294502
"69477","S01000345",2001,248,17,231,294502
"69478","S01000346",2001,266,4,262,294502
"69479","S01000347",2001,191,24,167,294502
"69480","S01000348",2001,322,4,318,294502
"69481","S01000349",2001,263,53,210,294502
"69482","S01000350",2001,355,24,331,294502
"69483","S01000351",2001,364,5,359,294502
"69484","S01000352",2001,300,1,299,294502
"69485","S01000353",2001,248,2,246,294502
"69486","S01000354",2001,188,1,187,294502
"69487","S01000355",2001,238,0,0,294502
"69488","S01000356",2001,222,3,219,294502
"69489","S01000357",2001,220,0,0,294502
"69490","S01000358",2001,351,2,349,294502
"69491","S01000359",2001,249,2,247,294502
"69492","S01000360",2001,226,24,202,294502
"69493","S01000361",2001,235,6,229,294502
"69494","S01000362",2001,346,28,318,294502
"69495","S01000363",2001,350,7,343,294502
"69496","S01000364",2001,332,5,327,294502
"69497","S01000365",2001,254,41,213,294502
"69498","S01000366",2001,286,15,271,294502
"69499","S01000367",2001,297,27,270,294502
"69500","S01000368",2001,341,70,271,294502
"69501","S01000369",2001,391,36,355,294502
"69502","S01000370",2001,292,4,288,294502
"69503","S01000371",2001,418,111,307,294502
"69504","S01000372",2001,376,96,280,294502
"69505","S01000373",2001,220,2,218,294502
"69506","S01000374",2001,291,35,256,294502
"69507","S01000375",2001,271,140,131,294502
"69508","S01000376",2001,345,169,176,294502
"69509","S01000377",2001,282,0,0,294502
"69510","S01000378",2001,195,73,122,294502
"69511","S01000379",2001,212,2,210,294502
"69512","S01000380",2001,268,13,255,294502
"69513","S01000381",2001,362,43,319,294502
"69514","S01000382",2001,299,32,267,294502
"69515","S01000383",2001,272,30,242,294502
"69516","S01000384",2001,313,61,252,294502
"69517","S01000385",2001,243,70,173,294502
"69518","S01000386",2001,339,49,290,294502
"69519","S01000387",2001,348,60,288,294502
"69520","S01000388",2001,281,8,273,294502
"69521","S01000389",2001,240,28,212,294502
"69522","S01000390",2001,303,114,189,294502
"69523","S01000391",2001,253,47,206,294502
"69524","S01000392",2001,271,10,261,294502
"69525","S01000393",2001,376,82,294,294502
"69526","S01000394",2001,282,115,167,294502
"69527","S01000395",2001,282,18,264,294502
"69528","S01000396",2001,461,244,217,294502
"69529","S01000397",2001,442,115,327,294502
"69530","S01000398",2001,271,3,268,294502
"69531","S01000399",2001,294,40,254,294502
"69532","S01000400",2001,339,90,249,294502
"69533","S01000401",2001,306,15,291,294502
"69534","S01000402",2001,303,21,282,294502
"69535","S01000403",2001,350,59,291,294502
"69536","S01000404",2001,284,18,266,294502
"69537","S01000405",2001,208,6,202,294502
"69538","S01000406",2001,265,79,186,294502
"69539","S01000407",2001,269,123,146,294502
"69540","S01000408",2001,199,1,198,294502
"69541","S01000409",2001,233,1,232,294502
"69542","S01000410",2001,242,1,241,294502
"69543","S01000411",2001,235,17,218,294502
"69544","S01000412",2001,291,44,247,294502
"69545","S01000413",2001,311,36,275,294502
"69546","S01000414",2001,245,13,232,294502
"69547","S01000415",2001,273,101,172,294502
"69548","S01000416",2001,274,67,207,294502
"69549","S01000417",2001,400,96,304,294502
"69550","S01000418",2001,273,17,256,294502
"69551","S01000419",2001,244,4,240,294502
"69552","S01000420",2001,412,86,326,294502
"69553","S01000421",2001,227,17,210,294502
"69554","S01000422",2001,286,71,215,294502
"69555","S01000423",2001,320,15,305,294502
"69556","S01000424",2001,256,27,229,294502
"69557","S01000425",2001,315,77,238,294502
"69558","S01000426",2001,277,24,253,294502
"69559","S01000427",2001,326,1,325,294502
"69560","S01000428",2001,276,4,272,294502
"69561","S01000429",2001,344,6,338,294502
"69562","S01000430",2001,214,0,0,294502
"69563","S01000431",2001,311,108,203,294502
"69564","S01000432",2001,422,6,416,294502
"69565","S01000433",2001,241,115,126,294502
"69566","S01000434",2001,245,111,134,294502
"69567","S01000435",2001,224,55,169,294502
"69568","S01000436",2001,232,1,231,294502
"69569","S01000437",2001,402,49,353,294502
"69570","S01000438",2001,230,2,228,294502
"69571","S01000439",2001,268,17,251,294502
"69572","S01000440",2001,342,38,304,294502
"69573","S01000441",2001,357,74,283,294502
"69574","S01000442",2001,319,4,315,294502
"69575","S01000443",2001,215,3,212,294502
"69576","S01000444",2001,200,3,197,294502
"69577","S01000445",2001,396,50,346,294502
"69578","S01000446",2001,362,9,353,294502
"69579","S01000447",2001,212,69,143,294502
"69580","S01000448",2001,225,10,215,294502
"69581","S01000449",2001,305,116,189,294502
"69582","S01000450",2001,256,6,250,294502
"69583","S01000451",2001,307,42,265,294502
"69584","S01000452",2001,208,7,201,294502
"69585","S01000453",2001,187,8,179,294502
"69586","S01000454",2001,220,87,133,294502
"69587","S01000455",2001,346,82,264,294502
"69588","S01000456",2001,297,9,288,294502
"69589","S01000457",2001,397,74,323,294502
"69590","S01000458",2001,309,16,293,294502
"69591","S01000459",2001,494,123,371,294502
"69592","S01000460",2001,321,178,143,294502
"69593","S01000461",2001,444,179,265,294502
"69594","S01000462",2001,435,175,260,294502
"69595","S01000463",2001,265,60,205,294502
"69596","S01000464",2001,299,27,272,294502
"69597","S01000465",2001,238,10,228,294502
"69598","S01000466",2001,289,18,271,294502
"69599","S01000467",2001,288,88,200,294502
"69600","S01000468",2001,183,4,179,294502
"69601","S01000469",2001,234,24,210,294502
"69602","S01000470",2001,344,23,321,294502
"69603","S01000471",2001,237,39,198,294502
"69604","S01000472",2001,285,70,215,294502
"69605","S01000473",2001,291,103,188,294502
"69606","S01000474",2001,233,15,218,294502
"69607","S01000475",2001,337,122,215,294502
"69608","S01000476",2001,213,32,181,294502
"69609","S01000477",2001,312,59,253,294502
"69610","S01000478",2001,385,125,260,294502
"69611","S01000479",2001,395,118,277,294502
"69612","S01000480",2001,256,37,219,294502
"69613","S01000481",2001,292,6,286,294502
"69614","S01000482",2001,396,117,279,294502
"69615","S01000483",2001,470,164,306,294502
"69616","S01000484",2001,383,74,309,294502
"69617","S01000485",2001,414,2,412,294502
"69618","S01000486",2001,520,239,281,294502
"69619","S01000487",2001,267,72,195,294502
"69620","S01000488",2001,308,142,166,294502
"69621","S01000489",2001,438,261,177,294502
"69622","S01000490",2001,235,2,233,294502
"69623","S01000491",2001,249,130,119,294502
"69624","S01000492",2001,367,142,225,294502
"69625","S01000493",2001,260,56,204,294502
"69626","S01000494",2001,222,70,152,294502
"69627","S01000495",2001,338,18,320,294502
"69628","S01000496",2001,217,4,213,294502
"69629","S01000497",2001,271,67,204,294502
"69630","S01000498",2001,236,32,204,294502
"69631","S01000499",2001,310,48,262,294502
"69632","S01000500",2001,241,121,120,294502
"69633","S01000501",2001,278,100,178,294502
"69634","S01000502",2001,183,7,176,294502
"69635","S01000503",2001,186,4,182,294502
"69636","S01000504",2001,395,89,306,294502
"69637","S01000505",2001,289,48,241,294502
"69638","S01000506",2001,234,5,229,294502
"69639","S01000507",2001,492,210,282,294502
"69640","S01000508",2001,338,22,316,294502
"69641","S01000509",2001,463,118,345,294502
"69642","S01000510",2001,299,78,221,294502
"69643","S01000511",2001,208,31,177,294502
"69644","S01000512",2001,386,56,330,294502
"69645","S01000513",2001,372,132,240,294502
"69646","S01000514",2001,212,8,204,294502
"69647","S01000515",2001,211,7,204,294502
"69648","S01000516",2001,251,46,205,294502
"69649","S01000517",2001,288,73,215,294502
"69650","S01000518",2001,393,93,300,294502
"69651","S01000519",2001,181,4,177,294502
"69652","S01000520",2001,378,55,323,294502
"69653","S01000521",2001,385,153,232,294502
"69654","S01000522",2001,239,14,225,294502
"69655","S01000523",2001,322,166,156,294502
"69656","S01000524",2001,234,9,225,294502
"69657","S01000525",2001,378,50,328,294502
"69658","S01000526",2001,335,15,320,294502
"69659","S01000527",2001,227,6,221,294502
"69660","S01000528",2001,279,15,264,294502
"69661","S01000529",2001,276,5,271,294502
"69662","S01000530",2001,182,3,179,294502
"69663","S01000531",2001,222,19,203,294502
"69664","S01000532",2001,356,104,252,294502
"69665","S01000533",2001,317,59,258,294502
"69666","S01000534",2001,357,168,189,294502
"69667","S01000535",2001,446,166,280,294502
"69668","S01000536",2001,210,34,176,294502
"69669","S01000537",2001,208,5,203,294502
"69670","S01000538",2001,336,123,213,294502
"69671","S01000539",2001,519,143,376,294502
"69672","S01000540",2001,340,87,253,294502
"69673","S01000541",2001,248,73,175,294502
"69674","S01000542",2001,290,105,185,294502
"69675","S01000543",2001,324,78,246,294502
"69676","S01000544",2001,304,44,260,294502
"69677","S01000545",2001,323,76,247,294502
"69678","S01000546",2001,291,119,172,294502
"69679","S01000547",2001,236,48,188,294502
"69680","S01000548",2001,457,110,347,294502
"69681","S01000549",2001,367,1,366,294502
"69682","S01000550",2001,179,1,178,294502
"69683","S01000551",2001,374,67,307,294502
"69684","S01000552",2001,204,1,203,294502
"69685","S01000553",2001,375,52,323,294502
"69686","S01000554",2001,298,170,128,294502
"69687","S01000555",2001,387,161,226,294502
"69688","S01000556",2001,331,187,144,294502
"69689","S01000557",2001,375,98,277,294502
"69690","S01000558",2001,221,4,217,294502
"69691","S01000559",2001,315,100,215,294502
"69692","S01000560",2001,440,213,227,294502
"69693","S01000561",2001,545,190,355,294502
"69694","S01000562",2001,458,233,225,294502
"69695","S01000563",2001,356,134,222,294502
"69696","S01000564",2001,419,265,154,294502
"69697","S01000565",2001,304,131,173,294502
"69698","S01000566",2001,353,120,233,294502
"69699","S01000567",2001,336,168,168,294502
"69700","S01000568",2001,222,51,171,294502
"69701","S01000569",2001,329,41,288,294502
"69702","S01000570",2001,414,66,348,294502
"69703","S01000571",2001,438,78,360,294502
"69704","S01000572",2001,305,21,284,294502
"69705","S01000573",2001,206,1,205,294502
"69706","S01000574",2001,351,17,334,294502
"69707","S01000575",2001,307,37,270,294502
"69708","S01000576",2001,255,2,253,294502
"69709","S01000577",2001,227,16,211,294502
"69710","S01000578",2001,287,44,243,294502
"69711","S01000579",2001,264,3,261,294502
"69712","S01000580",2001,274,5,269,294502
"69713","S01000581",2001,276,9,267,294502
"69714","S01000582",2001,283,98,185,294502
"69715","S01000583",2001,303,42,261,294502
"69716","S01000584",2001,372,152,220,294502
"69717","S01000585",2001,450,96,354,294502
"69718","S01000586",2001,309,40,269,294502
"69719","S01000587",2001,328,92,236,294502
"69720","S01000588",2001,260,15,245,294502
"69721","S01000589",2001,300,32,268,294502
"69722","S01000590",2001,315,9,306,294502
"69723","S01000591",2001,274,41,233,294502
"69724","S01000592",2001,379,43,336,294502
"69725","S01000593",2001,230,7,223,294502
"69726","S01000594",2001,210,10,200,294502
"69727","S01000595",2001,325,57,268,294502
"69728","S01000596",2001,335,5,330,294502
"69729","S01000597",2001,401,2,399,294502
"69730","S01000598",2001,211,8,203,294502
"69731","S01000599",2001,348,29,319,294502
"69732","S01000600",2001,306,37,269,294502
"69733","S01000601",2001,408,16,392,294502
"69734","S01000602",2001,286,39,247,294502
"69735","S01000603",2001,317,11,306,294502
"69736","S01000604",2001,382,12,370,294502
"69737","S01000605",2001,311,22,289,294502
"69738","S01000606",2001,393,180,213,294502
"69739","S01000607",2001,348,32,316,294502
"69740","S01000608",2001,539,154,385,294502
"69741","S01000609",2001,483,298,185,294502
"69742","S01000610",2001,443,169,274,294502
"69743","S01000611",2001,296,134,162,294502
"69744","S01000612",2001,545,155,390,294502
"69745","S01000613",2001,480,71,409,294502
"69746","S01000614",2001,301,70,231,294502
"69747","S01000615",2001,469,215,254,294502
"69748","S01000616",2001,394,10,384,294502
"69749","S01000617",2001,279,36,243,294502
"69750","S01000618",2001,343,64,279,294502
"69751","S01000619",2001,285,50,235,294502
"69752","S01000620",2001,437,308,129,294502
"69753","S01000621",2001,531,167,364,294502
"69754","S01000622",2001,212,100,112,294502
"69755","S01000623",2001,286,103,183,294502
"69756","S01000624",2001,262,67,195,294502
"69757","S01000625",2001,300,172,128,294502
"69758","S01000626",2001,308,203,105,294502
"69759","S01000627",2001,399,146,253,294502
"69760","S01000628",2001,243,126,117,294502
"69761","S01000629",2001,201,18,183,294502
"69762","S01000630",2001,338,103,235,294502
"69763","S01000631",2001,286,125,161,294502
"69764","S01000632",2001,232,4,228,294502
"69765","S01000633",2001,221,19,202,294502
"69766","S01000634",2001,347,143,204,294502
"69767","S01000635",2001,248,62,186,294502
"69768","S01000636",2001,197,18,179,294502
"69769","S01000637",2001,229,4,225,294502
"69770","S01000638",2001,202,2,200,294502
"69771","S01000639",2001,271,28,243,294502
"69772","S01000640",2001,260,14,246,294502
"69773","S01000641",2001,319,38,281,294502
"69774","S01000642",2001,331,22,309,294502
"69775","S01000643",2001,242,17,225,294502
"69776","S01000644",2001,286,26,260,294502
"69777","S01000645",2001,367,56,311,294502
"69778","S01000646",2001,356,51,305,294502
"69779","S01000647",2001,366,119,247,294502
"69780","S01000648",2001,412,227,185,294502
"69781","S01000649",2001,237,2,235,294502
"69782","S01000650",2001,298,97,201,294502
"69783","S01000651",2001,355,140,215,294502
"69784","S01000652",2001,343,96,247,294502
"69785","S01000653",2001,485,193,292,294502
"69786","S01000654",2001,382,141,241,294502
"69787","S01000655",2001,370,229,141,294502
"69788","S01000656",2001,385,150,235,294502
"69789","S01000657",2001,369,173,196,294502
"69790","S01000658",2001,284,136,148,294502
"69791","S01000659",2001,495,68,427,294502
"69792","S01000660",2001,396,9,387,294502
"69793","S01000661",2001,392,79,313,294502
"69794","S01000662",2001,210,22,188,294502
"69795","S01000663",2001,291,38,253,294502
"69796","S01000664",2001,337,63,274,294502
"69797","S01000665",2001,305,67,238,294502
"69798","S01000666",2001,204,16,188,294502
"69799","S01000667",2001,441,77,364,294502
"69800","S01000668",2001,417,260,157,294502
"69801","S01000669",2001,410,136,274,294502
"69802","S01000670",2001,250,64,186,294502
"69803","S01000671",2001,264,87,177,294502
"69804","S01000672",2001,268,80,188,294502
"69805","S01000673",2001,292,18,274,294502
"69806","S01000674",2001,426,49,377,294502
"69807","S01000675",2001,293,7,286,294502
"69808","S01000676",2001,209,19,190,294502
"69809","S01000677",2001,406,168,238,294502
"69810","S01000678",2001,413,84,329,294502
"69811","S01000679",2001,368,151,217,294502
"69812","S01000680",2001,390,153,237,294502
"69813","S01000681",2001,451,163,288,294502
"69814","S01000682",2001,329,57,272,294502
"69815","S01000683",2001,247,18,229,294502
"69816","S01000684",2001,423,211,212,294502
"69817","S01000685",2001,402,45,357,294502
"69818","S01000686",2001,380,91,289,294502
"69819","S01000687",2001,351,153,198,294502
"69820","S01000688",2001,322,46,276,294502
"69821","S01000689",2001,234,22,212,294502
"69822","S01000690",2001,314,27,287,294502
"69823","S01000691",2001,349,141,208,294502
"69824","S01000692",2001,385,246,139,294502
"69825","S01000693",2001,487,238,249,294502
"69826","S01000694",2001,324,110,214,294502
"69827","S01000695",2001,318,74,244,294502
"69828","S01000696",2001,382,102,280,294502
"69829","S01000697",2001,203,9,194,294502
"69830","S01000698",2001,295,73,222,294502
"69831","S01000699",2001,255,78,177,294502
"69832","S01000700",2001,329,100,229,294502
"69833","S01000701",2001,376,23,353,294502
"69834","S01000702",2001,238,15,223,294502
"69835","S01000703",2001,330,124,206,294502
"69836","S01000704",2001,308,17,291,294502
"69837","S01000705",2001,435,46,389,294502
"69838","S01000706",2001,330,1,329,294502
"69839","S01000707",2001,231,12,219,294502
"69840","S01000708",2001,222,4,218,294502
"69841","S01000709",2001,407,79,328,294502
"69842","S01000710",2001,440,28,412,294502
"69843","S01000711",2001,239,26,213,294502
"69844","S01000712",2001,266,33,233,294502
"69845","S01000713",2001,309,113,196,294502
"69846","S01000714",2001,330,99,231,294502
"69847","S01000715",2001,364,150,214,294502
"69848","S01000716",2001,331,77,254,294502
"69849","S01000717",2001,484,300,184,294502
"69850","S01000718",2001,422,213,209,294502
"69851","S01000719",2001,282,40,242,294502
"69852","S01000720",2001,370,61,309,294502
"69853","S01000721",2001,283,57,226,294502
"69854","S01000722",2001,372,167,205,294502
"69855","S01000723",2001,218,11,207,294502
"69856","S01000724",2001,384,145,239,294502
"69857","S01000725",2001,286,18,268,294502
"69858","S01000726",2001,369,72,297,294502
"69859","S01000727",2001,271,150,121,294502
"69860","S01000728",2001,359,40,319,294502
"69861","S01000729",2001,264,121,143,294502
"69862","S01000730",2001,250,146,104,294502
"69863","S01000731",2001,299,202,97,294502
"69864","S01000732",2001,321,208,113,294502
"69865","S01000733",2001,458,107,351,294502
"69866","S01000734",2001,357,6,351,294502
"69867","S01000735",2001,274,31,243,294502
"69868","S01000736",2001,385,35,350,294502
"69869","S01000737",2001,332,86,246,294502
"69870","S01000738",2001,278,58,220,294502
"69871","S01000739",2001,376,123,253,294502
"69872","S01000740",2001,418,53,365,294502
"69873","S01000741",2001,440,46,394,294502
"69874","S01000742",2001,246,33,213,294502
"69875","S01000743",2001,297,1,296,294502
"69876","S01000744",2001,376,49,327,294502
"69877","S01000745",2001,315,16,299,294502
"69878","S01000746",2001,364,67,297,294502
"69879","S01000747",2001,274,48,226,294502
"69880","S01000748",2001,323,175,148,294502
"69881","S01000749",2001,227,138,89,294502
"69882","S01000750",2001,327,78,249,294502
"69883","S01000751",2001,301,26,275,294502
"69884","S01000752",2001,448,287,161,294502
"69885","S01000753",2001,258,87,171,294502
"69886","S01000754",2001,279,6,273,294502
"69887","S01000755",2001,342,58,284,294502
"69888","S01000756",2001,483,48,435,294502
"69889","S01000757",2001,297,41,256,294502
"69890","S01000758",2001,388,2,386,294502
"69891","S01000759",2001,442,117,325,294502
"69892","S01000760",2001,224,32,192,294502
"69893","S01000761",2001,264,7,257,294502
"69894","S01000762",2001,260,0,0,294502
"69895","S01000763",2001,357,21,336,294502
"69896","S01000764",2001,280,0,0,294502
"69897","S01000765",2001,208,14,194,294502
"69898","S01000766",2001,335,34,301,294502
"69899","S01000767",2001,305,210,95,294502
"69900","S01000768",2001,467,75,392,294502
"69901","S01000769",2001,562,65,497,294502
"69902","S01000770",2001,236,141,95,294502
"69903","S01000771",2001,407,37,370,294502
"69904","S01000772",2001,322,3,319,294502
"69905","S01000773",2001,408,55,353,294502
"69906","S01000774",2001,194,93,101,294502
"69907","S01000775",2001,287,51,236,294502
"69908","S01000776",2001,218,2,216,294502
"69909","S01000777",2001,164,69,95,294502
"69910","S01000778",2001,205,1,204,294502
"69911","S01000779",2001,309,29,280,294502
"69912","S01000780",2001,367,162,205,294502
"69913","S01000781",2001,341,0,0,294502
"69914","S01000782",2001,245,0,0,294502
"69915","S01000783",2001,223,5,218,294502
"69916","S01000784",2001,293,2,291,294502
"69917","S01000785",2001,353,65,288,294502
"69918","S01000786",2001,361,58,303,294502
"69919","S01000787",2001,237,18,219,294502
"69920","S01000788",2001,281,37,244,294502
"69921","S01000789",2001,305,77,228,294502
"69922","S01000790",2001,229,5,224,294502
"69923","S01000791",2001,276,106,170,294502
"69924","S01000792",2001,268,0,0,294502
"69925","S01000793",2001,266,72,194,294502
"69926","S01000794",2001,407,143,264,294502
"69927","S01000795",2001,347,77,270,294502
"69928","S01000796",2001,236,29,207,294502
"69929","S01000797",2001,218,66,152,294502
"69930","S01000798",2001,232,95,137,294502
"69931","S01000799",2001,216,14,202,294502
"69932","S01000800",2001,470,35,435,294502
"69933","S01000801",2001,266,32,234,294502
"69934","S01000802",2001,345,43,302,294502
"69935","S01000803",2001,426,24,402,294502
"69936","S01000804",2001,405,66,339,294502
"69937","S01000805",2001,383,59,324,294502
"69938","S01000806",2001,385,30,355,294502
"69939","S01000807",2001,323,108,215,294502
"69940","S01000808",2001,302,11,291,294502
"69941","S01000809",2001,266,47,219,294502
"69942","S01000810",2001,252,3,249,294502
"69943","S01000811",2001,316,2,314,294502
"69944","S01000812",2001,276,109,167,294502
"69945","S01000813",2001,279,25,254,294502
"69946","S01000814",2001,311,182,129,294502
"69947","S01000815",2001,316,213,103,294502
"69948","S01000816",2001,357,75,282,294502
"69949","S01000817",2001,344,71,273,294502
"69950","S01000818",2001,371,13,358,294502
"69951","S01000819",2001,361,50,311,294502
"69952","S01000820",2001,262,25,237,294502
"69953","S01000821",2001,398,86,312,294502
"69954","S01000822",2001,265,89,176,294502
"69955","S01000823",2001,256,123,133,294502
"69956","S01000824",2001,278,71,207,294502
"69957","S01000825",2001,299,28,271,294502
"69958","S01000826",2001,286,119,167,294502
"69959","S01000827",2001,287,48,239,294502
"69960","S01000828",2001,344,43,301,294502
"69961","S01000829",2001,280,32,248,294502
"69962","S01000830",2001,318,47,271,294502
"69963","S01000831",2001,419,54,365,294502
"69964","S01000832",2001,432,80,352,294502
"69965","S01000833",2001,209,93,116,294502
"69966","S01000834",2001,416,208,208,294502
"69967","S01000835",2001,319,177,142,294502
"69968","S01000836",2001,396,249,147,294502
"69969","S01000837",2001,498,201,297,294502
"69970","S01000838",2001,295,84,211,294502
"69971","S01000839",2001,429,91,338,294502
"69972","S01000840",2001,340,222,118,294502
"69973","S01000841",2001,353,242,111,294502
"69974","S01000842",2001,338,31,307,294502
"69975","S01000843",2001,376,47,329,294502
"69976","S01000844",2001,304,106,198,294502
"69977","S01000845",2001,245,31,214,294502
"69978","S01000846",2001,386,230,156,294502
"69979","S01000847",2001,495,151,344,294502
"69980","S01000848",2001,326,67,259,294502
"69981","S01000849",2001,224,87,137,294502
"69982","S01000850",2001,327,201,126,294502
"69983","S01000851",2001,299,6,293,294502
"69984","S01000852",2001,300,104,196,294502
"69985","S01000853",2001,258,113,145,294502
"69986","S01000854",2001,403,235,168,294502
"69987","S01000855",2001,330,50,280,294502
"69988","S01000856",2001,204,93,111,294502
"69989","S01000857",2001,243,95,148,294502
"69990","S01000858",2001,266,12,254,294502
"69991","S01000859",2001,360,51,309,294502
"69992","S01000860",2001,406,231,175,294502
"69993","S01000861",2001,288,76,212,294502
"69994","S01000862",2001,224,18,206,294502
"69995","S01000863",2001,279,153,126,294502
"69996","S01000864",2001,272,77,195,294502
"69997","S01000865",2001,351,175,176,294502
"69998","S01000866",2001,378,179,199,294502
"69999","S01000867",2001,397,227,170,294502
"70000","S01000868",2001,306,194,112,294502
"70001","S01000869",2001,216,142,74,294502
"70002","S01000870",2001,296,174,122,294502
"70003","S01000871",2001,344,98,246,294502
"70004","S01000872",2001,280,78,202,294502
"70005","S01000873",2001,383,120,263,294502
"70006","S01000874",2001,232,140,92,294502
"70007","S01000875",2001,330,135,195,294502
"70008","S01000876",2001,328,85,243,294502
"70009","S01000877",2001,362,194,168,294502
"70010","S01000878",2001,208,13,195,294502
"70011","S01000879",2001,395,42,353,294502
"70012","S01000880",2001,316,11,305,294502
"70013","S01000881",2001,316,138,178,294502
"70014","S01000882",2001,465,149,316,294502
"70015","S01000883",2001,398,94,304,294502
"70016","S01000884",2001,238,56,182,294502
"70017","S01000885",2001,192,5,187,294502
"70018","S01000886",2001,305,120,185,294502
"70019","S01000887",2001,310,83,227,294502
"70020","S01000888",2001,342,109,233,294502
"70021","S01000889",2001,352,87,265,294502
"70022","S01000890",2001,388,168,220,294502
"70023","S01000891",2001,382,85,297,294502
"70024","S01000892",2001,203,6,197,294502
"70025","S01000893",2001,274,10,264,294502
"70026","S01000894",2001,260,39,221,294502
"70027","S01000895",2001,413,75,338,294502
"70028","S01000896",2001,190,8,182,294502
"70029","S01000897",2001,310,47,263,294502
"70030","S01000898",2001,246,27,219,294502
"70031","S01000899",2001,377,144,233,294502
"70032","S01000900",2001,271,25,246,294502
"70033","S01000901",2001,303,56,247,294502
"70034","S01000902",2001,429,73,356,294502
"70035","S01000903",2001,444,61,383,294502
"70036","S01000904",2001,311,55,256,294502
"70037","S01000905",2001,293,32,261,294502
"70038","S01000906",2001,233,57,176,294502
"70039","S01000907",2001,433,123,310,294502
"70040","S01000908",2001,369,120,249,294502
"70041","S01000909",2001,382,42,340,294502
"70042","S01000910",2001,324,92,232,294502
"70043","S01000911",2001,434,33,401,294502
"70044","S01000912",2001,319,49,270,294502
"70045","S01000913",2001,336,53,283,294502
"70046","S01000914",2001,419,3,416,294502
"70047","S01000915",2001,402,51,351,294502
"70048","S01000916",2001,432,85,347,294502
"70049","S01000917",2001,294,38,256,294502
"70050","S01000918",2001,275,4,271,294502
"70051","S01000919",2001,291,70,221,294502
"70052","S01000920",2001,214,29,185,294502
"70053","S01000921",2001,294,54,240,294502
"70054","S01000922",2001,320,36,284,294502
"70055","S01000923",2001,305,61,244,294502
"70056","S01000924",2001,377,166,211,294502
"70057","S01000925",2001,381,81,300,294502
"70058","S01000926",2001,245,80,165,294502
"70059","S01000927",2001,401,136,265,294502
"70060","S01000928",2001,444,87,357,294502
"70061","S01000929",2001,227,152,75,294502
"70062","S01000930",2001,371,262,109,294502
"70063","S01000931",2001,303,156,147,294502
"70064","S01000932",2001,418,106,312,294502
"70065","S01000933",2001,423,60,363,294502
"70066","S01000934",2001,549,166,383,294502
"70067","S01000935",2001,402,94,308,294502
"70068","S01000936",2001,418,92,326,294502
"70069","S01000937",2001,284,90,194,294502
"70070","S01000938",2001,335,103,232,294502
"70071","S01000939",2001,361,108,253,294502
"70072","S01000940",2001,367,19,348,294502
"70073","S01000941",2001,266,96,170,294502
"70074","S01000942",2001,408,107,301,294502
"70075","S01000943",2001,380,3,377,294502
"70076","S01000944",2001,374,53,321,294502
"70077","S01000945",2001,345,53,292,294502
"70078","S01000946",2001,319,102,217,294502
"70079","S01000947",2001,336,79,257,294502
"70080","S01000948",2001,282,26,256,294502
"70081","S01000949",2001,282,0,0,294502
"70082","S01000950",2001,349,48,301,294502
"70083","S01000951",2001,319,56,263,294502
"70084","S01000952",2001,404,125,279,294502
"70085","S01000953",2001,375,3,372,294502
"70086","S01000954",2001,360,37,323,294502
"70087","S01000955",2001,210,18,192,294502
"70088","S01000956",2001,389,212,177,294502
"70089","S01000957",2001,231,33,198,294502
"70090","S01000958",2001,366,125,241,294502
"70091","S01000959",2001,281,9,272,294502
"70092","S01000960",2001,263,49,214,294502
"70093","S01000961",2001,385,62,323,294502
"70094","S01000962",2001,283,58,225,294502
"70095","S01000963",2001,328,170,158,294502
"70096","S01000964",2001,358,34,324,294502
"70097","S01000965",2001,265,167,98,294502
"70098","S01000966",2001,471,194,277,294502
"70099","S01000967",2001,284,102,182,294502
"70100","S01000968",2001,399,41,358,294502
"70101","S01000969",2001,466,142,324,294502
"70102","S01000970",2001,375,136,239,294502
"70103","S01000971",2001,296,147,149,294502
"70104","S01000972",2001,380,2,378,294502
"70105","S01000973",2001,252,68,184,294502
"70106","S01000974",2001,327,13,314,294502
"70107","S01000975",2001,245,11,234,294502
"70108","S01000976",2001,215,4,211,294502
"70109","S01000977",2001,313,62,251,294502
"70110","S01000978",2001,322,73,249,294502
"70111","S01000979",2001,271,36,235,294502
"70112","S01000980",2001,327,50,277,294502
"70113","S01000981",2001,244,2,242,294502
"70114","S01000982",2001,227,3,224,294502
"70115","S01000983",2001,233,28,205,294502
"70116","S01000984",2001,276,44,232,294502
"70117","S01000985",2001,291,115,176,294502
"70118","S01000986",2001,203,53,150,294502
"70119","S01000987",2001,250,18,232,294502
"70120","S01000988",2001,183,18,165,294502
"70121","S01000989",2001,322,3,319,294502
"70122","S01000990",2001,337,57,280,294502
"70123","S01000991",2001,187,11,176,294502
"70124","S01000992",2001,383,83,300,294502
"70125","S01000993",2001,338,47,291,294502
"70126","S01000994",2001,424,135,289,294502
"70127","S01000995",2001,295,3,292,294502
"70128","S01000996",2001,474,85,389,294502
"70129","S01000997",2001,384,2,382,294502
"70130","S01000998",2001,286,96,190,294502
"70131","S01000999",2001,269,5,264,294502
"70132","S01001000",2001,249,64,185,294502
"70133","S01001001",2001,222,19,203,294502
"70134","S01001002",2001,291,23,268,294502
"70135","S01001003",2001,367,2,365,294502
"70136","S01001004",2001,318,5,313,294502
"70137","S01001005",2001,352,31,321,294502
"70138","S01001006",2001,296,1,295,294502
"70139","S01001007",2001,358,122,236,294502
"70140","S01001008",2001,385,26,359,294502
"70141","S01001009",2001,300,3,297,294502
"70142","S01001010",2001,463,164,299,294502
"70143","S01001011",2001,224,13,211,294502
"70144","S01001012",2001,315,10,305,294502
"70145","S01001013",2001,361,62,299,294502
"70146","S01001014",2001,439,121,318,294502
"70147","S01001015",2001,293,91,202,294502
"70148","S01001016",2001,398,86,312,294502
"70149","S01001017",2001,362,121,241,294502
"70150","S01001018",2001,414,123,291,294502
"70151","S01001019",2001,455,283,172,294502
"70152","S01001020",2001,238,81,157,294502
"70153","S01001021",2001,442,66,376,294502
"70154","S01001022",2001,356,44,312,294502
"70155","S01001023",2001,400,9,391,294502
"70156","S01001024",2001,327,67,260,294502
"70157","S01001025",2001,443,8,435,294502
"70158","S01001026",2001,340,68,272,294502
"70159","S01001027",2001,434,74,360,294502
"70160","S01001028",2001,318,154,164,294502
"70161","S01001029",2001,319,189,130,294502
"70162","S01001030",2001,325,1,324,294502
"70163","S01001031",2001,395,157,238,294502
"70164","S01001032",2001,351,212,139,294502
"70165","S01001033",2001,241,132,109,294502
"70166","S01001034",2001,428,284,144,294502
"70167","S01001035",2001,198,86,112,294502
"70168","S01001036",2001,242,122,120,294502
"70169","S01001037",2001,445,220,225,294502
"70170","S01001038",2001,334,15,319,294502
"70171","S01001039",2001,227,4,223,294502
"70172","S01001040",2001,246,23,223,294502
"70173","S01001041",2001,225,0,0,294502
"70174","S01001042",2001,364,0,0,294502
"70175","S01001043",2001,266,2,264,294502
"70176","S01001044",2001,453,56,397,294502
"70177","S01001045",2001,288,7,281,294502
"70178","S01001046",2001,217,47,170,294502
"70179","S01001047",2001,304,6,298,294502
"70180","S01001048",2001,260,6,254,294502
"70181","S01001049",2001,287,107,180,294502
"70182","S01001050",2001,405,53,352,294502
"70183","S01001051",2001,302,116,186,294502
"70184","S01001052",2001,229,112,117,294502
"70185","S01001053",2001,344,50,294,294502
"70186","S01001054",2001,317,78,239,294502
"70187","S01001055",2001,373,114,259,294502
"70188","S01001056",2001,345,125,220,294502
"70189","S01001057",2001,262,26,236,294502
"70190","S01001058",2001,375,99,276,294502
"70191","S01001059",2001,224,152,72,294502
"70192","S01001060",2001,324,137,187,294502
"70193","S01001061",2001,337,76,261,294502
"70194","S01001062",2001,208,8,200,294502
"70195","S01001063",2001,324,39,285,294502
"70196","S01001064",2001,373,86,287,294502
"70197","S01001065",2001,366,41,325,294502
"70198","S01001066",2001,299,23,276,294502
"70199","S01001067",2001,304,9,295,294502
"70200","S01001068",2001,371,9,362,294502
"70201","S01001069",2001,349,37,312,294502
"70202","S01001070",2001,384,34,350,294502
"70203","S01001071",2001,253,35,218,294502
"70204","S01001072",2001,303,24,279,294502
"70205","S01001073",2001,419,47,372,294502
"70206","S01001074",2001,219,2,217,294502
"70207","S01001075",2001,444,133,311,294502
"70208","S01001076",2001,334,34,300,294502
"70209","S01001077",2001,380,45,335,294502
"70210","S01001078",2001,341,70,271,294502
"70211","S01001079",2001,197,6,191,294502
"70212","S01001080",2001,271,54,217,294502
"70213","S01001081",2001,256,51,205,294502
"70214","S01001082",2001,456,121,335,294502
"70215","S01001083",2001,340,110,230,294502
"70216","S01001084",2001,390,72,318,294502
"70217","S01001085",2001,360,161,199,294502
"70218","S01001086",2001,309,197,112,294502
"70219","S01001087",2001,234,113,121,294502
"70220","S01001088",2001,426,191,235,294502
"70221","S01001089",2001,412,107,305,294502
"70222","S01001090",2001,424,9,415,294502
"70223","S01001091",2001,302,44,258,294502
"70224","S01001092",2001,469,61,408,294502
"70225","S01001093",2001,352,71,281,294502
"70226","S01001094",2001,397,4,393,294502
"70227","S01001095",2001,382,65,317,294502
"70228","S01001096",2001,460,106,354,294502
"70229","S01001097",2001,281,2,279,294502
"70230","S01001098",2001,273,4,269,294502
"70231","S01001099",2001,528,133,395,294502
"70232","S01001100",2001,587,197,390,294502
"70233","S01001101",2001,411,49,362,294502
"70234","S01001102",2001,425,109,316,294502
"70235","S01001103",2001,351,13,338,294502
"70236","S01001104",2001,378,127,251,294502
"70237","S01001105",2001,329,1,328,294502
"70238","S01001106",2001,277,2,275,294502
"70239","S01001107",2001,604,182,422,294502
"70240","S01001108",2001,333,119,214,294502
"70241","S01001109",2001,440,188,252,294502
"70242","S01001110",2001,449,91,358,294502
"70243","S01001111",2001,498,125,373,294502
"70244","S01001112",2001,464,27,437,294502
"70245","S01001113",2001,462,230,232,294502
"70246","S01001114",2001,497,320,177,294502
"70247","S01001115",2001,425,188,237,294502
"70248","S01001116",2001,321,163,158,294502
"70249","S01001117",2001,307,122,185,294502
"70250","S01001118",2001,331,67,264,294502
"70251","S01001119",2001,568,105,463,294502
"70252","S01001120",2001,351,44,307,294502
"70253","S01001121",2001,398,147,251,294502
"70254","S01001122",2001,401,105,296,294502
"70255","S01001123",2001,415,30,385,294502
"70256","S01001124",2001,333,103,230,294502
"70257","S01001125",2001,347,207,140,294502
"70258","S01001126",2001,402,20,382,294502
"70259","S01001127",2001,392,77,315,294502
"70260","S01001128",2001,258,2,256,294502
"70261","S01001129",2001,511,262,249,294502
"70262","S01001130",2001,429,156,273,294502
"70263","S01001131",2001,387,191,196,294502
"70264","S01001132",2001,339,71,268,294502
"70265","S01001133",2001,471,84,387,294502
"70266","S01001134",2001,399,7,392,294502
"70267","S01001135",2001,326,226,100,294502
"70268","S01001136",2001,482,142,340,294502
"70269","S01001137",2001,530,214,316,294502
"70270","S01001138",2001,530,120,410,294502
"70271","S01001139",2001,413,171,242,294502
"70272","S01001140",2001,583,233,350,294502
"70273","S01001141",2001,407,254,153,294502
"70274","S01001142",2001,468,6,462,294502
"70275","S01001143",2001,337,3,334,294502
"70276","S01001144",2001,314,152,162,294502
"70277","S01001145",2001,350,159,191,294502
"70278","S01001146",2001,382,3,379,294502
"70279","S01001147",2001,382,84,298,294502
"70280","S01001148",2001,316,12,304,294502
"70281","S01001149",2001,412,155,257,294502
"70282","S01001150",2001,384,228,156,294502
"70283","S01001151",2001,443,309,134,294502
"70284","S01001152",2001,533,203,330,294502
"70285","S01001153",2001,362,59,303,294502
"70286","S01001154",2001,315,4,311,294502
"70287","S01001155",2001,263,5,258,294502
"70288","S01001156",2001,406,93,313,294502
"70289","S01001157",2001,307,1,306,294502
"70290","S01001158",2001,336,158,178,294502
"70291","S01001159",2001,355,40,315,294502
"70292","S01001160",2001,334,174,160,294502
"70293","S01001161",2001,257,35,222,294502
"70294","S01001162",2001,371,23,348,294502
"70295","S01001163",2001,357,142,215,294502
"70296","S01001164",2001,338,154,184,294502
"70297","S01001165",2001,428,112,316,294502
"70298","S01001166",2001,537,402,135,294502
"70299","S01001167",2001,357,1,356,294502
"70300","S01001168",2001,398,20,378,294502
"70301","S01001169",2001,493,269,224,294502
"70302","S01001170",2001,435,269,166,294502
"70303","S01001171",2001,285,37,248,294502
"70304","S01001172",2001,372,140,232,294502
"70305","S01001173",2001,436,202,234,294502
"70306","S01001174",2001,359,78,281,294502
"70307","S01001175",2001,428,214,214,294502
"70308","S01001176",2001,280,50,230,294502
"70309","S01001177",2001,388,168,220,294502
"70310","S01001178",2001,467,200,267,294502
"70311","S01001179",2001,367,2,365,294502
"70312","S01001180",2001,456,167,289,294502
"70313","S01001181",2001,374,2,372,294502
"70314","S01001182",2001,479,193,286,294502
"70315","S01001183",2001,561,312,249,294502
"70316","S01001184",2001,319,1,318,294502
"70317","S01001185",2001,252,1,251,294502
"70318","S01001186",2001,292,1,291,294502
"70319","S01001187",2001,433,209,224,294502
"70320","S01001188",2001,502,169,333,294502
"70321","S01001189",2001,549,195,354,294502
"70322","S01001190",2001,329,3,326,294502
"70323","S01001191",2001,378,145,233,294502
"70324","S01001192",2001,589,285,304,294502
"70325","S01001193",2001,358,16,342,294502
"70326","S01001194",2001,402,4,398,294502
"70327","S01001195",2001,486,136,350,294502
"70328","S01001196",2001,636,250,386,294502
"70329","S01001197",2001,240,98,142,294502
"70330","S01001198",2001,346,128,218,294502
"70331","S01001199",2001,425,222,203,294502
"70332","S01001200",2001,420,272,148,294502
"70333","S01001201",2001,366,199,167,294502
"70334","S01001202",2001,290,118,172,294502
"70335","S01001203",2001,410,204,206,294502
"70336","S01001204",2001,316,3,313,294502
"70337","S01001205",2001,309,12,297,294502
"70338","S01001206",2001,446,155,291,294502
"70339","S01001207",2001,327,147,180,294502
"70340","S01001208",2001,344,269,75,294502
"70341","S01001209",2001,202,7,195,294502
"70342","S01001210",2001,412,217,195,294502
"70343","S01001211",2001,452,76,376,294502
"70344","S01001212",2001,309,185,124,294502
"70345","S01001213",2001,392,265,127,294502
"70346","S01001214",2001,389,154,235,294502
"70347","S01001215",2001,341,8,333,294502
"70348","S01001216",2001,411,190,221,294502
"70349","S01001217",2001,372,230,142,294502
"70350","S01001218",2001,293,3,290,294502
"70351","S01001219",2001,211,0,0,294502
"70352","S01001220",2001,242,77,165,294502
"70353","S01001221",2001,201,11,190,294502
"70354","S01001222",2001,489,358,131,294502
"70355","S01001223",2001,310,6,304,294502
"70356","S01001224",2001,371,214,157,294502
"70357","S01001225",2001,403,10,393,294502
"70358","S01001226",2001,433,241,192,294502
"70359","S01001227",2001,249,12,237,294502
"70360","S01001228",2001,345,59,286,294502
"70361","S01001229",2001,316,9,307,294502
"70362","S01001230",2001,483,340,143,294502
"70363","S01001231",2001,308,106,202,294502
"70364","S01001232",2001,239,1,238,294502
"70365","S01001233",2001,460,261,199,294502
"70366","S01001234",2001,335,220,115,294502
"70367","S01001235",2001,269,108,161,294502
"70368","S01001236",2001,360,158,202,294502
"70369","S01001237",2001,239,44,195,294502
"70370","S01001238",2001,414,231,183,294502
"70371","S01001239",2001,413,313,100,294502
"70372","S01001240",2001,333,89,244,294502
"70373","S01001241",2001,306,111,195,294502
"70374","S01001242",2001,358,64,294,294502
"70375","S01001243",2001,339,289,50,294502
"70376","S01001244",2001,315,32,283,294502
"70377","S01001245",2001,299,209,90,294502
"70378","S01001246",2001,398,102,296,294502
"70379","S01001247",2001,235,48,187,294502
"70380","S01001248",2001,329,3,326,294502
"70381","S01001249",2001,276,97,179,294502
"70382","S01001250",2001,385,96,289,294502
"70383","S01001251",2001,328,189,139,294502
"70384","S01001252",2001,238,53,185,294502
"70385","S01001253",2001,275,242,33,294502
"70386","S01001254",2001,263,99,164,294502
"70387","S01001255",2001,338,143,195,294502
"70388","S01001256",2001,340,131,209,294502
"70389","S01001257",2001,268,113,155,294502
"70390","S01001258",2001,202,164,38,294502
"70391","S01001259",2001,329,41,288,294502
"70392","S01001260",2001,246,190,56,294502
"70393","S01001261",2001,437,259,178,294502
"70394","S01001262",2001,338,4,334,294502
"70395","S01001263",2001,208,50,158,294502
"70396","S01001264",2001,186,7,179,294502
"70397","S01001265",2001,203,1,202,294502
"70398","S01001266",2001,306,32,274,294502
"70399","S01001267",2001,481,194,287,294502
"70400","S01001268",2001,271,4,267,294502
"70401","S01001269",2001,197,4,193,294502
"70402","S01001270",2001,332,265,67,294502
"70403","S01001271",2001,324,241,83,294502
"70404","S01001272",2001,284,86,198,294502
"70405","S01001273",2001,364,181,183,294502
"70406","S01001274",2001,285,152,133,294502
"70407","S01001275",2001,290,185,105,294502
"70408","S01001276",2001,170,7,163,294502
"70409","S01001277",2001,316,137,179,294502
"70410","S01001278",2001,203,37,166,294502
"70411","S01001279",2001,395,282,113,294502
"70412","S01001280",2001,265,144,121,294502
"70413","S01001281",2001,401,217,184,294502
"70414","S01001282",2001,334,90,244,294502
"70415","S01001283",2001,215,78,137,294502
"70416","S01001284",2001,333,112,221,294502
"70417","S01001285",2001,265,127,138,294502
"70418","S01001286",2001,239,75,164,294502
"70419","S01001287",2001,341,178,163,294502
"70420","S01001288",2001,408,197,211,294502
"70421","S01001289",2001,307,106,201,294502
"70422","S01001290",2001,219,88,131,294502
"70423","S01001291",2001,211,74,137,294502
"70424","S01001292",2001,324,148,176,294502
"70425","S01001293",2001,343,133,210,294502
"70426","S01001294",2001,312,157,155,294502
"70427","S01001295",2001,404,155,249,294502
"70428","S01001296",2001,350,180,170,294502
"70429","S01001297",2001,313,114,199,294502
"70430","S01001298",2001,400,130,270,294502
"70431","S01001299",2001,369,135,234,294502
"70432","S01001300",2001,352,5,347,294502
"70433","S01001301",2001,240,136,104,294502
"70434","S01001302",2001,290,40,250,294502
"70435","S01001303",2001,222,1,221,294502
"70436","S01001304",2001,248,2,246,294502
"70437","S01001305",2001,323,92,231,294502
"70438","S01001306",2001,309,168,141,294502
"70439","S01001307",2001,405,107,298,294502
"70440","S01001308",2001,432,273,159,294502
"70441","S01001309",2001,336,205,131,294502
"70442","S01001310",2001,321,186,135,294502
"70443","S01001311",2001,234,92,142,294502
"70444","S01001312",2001,345,193,152,294502
"70445","S01001313",2001,341,135,206,294502
"70446","S01001314",2001,309,33,276,294502
"70447","S01001315",2001,360,18,342,294502
"70448","S01001316",2001,384,248,136,294502
"70449","S01001317",2001,372,116,256,294502
"70450","S01001318",2001,228,43,185,294502
"70451","S01001319",2001,318,138,180,294502
"70452","S01001320",2001,399,203,196,294502
"70453","S01001321",2001,220,3,217,294502
"70454","S01001322",2001,303,29,274,294502
"70455","S01001323",2001,252,63,189,294502
"70456","S01001324",2001,381,276,105,294502
"70457","S01001325",2001,280,180,100,294502
"70458","S01001326",2001,406,140,266,294502
"70459","S01001327",2001,345,165,180,294502
"70460","S01001328",2001,343,191,152,294502
"70461","S01001329",2001,257,138,119,294502
"70462","S01001330",2001,358,1,357,294502
"70463","S01001331",2001,384,165,219,294502
"70464","S01001332",2001,408,177,231,294502
"70465","S01001333",2001,449,274,175,294502
"70466","S01001334",2001,330,172,158,294502
"70467","S01001335",2001,486,234,252,294502
"70468","S01001336",2001,379,142,237,294502
"70469","S01001337",2001,337,20,317,294502
"70470","S01001338",2001,314,185,129,294502
"70471","S01001339",2001,293,54,239,294502
"70472","S01001340",2001,301,153,148,294502
"70473","S01001341",2001,380,207,173,294502
"70474","S01001342",2001,402,150,252,294502
"70475","S01001343",2001,417,160,257,294502
"70476","S01001344",2001,332,51,281,294502
"70477","S01001345",2001,415,210,205,294502
"70478","S01001346",2001,309,26,283,294502
"70479","S01001347",2001,287,3,284,294502
"70480","S01001348",2001,348,133,215,294502
"70481","S01001349",2001,279,4,275,294502
"70482","S01001350",2001,295,170,125,294502
"70483","S01001351",2001,270,9,261,294502
"70484","S01001352",2001,395,53,342,294502
"70485","S01001353",2001,217,3,214,294502
"70486","S01001354",2001,358,96,262,294502
"70487","S01001355",2001,312,44,268,294502
"70488","S01001356",2001,288,4,284,294502
"70489","S01001357",2001,433,201,232,294502
"70490","S01001358",2001,399,147,252,294502
"70491","S01001359",2001,276,6,270,294502
"70492","S01001360",2001,402,98,304,294502
"70493","S01001361",2001,227,43,184,294502
"70494","S01001362",2001,256,5,251,294502
"70495","S01001363",2001,353,65,288,294502
"70496","S01001364",2001,411,118,293,294502
"70497","S01001365",2001,268,144,124,294502
"70498","S01001366",2001,378,2,376,294502
"70499","S01001367",2001,339,76,263,294502
"70500","S01001368",2001,358,5,353,294502
"70501","S01001369",2001,446,155,291,294502
"70502","S01001370",2001,306,23,283,294502
"70503","S01001371",2001,366,77,289,294502
"70504","S01001372",2001,281,7,274,294502
"70505","S01001373",2001,240,59,181,294502
"70506","S01001374",2001,221,31,190,294502
"70507","S01001375",2001,248,8,240,294502
"70508","S01001376",2001,434,91,343,294502
"70509","S01001377",2001,385,219,166,294502
"70510","S01001378",2001,283,35,248,294502
"70511","S01001379",2001,455,182,273,294502
"70512","S01001380",2001,442,155,287,294502
"70513","S01001381",2001,375,92,283,294502
"70514","S01001382",2001,393,250,143,294502
"70515","S01001383",2001,289,109,180,294502
"70516","S01001384",2001,400,204,196,294502
"70517","S01001385",2001,470,179,291,294502
"70518","S01001386",2001,478,210,268,294502
"70519","S01001387",2001,338,89,249,294502
"70520","S01001388",2001,460,329,131,294502
"70521","S01001389",2001,194,81,113,294502
"70522","S01001390",2001,319,40,279,294502
"70523","S01001391",2001,294,83,211,294502
"70524","S01001392",2001,219,161,58,294502
"70525","S01001393",2001,230,11,219,294502
"70526","S01001394",2001,229,64,165,294502
"70527","S01001395",2001,335,64,271,294502
"70528","S01001396",2001,293,99,194,294502
"70529","S01001397",2001,332,233,99,294502
"70530","S01001398",2001,344,4,340,294502
"70531","S01001399",2001,394,265,129,294502
"70532","S01001400",2001,395,269,126,294502
"70533","S01001401",2001,302,175,127,294502
"70534","S01001402",2001,331,3,328,294502
"70535","S01001403",2001,324,3,321,294502
"70536","S01001404",2001,242,0,0,294502
"70537","S01001405",2001,313,1,312,294502
"70538","S01001406",2001,238,31,207,294502
"70539","S01001407",2001,363,83,280,294502
"70540","S01001408",2001,395,173,222,294502
"70541","S01001409",2001,358,132,226,294502
"70542","S01001410",2001,400,55,345,294502
"70543","S01001411",2001,210,14,196,294502
"70544","S01001412",2001,405,208,197,294502
"70545","S01001413",2001,272,1,271,294502
"70546","S01001414",2001,327,129,198,294502
"70547","S01001415",2001,415,115,300,294502
"70548","S01001416",2001,286,101,185,294502
"70549","S01001417",2001,372,10,362,294502
"70550","S01001418",2001,369,17,352,294502
"70551","S01001419",2001,260,20,240,294502
"70552","S01001420",2001,216,9,207,294502
"70553","S01001421",2001,347,88,259,294502
"70554","S01001422",2001,202,6,196,294502
"70555","S01001423",2001,343,23,320,294502
"70556","S01001424",2001,498,228,270,294502
"70557","S01001425",2001,430,145,285,294502
"70558","S01001426",2001,296,26,270,294502
"70559","S01001427",2001,322,4,318,294502
"70560","S01001428",2001,410,156,254,294502
"70561","S01001429",2001,333,114,219,294502
"70562","S01001430",2001,365,7,358,294502
"70563","S01001431",2001,332,2,330,294502
"70564","S01001432",2001,249,1,248,294502
"70565","S01001433",2001,330,4,326,294502
"70566","S01001434",2001,391,39,352,294502
"70567","S01001435",2001,378,1,377,294502
"70568","S01001436",2001,364,2,362,294502
"70569","S01001437",2001,331,3,328,294502
"70570","S01001438",2001,248,1,247,294502
"70571","S01001439",2001,288,4,284,294502
"70572","S01001440",2001,353,4,349,294502
"70573","S01001441",2001,336,7,329,294502
"70574","S01001442",2001,263,2,261,294502
"70575","S01001443",2001,380,11,369,294502
"70576","S01001444",2001,370,1,369,294502
"70577","S01001445",2001,285,17,268,294502
"70578","S01001446",2001,358,16,342,294502
"70579","S01001447",2001,279,4,275,294502
"70580","S01001448",2001,293,1,292,294502
"70581","S01001449",2001,235,1,234,294502
"70582","S01001450",2001,326,3,323,294502
"70583","S01001451",2001,274,3,271,294502
"70584","S01001452",2001,324,16,308,294502
"70585","S01001453",2001,306,2,304,294502
"70586","S01001454",2001,366,16,350,294502
"70587","S01001455",2001,305,28,277,294502
"70588","S01001456",2001,302,5,297,294502
"70589","S01001457",2001,363,4,359,294502
"70590","S01001458",2001,392,2,390,294502
"70591","S01001459",2001,337,5,332,294502
"70592","S01001460",2001,243,3,240,294502
"70593","S01001461",2001,333,4,329,294502
"70594","S01001462",2001,345,11,334,294502
"70595","S01001463",2001,216,2,214,294502
"70596","S01001464",2001,360,5,355,294502
"70597","S01001465",2001,245,5,240,294502
"70598","S01001466",2001,268,1,267,294502
"70599","S01001467",2001,306,1,305,294502
"70600","S01001468",2001,237,2,235,294502
"70601","S01001469",2001,314,9,305,294502
"70602","S01001470",2001,329,5,324,294502
"70603","S01001471",2001,257,1,256,294502
"70604","S01001472",2001,326,32,294,294502
"70605","S01001473",2001,354,63,291,294502
"70606","S01001474",2001,396,78,318,294502
"70607","S01001475",2001,290,13,277,294502
"70608","S01001476",2001,362,10,352,294502
"70609","S01001477",2001,352,0,0,294502
"70610","S01001478",2001,267,1,266,294502
"70611","S01001479",2001,291,59,232,294502
"70612","S01001480",2001,200,0,0,294502
"70613","S01001481",2001,363,4,359,294502
"70614","S01001482",2001,306,172,134,294502
"70615","S01001483",2001,333,3,330,294502
"70616","S01001484",2001,334,5,329,294502
"70617","S01001485",2001,246,3,243,294502
"70618","S01001486",2001,316,30,286,294502
"70619","S01001487",2001,256,128,128,294502
"70620","S01001488",2001,370,6,364,294502
"70621","S01001489",2001,290,5,285,294502
"70622","S01001490",2001,456,136,320,294502
"70623","S01001491",2001,328,5,323,294502
"70624","S01001492",2001,424,165,259,294502
"70625","S01001493",2001,314,25,289,294502
"70626","S01001494",2001,411,129,282,294502
"70627","S01001495",2001,239,8,231,294502
"70628","S01001496",2001,395,29,366,294502
"70629","S01001497",2001,393,135,258,294502
"70630","S01001498",2001,260,2,258,294502
"70631","S01001499",2001,384,61,323,294502
"70632","S01001500",2001,371,225,146,294502
"70633","S01001501",2001,357,1,356,294502
"70634","S01001502",2001,319,6,313,294502
"70635","S01001503",2001,290,2,288,294502
"70636","S01001504",2001,443,114,329,294502
"70637","S01001505",2001,391,3,388,294502
"70638","S01001506",2001,316,26,290,294502
"70639","S01001507",2001,302,4,298,294502
"70640","S01001508",2001,327,1,326,294502
"70641","S01001509",2001,404,181,223,294502
"70642","S01001510",2001,312,101,211,294502
"70643","S01001511",2001,239,3,236,294502
"70644","S01001512",2001,366,229,137,294502
"70645","S01001513",2001,378,302,76,294502
"70646","S01001514",2001,328,62,266,294502
"70647","S01001515",2001,294,6,288,294502
"70648","S01001516",2001,318,125,193,294502
"70649","S01001517",2001,520,218,302,294502
"70650","S01001518",2001,375,176,199,294502
"70651","S01001519",2001,428,11,417,294502
"70652","S01001520",2001,312,98,214,294502
"70653","S01001521",2001,445,40,405,294502
"70654","S01001522",2001,461,177,284,294502
"70655","S01001523",2001,273,5,268,294502
"70656","S01001524",2001,435,152,283,294502
"70657","S01001525",2001,334,126,208,294502
"70658","S01001526",2001,271,11,260,294502
"70659","S01001527",2001,337,133,204,294502
"70660","S01001528",2001,333,13,320,294502
"70661","S01001529",2001,297,60,237,294502
"70662","S01001530",2001,340,174,166,294502
"70663","S01001531",2001,437,49,388,294502
"70664","S01001532",2001,259,9,250,294502
"70665","S01001533",2001,371,3,368,294502
"70666","S01001534",2001,246,1,245,294502
"70667","S01001535",2001,365,54,311,294502
"70668","S01001536",2001,346,210,136,294502
"70669","S01001537",2001,316,203,113,294502
"70670","S01001538",2001,345,32,313,294502
"70671","S01001539",2001,280,3,277,294502
"70672","S01001540",2001,255,5,250,294502
"70673","S01001541",2001,336,53,283,294502
"70674","S01001542",2001,275,28,247,294502
"70675","S01001543",2001,291,42,249,294502
"70676","S01001544",2001,379,93,286,294502
"70677","S01001545",2001,290,1,289,294502
"70678","S01001546",2001,419,250,169,294502
"70679","S01001547",2001,371,193,178,294502
"70680","S01001548",2001,279,10,269,294502
"70681","S01001549",2001,366,114,252,294502
"70682","S01001550",2001,260,55,205,294502
"70683","S01001551",2001,348,82,266,294502
"70684","S01001552",2001,341,97,244,294502
"70685","S01001553",2001,348,38,310,294502
"70686","S01001554",2001,397,77,320,294502
"70687","S01001555",2001,324,138,186,294502
"70688","S01001556",2001,369,103,266,294502
"70689","S01001557",2001,355,36,319,294502
"70690","S01001558",2001,342,129,213,294502
"70691","S01001559",2001,221,105,116,294502
"70692","S01001560",2001,293,124,169,294502
"70693","S01001561",2001,289,84,205,294502
"70694","S01001562",2001,268,109,159,294502
"70695","S01001563",2001,232,20,212,294502
"70696","S01001564",2001,250,63,187,294502
"70697","S01001565",2001,385,139,246,294502
"70698","S01001566",2001,261,48,213,294502
"70699","S01001567",2001,404,20,384,294502
"70700","S01001568",2001,315,16,299,294502
"70701","S01001569",2001,214,20,194,294502
"70702","S01001570",2001,174,1,173,294502
"70703","S01001571",2001,294,144,150,294502
"70704","S01001572",2001,233,40,193,294502
"70705","S01001573",2001,261,35,226,294502
"70706","S01001574",2001,354,194,160,294502
"70707","S01001575",2001,377,84,293,294502
"70708","S01001576",2001,276,156,120,294502
"70709","S01001577",2001,294,87,207,294502
"70710","S01001578",2001,297,136,161,294502
"70711","S01001579",2001,318,140,178,294502
"70712","S01001580",2001,274,73,201,294502
"70713","S01001581",2001,281,36,245,294502
"70714","S01001582",2001,259,120,139,294502
"70715","S01001583",2001,182,72,110,294502
"70716","S01001584",2001,368,135,233,294502
"70717","S01001585",2001,504,213,291,294502
"70718","S01001586",2001,170,4,166,294502
"70719","S01001587",2001,379,222,157,294502
"70720","S01001588",2001,318,131,187,294502
"70721","S01001589",2001,372,205,167,294502
"70722","S01001590",2001,295,33,262,294502
"70723","S01001591",2001,289,167,122,294502
"70724","S01001592",2001,322,194,128,294502
"70725","S01001593",2001,339,85,254,294502
"70726","S01001594",2001,459,119,340,294502
"70727","S01001595",2001,298,187,111,294502
"70728","S01001596",2001,316,66,250,294502
"70729","S01001597",2001,364,31,333,294502
"70730","S01001598",2001,259,10,249,294502
"70731","S01001599",2001,522,112,410,294502
"70732","S01001600",2001,568,152,416,294502
"70733","S01001601",2001,350,40,310,294502
"70734","S01001602",2001,266,25,241,294502
"70735","S01001603",2001,358,89,269,294502
"70736","S01001604",2001,235,137,98,294502
"70737","S01001605",2001,265,95,170,294502
"70738","S01001606",2001,230,89,141,294502
"70739","S01001607",2001,399,69,330,294502
"70740","S01001608",2001,398,14,384,294502
"70741","S01001609",2001,357,171,186,294502
"70742","S01001610",2001,321,74,247,294502
"70743","S01001611",2001,319,7,312,294502
"70744","S01001612",2001,330,6,324,294502
"70745","S01001613",2001,307,214,93,294502
"70746","S01001614",2001,345,95,250,294502
"70747","S01001615",2001,348,155,193,294502
"70748","S01001616",2001,204,1,203,294502
"70749","S01001617",2001,311,189,122,294502
"70750","S01001618",2001,409,82,327,294502
"70751","S01001619",2001,297,112,185,294502
"70752","S01001620",2001,421,192,229,294502
"70753","S01001621",2001,286,133,153,294502
"70754","S01001622",2001,365,163,202,294502
"70755","S01001623",2001,361,128,233,294502
"70756","S01001624",2001,424,144,280,294502
"70757","S01001625",2001,325,171,154,294502
"70758","S01001626",2001,295,58,237,294502
"70759","S01001627",2001,308,157,151,294502
"70760","S01001628",2001,230,139,91,294502
"70761","S01001629",2001,302,100,202,294502
"70762","S01001630",2001,283,137,146,294502
"70763","S01001631",2001,366,103,263,294502
"70764","S01001632",2001,210,9,201,294502
"70765","S01001633",2001,361,3,358,294502
"70766","S01001634",2001,311,39,272,294502
"70767","S01001635",2001,322,67,255,294502
"70768","S01001636",2001,202,0,0,294502
"70769","S01001637",2001,288,30,258,294502
"70770","S01001638",2001,426,123,303,294502
"70771","S01001639",2001,344,125,219,294502
"70772","S01001640",2001,258,1,257,294502
"70773","S01001641",2001,275,102,173,294502
"70774","S01001642",2001,433,137,296,294502
"70775","S01001643",2001,324,92,232,294502
"70776","S01001644",2001,293,87,206,294502
"70777","S01001645",2001,374,55,319,294502
"70778","S01001646",2001,232,40,192,294502
"70779","S01001647",2001,283,14,269,294502
"70780","S01001648",2001,304,143,161,294502
"70781","S01001649",2001,349,194,155,294502
"70782","S01001650",2001,308,110,198,294502
"70783","S01001651",2001,403,72,331,294502
"70784","S01001652",2001,326,4,322,294502
"70785","S01001653",2001,306,93,213,294502
"70786","S01001654",2001,251,62,189,294502
"70787","S01001655",2001,257,46,211,294502
"70788","S01001656",2001,450,108,342,294502
"70789","S01001657",2001,206,7,199,294502
"70790","S01001658",2001,363,74,289,294502
"70791","S01001659",2001,293,8,285,294502
"70792","S01001660",2001,315,28,287,294502
"70793","S01001661",2001,289,79,210,294502
"70794","S01001662",2001,321,150,171,294502
"70795","S01001663",2001,344,29,315,294502
"70796","S01001664",2001,182,23,159,294502
"70797","S01001665",2001,363,51,312,294502
"70798","S01001666",2001,272,44,228,294502
"70799","S01001667",2001,363,1,362,294502
"70800","S01001668",2001,338,1,337,294502
"70801","S01001669",2001,371,52,319,294502
"70802","S01001670",2001,268,8,260,294502
"70803","S01001671",2001,199,1,198,294502
"70804","S01001672",2001,264,91,173,294502
"70805","S01001673",2001,275,4,271,294502
"70806","S01001674",2001,335,105,230,294502
"70807","S01001675",2001,292,2,290,294502
"70808","S01001676",2001,351,28,323,294502
"70809","S01001677",2001,314,0,0,294502
"70810","S01001678",2001,320,2,318,294502
"70811","S01001679",2001,251,0,0,294502
"70812","S01001680",2001,235,0,0,294502
"70813","S01001681",2001,241,0,0,294502
"70814","S01001682",2001,220,1,219,294502
"70815","S01001683",2001,313,0,0,294502
"70816","S01001684",2001,254,12,242,294502
"70817","S01001685",2001,297,102,195,294502
"70818","S01001686",2001,344,0,0,294502
"70819","S01001687",2001,474,4,470,294502
"70820","S01001688",2001,383,4,379,294502
"70821","S01001689",2001,273,4,269,294502
"70822","S01001690",2001,215,73,142,294502
"70823","S01001691",2001,323,3,320,294502
"70824","S01001692",2001,232,61,171,294502
"70825","S01001693",2001,254,1,253,294502
"70826","S01001694",2001,308,19,289,294502
"70827","S01001695",2001,307,0,0,294502
"70828","S01001696",2001,309,2,307,294502
"70829","S01001697",2001,273,57,216,294502
"70830","S01001698",2001,215,33,182,294502
"70831","S01001699",2001,196,1,195,294502
"70832","S01001700",2001,347,1,346,294502
"70833","S01001701",2001,408,137,271,294502
"70834","S01001702",2001,413,87,326,294502
"70835","S01001703",2001,256,1,255,294502
"70836","S01001704",2001,345,2,343,294502
"70837","S01001705",2001,217,0,0,294502
"70838","S01001706",2001,276,2,274,294502
"70839","S01001707",2001,394,130,264,294502
"70840","S01001708",2001,363,5,358,294502
"70841","S01001709",2001,242,1,241,294502
"70842","S01001710",2001,311,26,285,294502
"70843","S01001711",2001,279,0,0,294502
"70844","S01001712",2001,186,20,166,294502
"70845","S01001713",2001,283,2,281,294502
"70846","S01001714",2001,262,0,0,294502
"70847","S01001715",2001,291,1,290,294502
"70848","S01001716",2001,314,103,211,294502
"70849","S01001717",2001,290,1,289,294502
"70850","S01001718",2001,171,3,168,294502
"70851","S01001719",2001,263,3,260,294502
"70852","S01001720",2001,227,3,224,294502
"70853","S01001721",2001,290,2,288,294502
"70854","S01001722",2001,279,3,276,294502
"70855","S01001723",2001,274,3,271,294502
"70856","S01001724",2001,345,185,160,294502
"70857","S01001725",2001,306,102,204,294502
"70858","S01001726",2001,228,2,226,294502
"70859","S01001727",2001,348,4,344,294502
"70860","S01001728",2001,227,1,226,294502
"70861","S01001729",2001,376,3,373,294502
"70862","S01001730",2001,234,2,232,294502
"70863","S01001731",2001,221,3,218,294502
"70864","S01001732",2001,220,19,201,294502
"70865","S01001733",2001,285,50,235,294502
"70866","S01001734",2001,200,0,0,294502
"70867","S01001735",2001,176,2,174,294502
"70868","S01001736",2001,370,3,367,294502
"70869","S01001737",2001,237,1,236,294502
"70870","S01001738",2001,209,0,0,294502
"70871","S01001739",2001,234,2,232,294502
"70872","S01001740",2001,297,0,0,294502
"70873","S01001741",2001,246,81,165,294502
"70874","S01001742",2001,281,138,143,294502
"70875","S01001743",2001,376,177,199,294502
"70876","S01001744",2001,195,2,193,294502
"70877","S01001745",2001,352,2,350,294502
"70878","S01001746",2001,357,6,351,294502
"70879","S01001747",2001,373,111,262,294502
"70880","S01001748",2001,248,2,246,294502
"70881","S01001749",2001,372,116,256,294502
"70882","S01001750",2001,302,50,252,294502
"70883","S01001751",2001,401,132,269,294502
"70884","S01001752",2001,340,1,339,294502
"70885","S01001753",2001,307,176,131,294502
"70886","S01001754",2001,264,0,0,294502
"70887","S01001755",2001,336,28,308,294502
"70888","S01001756",2001,316,28,288,294502
"70889","S01001757",2001,309,61,248,294502
"70890","S01001758",2001,346,41,305,294502
"70891","S01001759",2001,326,162,164,294502
"70892","S01001760",2001,273,74,199,294502
"70893","S01001761",2001,335,139,196,294502
"70894","S01001762",2001,462,111,351,294502
"70895","S01001763",2001,269,0,0,294502
"70896","S01001764",2001,187,1,186,294502
"70897","S01001765",2001,442,128,314,294502
"70898","S01001766",2001,243,27,216,294502
"70899","S01001767",2001,235,26,209,294502
"70900","S01001768",2001,251,16,235,294502
"70901","S01001769",2001,300,2,298,294502
"70902","S01001770",2001,265,150,115,294502
"70903","S01001771",2001,355,29,326,294502
"70904","S01001772",2001,256,8,248,294502
"70905","S01001773",2001,406,127,279,294502
"70906","S01001774",2001,261,3,258,294502
"70907","S01001775",2001,303,2,301,294502
"70908","S01001776",2001,282,74,208,294502
"70909","S01001777",2001,317,1,316,294502
"70910","S01001778",2001,386,169,217,294502
"70911","S01001779",2001,259,3,256,294502
"70912","S01001780",2001,382,66,316,294502
"70913","S01001781",2001,254,1,253,294502
"70914","S01001782",2001,369,6,363,294502
"70915","S01001783",2001,257,198,59,294502
"70916","S01001784",2001,264,5,259,294502
"70917","S01001785",2001,236,3,233,294502
"70918","S01001786",2001,210,11,199,294502
"70919","S01001787",2001,237,1,236,294502
"70920","S01001788",2001,307,1,306,294502
"70921","S01001789",2001,271,85,186,294502
"70922","S01001790",2001,311,2,309,294502
"70923","S01001791",2001,282,3,279,294502
"70924","S01001792",2001,285,29,256,294502
"70925","S01001793",2001,348,67,281,294502
"70926","S01001794",2001,369,46,323,294502
"70927","S01001795",2001,231,8,223,294502
"70928","S01001796",2001,317,1,316,294502
"70929","S01001797",2001,320,78,242,294502
"70930","S01001798",2001,341,2,339,294502
"70931","S01001799",2001,321,212,109,294502
"70932","S01001800",2001,343,14,329,294502
"70933","S01001801",2001,321,6,315,294502
"70934","S01001802",2001,339,13,326,294502
"70935","S01001803",2001,421,11,410,294502
"70936","S01001804",2001,452,37,415,294502
"70937","S01001805",2001,321,54,267,294502
"70938","S01001806",2001,257,12,245,294502
"70939","S01001807",2001,350,11,339,294502
"70940","S01001808",2001,251,57,194,294502
"70941","S01001809",2001,394,254,140,294502
"70942","S01001810",2001,381,24,357,294502
"70943","S01001811",2001,280,1,279,294502
"70944","S01001812",2001,204,1,203,294502
"70945","S01001813",2001,277,2,275,294502
"70946","S01001814",2001,265,11,254,294502
"70947","S01001815",2001,349,40,309,294502
"70948","S01001816",2001,413,1,412,294502
"70949","S01001817",2001,299,79,220,294502
"70950","S01001818",2001,344,3,341,294502
"70951","S01001819",2001,405,15,390,294502
"70952","S01001820",2001,344,129,215,294502
"70953","S01001821",2001,175,16,159,294502
"70954","S01001822",2001,495,16,479,294502
"70955","S01001823",2001,520,300,220,294502
"70956","S01001824",2001,347,75,272,294502
"70957","S01001825",2001,350,1,349,294502
"70958","S01001826",2001,492,342,150,294502
"70959","S01001827",2001,468,149,319,294502
"70960","S01001828",2001,261,1,260,294502
"70961","S01001829",2001,353,48,305,294502
"70962","S01001830",2001,336,0,0,294502
"70963","S01001831",2001,350,70,280,294502
"70964","S01001832",2001,295,80,215,294502
"70965","S01001833",2001,390,2,388,294502
"70966","S01001834",2001,282,70,212,294502
"70967","S01001835",2001,256,3,253,294502
"70968","S01001836",2001,280,14,266,294502
"70969","S01001837",2001,372,6,366,294502
"70970","S01001838",2001,251,53,198,294502
"70971","S01001839",2001,429,154,275,294502
"70972","S01001840",2001,284,6,278,294502
"70973","S01001841",2001,300,8,292,294502
"70974","S01001842",2001,288,0,0,294502
"70975","S01001843",2001,364,148,216,294502
"70976","S01001844",2001,424,12,412,294502
"70977","S01001845",2001,265,1,264,294502
"70978","S01001846",2001,322,5,317,294502
"70979","S01001847",2001,389,147,242,294502
"70980","S01001848",2001,395,147,248,294502
"70981","S01001849",2001,243,10,233,294502
"70982","S01001850",2001,332,5,327,294502
"70983","S01001851",2001,297,2,295,294502
"70984","S01001852",2001,300,1,299,294502
"70985","S01001853",2001,325,1,324,294502
"70986","S01001854",2001,448,166,282,294502
"70987","S01001855",2001,289,0,0,294502
"70988","S01001856",2001,348,157,191,294502
"70989","S01001857",2001,334,82,252,294502
"70990","S01001858",2001,332,3,329,294502
"70991","S01001859",2001,381,136,245,294502
"70992","S01001860",2001,326,0,0,294502
"70993","S01001861",2001,498,236,262,294502
"70994","S01001862",2001,325,0,0,294502
"70995","S01001863",2001,346,2,344,294502
"70996","S01001864",2001,355,196,159,294502
"70997","S01001865",2001,270,213,57,294502
"70998","S01001866",2001,287,1,286,294502
"70999","S01001867",2001,213,103,110,294502
"71000","S01001868",2001,295,2,293,294502
"71001","S01001869",2001,352,3,349,294502
"71002","S01001870",2001,324,188,136,294502
"71003","S01001871",2001,403,73,330,294502
"71004","S01001872",2001,310,38,272,294502
"71005","S01001873",2001,291,2,289,294502
"71006","S01001874",2001,282,210,72,294502
"71007","S01001875",2001,347,1,346,294502
"71008","S01001876",2001,468,144,324,294502
"71009","S01001877",2001,368,242,126,294502
"71010","S01001878",2001,433,6,427,294502
"71011","S01001879",2001,370,286,84,294502
"71012","S01001880",2001,342,197,145,294502
"71013","S01001881",2001,275,2,273,294502
"71014","S01001882",2001,334,7,327,294502
"71015","S01001883",2001,233,2,231,294502
"71016","S01001884",2001,498,178,320,294502
"71017","S01001885",2001,425,1,424,294502
"71018","S01001886",2001,342,298,44,294502
"71019","S01001887",2001,370,106,264,294502
"71020","S01001888",2001,355,4,351,294502
"71021","S01001889",2001,263,39,224,294502
"71022","S01001890",2001,398,78,320,294502
"71023","S01001891",2001,313,99,214,294502
"71024","S01001892",2001,425,244,181,294502
"71025","S01001893",2001,442,229,213,294502
"71026","S01001894",2001,326,215,111,294502
"71027","S01001895",2001,341,90,251,294502
"71028","S01001896",2001,335,4,331,294502
"71029","S01001897",2001,410,241,169,294502
"71030","S01001898",2001,379,175,204,294502
"71031","S01001899",2001,323,1,322,294502
"71032","S01001900",2001,347,41,306,294502
"71033","S01001901",2001,399,25,374,294502
"71034","S01001902",2001,382,3,379,294502
"71035","S01001903",2001,240,73,167,294502
"71036","S01001904",2001,331,117,214,294502
"71037","S01001905",2001,386,2,384,294502
"71038","S01001906",2001,488,341,147,294502
"71039","S01001907",2001,356,108,248,294502
"71040","S01001908",2001,288,0,0,294502
"71041","S01001909",2001,336,187,149,294502
"71042","S01001910",2001,313,3,310,294502
"71043","S01001911",2001,301,1,300,294502
"71044","S01001912",2001,356,10,346,294502
"71045","S01001913",2001,373,16,357,294502
"71046","S01001914",2001,237,18,219,294502
"71047","S01001915",2001,363,1,362,294502
"71048","S01001916",2001,454,10,444,294502
"71049","S01001917",2001,246,0,0,294502
"71050","S01001918",2001,573,32,541,294502
"71051","S01001919",2001,411,3,408,294502
"71052","S01001920",2001,354,52,302,294502
"71053","S01001921",2001,301,82,219,294502
"71054","S01001922",2001,314,13,301,294502
"71055","S01001923",2001,370,219,151,294502
"71056","S01001924",2001,338,7,331,294502
"71057","S01001925",2001,317,1,316,294502
"71058","S01001926",2001,352,149,203,294502
"71059","S01001927",2001,403,28,375,294502
"71060","S01001928",2001,455,7,448,294502
"71061","S01001929",2001,344,6,338,294502
"71062","S01001930",2001,431,9,422,294502
"71063","S01001931",2001,295,152,143,294502
"71064","S01001932",2001,370,125,245,294502
"71065","S01001933",2001,394,4,390,294502
"71066","S01001934",2001,427,80,347,294502
"71067","S01001935",2001,350,274,76,294502
"71068","S01001936",2001,521,48,473,294502
"71069","S01001937",2001,424,63,361,294502
"71070","S01001938",2001,256,6,250,294502
"71071","S01001939",2001,291,3,288,294502
"71072","S01001940",2001,315,12,303,294502
"71073","S01001941",2001,341,2,339,294502
"71074","S01001942",2001,288,30,258,294502
"71075","S01001943",2001,264,81,183,294502
"71076","S01001944",2001,297,45,252,294502
"71077","S01001945",2001,322,2,320,294502
"71078","S01001946",2001,317,192,125,294502
"71079","S01001947",2001,389,5,384,294502
"71080","S01001948",2001,313,183,130,294502
"71081","S01001949",2001,315,132,183,294502
"71082","S01001950",2001,512,81,431,294502
"71083","S01001951",2001,451,197,254,294502
"71084","S01001952",2001,284,6,278,294502
"71085","S01001953",2001,350,1,349,294502
"71086","S01001954",2001,233,40,193,294502
"71087","S01001955",2001,372,118,254,294502
"71088","S01001956",2001,316,122,194,294502
"71089","S01001957",2001,398,234,164,294502
"71090","S01001958",2001,470,128,342,294502
"71091","S01001959",2001,266,72,194,294502
"71092","S01001960",2001,361,2,359,294502
"71093","S01001961",2001,461,2,459,294502
"71094","S01001962",2001,351,31,320,294502
"71095","S01001963",2001,417,77,340,294502
"71096","S01001964",2001,389,3,386,294502
"71097","S01001965",2001,430,106,324,294502
"71098","S01001966",2001,369,226,143,294502
"71099","S01001967",2001,324,0,0,294502
"71100","S01001968",2001,430,23,407,294502
"71101","S01001969",2001,317,87,230,294502
"71102","S01001970",2001,256,13,243,294502
"71103","S01001971",2001,437,209,228,294502
"71104","S01001972",2001,339,2,337,294502
"71105","S01001973",2001,304,12,292,294502
"71106","S01001974",2001,338,0,0,294502
"71107","S01001975",2001,405,2,403,294502
"71108","S01001976",2001,324,38,286,294502
"71109","S01001977",2001,405,149,256,294502
"71110","S01001978",2001,393,202,191,294502
"71111","S01001979",2001,287,8,279,294502
"71112","S01001980",2001,353,11,342,294502
"71113","S01001981",2001,398,14,384,294502
"71114","S01001982",2001,312,215,97,294502
"71115","S01001983",2001,342,0,0,294502
"71116","S01001984",2001,289,97,192,294502
"71117","S01001985",2001,327,6,321,294502
"71118","S01001986",2001,377,3,374,294502
"71119","S01001987",2001,283,1,282,294502
"71120","S01001988",2001,352,10,342,294502
"71121","S01001989",2001,387,17,370,294502
"71122","S01001990",2001,378,4,374,294502
"71123","S01001991",2001,311,1,310,294502
"71124","S01001992",2001,319,7,312,294502
"71125","S01001993",2001,281,0,0,294502
"71126","S01001994",2001,400,17,383,294502
"71127","S01001995",2001,323,4,319,294502
"71128","S01001996",2001,384,6,378,294502
"71129","S01001997",2001,387,65,322,294502
"71130","S01001998",2001,312,4,308,294502
"71131","S01001999",2001,261,0,0,294502
"71132","S01002000",2001,347,55,292,294502
"71133","S01002001",2001,552,37,515,294502
"71134","S01002002",2001,255,0,0,294502
"71135","S01002003",2001,350,53,297,294502
"71136","S01002004",2001,443,27,416,294502
"71137","S01002005",2001,459,141,318,294502
"71138","S01002006",2001,353,3,350,294502
"71139","S01002007",2001,654,33,621,294502
"71140","S01002008",2001,404,3,401,294502
"71141","S01002009",2001,377,6,371,294502
"71142","S01002010",2001,197,1,196,294502
"71143","S01002011",2001,426,12,414,294502
"71144","S01002012",2001,350,1,349,294502
"71145","S01002013",2001,362,8,354,294502
"71146","S01002014",2001,318,15,303,294502
"71147","S01002015",2001,352,1,351,294502
"71148","S01002016",2001,314,2,312,294502
"71149","S01002017",2001,464,318,146,294502
"71150","S01002018",2001,342,5,337,294502
"71151","S01002019",2001,267,1,266,294502
"71152","S01002020",2001,218,2,216,294502
"71153","S01002021",2001,538,167,371,294502
"71154","S01002022",2001,303,42,261,294502
"71155","S01002023",2001,335,2,333,294502
"71156","S01002024",2001,323,2,321,294502
"71157","S01002025",2001,559,41,518,294502
"71158","S01002026",2001,319,4,315,294502
"71159","S01002027",2001,479,8,471,294502
"71160","S01002028",2001,325,34,291,294502
"71161","S01002029",2001,278,2,276,294502
"71162","S01002030",2001,469,35,434,294502
"71163","S01002031",2001,409,45,364,294502
"71164","S01002032",2001,368,47,321,294502
"71165","S01002033",2001,500,111,389,294502
"71166","S01002034",2001,456,47,409,294502
"71167","S01002035",2001,310,2,308,294502
"71168","S01002036",2001,564,51,513,294502
"71169","S01002037",2001,299,23,276,294502
"71170","S01002038",2001,253,5,248,294502
"71171","S01002039",2001,270,15,255,294502
"71172","S01002040",2001,295,41,254,294502
"71173","S01002041",2001,411,4,407,294502
"71174","S01002042",2001,507,126,381,294502
"71175","S01002043",2001,364,29,335,294502
"71176","S01002044",2001,306,168,138,294502
"71177","S01002045",2001,377,37,340,294502
"71178","S01002046",2001,379,132,247,294502
"71179","S01002047",2001,324,108,216,294502
"71180","S01002048",2001,296,18,278,294502
"71181","S01002049",2001,550,52,498,294502
"71182","S01002050",2001,284,20,264,294502
"71183","S01002051",2001,384,133,251,294502
"71184","S01002052",2001,475,72,403,294502
"71185","S01002053",2001,295,13,282,294502
"71186","S01002054",2001,384,24,360,294502
"71187","S01002055",2001,309,2,307,294502
"71188","S01002056",2001,455,78,377,294502
"71189","S01002057",2001,384,4,380,294502
"71190","S01002058",2001,440,117,323,294502
"71191","S01002059",2001,401,117,284,294502
"71192","S01002060",2001,327,21,306,294502
"71193","S01002061",2001,360,45,315,294502
"71194","S01002062",2001,294,98,196,294502
"71195","S01002063",2001,446,68,378,294502
"71196","S01002064",2001,480,135,345,294502
"71197","S01002065",2001,303,47,256,294502
"71198","S01002066",2001,380,99,281,294502
"71199","S01002067",2001,417,29,388,294502
"71200","S01002068",2001,556,119,437,294502
"71201","S01002069",2001,274,20,254,294502
"71202","S01002070",2001,364,68,296,294502
"71203","S01002071",2001,325,13,312,294502
"71204","S01002072",2001,502,13,489,294502
"71205","S01002073",2001,401,143,258,294502
"71206","S01002074",2001,282,4,278,294502
"71207","S01002075",2001,525,25,500,294502
"71208","S01002076",2001,411,86,325,294502
"71209","S01002077",2001,352,1,351,294502
"71210","S01002078",2001,446,14,432,294502
"71211","S01002079",2001,469,122,347,294502
"71212","S01002080",2001,389,3,386,294502
"71213","S01002081",2001,368,109,259,294502
"71214","S01002082",2001,511,51,460,294502
"71215","S01002083",2001,298,116,182,294502
"71216","S01002084",2001,294,37,257,294502
"71217","S01002085",2001,332,72,260,294502
"71218","S01002086",2001,283,68,215,294502
"71219","S01002087",2001,596,187,409,294502
"71220","S01002088",2001,361,37,324,294502
"71221","S01002089",2001,436,8,428,294502
"71222","S01002090",2001,474,74,400,294502
"71223","S01002091",2001,422,78,344,294502
"71224","S01002092",2001,334,1,333,294502
"71225","S01002093",2001,407,141,266,294502
"71226","S01002094",2001,356,51,305,294502
"71227","S01002095",2001,267,3,264,294502
"71228","S01002096",2001,321,5,316,294502
"71229","S01002097",2001,306,2,304,294502
"71230","S01002098",2001,330,75,255,294502
"71231","S01002099",2001,390,1,389,294502
"71232","S01002100",2001,262,27,235,294502
"71233","S01002101",2001,491,282,209,294502
"71234","S01002102",2001,337,78,259,294502
"71235","S01002103",2001,300,3,297,294502
"71236","S01002104",2001,526,304,222,294502
"71237","S01002105",2001,378,1,377,294502
"71238","S01002106",2001,381,45,336,294502
"71239","S01002107",2001,216,14,202,294502
"71240","S01002108",2001,438,61,377,294502
"71241","S01002109",2001,400,8,392,294502
"71242","S01002110",2001,326,0,0,294502
"71243","S01002111",2001,436,2,434,294502
"71244","S01002112",2001,447,26,421,294502
"71245","S01002113",2001,327,17,310,294502
"71246","S01002114",2001,267,0,0,294502
"71247","S01002115",2001,482,1,481,294502
"71248","S01002116",2001,344,37,307,294502
"71249","S01002117",2001,381,87,294,294502
"71250","S01002118",2001,486,183,303,294502
"71251","S01002119",2001,301,62,239,294502
"71252","S01002120",2001,320,3,317,294502
"71253","S01002121",2001,308,33,275,294502
"71254","S01002122",2001,362,1,361,294502
"71255","S01002123",2001,383,1,382,294502
"71256","S01002124",2001,303,3,300,294502
"71257","S01002125",2001,458,23,435,294502
"71258","S01002126",2001,244,2,242,294502
"71259","S01002127",2001,311,25,286,294502
"71260","S01002128",2001,424,27,397,294502
"71261","S01002129",2001,389,123,266,294502
"71262","S01002130",2001,229,1,228,294502
"71263","S01002131",2001,377,54,323,294502
"71264","S01002132",2001,368,40,328,294502
"71265","S01002133",2001,612,62,550,294502
"71266","S01002134",2001,254,2,252,294502
"71267","S01002135",2001,341,3,338,294502
"71268","S01002136",2001,333,1,332,294502
"71269","S01002137",2001,383,70,313,294502
"71270","S01002138",2001,367,177,190,294502
"71271","S01002139",2001,282,2,280,294502
"71272","S01002140",2001,431,166,265,294502
"71273","S01002141",2001,287,23,264,294502
"71274","S01002142",2001,442,25,417,294502
"71275","S01002143",2001,381,51,330,294502
"71276","S01002144",2001,324,0,0,294502
"71277","S01002145",2001,484,10,474,294502
"71278","S01002146",2001,509,12,497,294502
"71279","S01002147",2001,423,108,315,294502
"71280","S01002148",2001,347,0,0,294502
"71281","S01002149",2001,540,86,454,294502
"71282","S01002150",2001,332,4,328,294502
"71283","S01002151",2001,648,56,592,294502
"71284","S01002152",2001,390,1,389,294502
"71285","S01002153",2001,235,1,234,294502
"71286","S01002154",2001,429,142,287,294502
"71287","S01002155",2001,501,200,301,294502
"71288","S01002156",2001,372,0,0,294502
"71289","S01002157",2001,369,3,366,294502
"71290","S01002158",2001,425,5,420,294502
"71291","S01002159",2001,378,46,332,294502
"71292","S01002160",2001,458,166,292,294502
"71293","S01002161",2001,324,30,294,294502
"71294","S01002162",2001,422,112,310,294502
"71295","S01002163",2001,633,71,562,294502
"71296","S01002164",2001,347,97,250,294502
"71297","S01002165",2001,404,36,368,294502
"71298","S01002166",2001,366,1,365,294502
"71299","S01002167",2001,304,80,224,294502
"71300","S01002168",2001,628,142,486,294502
"71301","S01002169",2001,417,2,415,294502
"71302","S01002170",2001,445,144,301,294502
"71303","S01002171",2001,282,34,248,294502
"71304","S01002172",2001,306,5,301,294502
"71305","S01002173",2001,536,64,472,294502
"71306","S01002174",2001,508,49,459,294502
"71307","S01002175",2001,570,12,558,294502
"71308","S01002176",2001,358,40,318,294502
"71309","S01002177",2001,455,4,451,294502
"71310","S01002178",2001,548,42,506,294502
"71311","S01002179",2001,286,3,283,294502
"71312","S01002180",2001,234,3,231,294502
"71313","S01002181",2001,449,11,438,294502
"71314","S01002182",2001,374,28,346,294502
"71315","S01002183",2001,514,57,457,294502
"71316","S01002184",2001,335,2,333,294502
"71317","S01002185",2001,456,157,299,294502
"71318","S01002186",2001,382,2,380,294502
"71319","S01002187",2001,451,0,0,294502
"71320","S01002188",2001,351,2,349,294502
"71321","S01002189",2001,438,75,363,294502
"71322","S01002190",2001,364,3,361,294502
"71323","S01002191",2001,470,182,288,294502
"71324","S01002192",2001,390,75,315,294502
"71325","S01002193",2001,353,4,349,294502
"71326","S01002194",2001,348,69,279,294502
"71327","S01002195",2001,622,99,523,294502
"71328","S01002196",2001,294,26,268,294502
"71329","S01002197",2001,342,71,271,294502
"71330","S01002198",2001,499,34,465,294502
"71331","S01002199",2001,393,33,360,294502
"71332","S01002200",2001,340,3,337,294502
"71333","S01002201",2001,506,9,497,294502
"71334","S01002202",2001,311,2,309,294502
"71335","S01002203",2001,258,4,254,294502
"71336","S01002204",2001,405,184,221,294502
"71337","S01002205",2001,407,13,394,294502
"71338","S01002206",2001,321,36,285,294502
"71339","S01002207",2001,352,26,326,294502
"71340","S01002208",2001,280,2,278,294502
"71341","S01002209",2001,568,41,527,294502
"71342","S01002210",2001,350,0,0,294502
"71343","S01002211",2001,380,218,162,294502
"71344","S01002212",2001,552,186,366,294502
"71345","S01002213",2001,311,81,230,294502
"71346","S01002214",2001,433,3,430,294502
"71347","S01002215",2001,408,15,393,294502
"71348","S01002216",2001,510,59,451,294502
"71349","S01002217",2001,514,70,444,294502
"71350","S01002218",2001,288,5,283,294502
"71351","S01002219",2001,304,2,302,294502
"71352","S01002220",2001,298,5,293,294502
"71353","S01002221",2001,497,96,401,294502
"71354","S01002222",2001,331,3,328,294502
"71355","S01002223",2001,296,2,294,294502
"71356","S01002224",2001,302,2,300,294502
"71357","S01002225",2001,369,20,349,294502
"71358","S01002226",2001,502,3,499,294502
"71359","S01002227",2001,450,196,254,294502
"71360","S01002228",2001,404,4,400,294502
"71361","S01002229",2001,331,1,330,294502
"71362","S01002230",2001,552,38,514,294502
"71363","S01002231",2001,452,3,449,294502
"71364","S01002232",2001,350,112,238,294502
"71365","S01002233",2001,539,149,390,294502
"71366","S01002234",2001,489,86,403,294502
"71367","S01002235",2001,583,22,561,294502
"71368","S01002236",2001,388,87,301,294502
"71369","S01002237",2001,476,29,447,294502
"71370","S01002238",2001,325,148,177,294502
"71371","S01002239",2001,428,248,180,294502
"71372","S01002240",2001,391,103,288,294502
"71373","S01002241",2001,398,126,272,294502
"71374","S01002242",2001,336,6,330,294502
"71375","S01002243",2001,343,30,313,294502
"71376","S01002244",2001,405,35,370,294502
"71377","S01002245",2001,459,1,458,294502
"71378","S01002246",2001,538,48,490,294502
"71379","S01002247",2001,387,177,210,294502
"71380","S01002248",2001,508,3,505,294502
"71381","S01002249",2001,484,180,304,294502
"71382","S01002250",2001,439,3,436,294502
"71383","S01002251",2001,325,29,296,294502
"71384","S01002252",2001,254,4,250,294502
"71385","S01002253",2001,472,132,340,294502
"71386","S01002254",2001,508,89,419,294502
"71387","S01002255",2001,669,140,529,294502
"71388","S01002256",2001,429,2,427,294502
"71389","S01002257",2001,283,31,252,294502
"71390","S01002258",2001,393,112,281,294502
"71391","S01002259",2001,248,33,215,294502
"71392","S01002260",2001,356,1,355,294502
"71393","S01002261",2001,385,5,380,294502
"71394","S01002262",2001,342,0,0,294502
"71395","S01002263",2001,347,0,0,294502
"71396","S01002264",2001,395,4,391,294502
"71397","S01002265",2001,423,265,158,294502
"71398","S01002266",2001,382,59,323,294502
"71399","S01002267",2001,417,114,303,294502
"71400","S01002268",2001,286,1,285,294502
"71401","S01002269",2001,482,37,445,294502
"71402","S01002270",2001,470,80,390,294502
"71403","S01002271",2001,398,22,376,294502
"71404","S01002272",2001,244,3,241,294502
"71405","S01002273",2001,400,71,329,294502
"71406","S01002274",2001,453,84,369,294502
"71407","S01002275",2001,460,222,238,294502
"71408","S01002276",2001,304,4,300,294502
"71409","S01002277",2001,359,98,261,294502
"71410","S01002278",2001,475,216,259,294502
"71411","S01002279",2001,427,208,219,294502
"71412","S01002280",2001,342,22,320,294502
"71413","S01002281",2001,322,254,68,294502
"71414","S01002282",2001,496,399,97,294502
"71415","S01002283",2001,306,34,272,294502
"71416","S01002284",2001,400,5,395,294502
"71417","S01002285",2001,463,193,270,294502
"71418","S01002286",2001,366,15,351,294502
"71419","S01002287",2001,354,8,346,294502
"71420","S01002288",2001,396,61,335,294502
"71421","S01002289",2001,457,177,280,294502
"71422","S01002290",2001,441,170,271,294502
"71423","S01002291",2001,452,351,101,294502
"71424","S01002292",2001,458,114,344,294502
"71425","S01002293",2001,351,3,348,294502
"71426","S01002294",2001,262,3,259,294502
"71427","S01002295",2001,341,8,333,294502
"71428","S01002296",2001,355,264,91,294502
"71429","S01002297",2001,416,68,348,294502
"71430","S01002298",2001,273,9,264,294502
"71431","S01002299",2001,322,2,320,294502
"71432","S01002300",2001,350,25,325,294502
"71433","S01002301",2001,338,1,337,294502
"71434","S01002302",2001,335,229,106,294502
"71435","S01002303",2001,371,106,265,294502
"71436","S01002304",2001,477,84,393,294502
"71437","S01002305",2001,460,147,313,294502
"71438","S01002306",2001,349,120,229,294502
"71439","S01002307",2001,430,59,371,294502
"71440","S01002308",2001,477,29,448,294502
"71441","S01002309",2001,376,155,221,294502
"71442","S01002310",2001,504,267,237,294502
"71443","S01002311",2001,259,23,236,294502
"71444","S01002312",2001,321,180,141,294502
"71445","S01002313",2001,283,3,280,294502
"71446","S01002314",2001,423,26,397,294502
"71447","S01002315",2001,230,12,218,294502
"71448","S01002316",2001,276,1,275,294502
"71449","S01002317",2001,472,58,414,294502
"71450","S01002318",2001,437,101,336,294502
"71451","S01002319",2001,573,265,308,294502
"71452","S01002320",2001,309,7,302,294502
"71453","S01002321",2001,460,352,108,294502
"71454","S01002322",2001,371,67,304,294502
"71455","S01002323",2001,377,43,334,294502
"71456","S01002324",2001,376,247,129,294502
"71457","S01002325",2001,287,121,166,294502
"71458","S01002326",2001,475,77,398,294502
"71459","S01002327",2001,328,39,289,294502
"71460","S01002328",2001,330,12,318,294502
"71461","S01002329",2001,275,19,256,294502
"71462","S01002330",2001,320,50,270,294502
"71463","S01002331",2001,295,51,244,294502
"71464","S01002332",2001,321,0,0,294502
"71465","S01002333",2001,300,2,298,294502
"71466","S01002334",2001,335,29,306,294502
"71467","S01002335",2001,439,64,375,294502
"71468","S01002336",2001,364,10,354,294502
"71469","S01002337",2001,364,14,350,294502
"71470","S01002338",2001,260,124,136,294502
"71471","S01002339",2001,258,62,196,294502
"71472","S01002340",2001,240,22,218,294502
"71473","S01002341",2001,247,27,220,294502
"71474","S01002342",2001,237,74,163,294502
"71475","S01002343",2001,305,42,263,294502
"71476","S01002344",2001,203,35,168,294502
"71477","S01002345",2001,299,75,224,294502
"71478","S01002346",2001,412,74,338,294502
"71479","S01002347",2001,318,31,287,294502
"71480","S01002348",2001,409,36,373,294502
"71481","S01002349",2001,461,93,368,294502
"71482","S01002350",2001,433,44,389,294502
"71483","S01002351",2001,297,29,268,294502
"71484","S01002352",2001,347,32,315,294502
"71485","S01002353",2001,296,14,282,294502
"71486","S01002354",2001,322,28,294,294502
"71487","S01002355",2001,385,117,268,294502
"71488","S01002356",2001,422,109,313,294502
"71489","S01002357",2001,293,115,178,294502
"71490","S01002358",2001,269,38,231,294502
"71491","S01002359",2001,413,121,292,294502
"71492","S01002360",2001,329,128,201,294502
"71493","S01002361",2001,249,55,194,294502
"71494","S01002362",2001,285,35,250,294502
"71495","S01002363",2001,387,40,347,294502
"71496","S01002364",2001,322,186,136,294502
"71497","S01002365",2001,228,27,201,294502
"71498","S01002366",2001,233,12,221,294502
"71499","S01002367",2001,342,51,291,294502
"71500","S01002368",2001,334,34,300,294502
"71501","S01002369",2001,225,24,201,294502
"71502","S01002370",2001,289,51,238,294502
"71503","S01002371",2001,258,17,241,294502
"71504","S01002372",2001,324,47,277,294502
"71505","S01002373",2001,266,14,252,294502
"71506","S01002374",2001,338,12,326,294502
"71507","S01002375",2001,372,215,157,294502
"71508","S01002376",2001,365,155,210,294502
"71509","S01002377",2001,375,204,171,294502
"71510","S01002378",2001,215,22,193,294502
"71511","S01002379",2001,364,178,186,294502
"71512","S01002380",2001,266,120,146,294502
"71513","S01002381",2001,313,141,172,294502
"71514","S01002382",2001,271,158,113,294502
"71515","S01002383",2001,191,13,178,294502
"71516","S01002384",2001,232,111,121,294502
"71517","S01002385",2001,336,204,132,294502
"71518","S01002386",2001,392,65,327,294502
"71519","S01002387",2001,263,45,218,294502
"71520","S01002388",2001,265,2,263,294502
"71521","S01002389",2001,263,4,259,294502
"71522","S01002390",2001,282,45,237,294502
"71523","S01002391",2001,343,6,337,294502
"71524","S01002392",2001,415,37,378,294502
"71525","S01002393",2001,219,21,198,294502
"71526","S01002394",2001,292,93,199,294502
"71527","S01002395",2001,296,58,238,294502
"71528","S01002396",2001,316,99,217,294502
"71529","S01002397",2001,366,30,336,294502
"71530","S01002398",2001,372,4,368,294502
"71531","S01002399",2001,438,169,269,294502
"71532","S01002400",2001,365,2,363,294502
"71533","S01002401",2001,331,3,328,294502
"71534","S01002402",2001,355,170,185,294502
"71535","S01002403",2001,314,166,148,294502
"71536","S01002404",2001,360,66,294,294502
"71537","S01002405",2001,305,2,303,294502
"71538","S01002406",2001,332,141,191,294502
"71539","S01002407",2001,282,79,203,294502
"71540","S01002408",2001,374,170,204,294502
"71541","S01002409",2001,300,16,284,294502
"71542","S01002410",2001,217,14,203,294502
"71543","S01002411",2001,266,84,182,294502
"71544","S01002412",2001,377,5,372,294502
"71545","S01002413",2001,282,75,207,294502
"71546","S01002414",2001,277,196,81,294502
"71547","S01002415",2001,299,185,114,294502
"71548","S01002416",2001,228,12,216,294502
"71549","S01002417",2001,301,50,251,294502
"71550","S01002418",2001,401,146,255,294502
"71551","S01002419",2001,213,1,212,294502
"71552","S01002420",2001,256,148,108,294502
"71553","S01002421",2001,341,6,335,294502
"71554","S01002422",2001,259,12,247,294502
"71555","S01002423",2001,378,144,234,294502
"71556","S01002424",2001,378,101,277,294502
"71557","S01002425",2001,347,130,217,294502
"71558","S01002426",2001,424,148,276,294502
"71559","S01002427",2001,373,91,282,294502
"71560","S01002428",2001,221,90,131,294502
"71561","S01002429",2001,534,455,79,294502
"71562","S01002430",2001,230,2,228,294502
"71563","S01002431",2001,332,162,170,294502
"71564","S01002432",2001,307,43,264,294502
"71565","S01002433",2001,271,104,167,294502
"71566","S01002434",2001,435,192,243,294502
"71567","S01002435",2001,314,116,198,294502
"71568","S01002436",2001,418,235,183,294502
"71569","S01002437",2001,274,44,230,294502
"71570","S01002438",2001,278,108,170,294502
"71571","S01002439",2001,345,93,252,294502
"71572","S01002440",2001,416,218,198,294502
"71573","S01002441",2001,285,6,279,294502
"71574","S01002442",2001,284,19,265,294502
"71575","S01002443",2001,339,128,211,294502
"71576","S01002444",2001,253,155,98,294502
"71577","S01002445",2001,316,133,183,294502
"71578","S01002446",2001,331,4,327,294502
"71579","S01002447",2001,263,121,142,294502
"71580","S01002448",2001,197,111,86,294502
"71581","S01002449",2001,191,10,181,294502
"71582","S01002450",2001,401,149,252,294502
"71583","S01002451",2001,403,74,329,294502
"71584","S01002452",2001,243,113,130,294502
"71585","S01002453",2001,307,68,239,294502
"71586","S01002454",2001,319,51,268,294502
"71587","S01002455",2001,224,63,161,294502
"71588","S01002456",2001,433,254,179,294502
"71589","S01002457",2001,314,118,196,294502
"71590","S01002458",2001,371,193,178,294502
"71591","S01002459",2001,351,54,297,294502
"71592","S01002460",2001,395,231,164,294502
"71593","S01002461",2001,161,1,160,294502
"71594","S01002462",2001,353,144,209,294502
"71595","S01002463",2001,470,279,191,294502
"71596","S01002464",2001,244,77,167,294502
"71597","S01002465",2001,255,15,240,294502
"71598","S01002466",2001,434,146,288,294502
"71599","S01002467",2001,262,64,198,294502
"71600","S01002468",2001,307,147,160,294502
"71601","S01002469",2001,276,104,172,294502
"71602","S01002470",2001,376,174,202,294502
"71603","S01002471",2001,243,77,166,294502
"71604","S01002472",2001,303,198,105,294502
"71605","S01002473",2001,459,194,265,294502
"71606","S01002474",2001,329,116,213,294502
"71607","S01002475",2001,242,94,148,294502
"71608","S01002476",2001,369,1,368,294502
"71609","S01002477",2001,401,151,250,294502
"71610","S01002478",2001,399,115,284,294502
"71611","S01002479",2001,314,179,135,294502
"71612","S01002480",2001,280,125,155,294502
"71613","S01002481",2001,424,214,210,294502
"71614","S01002482",2001,422,250,172,294502
"71615","S01002483",2001,395,272,123,294502
"71616","S01002484",2001,375,190,185,294502
"71617","S01002485",2001,356,35,321,294502
"71618","S01002486",2001,292,195,97,294502
"71619","S01002487",2001,276,127,149,294502
"71620","S01002488",2001,363,208,155,294502
"71621","S01002489",2001,273,156,117,294502
"71622","S01002490",2001,271,81,190,294502
"71623","S01002491",2001,243,127,116,294502
"71624","S01002492",2001,265,53,212,294502
"71625","S01002493",2001,413,83,330,294502
"71626","S01002494",2001,266,12,254,294502
"71627","S01002495",2001,294,155,139,294502
"71628","S01002496",2001,276,95,181,294502
"71629","S01002497",2001,431,197,234,294502
"71630","S01002498",2001,245,2,243,294502
"71631","S01002499",2001,474,245,229,294502
"71632","S01002500",2001,301,125,176,294502
"71633","S01002501",2001,224,48,176,294502
"71634","S01002502",2001,383,249,134,294502
"71635","S01002503",2001,277,66,211,294502
"71636","S01002504",2001,376,111,265,294502
"71637","S01002505",2001,385,229,156,294502
"71638","S01002506",2001,336,109,227,294502
"71639","S01002507",2001,358,153,205,294502
"71640","S01002508",2001,378,3,375,294502
"71641","S01002509",2001,431,130,301,294502
"71642","S01002510",2001,442,48,394,294502
"71643","S01002511",2001,222,27,195,294502
"71644","S01002512",2001,309,125,184,294502
"71645","S01002513",2001,341,4,337,294502
"71646","S01002514",2001,313,98,215,294502
"71647","S01002515",2001,322,146,176,294502
"71648","S01002516",2001,345,73,272,294502
"71649","S01002517",2001,261,93,168,294502
"71650","S01002518",2001,288,58,230,294502
"71651","S01002519",2001,499,346,153,294502
"71652","S01002520",2001,303,204,99,294502
"71653","S01002521",2001,286,86,200,294502
"71654","S01002522",2001,266,33,233,294502
"71655","S01002523",2001,287,3,284,294502
"71656","S01002524",2001,318,40,278,294502
"71657","S01002525",2001,347,176,171,294502
"71658","S01002526",2001,189,1,188,294502
"71659","S01002527",2001,301,2,299,294502
"71660","S01002528",2001,310,72,238,294502
"71661","S01002529",2001,377,219,158,294502
"71662","S01002530",2001,325,163,162,294502
"71663","S01002531",2001,401,106,295,294502
"71664","S01002532",2001,325,137,188,294502
"71665","S01002533",2001,320,230,90,294502
"71666","S01002534",2001,377,215,162,294502
"71667","S01002535",2001,228,62,166,294502
"71668","S01002536",2001,249,166,83,294502
"71669","S01002537",2001,210,112,98,294502
"71670","S01002538",2001,376,3,373,294502
"71671","S01002539",2001,416,225,191,294502
"71672","S01002540",2001,301,207,94,294502
"71673","S01002541",2001,415,74,341,294502
"71674","S01002542",2001,261,51,210,294502
"71675","S01002543",2001,290,195,95,294502
"71676","S01002544",2001,342,118,224,294502
"71677","S01002545",2001,302,114,188,294502
"71678","S01002546",2001,287,91,196,294502
"71679","S01002547",2001,309,83,226,294502
"71680","S01002548",2001,450,140,310,294502
"71681","S01002549",2001,212,2,210,294502
"71682","S01002550",2001,196,4,192,294502
"71683","S01002551",2001,264,72,192,294502
"71684","S01002552",2001,238,123,115,294502
"71685","S01002553",2001,380,113,267,294502
"71686","S01002554",2001,216,9,207,294502
"71687","S01002555",2001,334,91,243,294502
"71688","S01002556",2001,283,166,117,294502
"71689","S01002557",2001,393,161,232,294502
"71690","S01002558",2001,218,109,109,294502
"71691","S01002559",2001,283,12,271,294502
"71692","S01002560",2001,229,88,141,294502
"71693","S01002561",2001,293,108,185,294502
"71694","S01002562",2001,281,75,206,294502
"71695","S01002563",2001,331,61,270,294502
"71696","S01002564",2001,246,6,240,294502
"71697","S01002565",2001,374,40,334,294502
"71698","S01002566",2001,267,4,263,294502
"71699","S01002567",2001,201,0,0,294502
"71700","S01002568",2001,316,41,275,294502
"71701","S01002569",2001,400,126,274,294502
"71702","S01002570",2001,235,92,143,294502
"71703","S01002571",2001,266,102,164,294502
"71704","S01002572",2001,253,16,237,294502
"71705","S01002573",2001,220,38,182,294502
"71706","S01002574",2001,408,116,292,294502
"71707","S01002575",2001,280,40,240,294502
"71708","S01002576",2001,332,1,331,294502
"71709","S01002577",2001,408,232,176,294502
"71710","S01002578",2001,296,1,295,294502
"71711","S01002579",2001,390,7,383,294502
"71712","S01002580",2001,338,170,168,294502
"71713","S01002581",2001,264,3,261,294502
"71714","S01002582",2001,325,138,187,294502
"71715","S01002583",2001,269,140,129,294502
"71716","S01002584",2001,258,62,196,294502
"71717","S01002585",2001,399,60,339,294502
"71718","S01002586",2001,227,34,193,294502
"71719","S01002587",2001,301,5,296,294502
"71720","S01002588",2001,311,8,303,294502
"71721","S01002589",2001,339,13,326,294502
"71722","S01002590",2001,305,3,302,294502
"71723","S01002591",2001,270,114,156,294502
"71724","S01002592",2001,427,156,271,294502
"71725","S01002593",2001,326,96,230,294502
"71726","S01002594",2001,258,1,257,294502
"71727","S01002595",2001,311,52,259,294502
"71728","S01002596",2001,284,14,270,294502
"71729","S01002597",2001,193,64,129,294502
"71730","S01002598",2001,390,66,324,294502
"71731","S01002599",2001,239,47,192,294502
"71732","S01002600",2001,324,0,0,294502
"71733","S01002601",2001,292,98,194,294502
"71734","S01002602",2001,214,37,177,294502
"71735","S01002603",2001,365,136,229,294502
"71736","S01002604",2001,393,2,391,294502
"71737","S01002605",2001,260,51,209,294502
"71738","S01002606",2001,218,107,111,294502
"71739","S01002607",2001,355,90,265,294502
"71740","S01002608",2001,208,17,191,294502
"71741","S01002609",2001,381,95,286,294502
"71742","S01002610",2001,381,88,293,294502
"71743","S01002611",2001,298,37,261,294502
"71744","S01002612",2001,362,10,352,294502
"71745","S01002613",2001,403,18,385,294502
"71746","S01002614",2001,406,30,376,294502
"71747","S01002615",2001,236,40,196,294502
"71748","S01002616",2001,230,1,229,294502
"71749","S01002617",2001,405,163,242,294502
"71750","S01002618",2001,395,237,158,294502
"71751","S01002619",2001,309,29,280,294502
"71752","S01002620",2001,421,122,299,294502
"71753","S01002621",2001,245,1,244,294502
"71754","S01002622",2001,325,6,319,294502
"71755","S01002623",2001,269,1,268,294502
"71756","S01002624",2001,315,3,312,294502
"71757","S01002625",2001,370,5,365,294502
"71758","S01002626",2001,272,128,144,294502
"71759","S01002627",2001,393,8,385,294502
"71760","S01002628",2001,287,15,272,294502
"71761","S01002629",2001,348,24,324,294502
"71762","S01002630",2001,320,73,247,294502
"71763","S01002631",2001,331,2,329,294502
"71764","S01002632",2001,243,26,217,294502
"71765","S01002633",2001,381,45,336,294502
"71766","S01002634",2001,333,16,317,294502
"71767","S01002635",2001,258,8,250,294502
"71768","S01002636",2001,243,62,181,294502
"71769","S01002637",2001,336,99,237,294502
"71770","S01002638",2001,315,146,169,294502
"71771","S01002639",2001,396,12,384,294502
"71772","S01002640",2001,319,22,297,294502
"71773","S01002641",2001,356,17,339,294502
"71774","S01002642",2001,281,121,160,294502
"71775","S01002643",2001,281,109,172,294502
"71776","S01002644",2001,316,82,234,294502
"71777","S01002645",2001,285,119,166,294502
"71778","S01002646",2001,350,42,308,294502
"71779","S01002647",2001,403,238,165,294502
"71780","S01002648",2001,310,27,283,294502
"71781","S01002649",2001,354,163,191,294502
"71782","S01002650",2001,283,3,280,294502
"71783","S01002651",2001,276,114,162,294502
"71784","S01002652",2001,274,13,261,294502
"71785","S01002653",2001,353,75,278,294502
"71786","S01002654",2001,372,152,220,294502
"71787","S01002655",2001,377,231,146,294502
"71788","S01002656",2001,549,351,198,294502
"71789","S01002657",2001,377,43,334,294502
"71790","S01002658",2001,544,88,456,294502
"71791","S01002659",2001,385,25,360,294502
"71792","S01002660",2001,394,178,216,294502
"71793","S01002661",2001,380,45,335,294502
"71794","S01002662",2001,346,96,250,294502
"71795","S01002663",2001,279,12,267,294502
"71796","S01002664",2001,353,1,352,294502
"71797","S01002665",2001,323,76,247,294502
"71798","S01002666",2001,373,44,329,294502
"71799","S01002667",2001,310,155,155,294502
"71800","S01002668",2001,223,40,183,294502
"71801","S01002669",2001,491,96,395,294502
"71802","S01002670",2001,237,3,234,294502
"71803","S01002671",2001,519,71,448,294502
"71804","S01002672",2001,326,176,150,294502
"71805","S01002673",2001,286,81,205,294502
"71806","S01002674",2001,340,82,258,294502
"71807","S01002675",2001,411,25,386,294502
"71808","S01002676",2001,339,31,308,294502
"71809","S01002677",2001,524,222,302,294502
"71810","S01002678",2001,341,0,0,294502
"71811","S01002679",2001,543,247,296,294502
"71812","S01002680",2001,532,69,463,294502
"71813","S01002681",2001,351,125,226,294502
"71814","S01002682",2001,238,109,129,294502
"71815","S01002683",2001,365,107,258,294502
"71816","S01002684",2001,390,108,282,294502
"71817","S01002685",2001,469,238,231,294502
"71818","S01002686",2001,387,42,345,294502
"71819","S01002687",2001,352,54,298,294502
"71820","S01002688",2001,263,4,259,294502
"71821","S01002689",2001,273,0,0,294502
"71822","S01002690",2001,240,9,231,294502
"71823","S01002691",2001,406,7,399,294502
"71824","S01002692",2001,343,55,288,294502
"71825","S01002693",2001,202,19,183,294502
"71826","S01002694",2001,284,126,158,294502
"71827","S01002695",2001,247,20,227,294502
"71828","S01002696",2001,332,78,254,294502
"71829","S01002697",2001,354,43,311,294502
"71830","S01002698",2001,311,63,248,294502
"71831","S01002699",2001,226,94,132,294502
"71832","S01002700",2001,346,204,142,294502
"71833","S01002701",2001,333,1,332,294502
"71834","S01002702",2001,306,143,163,294502
"71835","S01002703",2001,409,116,293,294502
"71836","S01002704",2001,305,73,232,294502
"71837","S01002705",2001,361,143,218,294502
"71838","S01002706",2001,366,163,203,294502
"71839","S01002707",2001,349,185,164,294502
"71840","S01002708",2001,313,92,221,294502
"71841","S01002709",2001,336,120,216,294502
"71842","S01002710",2001,241,38,203,294502
"71843","S01002711",2001,363,169,194,294502
"71844","S01002712",2001,335,113,222,294502
"71845","S01002713",2001,468,286,182,294502
"71846","S01002714",2001,410,158,252,294502
"71847","S01002715",2001,409,206,203,294502
"71848","S01002716",2001,228,1,227,294502
"71849","S01002717",2001,363,53,310,294502
"71850","S01002718",2001,393,225,168,294502
"71851","S01002719",2001,306,126,180,294502
"71852","S01002720",2001,319,2,317,294502
"71853","S01002721",2001,363,161,202,294502
"71854","S01002722",2001,338,52,286,294502
"71855","S01002723",2001,317,99,218,294502
"71856","S01002724",2001,415,100,315,294502
"71857","S01002725",2001,407,138,269,294502
"71858","S01002726",2001,352,43,309,294502
"71859","S01002727",2001,396,4,392,294502
"71860","S01002728",2001,386,90,296,294502
"71861","S01002729",2001,380,3,377,294502
"71862","S01002730",2001,419,87,332,294502
"71863","S01002731",2001,360,139,221,294502
"71864","S01002732",2001,346,13,333,294502
"71865","S01002733",2001,295,65,230,294502
"71866","S01002734",2001,473,189,284,294502
"71867","S01002735",2001,535,142,393,294502
"71868","S01002736",2001,295,74,221,294502
"71869","S01002737",2001,404,5,399,294502
"71870","S01002738",2001,275,58,217,294502
"71871","S01002739",2001,313,40,273,294502
"71872","S01002740",2001,203,11,192,294502
"71873","S01002741",2001,476,45,431,294502
"71874","S01002742",2001,402,149,253,294502
"71875","S01002743",2001,319,145,174,294502
"71876","S01002744",2001,251,3,248,294502
"71877","S01002745",2001,284,169,115,294502
"71878","S01002746",2001,358,72,286,294502
"71879","S01002747",2001,270,82,188,294502
"71880","S01002748",2001,342,100,242,294502
"71881","S01002749",2001,320,182,138,294502
"71882","S01002750",2001,387,184,203,294502
"71883","S01002751",2001,434,234,200,294502
"71884","S01002752",2001,247,82,165,294502
"71885","S01002753",2001,279,1,278,294502
"71886","S01002754",2001,259,27,232,294502
"71887","S01002755",2001,347,209,138,294502
"71888","S01002756",2001,428,207,221,294502
"71889","S01002757",2001,241,63,178,294502
"71890","S01002758",2001,322,173,149,294502
"71891","S01002759",2001,287,132,155,294502
"71892","S01002760",2001,241,88,153,294502
"71893","S01002761",2001,438,182,256,294502
"71894","S01002762",2001,366,181,185,294502
"71895","S01002763",2001,374,198,176,294502
"71896","S01002764",2001,279,142,137,294502
"71897","S01002765",2001,396,230,166,294502
"71898","S01002766",2001,480,217,263,294502
"71899","S01002767",2001,398,55,343,294502
"71900","S01002768",2001,378,138,240,294502
"71901","S01002769",2001,347,160,187,294502
"71902","S01002770",2001,284,87,197,294502
"71903","S01002771",2001,351,214,137,294502
"71904","S01002772",2001,397,23,374,294502
"71905","S01002773",2001,413,155,258,294502
"71906","S01002774",2001,387,195,192,294502
"71907","S01002775",2001,288,142,146,294502
"71908","S01002776",2001,267,106,161,294502
"71909","S01002777",2001,465,181,284,294502
"71910","S01002778",2001,432,223,209,294502
"71911","S01002779",2001,309,190,119,294502
"71912","S01002780",2001,386,216,170,294502
"71913","S01002781",2001,397,143,254,294502
"71914","S01002782",2001,440,230,210,294502
"71915","S01002783",2001,352,123,229,294502
"71916","S01002784",2001,217,104,113,294502
"71917","S01002785",2001,304,156,148,294502
"71918","S01002786",2001,268,19,249,294502
"71919","S01002787",2001,305,96,209,294502
"71920","S01002788",2001,300,54,246,294502
"71921","S01002789",2001,302,0,0,294502
"71922","S01002790",2001,423,213,210,294502
"71923","S01002791",2001,261,180,81,294502
"71924","S01002792",2001,420,89,331,294502
"71925","S01002793",2001,426,200,226,294502
"71926","S01002794",2001,336,137,199,294502
"71927","S01002795",2001,260,4,256,294502
"71928","S01002796",2001,238,40,198,294502
"71929","S01002797",2001,314,2,312,294502
"71930","S01002798",2001,241,125,116,294502
"71931","S01002799",2001,325,162,163,294502
"71932","S01002800",2001,285,3,282,294502
"71933","S01002801",2001,391,245,146,294502
"71934","S01002802",2001,247,1,246,294502
"71935","S01002803",2001,372,115,257,294502
"71936","S01002804",2001,260,130,130,294502
"71937","S01002805",2001,399,200,199,294502
"71938","S01002806",2001,269,75,194,294502
"71939","S01002807",2001,323,164,159,294502
"71940","S01002808",2001,375,238,137,294502
"71941","S01002809",2001,354,115,239,294502
"71942","S01002810",2001,469,125,344,294502
"71943","S01002811",2001,426,113,313,294502
"71944","S01002812",2001,256,67,189,294502
"71945","S01002813",2001,370,171,199,294502
"71946","S01002814",2001,326,107,219,294502
"71947","S01002815",2001,368,192,176,294502
"71948","S01002816",2001,219,82,137,294502
"71949","S01002817",2001,250,129,121,294502
"71950","S01002818",2001,258,70,188,294502
"71951","S01002819",2001,351,236,115,294502
"71952","S01002820",2001,350,200,150,294502
"71953","S01002821",2001,474,209,265,294502
"71954","S01002822",2001,322,201,121,294502
"71955","S01002823",2001,412,224,188,294502
"71956","S01002824",2001,342,74,268,294502
"71957","S01002825",2001,449,130,319,294502
"71958","S01002826",2001,252,104,148,294502
"71959","S01002827",2001,295,141,154,294502
"71960","S01002828",2001,273,195,78,294502
"71961","S01002829",2001,425,205,220,294502
"71962","S01002830",2001,306,105,201,294502
"71963","S01002831",2001,341,115,226,294502
"71964","S01002832",2001,310,62,248,294502
"71965","S01002833",2001,390,21,369,294502
"71966","S01002834",2001,384,154,230,294502
"71967","S01002835",2001,360,82,278,294502
"71968","S01002836",2001,234,71,163,294502
"71969","S01002837",2001,334,192,142,294502
"71970","S01002838",2001,266,90,176,294502
"71971","S01002839",2001,263,130,133,294502
"71972","S01002840",2001,306,82,224,294502
"71973","S01002841",2001,243,5,238,294502
"71974","S01002842",2001,324,170,154,294502
"71975","S01002843",2001,338,185,153,294502
"71976","S01002844",2001,275,24,251,294502
"71977","S01002845",2001,360,108,252,294502
"71978","S01002846",2001,391,92,299,294502
"71979","S01002847",2001,406,76,330,294502
"71980","S01002848",2001,343,102,241,294502
"71981","S01002849",2001,415,104,311,294502
"71982","S01002850",2001,421,110,311,294502
"71983","S01002851",2001,344,54,290,294502
"71984","S01002852",2001,396,110,286,294502
"71985","S01002853",2001,241,105,136,294502
"71986","S01002854",2001,347,135,212,294502
"71987","S01002855",2001,268,136,132,294502
"71988","S01002856",2001,410,142,268,294502
"71989","S01002857",2001,212,30,182,294502
"71990","S01002858",2001,200,14,186,294502
"71991","S01002859",2001,343,176,167,294502
"71992","S01002860",2001,423,119,304,294502
"71993","S01002861",2001,418,85,333,294502
"71994","S01002862",2001,256,62,194,294502
"71995","S01002863",2001,321,147,174,294502
"71996","S01002864",2001,253,109,144,294502
"71997","S01002865",2001,357,114,243,294502
"71998","S01002866",2001,501,211,290,294502
"71999","S01002867",2001,212,17,195,294502
"72000","S01002868",2001,336,144,192,294502
"72001","S01002869",2001,242,72,170,294502
"72002","S01002870",2001,385,123,262,294502
"72003","S01002871",2001,259,56,203,294502
"72004","S01002872",2001,294,78,216,294502
"72005","S01002873",2001,341,87,254,294502
"72006","S01002874",2001,388,153,235,294502
"72007","S01002875",2001,350,153,197,294502
"72008","S01002876",2001,285,116,169,294502
"72009","S01002877",2001,390,108,282,294502
"72010","S01002878",2001,229,35,194,294502
"72011","S01002879",2001,367,80,287,294502
"72012","S01002880",2001,218,16,202,294502
"72013","S01002881",2001,443,86,357,294502
"72014","S01002882",2001,447,126,321,294502
"72015","S01002883",2001,433,111,322,294502
"72016","S01002884",2001,377,85,292,294502
"72017","S01002885",2001,282,5,277,294502
"72018","S01002886",2001,281,94,187,294502
"72019","S01002887",2001,253,89,164,294502
"72020","S01002888",2001,305,31,274,294502
"72021","S01002889",2001,342,128,214,294502
"72022","S01002890",2001,319,120,199,294502
"72023","S01002891",2001,315,57,258,294502
"72024","S01002892",2001,303,117,186,294502
"72025","S01002893",2001,341,116,225,294502
"72026","S01002894",2001,292,5,287,294502
"72027","S01002895",2001,332,161,171,294502
"72028","S01002896",2001,323,65,258,294502
"72029","S01002897",2001,371,179,192,294502
"72030","S01002898",2001,487,124,363,294502
"72031","S01002899",2001,192,4,188,294502
"72032","S01002900",2001,296,102,194,294502
"72033","S01002901",2001,351,126,225,294502
"72034","S01002902",2001,388,144,244,294502
"72035","S01002903",2001,422,227,195,294502
"72036","S01002904",2001,287,22,265,294502
"72037","S01002905",2001,348,64,284,294502
"72038","S01002906",2001,339,95,244,294502
"72039","S01002907",2001,285,90,195,294502
"72040","S01002908",2001,345,5,340,294502
"72041","S01002909",2001,308,76,232,294502
"72042","S01002910",2001,331,166,165,294502
"72043","S01002911",2001,351,188,163,294502
"72044","S01002912",2001,402,11,391,294502
"72045","S01002913",2001,325,2,323,294502
"72046","S01002914",2001,314,185,129,294502
"72047","S01002915",2001,413,141,272,294502
"72048","S01002916",2001,396,205,191,294502
"72049","S01002917",2001,292,20,272,294502
"72050","S01002918",2001,397,9,388,294502
"72051","S01002919",2001,367,230,137,294502
"72052","S01002920",2001,302,91,211,294502
"72053","S01002921",2001,337,49,288,294502
"72054","S01002922",2001,242,81,161,294502
"72055","S01002923",2001,321,58,263,294502
"72056","S01002924",2001,311,55,256,294502
"72057","S01002925",2001,390,119,271,294502
"72058","S01002926",2001,334,168,166,294502
"72059","S01002927",2001,337,181,156,294502
"72060","S01002928",2001,236,1,235,294502
"72061","S01002929",2001,295,136,159,294502
"72062","S01002930",2001,234,44,190,294502
"72063","S01002931",2001,293,138,155,294502
"72064","S01002932",2001,262,2,260,294502
"72065","S01002933",2001,401,76,325,294502
"72066","S01002934",2001,395,241,154,294502
"72067","S01002935",2001,354,113,241,294502
"72068","S01002936",2001,255,2,253,294502
"72069","S01002937",2001,271,2,269,294502
"72070","S01002938",2001,349,120,229,294502
"72071","S01002939",2001,213,7,206,294502
"72072","S01002940",2001,228,18,210,294502
"72073","S01002941",2001,411,53,358,294502
"72074","S01002942",2001,246,41,205,294502
"72075","S01002943",2001,227,14,213,294502
"72076","S01002944",2001,417,59,358,294502
"72077","S01002945",2001,303,20,283,294502
"72078","S01002946",2001,266,2,264,294502
"72079","S01002947",2001,257,26,231,294502
"72080","S01002948",2001,343,85,258,294502
"72081","S01002949",2001,207,21,186,294502
"72082","S01002950",2001,298,50,248,294502
"72083","S01002951",2001,410,18,392,294502
"72084","S01002952",2001,265,48,217,294502
"72085","S01002953",2001,470,82,388,294502
"72086","S01002954",2001,364,75,289,294502
"72087","S01002955",2001,443,86,357,294502
"72088","S01002956",2001,328,60,268,294502
"72089","S01002957",2001,382,38,344,294502
"72090","S01002958",2001,216,4,212,294502
"72091","S01002959",2001,416,41,375,294502
"72092","S01002960",2001,284,33,251,294502
"72093","S01002961",2001,321,52,269,294502
"72094","S01002962",2001,250,87,163,294502
"72095","S01002963",2001,343,138,205,294502
"72096","S01002964",2001,364,32,332,294502
"72097","S01002965",2001,357,25,332,294502
"72098","S01002966",2001,239,53,186,294502
"72099","S01002967",2001,350,41,309,294502
"72100","S01002968",2001,304,4,300,294502
"72101","S01002969",2001,426,15,411,294502
"72102","S01002970",2001,234,24,210,294502
"72103","S01002971",2001,422,10,412,294502
"72104","S01002972",2001,457,146,311,294502
"72105","S01002973",2001,382,42,340,294502
"72106","S01002974",2001,229,21,208,294502
"72107","S01002975",2001,348,85,263,294502
"72108","S01002976",2001,453,289,164,294502
"72109","S01002977",2001,327,58,269,294502
"72110","S01002978",2001,466,26,440,294502
"72111","S01002979",2001,290,59,231,294502
"72112","S01002980",2001,345,135,210,294502
"72113","S01002981",2001,335,1,334,294502
"72114","S01002982",2001,291,5,286,294502
"72115","S01002983",2001,384,146,238,294502
"72116","S01002984",2001,339,28,311,294502
"72117","S01002985",2001,269,2,267,294502
"72118","S01002986",2001,335,129,206,294502
"72119","S01002987",2001,307,118,189,294502
"72120","S01002988",2001,310,36,274,294502
"72121","S01002989",2001,487,228,259,294502
"72122","S01002990",2001,229,14,215,294502
"72123","S01002991",2001,329,6,323,294502
"72124","S01002992",2001,288,29,259,294502
"72125","S01002993",2001,309,14,295,294502
"72126","S01002994",2001,356,47,309,294502
"72127","S01002995",2001,222,8,214,294502
"72128","S01002996",2001,355,40,315,294502
"72129","S01002997",2001,310,68,242,294502
"72130","S01002998",2001,329,82,247,294502
"72131","S01002999",2001,241,11,230,294502
"72132","S01003000",2001,281,17,264,294502
"72133","S01003001",2001,270,74,196,294502
"72134","S01003002",2001,376,105,271,294502
"72135","S01003003",2001,256,18,238,294502
"72136","S01003004",2001,234,18,216,294502
"72137","S01003005",2001,226,5,221,294502
"72138","S01003006",2001,317,31,286,294502
"72139","S01003007",2001,302,80,222,294502
"72140","S01003008",2001,168,28,140,294502
"72141","S01003009",2001,245,58,187,294502
"72142","S01003010",2001,249,4,245,294502
"72143","S01003011",2001,234,22,212,294502
"72144","S01003012",2001,410,22,388,294502
"72145","S01003013",2001,241,1,240,294502
"72146","S01003014",2001,267,18,249,294502
"72147","S01003015",2001,310,31,279,294502
"72148","S01003016",2001,232,2,230,294502
"72149","S01003017",2001,336,70,266,294502
"72150","S01003018",2001,362,59,303,294502
"72151","S01003019",2001,338,124,214,294502
"72152","S01003020",2001,288,93,195,294502
"72153","S01003021",2001,277,24,253,294502
"72154","S01003022",2001,409,58,351,294502
"72155","S01003023",2001,313,31,282,294502
"72156","S01003024",2001,341,71,270,294502
"72157","S01003025",2001,314,33,281,294502
"72158","S01003026",2001,283,107,176,294502
"72159","S01003027",2001,421,2,419,294502
"72160","S01003028",2001,365,283,82,294502
"72161","S01003029",2001,359,267,92,294502
"72162","S01003030",2001,376,287,89,294502
"72163","S01003031",2001,332,251,81,294502
"72164","S01003032",2001,431,325,106,294502
"72165","S01003033",2001,270,157,113,294502
"72166","S01003034",2001,366,19,347,294502
"72167","S01003035",2001,317,187,130,294502
"72168","S01003036",2001,508,364,144,294502
"72169","S01003037",2001,295,3,292,294502
"72170","S01003038",2001,296,2,294,294502
"72171","S01003039",2001,460,266,194,294502
"72172","S01003040",2001,485,300,185,294502
"72173","S01003041",2001,262,2,260,294502
"72174","S01003042",2001,269,220,49,294502
"72175","S01003043",2001,253,211,42,294502
"72176","S01003044",2001,428,344,84,294502
"72177","S01003045",2001,375,303,72,294502
"72178","S01003046",2001,306,113,193,294502
"72179","S01003047",2001,503,359,144,294502
"72180","S01003048",2001,370,275,95,294502
"72181","S01003049",2001,276,205,71,294502
"72182","S01003050",2001,261,2,259,294502
"72183","S01003051",2001,394,234,160,294502
"72184","S01003052",2001,341,230,111,294502
"72185","S01003053",2001,373,119,254,294502
"72186","S01003054",2001,352,46,306,294502
"72187","S01003055",2001,410,244,166,294502
"72188","S01003056",2001,484,371,113,294502
"72189","S01003057",2001,285,4,281,294502
"72190","S01003058",2001,357,231,126,294502
"72191","S01003059",2001,373,26,347,294502
"72192","S01003060",2001,275,198,77,294502
"72193","S01003061",2001,291,2,289,294502
"72194","S01003062",2001,396,103,293,294502
"72195","S01003063",2001,323,2,321,294502
"72196","S01003064",2001,440,272,168,294502
"72197","S01003065",2001,559,70,489,294502
"72198","S01003066",2001,332,4,328,294502
"72199","S01003067",2001,231,3,228,294502
"72200","S01003068",2001,385,13,372,294502
"72201","S01003069",2001,267,91,176,294502
"72202","S01003070",2001,347,103,244,294502
"72203","S01003071",2001,278,2,276,294502
"72204","S01003072",2001,486,245,241,294502
"72205","S01003073",2001,303,6,297,294502
"72206","S01003074",2001,259,4,255,294502
"72207","S01003075",2001,301,7,294,294502
"72208","S01003076",2001,538,419,119,294502
"72209","S01003077",2001,506,228,278,294502
"72210","S01003078",2001,298,51,247,294502
"72211","S01003079",2001,343,5,338,294502
"72212","S01003080",2001,347,4,343,294502
"72213","S01003081",2001,331,1,330,294502
"72214","S01003082",2001,233,166,67,294502
"72215","S01003083",2001,476,151,325,294502
"72216","S01003084",2001,411,272,139,294502
"72217","S01003085",2001,417,8,409,294502
"72218","S01003086",2001,214,13,201,294502
"72219","S01003087",2001,277,7,270,294502
"72220","S01003088",2001,415,305,110,294502
"72221","S01003089",2001,212,0,0,294502
"72222","S01003090",2001,342,76,266,294502
"72223","S01003091",2001,257,2,255,294502
"72224","S01003092",2001,327,97,230,294502
"72225","S01003093",2001,508,296,212,294502
"72226","S01003094",2001,440,63,377,294502
"72227","S01003095",2001,265,3,262,294502
"72228","S01003096",2001,268,6,262,294502
"72229","S01003097",2001,330,215,115,294502
"72230","S01003098",2001,682,127,555,294502
"72231","S01003099",2001,220,138,82,294502
"72232","S01003100",2001,387,89,298,294502
"72233","S01003101",2001,230,158,72,294502
"72234","S01003102",2001,291,3,288,294502
"72235","S01003103",2001,272,3,269,294502
"72236","S01003104",2001,586,315,271,294502
"72237","S01003105",2001,311,25,286,294502
"72238","S01003106",2001,276,8,268,294502
"72239","S01003107",2001,393,325,68,294502
"72240","S01003108",2001,463,69,394,294502
"72241","S01003109",2001,370,2,368,294502
"72242","S01003110",2001,306,2,304,294502
"72243","S01003111",2001,359,213,146,294502
"72244","S01003112",2001,410,3,407,294502
"72245","S01003113",2001,279,6,273,294502
"72246","S01003114",2001,345,7,338,294502
"72247","S01003115",2001,239,27,212,294502
"72248","S01003116",2001,562,90,472,294502
"72249","S01003117",2001,466,56,410,294502
"72250","S01003118",2001,541,404,137,294502
"72251","S01003119",2001,275,4,271,294502
"72252","S01003120",2001,412,2,410,294502
"72253","S01003121",2001,371,200,171,294502
"72254","S01003122",2001,324,90,234,294502
"72255","S01003123",2001,390,29,361,294502
"72256","S01003124",2001,491,9,482,294502
"72257","S01003125",2001,439,36,403,294502
"72258","S01003126",2001,483,361,122,294502
"72259","S01003127",2001,333,8,325,294502
"72260","S01003128",2001,513,179,334,294502
"72261","S01003129",2001,626,96,530,294502
"72262","S01003130",2001,413,10,403,294502
"72263","S01003131",2001,438,4,434,294502
"72264","S01003132",2001,394,286,108,294502
"72265","S01003133",2001,571,7,564,294502
"72266","S01003134",2001,328,173,155,294502
"72267","S01003135",2001,343,112,231,294502
"72268","S01003136",2001,374,18,356,294502
"72269","S01003137",2001,354,34,320,294502
"72270","S01003138",2001,623,352,271,294502
"72271","S01003139",2001,579,5,574,294502
"72272","S01003140",2001,445,271,174,294502
"72273","S01003141",2001,455,4,451,294502
"72274","S01003142",2001,414,234,180,294502
"72275","S01003143",2001,461,78,383,294502
"72276","S01003144",2001,405,151,254,294502
"72277","S01003145",2001,333,107,226,294502
"72278","S01003146",2001,433,5,428,294502
"72279","S01003147",2001,420,109,311,294502
"72280","S01003148",2001,296,81,215,294502
"72281","S01003149",2001,607,64,543,294502
"72282","S01003150",2001,386,272,114,294502
"72283","S01003151",2001,348,85,263,294502
"72284","S01003152",2001,516,145,371,294502
"72285","S01003153",2001,284,13,271,294502
"72286","S01003154",2001,491,74,417,294502
"72287","S01003155",2001,395,2,393,294502
"72288","S01003156",2001,498,78,420,294502
"72289","S01003157",2001,582,102,480,294502
"72290","S01003158",2001,439,362,77,294502
"72291","S01003159",2001,246,183,63,294502
"72292","S01003160",2001,325,157,168,294502
"72293","S01003161",2001,250,76,174,294502
"72294","S01003162",2001,297,165,132,294502
"72295","S01003163",2001,298,3,295,294502
"72296","S01003164",2001,329,3,326,294502
"72297","S01003165",2001,504,110,394,294502
"72298","S01003166",2001,421,8,413,294502
"72299","S01003167",2001,310,162,148,294502
"72300","S01003168",2001,521,14,507,294502
"72301","S01003169",2001,390,29,361,294502
"72302","S01003170",2001,311,2,309,294502
"72303","S01003171",2001,180,5,175,294502
"72304","S01003172",2001,361,11,350,294502
"72305","S01003173",2001,266,3,263,294502
"72306","S01003174",2001,392,60,332,294502
"72307","S01003175",2001,460,302,158,294502
"72308","S01003176",2001,440,21,419,294502
"72309","S01003177",2001,442,4,438,294502
"72310","S01003178",2001,360,257,103,294502
"72311","S01003179",2001,303,20,283,294502
"72312","S01003180",2001,250,4,246,294502
"72313","S01003181",2001,338,169,169,294502
"72314","S01003182",2001,373,240,133,294502
"72315","S01003183",2001,370,38,332,294502
"72316","S01003184",2001,360,260,100,294502
"72317","S01003185",2001,266,137,129,294502
"72318","S01003186",2001,390,7,383,294502
"72319","S01003187",2001,483,8,475,294502
"72320","S01003188",2001,460,133,327,294502
"72321","S01003189",2001,447,22,425,294502
"72322","S01003190",2001,416,244,172,294502
"72323","S01003191",2001,278,163,115,294502
"72324","S01003192",2001,547,51,496,294502
"72325","S01003193",2001,279,107,172,294502
"72326","S01003194",2001,371,200,171,294502
"72327","S01003195",2001,295,8,287,294502
"72328","S01003196",2001,393,7,386,294502
"72329","S01003197",2001,304,8,296,294502
"72330","S01003198",2001,449,255,194,294502
"72331","S01003199",2001,354,69,285,294502
"72332","S01003200",2001,416,95,321,294502
"72333","S01003201",2001,400,307,93,294502
"72334","S01003202",2001,541,383,158,294502
"72335","S01003203",2001,423,106,317,294502
"72336","S01003204",2001,376,127,249,294502
"72337","S01003205",2001,440,257,183,294502
"72338","S01003206",2001,424,263,161,294502
"72339","S01003207",2001,313,13,300,294502
"72340","S01003208",2001,442,326,116,294502
"72341","S01003209",2001,255,68,187,294502
"72342","S01003210",2001,349,36,313,294502
"72343","S01003211",2001,243,2,241,294502
"72344","S01003212",2001,268,20,248,294502
"72345","S01003213",2001,248,91,157,294502
"72346","S01003214",2001,354,134,220,294502
"72347","S01003215",2001,412,207,205,294502
"72348","S01003216",2001,349,116,233,294502
"72349","S01003217",2001,455,311,144,294502
"72350","S01003218",2001,333,77,256,294502
"72351","S01003219",2001,344,96,248,294502
"72352","S01003220",2001,270,45,225,294502
"72353","S01003221",2001,418,176,242,294502
"72354","S01003222",2001,271,8,263,294502
"72355","S01003223",2001,477,306,171,294502
"72356","S01003224",2001,299,5,294,294502
"72357","S01003225",2001,444,273,171,294502
"72358","S01003226",2001,329,185,144,294502
"72359","S01003227",2001,361,44,317,294502
"72360","S01003228",2001,394,177,217,294502
"72361","S01003229",2001,349,4,345,294502
"72362","S01003230",2001,369,109,260,294502
"72363","S01003231",2001,447,198,249,294502
"72364","S01003232",2001,425,272,153,294502
"72365","S01003233",2001,344,7,337,294502
"72366","S01003234",2001,339,5,334,294502
"72367","S01003235",2001,366,95,271,294502
"72368","S01003236",2001,264,63,201,294502
"72369","S01003237",2001,421,201,220,294502
"72370","S01003238",2001,342,57,285,294502
"72371","S01003239",2001,448,133,315,294502
"72372","S01003240",2001,331,18,313,294502
"72373","S01003241",2001,354,42,312,294502
"72374","S01003242",2001,498,201,297,294502
"72375","S01003243",2001,406,105,301,294502
"72376","S01003244",2001,430,214,216,294502
"72377","S01003245",2001,496,373,123,294502
"72378","S01003246",2001,664,483,181,294502
"72379","S01003247",2001,319,161,158,294502
"72380","S01003248",2001,431,204,227,294502
"72381","S01003249",2001,365,103,262,294502
"72382","S01003250",2001,256,72,184,294502
"72383","S01003251",2001,453,327,126,294502
"72384","S01003252",2001,254,4,250,294502
"72385","S01003253",2001,468,386,82,294502
"72386","S01003254",2001,292,220,72,294502
"72387","S01003255",2001,449,109,340,294502
"72388","S01003256",2001,424,282,142,294502
"72389","S01003257",2001,257,4,253,294502
"72390","S01003258",2001,319,16,303,294502
"72391","S01003259",2001,413,42,371,294502
"72392","S01003260",2001,302,7,295,294502
"72393","S01003261",2001,392,11,381,294502
"72394","S01003262",2001,381,133,248,294502
"72395","S01003263",2001,261,177,84,294502
"72396","S01003264",2001,295,66,229,294502
"72397","S01003265",2001,308,68,240,294502
"72398","S01003266",2001,398,176,222,294502
"72399","S01003267",2001,599,217,382,294502
"72400","S01003268",2001,395,129,266,294502
"72401","S01003269",2001,451,272,179,294502
"72402","S01003270",2001,434,193,241,294502
"72403","S01003271",2001,518,156,362,294502
"72404","S01003272",2001,505,375,130,294502
"72405","S01003273",2001,472,303,169,294502
"72406","S01003274",2001,629,446,183,294502
"72407","S01003275",2001,560,243,317,294502
"72408","S01003276",2001,283,4,279,294502
"72409","S01003277",2001,324,92,232,294502
"72410","S01003278",2001,362,64,298,294502
"72411","S01003279",2001,240,213,27,294502
"72412","S01003280",2001,469,111,358,294502
"72413","S01003281",2001,378,190,188,294502
"72414","S01003282",2001,307,12,295,294502
"72415","S01003283",2001,298,32,266,294502
"72416","S01003284",2001,596,252,344,294502
"72417","S01003285",2001,526,337,189,294502
"72418","S01003286",2001,616,281,335,294502
"72419","S01003287",2001,241,196,45,294502
"72420","S01003288",2001,295,7,288,294502
"72421","S01003289",2001,315,226,89,294502
"72422","S01003290",2001,375,126,249,294502
"72423","S01003291",2001,402,263,139,294502
"72424","S01003292",2001,285,33,252,294502
"72425","S01003293",2001,478,350,128,294502
"72426","S01003294",2001,462,151,311,294502
"72427","S01003295",2001,375,14,361,294502
"72428","S01003296",2001,335,252,83,294502
"72429","S01003297",2001,283,203,80,294502
"72430","S01003298",2001,488,52,436,294502
"72431","S01003299",2001,265,211,54,294502
"72432","S01003300",2001,340,48,292,294502
"72433","S01003301",2001,393,229,164,294502
"72434","S01003302",2001,609,411,198,294502
"72435","S01003303",2001,631,112,519,294502
"72436","S01003304",2001,373,9,364,294502
"72437","S01003305",2001,376,7,369,294502
"72438","S01003306",2001,514,225,289,294502
"72439","S01003307",2001,518,246,272,294502
"72440","S01003308",2001,381,172,209,294502
"72441","S01003309",2001,407,291,116,294502
"72442","S01003310",2001,369,132,237,294502
"72443","S01003311",2001,298,6,292,294502
"72444","S01003312",2001,242,100,142,294502
"72445","S01003313",2001,408,137,271,294502
"72446","S01003314",2001,328,174,154,294502
"72447","S01003315",2001,269,15,254,294502
"72448","S01003316",2001,332,80,252,294502
"72449","S01003317",2001,295,23,272,294502
"72450","S01003318",2001,309,12,297,294502
"72451","S01003319",2001,322,271,51,294502
"72452","S01003320",2001,294,6,288,294502
"72453","S01003321",2001,313,22,291,294502
"72454","S01003322",2001,470,68,402,294502
"72455","S01003323",2001,254,2,252,294502
"72456","S01003324",2001,478,203,275,294502
"72457","S01003325",2001,324,3,321,294502
"72458","S01003326",2001,448,233,215,294502
"72459","S01003327",2001,288,80,208,294502
"72460","S01003328",2001,330,39,291,294502
"72461","S01003329",2001,344,57,287,294502
"72462","S01003330",2001,324,6,318,294502
"72463","S01003331",2001,355,225,130,294502
"72464","S01003332",2001,295,235,60,294502
"72465","S01003333",2001,444,258,186,294502
"72466","S01003334",2001,429,233,196,294502
"72467","S01003335",2001,380,160,220,294502
"72468","S01003336",2001,489,249,240,294502
"72469","S01003337",2001,374,210,164,294502
"72470","S01003338",2001,437,83,354,294502
"72471","S01003339",2001,335,41,294,294502
"72472","S01003340",2001,546,236,310,294502
"72473","S01003341",2001,269,4,265,294502
"72474","S01003342",2001,472,385,87,294502
"72475","S01003343",2001,255,212,43,294502
"72476","S01003344",2001,311,176,135,294502
"72477","S01003345",2001,512,146,366,294502
"72478","S01003346",2001,379,146,233,294502
"72479","S01003347",2001,446,377,69,294502
"72480","S01003348",2001,521,116,405,294502
"72481","S01003349",2001,422,308,114,294502
"72482","S01003350",2001,306,167,139,294502
"72483","S01003351",2001,570,182,388,294502
"72484","S01003352",2001,392,232,160,294502
"72485","S01003353",2001,521,390,131,294502
"72486","S01003354",2001,476,291,185,294502
"72487","S01003355",2001,440,254,186,294502
"72488","S01003356",2001,516,426,90,294502
"72489","S01003357",2001,551,419,132,294502
"72490","S01003358",2001,569,140,429,294502
"72491","S01003359",2001,356,5,351,294502
"72492","S01003360",2001,305,105,200,294502
"72493","S01003361",2001,372,218,154,294502
"72494","S01003362",2001,320,131,189,294502
"72495","S01003363",2001,367,162,205,294502
"72496","S01003364",2001,333,230,103,294502
"72497","S01003365",2001,381,223,158,294502
"72498","S01003366",2001,416,38,378,294502
"72499","S01003367",2001,636,522,114,294502
"72500","S01003368",2001,467,79,388,294502
"72501","S01003369",2001,381,230,151,294502
"72502","S01003370",2001,385,19,366,294502
"72503","S01003371",2001,418,48,370,294502
"72504","S01003372",2001,291,134,157,294502
"72505","S01003373",2001,685,401,284,294502
"72506","S01003374",2001,218,179,39,294502
"72507","S01003375",2001,326,95,231,294502
"72508","S01003376",2001,294,237,57,294502
"72509","S01003377",2001,349,150,199,294502
"72510","S01003378",2001,447,294,153,294502
"72511","S01003379",2001,382,299,83,294502
"72512","S01003380",2001,386,39,347,294502
"72513","S01003381",2001,357,92,265,294502
"72514","S01003382",2001,427,217,210,294502
"72515","S01003383",2001,447,150,297,294502
"72516","S01003384",2001,474,192,282,294502
"72517","S01003385",2001,469,28,441,294502
"72518","S01003386",2001,365,181,184,294502
"72519","S01003387",2001,447,199,248,294502
"72520","S01003388",2001,530,311,219,294502
"72521","S01003389",2001,584,242,342,294502
"72522","S01003390",2001,429,357,72,294502
"72523","S01003391",2001,415,263,152,294502
"72524","S01003392",2001,418,74,344,294502
"72525","S01003393",2001,471,203,268,294502
"72526","S01003394",2001,345,116,229,294502
"72527","S01003395",2001,358,45,313,294502
"72528","S01003396",2001,463,358,105,294502
"72529","S01003397",2001,351,301,50,294502
"72530","S01003398",2001,410,150,260,294502
"72531","S01003399",2001,416,196,220,294502
"72532","S01003400",2001,412,181,231,294502
"72533","S01003401",2001,344,264,80,294502
"72534","S01003402",2001,370,306,64,294502
"72535","S01003403",2001,368,151,217,294502
"72536","S01003404",2001,274,217,57,294502
"72537","S01003405",2001,382,150,232,294502
"72538","S01003406",2001,381,144,237,294502
"72539","S01003407",2001,395,121,274,294502
"72540","S01003408",2001,344,221,123,294502
"72541","S01003409",2001,444,40,404,294502
"72542","S01003410",2001,357,60,297,294502
"72543","S01003411",2001,525,270,255,294502
"72544","S01003412",2001,454,247,207,294502
"72545","S01003413",2001,308,138,170,294502
"72546","S01003414",2001,280,170,110,294502
"72547","S01003415",2001,458,334,124,294502
"72548","S01003416",2001,559,346,213,294502
"72549","S01003417",2001,446,82,364,294502
"72550","S01003418",2001,474,323,151,294502
"72551","S01003419",2001,406,286,120,294502
"72552","S01003420",2001,430,329,101,294502
"72553","S01003421",2001,283,143,140,294502
"72554","S01003422",2001,427,251,176,294502
"72555","S01003423",2001,354,50,304,294502
"72556","S01003424",2001,594,414,180,294502
"72557","S01003425",2001,423,114,309,294502
"72558","S01003426",2001,613,184,429,294502
"72559","S01003427",2001,503,220,283,294502
"72560","S01003428",2001,428,339,89,294502
"72561","S01003429",2001,329,59,270,294502
"72562","S01003430",2001,376,84,292,294502
"72563","S01003431",2001,485,234,251,294502
"72564","S01003432",2001,405,26,379,294502
"72565","S01003433",2001,379,12,367,294502
"72566","S01003434",2001,461,342,119,294502
"72567","S01003435",2001,406,325,81,294502
"72568","S01003436",2001,234,26,208,294502
"72569","S01003437",2001,276,27,249,294502
"72570","S01003438",2001,561,107,454,294502
"72571","S01003439",2001,626,447,179,294502
"72572","S01003440",2001,252,85,167,294502
"72573","S01003441",2001,618,492,126,294502
"72574","S01003442",2001,435,373,62,294502
"72575","S01003443",2001,500,376,124,294502
"72576","S01003444",2001,369,320,49,294502
"72577","S01003445",2001,428,299,129,294502
"72578","S01003446",2001,290,68,222,294502
"72579","S01003447",2001,515,272,243,294502
"72580","S01003448",2001,378,122,256,294502
"72581","S01003449",2001,449,84,365,294502
"72582","S01003450",2001,520,257,263,294502
"72583","S01003451",2001,446,168,278,294502
"72584","S01003452",2001,247,35,212,294502
"72585","S01003453",2001,383,63,320,294502
"72586","S01003454",2001,280,119,161,294502
"72587","S01003455",2001,369,305,64,294502
"72588","S01003456",2001,326,267,59,294502
"72589","S01003457",2001,562,439,123,294502
"72590","S01003458",2001,425,246,179,294502
"72591","S01003459",2001,386,206,180,294502
"72592","S01003460",2001,421,75,346,294502
"72593","S01003461",2001,331,104,227,294502
"72594","S01003462",2001,238,122,116,294502
"72595","S01003463",2001,442,346,96,294502
"72596","S01003464",2001,406,18,388,294502
"72597","S01003465",2001,526,89,437,294502
"72598","S01003466",2001,410,235,175,294502
"72599","S01003467",2001,352,181,171,294502
"72600","S01003468",2001,316,60,256,294502
"72601","S01003469",2001,552,251,301,294502
"72602","S01003470",2001,475,152,323,294502
"72603","S01003471",2001,375,272,103,294502
"72604","S01003472",2001,427,341,86,294502
"72605","S01003473",2001,549,241,308,294502
"72606","S01003474",2001,293,13,280,294502
"72607","S01003475",2001,442,198,244,294502
"72608","S01003476",2001,284,61,223,294502
"72609","S01003477",2001,624,109,515,294502
"72610","S01003478",2001,429,133,296,294502
"72611","S01003479",2001,467,155,312,294502
"72612","S01003480",2001,386,196,190,294502
"72613","S01003481",2001,586,194,392,294502
"72614","S01003482",2001,382,287,95,294502
"72615","S01003483",2001,282,139,143,294502
"72616","S01003484",2001,422,74,348,294502
"72617","S01003485",2001,397,12,385,294502
"72618","S01003486",2001,332,259,73,294502
"72619","S01003487",2001,451,132,319,294502
"72620","S01003488",2001,546,367,179,294502
"72621","S01003489",2001,421,295,126,294502
"72622","S01003490",2001,382,227,155,294502
"72623","S01003491",2001,373,241,132,294502
"72624","S01003492",2001,538,289,249,294502
"72625","S01003493",2001,400,297,103,294502
"72626","S01003494",2001,442,252,190,294502
"72627","S01003495",2001,439,238,201,294502
"72628","S01003496",2001,485,23,462,294502
"72629","S01003497",2001,497,80,417,294502
"72630","S01003498",2001,552,261,291,294502
"72631","S01003499",2001,606,148,458,294502
"72632","S01003500",2001,319,259,60,294502
"72633","S01003501",2001,315,31,284,294502
"72634","S01003502",2001,294,126,168,294502
"72635","S01003503",2001,373,50,323,294502
"72636","S01003504",2001,319,37,282,294502
"72637","S01003505",2001,365,264,101,294502
"72638","S01003506",2001,480,55,425,294502
"72639","S01003507",2001,276,13,263,294502
"72640","S01003508",2001,508,353,155,294502
"72641","S01003509",2001,418,16,402,294502
"72642","S01003510",2001,514,298,216,294502
"72643","S01003511",2001,494,17,477,294502
"72644","S01003512",2001,381,200,181,294502
"72645","S01003513",2001,312,19,293,294502
"72646","S01003514",2001,378,7,371,294502
"72647","S01003515",2001,277,165,112,294502
"72648","S01003516",2001,296,15,281,294502
"72649","S01003517",2001,436,77,359,294502
"72650","S01003518",2001,591,330,261,294502
"72651","S01003519",2001,405,259,146,294502
"72652","S01003520",2001,429,67,362,294502
"72653","S01003521",2001,249,5,244,294502
"72654","S01003522",2001,430,13,417,294502
"72655","S01003523",2001,303,166,137,294502
"72656","S01003524",2001,548,27,521,294502
"72657","S01003525",2001,526,9,517,294502
"72658","S01003526",2001,444,4,440,294502
"72659","S01003527",2001,347,32,315,294502
"72660","S01003528",2001,203,31,172,294502
"72661","S01003529",2001,199,3,196,294502
"72662","S01003530",2001,426,17,409,294502
"72663","S01003531",2001,434,280,154,294502
"72664","S01003532",2001,458,70,388,294502
"72665","S01003533",2001,518,417,101,294502
"72666","S01003534",2001,536,135,401,294502
"72667","S01003535",2001,418,159,259,294502
"72668","S01003536",2001,500,28,472,294502
"72669","S01003537",2001,475,225,250,294502
"72670","S01003538",2001,301,164,137,294502
"72671","S01003539",2001,509,15,494,294502
"72672","S01003540",2001,597,485,112,294502
"72673","S01003541",2001,461,252,209,294502
"72674","S01003542",2001,433,44,389,294502
"72675","S01003543",2001,370,258,112,294502
"72676","S01003544",2001,246,16,230,294502
"72677","S01003545",2001,436,8,428,294502
"72678","S01003546",2001,527,314,213,294502
"72679","S01003547",2001,440,106,334,294502
"72680","S01003548",2001,316,251,65,294502
"72681","S01003549",2001,330,201,129,294502
"72682","S01003550",2001,266,3,263,294502
"72683","S01003551",2001,373,186,187,294502
"72684","S01003552",2001,530,5,525,294502
"72685","S01003553",2001,363,302,61,294502
"72686","S01003554",2001,428,40,388,294502
"72687","S01003555",2001,322,8,314,294502
"72688","S01003556",2001,255,2,253,294502
"72689","S01003557",2001,381,314,67,294502
"72690","S01003558",2001,455,4,451,294502
"72691","S01003559",2001,326,14,312,294502
"72692","S01003560",2001,486,13,473,294502
"72693","S01003561",2001,457,318,139,294502
"72694","S01003562",2001,313,217,96,294502
"72695","S01003563",2001,239,123,116,294502
"72696","S01003564",2001,431,312,119,294502
"72697","S01003565",2001,428,257,171,294502
"72698","S01003566",2001,405,44,361,294502
"72699","S01003567",2001,393,351,42,294502
"72700","S01003568",2001,371,10,361,294502
"72701","S01003569",2001,302,10,292,294502
"72702","S01003570",2001,326,53,273,294502
"72703","S01003571",2001,432,236,196,294502
"72704","S01003572",2001,506,318,188,294502
"72705","S01003573",2001,450,204,246,294502
"72706","S01003574",2001,518,13,505,294502
"72707","S01003575",2001,439,263,176,294502
"72708","S01003576",2001,407,1,406,294502
"72709","S01003577",2001,312,138,174,294502
"72710","S01003578",2001,215,155,60,294502
"72711","S01003579",2001,319,276,43,294502
"72712","S01003580",2001,536,237,299,294502
"72713","S01003581",2001,481,240,241,294502
"72714","S01003582",2001,398,346,52,294502
"72715","S01003583",2001,272,161,111,294502
"72716","S01003584",2001,333,233,100,294502
"72717","S01003585",2001,362,228,134,294502
"72718","S01003586",2001,462,225,237,294502
"72719","S01003587",2001,352,2,350,294502
"72720","S01003588",2001,302,5,297,294502
"72721","S01003589",2001,499,19,480,294502
"72722","S01003590",2001,414,241,173,294502
"72723","S01003591",2001,400,4,396,294502
"72724","S01003592",2001,506,338,168,294502
"72725","S01003593",2001,417,175,242,294502
"72726","S01003594",2001,415,4,411,294502
"72727","S01003595",2001,468,362,106,294502
"72728","S01003596",2001,578,429,149,294502
"72729","S01003597",2001,290,4,286,294502
"72730","S01003598",2001,316,137,179,294502
"72731","S01003599",2001,338,105,233,294502
"72732","S01003600",2001,503,291,212,294502
"72733","S01003601",2001,377,229,148,294502
"72734","S01003602",2001,274,95,179,294502
"72735","S01003603",2001,433,255,178,294502
"72736","S01003604",2001,406,161,245,294502
"72737","S01003605",2001,363,235,128,294502
"72738","S01003606",2001,400,108,292,294502
"72739","S01003607",2001,215,52,163,294502
"72740","S01003608",2001,265,122,143,294502
"72741","S01003609",2001,472,47,425,294502
"72742","S01003610",2001,371,178,193,294502
"72743","S01003611",2001,496,369,127,294502
"72744","S01003612",2001,439,23,416,294502
"72745","S01003613",2001,329,9,320,294502
"72746","S01003614",2001,280,77,203,294502
"72747","S01003615",2001,249,182,67,294502
"72748","S01003616",2001,277,8,269,294502
"72749","S01003617",2001,547,393,154,294502
"72750","S01003618",2001,372,96,276,294502
"72751","S01003619",2001,468,352,116,294502
"72752","S01003620",2001,451,4,447,294502
"72753","S01003621",2001,500,255,245,294502
"72754","S01003622",2001,386,128,258,294502
"72755","S01003623",2001,341,8,333,294502
"72756","S01003624",2001,442,257,185,294502
"72757","S01003625",2001,433,279,154,294502
"72758","S01003626",2001,313,6,307,294502
"72759","S01003627",2001,326,241,85,294502
"72760","S01003628",2001,248,121,127,294502
"72761","S01003629",2001,405,253,152,294502
"72762","S01003630",2001,408,171,237,294502
"72763","S01003631",2001,365,96,269,294502
"72764","S01003632",2001,343,10,333,294502
"72765","S01003633",2001,497,125,372,294502
"72766","S01003634",2001,425,202,223,294502
"72767","S01003635",2001,390,125,265,294502
"72768","S01003636",2001,498,264,234,294502
"72769","S01003637",2001,404,127,277,294502
"72770","S01003638",2001,376,46,330,294502
"72771","S01003639",2001,372,124,248,294502
"72772","S01003640",2001,446,197,249,294502
"72773","S01003641",2001,279,6,273,294502
"72774","S01003642",2001,388,111,277,294502
"72775","S01003643",2001,389,148,241,294502
"72776","S01003644",2001,406,242,164,294502
"72777","S01003645",2001,255,82,173,294502
"72778","S01003646",2001,416,352,64,294502
"72779","S01003647",2001,352,84,268,294502
"72780","S01003648",2001,426,94,332,294502
"72781","S01003649",2001,428,34,394,294502
"72782","S01003650",2001,360,224,136,294502
"72783","S01003651",2001,388,176,212,294502
"72784","S01003652",2001,297,158,139,294502
"72785","S01003653",2001,283,152,131,294502
"72786","S01003654",2001,384,236,148,294502
"72787","S01003655",2001,349,214,135,294502
"72788","S01003656",2001,241,138,103,294502
"72789","S01003657",2001,392,209,183,294502
"72790","S01003658",2001,368,74,294,294502
"72791","S01003659",2001,464,46,418,294502
"72792","S01003660",2001,307,3,304,294502
"72793","S01003661",2001,381,11,370,294502
"72794","S01003662",2001,330,139,191,294502
"72795","S01003663",2001,391,254,137,294502
"72796","S01003664",2001,287,157,130,294502
"72797","S01003665",2001,383,351,32,294502
"72798","S01003666",2001,307,205,102,294502
"72799","S01003667",2001,341,68,273,294502
"72800","S01003668",2001,340,93,247,294502
"72801","S01003669",2001,274,120,154,294502
"72802","S01003670",2001,464,298,166,294502
"72803","S01003671",2001,334,144,190,294502
"72804","S01003672",2001,365,219,146,294502
"72805","S01003673",2001,352,273,79,294502
"72806","S01003674",2001,412,152,260,294502
"72807","S01003675",2001,367,4,363,294502
"72808","S01003676",2001,359,132,227,294502
"72809","S01003677",2001,297,110,187,294502
"72810","S01003678",2001,298,105,193,294502
"72811","S01003679",2001,529,308,221,294502
"72812","S01003680",2001,343,194,149,294502
"72813","S01003681",2001,328,110,218,294502
"72814","S01003682",2001,405,41,364,294502
"72815","S01003683",2001,312,90,222,294502
"72816","S01003684",2001,358,131,227,294502
"72817","S01003685",2001,238,74,164,294502
"72818","S01003686",2001,451,217,234,294502
"72819","S01003687",2001,400,315,85,294502
"72820","S01003688",2001,444,230,214,294502
"72821","S01003689",2001,245,142,103,294502
"72822","S01003690",2001,605,430,175,294502
"72823","S01003691",2001,468,73,395,294502
"72824","S01003692",2001,526,221,305,294502
"72825","S01003693",2001,251,109,142,294502
"72826","S01003694",2001,370,78,292,294502
"72827","S01003695",2001,416,253,163,294502
"72828","S01003696",2001,541,183,358,294502
"72829","S01003697",2001,369,2,367,294502
"72830","S01003698",2001,447,125,322,294502
"72831","S01003699",2001,382,10,372,294502
"72832","S01003700",2001,484,189,295,294502
"72833","S01003701",2001,626,334,292,294502
"72834","S01003702",2001,338,227,111,294502
"72835","S01003703",2001,482,246,236,294502
"72836","S01003704",2001,328,232,96,294502
"72837","S01003705",2001,376,300,76,294502
"72838","S01003706",2001,313,234,79,294502
"72839","S01003707",2001,354,302,52,294502
"72840","S01003708",2001,325,282,43,294502
"72841","S01003709",2001,493,398,95,294502
"72842","S01003710",2001,479,324,155,294502
"72843","S01003711",2001,391,311,80,294502
"72844","S01003712",2001,428,267,161,294502
"72845","S01003713",2001,312,238,74,294502
"72846","S01003714",2001,382,223,159,294502
"72847","S01003715",2001,332,159,173,294502
"72848","S01003716",2001,305,260,45,294502
"72849","S01003717",2001,322,269,53,294502
"72850","S01003718",2001,262,213,49,294502
"72851","S01003719",2001,226,21,205,294502
"72852","S01003720",2001,431,90,341,294502
"72853","S01003721",2001,349,114,235,294502
"72854","S01003722",2001,450,211,239,294502
"72855","S01003723",2001,231,11,220,294502
"72856","S01003724",2001,368,161,207,294502
"72857","S01003725",2001,272,43,229,294502
"72858","S01003726",2001,293,60,233,294502
"72859","S01003727",2001,274,120,154,294502
"72860","S01003728",2001,234,32,202,294502
"72861","S01003729",2001,301,96,205,294502
"72862","S01003730",2001,265,182,83,294502
"72863","S01003731",2001,264,85,179,294502
"72864","S01003732",2001,352,33,319,294502
"72865","S01003733",2001,334,170,164,294502
"72866","S01003734",2001,282,117,165,294502
"72867","S01003735",2001,294,50,244,294502
"72868","S01003736",2001,349,153,196,294502
"72869","S01003737",2001,275,99,176,294502
"72870","S01003738",2001,267,16,251,294502
"72871","S01003739",2001,257,38,219,294502
"72872","S01003740",2001,244,29,215,294502
"72873","S01003741",2001,366,33,333,294502
"72874","S01003742",2001,215,42,173,294502
"72875","S01003743",2001,251,14,237,294502
"72876","S01003744",2001,254,27,227,294502
"72877","S01003745",2001,329,97,232,294502
"72878","S01003746",2001,317,55,262,294502
"72879","S01003747",2001,419,63,356,294502
"72880","S01003748",2001,242,25,217,294502
"72881","S01003749",2001,334,86,248,294502
"72882","S01003750",2001,267,23,244,294502
"72883","S01003751",2001,421,51,370,294502
"72884","S01003752",2001,346,31,315,294502
"72885","S01003753",2001,407,74,333,294502
"72886","S01003754",2001,395,156,239,294502
"72887","S01003755",2001,311,81,230,294502
"72888","S01003756",2001,331,44,287,294502
"72889","S01003757",2001,246,29,217,294502
"72890","S01003758",2001,340,34,306,294502
"72891","S01003759",2001,280,29,251,294502
"72892","S01003760",2001,311,50,261,294502
"72893","S01003761",2001,359,46,313,294502
"72894","S01003762",2001,349,19,330,294502
"72895","S01003763",2001,393,104,289,294502
"72896","S01003764",2001,349,97,252,294502
"72897","S01003765",2001,322,154,168,294502
"72898","S01003766",2001,293,48,245,294502
"72899","S01003767",2001,303,31,272,294502
"72900","S01003768",2001,241,16,225,294502
"72901","S01003769",2001,302,77,225,294502
"72902","S01003770",2001,263,2,261,294502
"72903","S01003771",2001,279,23,256,294502
"72904","S01003772",2001,233,16,217,294502
"72905","S01003773",2001,303,43,260,294502
"72906","S01003774",2001,263,31,232,294502
"72907","S01003775",2001,332,10,322,294502
"72908","S01003776",2001,237,15,222,294502
"72909","S01003777",2001,368,41,327,294502
"72910","S01003778",2001,205,2,203,294502
"72911","S01003779",2001,237,16,221,294502
"72912","S01003780",2001,322,3,319,294502
"72913","S01003781",2001,290,3,287,294502
"72914","S01003782",2001,216,3,213,294502
"72915","S01003783",2001,379,51,328,294502
"72916","S01003784",2001,244,3,241,294502
"72917","S01003785",2001,365,6,359,294502
"72918","S01003786",2001,381,1,380,294502
"72919","S01003787",2001,255,1,254,294502
"72920","S01003788",2001,301,13,288,294502
"72921","S01003789",2001,195,3,192,294502
"72922","S01003790",2001,239,96,143,294502
"72923","S01003791",2001,320,35,285,294502
"72924","S01003792",2001,326,4,322,294502
"72925","S01003793",2001,263,147,116,294502
"72926","S01003794",2001,340,15,325,294502
"72927","S01003795",2001,232,2,230,294502
"72928","S01003796",2001,296,160,136,294502
"72929","S01003797",2001,493,135,358,294502
"72930","S01003798",2001,331,2,329,294502
"72931","S01003799",2001,310,3,307,294502
"72932","S01003800",2001,287,148,139,294502
"72933","S01003801",2001,355,114,241,294502
"72934","S01003802",2001,307,50,257,294502
"72935","S01003803",2001,267,1,266,294502
"72936","S01003804",2001,282,99,183,294502
"72937","S01003805",2001,427,168,259,294502
"72938","S01003806",2001,285,116,169,294502
"72939","S01003807",2001,360,0,0,294502
"72940","S01003808",2001,291,91,200,294502
"72941","S01003809",2001,293,94,199,294502
"72942","S01003810",2001,350,20,330,294502
"72943","S01003811",2001,284,1,283,294502
"72944","S01003812",2001,471,177,294,294502
"72945","S01003813",2001,360,2,358,294502
"72946","S01003814",2001,336,1,335,294502
"72947","S01003815",2001,385,30,355,294502
"72948","S01003816",2001,378,4,374,294502
"72949","S01003817",2001,419,212,207,294502
"72950","S01003818",2001,346,152,194,294502
"72951","S01003819",2001,240,3,237,294502
"72952","S01003820",2001,482,3,479,294502
"72953","S01003821",2001,349,112,237,294502
"72954","S01003822",2001,241,63,178,294502
"72955","S01003823",2001,423,77,346,294502
"72956","S01003824",2001,351,23,328,294502
"72957","S01003825",2001,243,32,211,294502
"72958","S01003826",2001,330,89,241,294502
"72959","S01003827",2001,395,33,362,294502
"72960","S01003828",2001,250,6,244,294502
"72961","S01003829",2001,262,90,172,294502
"72962","S01003830",2001,354,193,161,294502
"72963","S01003831",2001,304,1,303,294502
"72964","S01003832",2001,400,54,346,294502
"72965","S01003833",2001,378,126,252,294502
"72966","S01003834",2001,300,43,257,294502
"72967","S01003835",2001,260,1,259,294502
"72968","S01003836",2001,298,22,276,294502
"72969","S01003837",2001,403,124,279,294502
"72970","S01003838",2001,204,78,126,294502
"72971","S01003839",2001,336,180,156,294502
"72972","S01003840",2001,305,4,301,294502
"72973","S01003841",2001,272,38,234,294502
"72974","S01003842",2001,233,34,199,294502
"72975","S01003843",2001,262,1,261,294502
"72976","S01003844",2001,326,1,325,294502
"72977","S01003845",2001,487,156,331,294502
"72978","S01003846",2001,374,44,330,294502
"72979","S01003847",2001,261,67,194,294502
"72980","S01003848",2001,285,0,0,294502
"72981","S01003849",2001,456,303,153,294502
"72982","S01003850",2001,251,0,0,294502
"72983","S01003851",2001,325,1,324,294502
"72984","S01003852",2001,229,2,227,294502
"72985","S01003853",2001,450,69,381,294502
"72986","S01003854",2001,290,82,208,294502
"72987","S01003855",2001,443,273,170,294502
"72988","S01003856",2001,288,90,198,294502
"72989","S01003857",2001,295,19,276,294502
"72990","S01003858",2001,220,78,142,294502
"72991","S01003859",2001,213,4,209,294502
"72992","S01003860",2001,347,258,89,294502
"72993","S01003861",2001,389,6,383,294502
"72994","S01003862",2001,246,187,59,294502
"72995","S01003863",2001,281,3,278,294502
"72996","S01003864",2001,378,49,329,294502
"72997","S01003865",2001,305,59,246,294502
"72998","S01003866",2001,330,29,301,294502
"72999","S01003867",2001,432,162,270,294502
"73000","S01003868",2001,254,2,252,294502
"73001","S01003869",2001,316,33,283,294502
"73002","S01003870",2001,320,58,262,294502
"73003","S01003871",2001,340,23,317,294502
"73004","S01003872",2001,321,7,314,294502
"73005","S01003873",2001,408,37,371,294502
"73006","S01003874",2001,258,2,256,294502
"73007","S01003875",2001,186,4,182,294502
"73008","S01003876",2001,251,8,243,294502
"73009","S01003877",2001,215,3,212,294502
"73010","S01003878",2001,407,161,246,294502
"73011","S01003879",2001,261,16,245,294502
"73012","S01003880",2001,390,75,315,294502
"73013","S01003881",2001,304,31,273,294502
"73014","S01003882",2001,263,164,99,294502
"73015","S01003883",2001,216,41,175,294502
"73016","S01003884",2001,305,166,139,294502
"73017","S01003885",2001,264,90,174,294502
"73018","S01003886",2001,211,90,121,294502
"73019","S01003887",2001,382,227,155,294502
"73020","S01003888",2001,234,3,231,294502
"73021","S01003889",2001,250,50,200,294502
"73022","S01003890",2001,269,17,252,294502
"73023","S01003891",2001,311,18,293,294502
"73024","S01003892",2001,254,101,153,294502
"73025","S01003893",2001,272,5,267,294502
"73026","S01003894",2001,401,42,359,294502
"73027","S01003895",2001,268,19,249,294502
"73028","S01003896",2001,271,4,267,294502
"73029","S01003897",2001,312,49,263,294502
"73030","S01003898",2001,333,39,294,294502
"73031","S01003899",2001,328,65,263,294502
"73032","S01003900",2001,384,25,359,294502
"73033","S01003901",2001,240,50,190,294502
"73034","S01003902",2001,376,92,284,294502
"73035","S01003903",2001,228,3,225,294502
"73036","S01003904",2001,372,69,303,294502
"73037","S01003905",2001,337,9,328,294502
"73038","S01003906",2001,327,108,219,294502
"73039","S01003907",2001,407,198,209,294502
"73040","S01003908",2001,314,117,197,294502
"73041","S01003909",2001,269,2,267,294502
"73042","S01003910",2001,236,105,131,294502
"73043","S01003911",2001,241,30,211,294502
"73044","S01003912",2001,281,31,250,294502
"73045","S01003913",2001,285,2,283,294502
"73046","S01003914",2001,366,45,321,294502
"73047","S01003915",2001,264,21,243,294502
"73048","S01003916",2001,310,11,299,294502
"73049","S01003917",2001,377,99,278,294502
"73050","S01003918",2001,346,96,250,294502
"73051","S01003919",2001,310,69,241,294502
"73052","S01003920",2001,275,105,170,294502
"73053","S01003921",2001,370,111,259,294502
"73054","S01003922",2001,314,211,103,294502
"73055","S01003923",2001,276,170,106,294502
"73056","S01003924",2001,245,190,55,294502
"73057","S01003925",2001,305,92,213,294502
"73058","S01003926",2001,262,180,82,294502
"73059","S01003927",2001,271,39,232,294502
"73060","S01003928",2001,336,192,144,294502
"73061","S01003929",2001,215,100,115,294502
"73062","S01003930",2001,308,95,213,294502
"73063","S01003931",2001,360,175,185,294502
"73064","S01003932",2001,334,36,298,294502
"73065","S01003933",2001,286,26,260,294502
"73066","S01003934",2001,368,50,318,294502
"73067","S01003935",2001,325,143,182,294502
"73068","S01003936",2001,329,1,328,294502
"73069","S01003937",2001,346,184,162,294502
"73070","S01003938",2001,220,5,215,294502
"73071","S01003939",2001,261,5,256,294502
"73072","S01003940",2001,377,155,222,294502
"73073","S01003941",2001,233,15,218,294502
"73074","S01003942",2001,313,120,193,294502
"73075","S01003943",2001,312,111,201,294502
"73076","S01003944",2001,293,99,194,294502
"73077","S01003945",2001,282,10,272,294502
"73078","S01003946",2001,367,64,303,294502
"73079","S01003947",2001,222,20,202,294502
"73080","S01003948",2001,272,3,269,294502
"73081","S01003949",2001,246,29,217,294502
"73082","S01003950",2001,295,102,193,294502
"73083","S01003951",2001,245,54,191,294502
"73084","S01003952",2001,218,10,208,294502
"73085","S01003953",2001,252,35,217,294502
"73086","S01003954",2001,247,27,220,294502
"73087","S01003955",2001,326,85,241,294502
"73088","S01003956",2001,253,71,182,294502
"73089","S01003957",2001,310,93,217,294502
"73090","S01003958",2001,342,79,263,294502
"73091","S01003959",2001,341,46,295,294502
"73092","S01003960",2001,385,104,281,294502
"73093","S01003961",2001,273,88,185,294502
"73094","S01003962",2001,280,122,158,294502
"73095","S01003963",2001,216,19,197,294502
"73096","S01003964",2001,239,3,236,294502
"73097","S01003965",2001,259,31,228,294502
"73098","S01003966",2001,420,88,332,294502
"73099","S01003967",2001,239,62,177,294502
"73100","S01003968",2001,443,112,331,294502
"73101","S01003969",2001,347,51,296,294502
"73102","S01003970",2001,282,41,241,294502
"73103","S01003971",2001,297,91,206,294502
"73104","S01003972",2001,270,39,231,294502
"73105","S01003973",2001,219,47,172,294502
"73106","S01003974",2001,389,49,340,294502
"73107","S01003975",2001,276,14,262,294502
"73108","S01003976",2001,338,155,183,294502
"73109","S01003977",2001,255,154,101,294502
"73110","S01003978",2001,294,148,146,294502
"73111","S01003979",2001,264,77,187,294502
"73112","S01003980",2001,211,18,193,294502
"73113","S01003981",2001,270,77,193,294502
"73114","S01003982",2001,319,33,286,294502
"73115","S01003983",2001,298,34,264,294502
"73116","S01003984",2001,300,79,221,294502
"73117","S01003985",2001,351,206,145,294502
"73118","S01003986",2001,273,119,154,294502
"73119","S01003987",2001,194,36,158,294502
"73120","S01003988",2001,251,47,204,294502
"73121","S01003989",2001,339,72,267,294502
"73122","S01003990",2001,230,38,192,294502
"73123","S01003991",2001,256,30,226,294502
"73124","S01003992",2001,401,76,325,294502
"73125","S01003993",2001,263,33,230,294502
"73126","S01003994",2001,275,68,207,294502
"73127","S01003995",2001,373,33,340,294502
"73128","S01003996",2001,206,8,198,294502
"73129","S01003997",2001,414,214,200,294502
"73130","S01003998",2001,259,79,180,294502
"73131","S01003999",2001,341,71,270,294502
"73132","S01004000",2001,360,129,231,294502
"73133","S01004001",2001,324,145,179,294502
"73134","S01004002",2001,472,127,345,294502
"73135","S01004003",2001,234,75,159,294502
"73136","S01004004",2001,357,160,197,294502
"73137","S01004005",2001,271,57,214,294502
"73138","S01004006",2001,230,63,167,294502
"73139","S01004007",2001,249,129,120,294502
"73140","S01004008",2001,261,29,232,294502
"73141","S01004009",2001,256,37,219,294502
"73142","S01004010",2001,331,24,307,294502
"73143","S01004011",2001,385,3,382,294502
"73144","S01004012",2001,280,2,278,294502
"73145","S01004013",2001,219,4,215,294502
"73146","S01004014",2001,309,27,282,294502
"73147","S01004015",2001,357,1,356,294502
"73148","S01004016",2001,207,1,206,294502
"73149","S01004017",2001,426,19,407,294502
"73150","S01004018",2001,271,12,259,294502
"73151","S01004019",2001,179,2,177,294502
"73152","S01004020",2001,345,64,281,294502
"73153","S01004021",2001,278,2,276,294502
"73154","S01004022",2001,275,17,258,294502
"73155","S01004023",2001,231,14,217,294502
"73156","S01004024",2001,264,40,224,294502
"73157","S01004025",2001,378,196,182,294502
"73158","S01004026",2001,263,129,134,294502
"73159","S01004027",2001,328,132,196,294502
"73160","S01004028",2001,325,160,165,294502
"73161","S01004029",2001,387,170,217,294502
"73162","S01004030",2001,330,195,135,294502
"73163","S01004031",2001,249,102,147,294502
"73164","S01004032",2001,244,184,60,294502
"73165","S01004033",2001,369,208,161,294502
"73166","S01004034",2001,260,27,233,294502
"73167","S01004035",2001,318,120,198,294502
"73168","S01004036",2001,257,131,126,294502
"73169","S01004037",2001,252,21,231,294502
"73170","S01004038",2001,268,101,167,294502
"73171","S01004039",2001,346,229,117,294502
"73172","S01004040",2001,317,55,262,294502
"73173","S01004041",2001,325,72,253,294502
"73174","S01004042",2001,393,114,279,294502
"73175","S01004043",2001,277,12,265,294502
"73176","S01004044",2001,418,306,112,294502
"73177","S01004045",2001,248,146,102,294502
"73178","S01004046",2001,355,162,193,294502
"73179","S01004047",2001,294,70,224,294502
"73180","S01004048",2001,395,86,309,294502
"73181","S01004049",2001,333,104,229,294502
"73182","S01004050",2001,344,255,89,294502
"73183","S01004051",2001,309,181,128,294502
"73184","S01004052",2001,364,233,131,294502
"73185","S01004053",2001,439,156,283,294502
"73186","S01004054",2001,368,97,271,294502
"73187","S01004055",2001,326,151,175,294502
"73188","S01004056",2001,287,106,181,294502
"73189","S01004057",2001,385,157,228,294502
"73190","S01004058",2001,334,156,178,294502
"73191","S01004059",2001,263,109,154,294502
"73192","S01004060",2001,455,315,140,294502
"73193","S01004061",2001,426,300,126,294502
"73194","S01004062",2001,335,88,247,294502
"73195","S01004063",2001,518,298,220,294502
"73196","S01004064",2001,293,71,222,294502
"73197","S01004065",2001,486,253,233,294502
"73198","S01004066",2001,315,155,160,294502
"73199","S01004067",2001,347,70,277,294502
"73200","S01004068",2001,416,228,188,294502
"73201","S01004069",2001,368,170,198,294502
"73202","S01004070",2001,404,245,159,294502
"73203","S01004071",2001,430,184,246,294502
"73204","S01004072",2001,500,115,385,294502
"73205","S01004073",2001,274,143,131,294502
"73206","S01004074",2001,344,175,169,294502
"73207","S01004075",2001,402,284,118,294502
"73208","S01004076",2001,258,66,192,294502
"73209","S01004077",2001,355,113,242,294502
"73210","S01004078",2001,368,116,252,294502
"73211","S01004079",2001,325,184,141,294502
"73212","S01004080",2001,404,240,164,294502
"73213","S01004081",2001,326,11,315,294502
"73214","S01004082",2001,327,2,325,294502
"73215","S01004083",2001,441,263,178,294502
"73216","S01004084",2001,463,232,231,294502
"73217","S01004085",2001,328,128,200,294502
"73218","S01004086",2001,501,268,233,294502
"73219","S01004087",2001,245,129,116,294502
"73220","S01004088",2001,219,92,127,294502
"73221","S01004089",2001,340,150,190,294502
"73222","S01004090",2001,347,244,103,294502
"73223","S01004091",2001,318,20,298,294502
"73224","S01004092",2001,365,118,247,294502
"73225","S01004093",2001,371,207,164,294502
"73226","S01004094",2001,411,175,236,294502
"73227","S01004095",2001,239,22,217,294502
"73228","S01004096",2001,281,1,280,294502
"73229","S01004097",2001,319,166,153,294502
"73230","S01004098",2001,251,42,209,294502
"73231","S01004099",2001,310,3,307,294502
"73232","S01004100",2001,295,101,194,294502
"73233","S01004101",2001,372,36,336,294502
"73234","S01004102",2001,302,0,0,294502
"73235","S01004103",2001,289,35,254,294502
"73236","S01004104",2001,276,1,275,294502
"73237","S01004105",2001,324,63,261,294502
"73238","S01004106",2001,357,10,347,294502
"73239","S01004107",2001,284,14,270,294502
"73240","S01004108",2001,307,12,295,294502
"73241","S01004109",2001,253,2,251,294502
"73242","S01004110",2001,272,23,249,294502
"73243","S01004111",2001,375,0,0,294502
"73244","S01004112",2001,297,27,270,294502
"73245","S01004113",2001,334,38,296,294502
"73246","S01004114",2001,402,120,282,294502
"73247","S01004115",2001,302,36,266,294502
"73248","S01004116",2001,274,24,250,294502
"73249","S01004117",2001,356,8,348,294502
"73250","S01004118",2001,581,205,376,294502
"73251","S01004119",2001,323,8,315,294502
"73252","S01004120",2001,317,1,316,294502
"73253","S01004121",2001,255,27,228,294502
"73254","S01004122",2001,252,15,237,294502
"73255","S01004123",2001,212,21,191,294502
"73256","S01004124",2001,387,18,369,294502
"73257","S01004125",2001,315,60,255,294502
"73258","S01004126",2001,402,141,261,294502
"73259","S01004127",2001,324,3,321,294502
"73260","S01004128",2001,270,1,269,294502
"73261","S01004129",2001,327,63,264,294502
"73262","S01004130",2001,200,31,169,294502
"73263","S01004131",2001,374,226,148,294502
"73264","S01004132",2001,234,103,131,294502
"73265","S01004133",2001,362,178,184,294502
"73266","S01004134",2001,268,2,266,294502
"73267","S01004135",2001,300,170,130,294502
"73268","S01004136",2001,230,90,140,294502
"73269","S01004137",2001,206,4,202,294502
"73270","S01004138",2001,306,149,157,294502
"73271","S01004139",2001,229,52,177,294502
"73272","S01004140",2001,224,86,138,294502
"73273","S01004141",2001,285,119,166,294502
"73274","S01004142",2001,204,32,172,294502
"73275","S01004143",2001,381,96,285,294502
"73276","S01004144",2001,395,153,242,294502
"73277","S01004145",2001,263,52,211,294502
"73278","S01004146",2001,285,24,261,294502
"73279","S01004147",2001,350,153,197,294502
"73280","S01004148",2001,333,3,330,294502
"73281","S01004149",2001,247,124,123,294502
"73282","S01004150",2001,204,2,202,294502
"73283","S01004151",2001,198,11,187,294502
"73284","S01004152",2001,286,124,162,294502
"73285","S01004153",2001,386,144,242,294502
"73286","S01004154",2001,282,56,226,294502
"73287","S01004155",2001,343,218,125,294502
"73288","S01004156",2001,356,160,196,294502
"73289","S01004157",2001,234,11,223,294502
"73290","S01004158",2001,311,67,244,294502
"73291","S01004159",2001,236,92,144,294502
"73292","S01004160",2001,259,68,191,294502
"73293","S01004161",2001,272,29,243,294502
"73294","S01004162",2001,250,35,215,294502
"73295","S01004163",2001,258,123,135,294502
"73296","S01004164",2001,398,190,208,294502
"73297","S01004165",2001,372,37,335,294502
"73298","S01004166",2001,202,72,130,294502
"73299","S01004167",2001,336,143,193,294502
"73300","S01004168",2001,279,104,175,294502
"73301","S01004169",2001,212,71,141,294502
"73302","S01004170",2001,259,117,142,294502
"73303","S01004171",2001,283,34,249,294502
"73304","S01004172",2001,320,151,169,294502
"73305","S01004173",2001,237,100,137,294502
"73306","S01004174",2001,315,99,216,294502
"73307","S01004175",2001,251,156,95,294502
"73308","S01004176",2001,248,20,228,294502
"73309","S01004177",2001,200,120,80,294502
"73310","S01004178",2001,235,101,134,294502
"73311","S01004179",2001,208,30,178,294502
"73312","S01004180",2001,301,3,298,294502
"73313","S01004181",2001,295,95,200,294502
"73314","S01004182",2001,387,231,156,294502
"73315","S01004183",2001,333,19,314,294502
"73316","S01004184",2001,356,135,221,294502
"73317","S01004185",2001,290,175,115,294502
"73318","S01004186",2001,333,156,177,294502
"73319","S01004187",2001,306,167,139,294502
"73320","S01004188",2001,303,151,152,294502
"73321","S01004189",2001,209,4,205,294502
"73322","S01004190",2001,318,117,201,294502
"73323","S01004191",2001,353,141,212,294502
"73324","S01004192",2001,348,119,229,294502
"73325","S01004193",2001,306,78,228,294502
"73326","S01004194",2001,340,125,215,294502
"73327","S01004195",2001,243,75,168,294502
"73328","S01004196",2001,277,150,127,294502
"73329","S01004197",2001,310,134,176,294502
"73330","S01004198",2001,256,17,239,294502
"73331","S01004199",2001,376,100,276,294502
"73332","S01004200",2001,291,4,287,294502
"73333","S01004201",2001,307,41,266,294502
"73334","S01004202",2001,221,45,176,294502
"73335","S01004203",2001,405,120,285,294502
"73336","S01004204",2001,304,43,261,294502
"73337","S01004205",2001,290,127,163,294502
"73338","S01004206",2001,235,9,226,294502
"73339","S01004207",2001,313,125,188,294502
"73340","S01004208",2001,354,48,306,294502
"73341","S01004209",2001,239,9,230,294502
"73342","S01004210",2001,270,41,229,294502
"73343","S01004211",2001,276,2,274,294502
"73344","S01004212",2001,336,16,320,294502
"73345","S01004213",2001,342,4,338,294502
"73346","S01004214",2001,291,3,288,294502
"73347","S01004215",2001,206,5,201,294502
"73348","S01004216",2001,335,81,254,294502
"73349","S01004217",2001,232,103,129,294502
"73350","S01004218",2001,381,180,201,294502
"73351","S01004219",2001,257,151,106,294502
"73352","S01004220",2001,333,30,303,294502
"73353","S01004221",2001,343,162,181,294502
"73354","S01004222",2001,336,136,200,294502
"73355","S01004223",2001,326,231,95,294502
"73356","S01004224",2001,289,166,123,294502
"73357","S01004225",2001,456,249,207,294502
"73358","S01004226",2001,345,148,197,294502
"73359","S01004227",2001,248,73,175,294502
"73360","S01004228",2001,315,46,269,294502
"73361","S01004229",2001,281,119,162,294502
"73362","S01004230",2001,296,106,190,294502
"73363","S01004231",2001,320,135,185,294502
"73364","S01004232",2001,259,47,212,294502
"73365","S01004233",2001,299,43,256,294502
"73366","S01004234",2001,370,39,331,294502
"73367","S01004235",2001,251,18,233,294502
"73368","S01004236",2001,399,97,302,294502
"73369","S01004237",2001,301,97,204,294502
"73370","S01004238",2001,217,24,193,294502
"73371","S01004239",2001,306,66,240,294502
"73372","S01004240",2001,267,22,245,294502
"73373","S01004241",2001,227,53,174,294502
"73374","S01004242",2001,340,9,331,294502
"73375","S01004243",2001,218,16,202,294502
"73376","S01004244",2001,273,113,160,294502
"73377","S01004245",2001,389,106,283,294502
"73378","S01004246",2001,218,22,196,294502
"73379","S01004247",2001,387,181,206,294502
"73380","S01004248",2001,412,186,226,294502
"73381","S01004249",2001,388,82,306,294502
"73382","S01004250",2001,456,101,355,294502
"73383","S01004251",2001,395,78,317,294502
"73384","S01004252",2001,214,7,207,294502
"73385","S01004253",2001,223,35,188,294502
"73386","S01004254",2001,253,6,247,294502
"73387","S01004255",2001,266,3,263,294502
"73388","S01004256",2001,238,38,200,294502
"73389","S01004257",2001,218,6,212,294502
"73390","S01004258",2001,273,2,271,294502
"73391","S01004259",2001,214,27,187,294502
"73392","S01004260",2001,231,16,215,294502
"73393","S01004261",2001,332,159,173,294502
"73394","S01004262",2001,290,34,256,294502
"73395","S01004263",2001,336,163,173,294502
"73396","S01004264",2001,331,120,211,294502
"73397","S01004265",2001,340,98,242,294502
"73398","S01004266",2001,282,126,156,294502
"73399","S01004267",2001,217,0,0,294502
"73400","S01004268",2001,254,73,181,294502
"73401","S01004269",2001,353,64,289,294502
"73402","S01004270",2001,318,121,197,294502
"73403","S01004271",2001,304,106,198,294502
"73404","S01004272",2001,249,2,247,294502
"73405","S01004273",2001,290,7,283,294502
"73406","S01004274",2001,337,25,312,294502
"73407","S01004275",2001,252,78,174,294502
"73408","S01004276",2001,339,76,263,294502
"73409","S01004277",2001,298,27,271,294502
"73410","S01004278",2001,412,82,330,294502
"73411","S01004279",2001,360,209,151,294502
"73412","S01004280",2001,447,111,336,294502
"73413","S01004281",2001,230,56,174,294502
"73414","S01004282",2001,399,210,189,294502
"73415","S01004283",2001,310,132,178,294502
"73416","S01004284",2001,409,183,226,294502
"73417","S01004285",2001,299,63,236,294502
"73418","S01004286",2001,259,56,203,294502
"73419","S01004287",2001,275,26,249,294502
"73420","S01004288",2001,268,31,237,294502
"73421","S01004289",2001,213,96,117,294502
"73422","S01004290",2001,269,23,246,294502
"73423","S01004291",2001,356,33,323,294502
"73424","S01004292",2001,250,55,195,294502
"73425","S01004293",2001,375,34,341,294502
"73426","S01004294",2001,388,7,381,294502
"73427","S01004295",2001,360,72,288,294502
"73428","S01004296",2001,405,36,369,294502
"73429","S01004297",2001,404,85,319,294502
"73430","S01004298",2001,397,10,387,294502
"73431","S01004299",2001,332,109,223,294502
"73432","S01004300",2001,315,127,188,294502
"73433","S01004301",2001,264,3,261,294502
"73434","S01004302",2001,315,5,310,294502
"73435","S01004303",2001,232,121,111,294502
"73436","S01004304",2001,430,191,239,294502
"73437","S01004305",2001,294,71,223,294502
"73438","S01004306",2001,292,106,186,294502
"73439","S01004307",2001,314,39,275,294502
"73440","S01004308",2001,413,136,277,294502
"73441","S01004309",2001,274,14,260,294502
"73442","S01004310",2001,338,84,254,294502
"73443","S01004311",2001,332,115,217,294502
"73444","S01004312",2001,336,39,297,294502
"73445","S01004313",2001,372,28,344,294502
"73446","S01004314",2001,337,88,249,294502
"73447","S01004315",2001,195,69,126,294502
"73448","S01004316",2001,147,26,121,294502
"73449","S01004317",2001,362,18,344,294502
"73450","S01004318",2001,270,144,126,294502
"73451","S01004319",2001,348,26,322,294502
"73452","S01004320",2001,350,132,218,294502
"73453","S01004321",2001,336,224,112,294502
"73454","S01004322",2001,429,74,355,294502
"73455","S01004323",2001,307,118,189,294502
"73456","S01004324",2001,364,205,159,294502
"73457","S01004325",2001,439,18,421,294502
"73458","S01004326",2001,337,34,303,294502
"73459","S01004327",2001,290,15,275,294502
"73460","S01004328",2001,279,56,223,294502
"73461","S01004329",2001,233,40,193,294502
"73462","S01004330",2001,391,56,335,294502
"73463","S01004331",2001,268,66,202,294502
"73464","S01004332",2001,240,48,192,294502
"73465","S01004333",2001,216,56,160,294502
"73466","S01004334",2001,324,9,315,294502
"73467","S01004335",2001,222,68,154,294502
"73468","S01004336",2001,407,43,364,294502
"73469","S01004337",2001,307,90,217,294502
"73470","S01004338",2001,273,54,219,294502
"73471","S01004339",2001,358,4,354,294502
"73472","S01004340",2001,218,116,102,294502
"73473","S01004341",2001,223,99,124,294502
"73474","S01004342",2001,279,22,257,294502
"73475","S01004343",2001,206,89,117,294502
"73476","S01004344",2001,364,70,294,294502
"73477","S01004345",2001,393,87,306,294502
"73478","S01004346",2001,190,54,136,294502
"73479","S01004347",2001,330,7,323,294502
"73480","S01004348",2001,268,9,259,294502
"73481","S01004349",2001,353,32,321,294502
"73482","S01004350",2001,257,12,245,294502
"73483","S01004351",2001,245,72,173,294502
"73484","S01004352",2001,287,9,278,294502
"73485","S01004353",2001,414,61,353,294502
"73486","S01004354",2001,219,30,189,294502
"73487","S01004355",2001,207,40,167,294502
"73488","S01004356",2001,436,155,281,294502
"73489","S01004357",2001,278,1,277,294502
"73490","S01004358",2001,290,19,271,294502
"73491","S01004359",2001,217,99,118,294502
"73492","S01004360",2001,297,143,154,294502
"73493","S01004361",2001,255,40,215,294502
"73494","S01004362",2001,281,158,123,294502
"73495","S01004363",2001,486,377,109,294502
"73496","S01004364",2001,392,269,123,294502
"73497","S01004365",2001,294,133,161,294502
"73498","S01004366",2001,263,117,146,294502
"73499","S01004367",2001,316,116,200,294502
"73500","S01004368",2001,309,133,176,294502
"73501","S01004369",2001,294,94,200,294502
"73502","S01004370",2001,295,14,281,294502
"73503","S01004371",2001,300,136,164,294502
"73504","S01004372",2001,407,21,386,294502
"73505","S01004373",2001,264,179,85,294502
"73506","S01004374",2001,347,104,243,294502
"73507","S01004375",2001,272,130,142,294502
"73508","S01004376",2001,365,161,204,294502
"73509","S01004377",2001,385,94,291,294502
"73510","S01004378",2001,444,132,312,294502
"73511","S01004379",2001,409,212,197,294502
"73512","S01004380",2001,299,169,130,294502
"73513","S01004381",2001,328,131,197,294502
"73514","S01004382",2001,341,149,192,294502
"73515","S01004383",2001,365,116,249,294502
"73516","S01004384",2001,310,144,166,294502
"73517","S01004385",2001,360,68,292,294502
"73518","S01004386",2001,378,59,319,294502
"73519","S01004387",2001,455,150,305,294502
"73520","S01004388",2001,378,277,101,294502
"73521","S01004389",2001,268,61,207,294502
"73522","S01004390",2001,346,179,167,294502
"73523","S01004391",2001,237,12,225,294502
"73524","S01004392",2001,387,136,251,294502
"73525","S01004393",2001,435,178,257,294502
"73526","S01004394",2001,389,181,208,294502
"73527","S01004395",2001,234,135,99,294502
"73528","S01004396",2001,333,165,168,294502
"73529","S01004397",2001,344,15,329,294502
"73530","S01004398",2001,361,95,266,294502
"73531","S01004399",2001,248,105,143,294502
"73532","S01004400",2001,212,109,103,294502
"73533","S01004401",2001,368,71,297,294502
"73534","S01004402",2001,351,109,242,294502
"73535","S01004403",2001,193,17,176,294502
"73536","S01004404",2001,233,25,208,294502
"73537","S01004405",2001,296,121,175,294502
"73538","S01004406",2001,370,215,155,294502
"73539","S01004407",2001,280,129,151,294502
"73540","S01004408",2001,224,10,214,294502
"73541","S01004409",2001,284,29,255,294502
"73542","S01004410",2001,372,162,210,294502
"73543","S01004411",2001,288,91,197,294502
"73544","S01004412",2001,468,94,374,294502
"73545","S01004413",2001,424,176,248,294502
"73546","S01004414",2001,449,151,298,294502
"73547","S01004415",2001,316,146,170,294502
"73548","S01004416",2001,330,70,260,294502
"73549","S01004417",2001,356,179,177,294502
"73550","S01004418",2001,387,129,258,294502
"73551","S01004419",2001,349,116,233,294502
"73552","S01004420",2001,342,33,309,294502
"73553","S01004421",2001,430,266,164,294502
"73554","S01004422",2001,306,126,180,294502
"73555","S01004423",2001,375,117,258,294502
"73556","S01004424",2001,318,202,116,294502
"73557","S01004425",2001,227,30,197,294502
"73558","S01004426",2001,259,63,196,294502
"73559","S01004427",2001,373,204,169,294502
"73560","S01004428",2001,335,132,203,294502
"73561","S01004429",2001,318,194,124,294502
"73562","S01004430",2001,207,63,144,294502
"73563","S01004431",2001,420,200,220,294502
"73564","S01004432",2001,382,163,219,294502
"73565","S01004433",2001,369,132,237,294502
"73566","S01004434",2001,380,161,219,294502
"73567","S01004435",2001,285,49,236,294502
"73568","S01004436",2001,327,131,196,294502
"73569","S01004437",2001,340,151,189,294502
"73570","S01004438",2001,276,143,133,294502
"73571","S01004439",2001,256,138,118,294502
"73572","S01004440",2001,328,191,137,294502
"73573","S01004441",2001,307,3,304,294502
"73574","S01004442",2001,430,227,203,294502
"73575","S01004443",2001,265,166,99,294502
"73576","S01004444",2001,377,219,158,294502
"73577","S01004445",2001,276,136,140,294502
"73578","S01004446",2001,335,143,192,294502
"73579","S01004447",2001,302,137,165,294502
"73580","S01004448",2001,239,2,237,294502
"73581","S01004449",2001,390,193,197,294502
"73582","S01004450",2001,520,248,272,294502
"73583","S01004451",2001,388,263,125,294502
"73584","S01004452",2001,301,21,280,294502
"73585","S01004453",2001,360,2,358,294502
"73586","S01004454",2001,416,139,277,294502
"73587","S01004455",2001,334,20,314,294502
"73588","S01004456",2001,231,4,227,294502
"73589","S01004457",2001,381,187,194,294502
"73590","S01004458",2001,348,204,144,294502
"73591","S01004459",2001,276,85,191,294502
"73592","S01004460",2001,226,4,222,294502
"73593","S01004461",2001,232,41,191,294502
"73594","S01004462",2001,225,2,223,294502
"73595","S01004463",2001,299,48,251,294502
"73596","S01004464",2001,313,162,151,294502
"73597","S01004465",2001,298,12,286,294502
"73598","S01004466",2001,395,64,331,294502
"73599","S01004467",2001,395,235,160,294502
"73600","S01004468",2001,293,57,236,294502
"73601","S01004469",2001,225,116,109,294502
"73602","S01004470",2001,193,2,191,294502
"73603","S01004471",2001,216,2,214,294502
"73604","S01004472",2001,304,3,301,294502
"73605","S01004473",2001,422,2,420,294502
"73606","S01004474",2001,440,228,212,294502
"73607","S01004475",2001,186,4,182,294502
"73608","S01004476",2001,356,35,321,294502
"73609","S01004477",2001,376,39,337,294502
"73610","S01004478",2001,273,91,182,294502
"73611","S01004479",2001,259,1,258,294502
"73612","S01004480",2001,420,234,186,294502
"73613","S01004481",2001,255,143,112,294502
"73614","S01004482",2001,523,226,297,294502
"73615","S01004483",2001,254,125,129,294502
"73616","S01004484",2001,399,13,386,294502
"73617","S01004485",2001,217,4,213,294502
"73618","S01004486",2001,357,30,327,294502
"73619","S01004487",2001,514,134,380,294502
"73620","S01004488",2001,321,124,197,294502
"73621","S01004489",2001,320,4,316,294502
"73622","S01004490",2001,275,10,265,294502
"73623","S01004491",2001,350,244,106,294502
"73624","S01004492",2001,429,223,206,294502
"73625","S01004493",2001,429,143,286,294502
"73626","S01004494",2001,394,245,149,294502
"73627","S01004495",2001,341,193,148,294502
"73628","S01004496",2001,300,85,215,294502
"73629","S01004497",2001,434,202,232,294502
"73630","S01004498",2001,286,49,237,294502
"73631","S01004499",2001,281,117,164,294502
"73632","S01004500",2001,320,6,314,294502
"73633","S01004501",2001,278,77,201,294502
"73634","S01004502",2001,299,63,236,294502
"73635","S01004503",2001,416,51,365,294502
"73636","S01004504",2001,283,177,106,294502
"73637","S01004505",2001,216,105,111,294502
"73638","S01004506",2001,210,93,117,294502
"73639","S01004507",2001,345,65,280,294502
"73640","S01004508",2001,339,46,293,294502
"73641","S01004509",2001,268,4,264,294502
"73642","S01004510",2001,384,5,379,294502
"73643","S01004511",2001,461,4,457,294502
"73644","S01004512",2001,409,3,406,294502
"73645","S01004513",2001,298,35,263,294502
"73646","S01004514",2001,234,26,208,294502
"73647","S01004515",2001,609,48,561,294502
"73648","S01004516",2001,233,48,185,294502
"73649","S01004517",2001,481,80,401,294502
"73650","S01004518",2001,259,68,191,294502
"73651","S01004519",2001,353,114,239,294502
"73652","S01004520",2001,384,35,349,294502
"73653","S01004521",2001,328,11,317,294502
"73654","S01004522",2001,247,3,244,294502
"73655","S01004523",2001,377,2,375,294502
"73656","S01004524",2001,285,2,283,294502
"73657","S01004525",2001,312,8,304,294502
"73658","S01004526",2001,271,2,269,294502
"73659","S01004527",2001,249,71,178,294502
"73660","S01004528",2001,365,136,229,294502
"73661","S01004529",2001,348,92,256,294502
"73662","S01004530",2001,185,1,184,294502
"73663","S01004531",2001,322,100,222,294502
"73664","S01004532",2001,333,263,70,294502
"73665","S01004533",2001,392,345,47,294502
"73666","S01004534",2001,258,137,121,294502
"73667","S01004535",2001,312,63,249,294502
"73668","S01004536",2001,288,171,117,294502
"73669","S01004537",2001,340,184,156,294502
"73670","S01004538",2001,311,122,189,294502
"73671","S01004539",2001,321,153,168,294502
"73672","S01004540",2001,366,143,223,294502
"73673","S01004541",2001,356,155,201,294502
"73674","S01004542",2001,209,20,189,294502
"73675","S01004543",2001,354,152,202,294502
"73676","S01004544",2001,482,216,266,294502
"73677","S01004545",2001,386,158,228,294502
"73678","S01004546",2001,397,240,157,294502
"73679","S01004547",2001,471,322,149,294502
"73680","S01004548",2001,354,141,213,294502
"73681","S01004549",2001,367,139,228,294502
"73682","S01004550",2001,418,368,50,294502
"73683","S01004551",2001,388,81,307,294502
"73684","S01004552",2001,339,224,115,294502
"73685","S01004553",2001,210,66,144,294502
"73686","S01004554",2001,280,123,157,294502
"73687","S01004555",2001,290,82,208,294502
"73688","S01004556",2001,331,251,80,294502
"73689","S01004557",2001,210,35,175,294502
"73690","S01004558",2001,461,201,260,294502
"73691","S01004559",2001,497,109,388,294502
"73692","S01004560",2001,210,152,58,294502
"73693","S01004561",2001,449,263,186,294502
"73694","S01004562",2001,237,88,149,294502
"73695","S01004563",2001,374,104,270,294502
"73696","S01004564",2001,239,20,219,294502
"73697","S01004565",2001,257,3,254,294502
"73698","S01004566",2001,272,36,236,294502
"73699","S01004567",2001,309,264,45,294502
"73700","S01004568",2001,282,78,204,294502
"73701","S01004569",2001,305,230,75,294502
"73702","S01004570",2001,237,2,235,294502
"73703","S01004571",2001,285,74,211,294502
"73704","S01004572",2001,325,136,189,294502
"73705","S01004573",2001,262,80,182,294502
"73706","S01004574",2001,200,3,197,294502
"73707","S01004575",2001,355,129,226,294502
"73708","S01004576",2001,226,2,224,294502
"73709","S01004577",2001,265,47,218,294502
"73710","S01004578",2001,330,3,327,294502
"73711","S01004579",2001,366,301,65,294502
"73712","S01004580",2001,370,168,202,294502
"73713","S01004581",2001,483,189,294,294502
"73714","S01004582",2001,263,23,240,294502
"73715","S01004583",2001,562,396,166,294502
"73716","S01004584",2001,283,154,129,294502
"73717","S01004585",2001,273,159,114,294502
"73718","S01004586",2001,451,19,432,294502
"73719","S01004587",2001,527,366,161,294502
"73720","S01004588",2001,304,102,202,294502
"73721","S01004589",2001,334,8,326,294502
"73722","S01004590",2001,354,239,115,294502
"73723","S01004591",2001,254,110,144,294502
"73724","S01004592",2001,233,120,113,294502
"73725","S01004593",2001,342,95,247,294502
"73726","S01004594",2001,295,178,117,294502
"73727","S01004595",2001,378,5,373,294502
"73728","S01004596",2001,452,303,149,294502
"73729","S01004597",2001,221,3,218,294502
"73730","S01004598",2001,289,124,165,294502
"73731","S01004599",2001,184,4,180,294502
"73732","S01004600",2001,375,221,154,294502
"73733","S01004601",2001,375,189,186,294502
"73734","S01004602",2001,354,5,349,294502
"73735","S01004603",2001,500,339,161,294502
"73736","S01004604",2001,260,111,149,294502
"73737","S01004605",2001,372,219,153,294502
"73738","S01004606",2001,334,142,192,294502
"73739","S01004607",2001,279,123,156,294502
"73740","S01004608",2001,280,144,136,294502
"73741","S01004609",2001,230,146,84,294502
"73742","S01004610",2001,283,149,134,294502
"73743","S01004611",2001,495,261,234,294502
"73744","S01004612",2001,265,138,127,294502
"73745","S01004613",2001,294,58,236,294502
"73746","S01004614",2001,368,93,275,294502
"73747","S01004615",2001,403,189,214,294502
"73748","S01004616",2001,303,103,200,294502
"73749","S01004617",2001,255,173,82,294502
"73750","S01004618",2001,285,209,76,294502
"73751","S01004619",2001,387,248,139,294502
"73752","S01004620",2001,398,148,250,294502
"73753","S01004621",2001,355,74,281,294502
"73754","S01004622",2001,351,125,226,294502
"73755","S01004623",2001,471,179,292,294502
"73756","S01004624",2001,500,275,225,294502
"73757","S01004625",2001,337,188,149,294502
"73758","S01004626",2001,262,136,126,294502
"73759","S01004627",2001,282,16,266,294502
"73760","S01004628",2001,245,178,67,294502
"73761","S01004629",2001,364,3,361,294502
"73762","S01004630",2001,399,105,294,294502
"73763","S01004631",2001,354,193,161,294502
"73764","S01004632",2001,317,185,132,294502
"73765","S01004633",2001,251,66,185,294502
"73766","S01004634",2001,350,46,304,294502
"73767","S01004635",2001,341,209,132,294502
"73768","S01004636",2001,337,202,135,294502
"73769","S01004637",2001,230,80,150,294502
"73770","S01004638",2001,260,147,113,294502
"73771","S01004639",2001,305,168,137,294502
"73772","S01004640",2001,329,165,164,294502
"73773","S01004641",2001,245,54,191,294502
"73774","S01004642",2001,360,203,157,294502
"73775","S01004643",2001,210,144,66,294502
"73776","S01004644",2001,297,73,224,294502
"73777","S01004645",2001,483,349,134,294502
"73778","S01004646",2001,314,175,139,294502
"73779","S01004647",2001,397,94,303,294502
"73780","S01004648",2001,405,208,197,294502
"73781","S01004649",2001,276,126,150,294502
"73782","S01004650",2001,355,199,156,294502
"73783","S01004651",2001,362,222,140,294502
"73784","S01004652",2001,419,127,292,294502
"73785","S01004653",2001,284,120,164,294502
"73786","S01004654",2001,311,37,274,294502
"73787","S01004655",2001,424,179,245,294502
"73788","S01004656",2001,248,156,92,294502
"73789","S01004657",2001,297,32,265,294502
"73790","S01004658",2001,390,71,319,294502
"73791","S01004659",2001,226,70,156,294502
"73792","S01004660",2001,259,12,247,294502
"73793","S01004661",2001,335,126,209,294502
"73794","S01004662",2001,397,172,225,294502
"73795","S01004663",2001,221,68,153,294502
"73796","S01004664",2001,289,104,185,294502
"73797","S01004665",2001,327,224,103,294502
"73798","S01004666",2001,307,141,166,294502
"73799","S01004667",2001,289,124,165,294502
"73800","S01004668",2001,371,49,322,294502
"73801","S01004669",2001,357,162,195,294502
"73802","S01004670",2001,446,174,272,294502
"73803","S01004671",2001,379,84,295,294502
"73804","S01004672",2001,251,92,159,294502
"73805","S01004673",2001,367,247,120,294502
"73806","S01004674",2001,346,166,180,294502
"73807","S01004675",2001,343,75,268,294502
"73808","S01004676",2001,361,152,209,294502
"73809","S01004677",2001,379,184,195,294502
"73810","S01004678",2001,249,79,170,294502
"73811","S01004679",2001,240,89,151,294502
"73812","S01004680",2001,418,295,123,294502
"73813","S01004681",2001,291,8,283,294502
"73814","S01004682",2001,302,203,99,294502
"73815","S01004683",2001,260,0,0,294502
"73816","S01004684",2001,333,94,239,294502
"73817","S01004685",2001,261,171,90,294502
"73818","S01004686",2001,303,169,134,294502
"73819","S01004687",2001,309,141,168,294502
"73820","S01004688",2001,264,2,262,294502
"73821","S01004689",2001,368,128,240,294502
"73822","S01004690",2001,246,4,242,294502
"73823","S01004691",2001,271,3,268,294502
"73824","S01004692",2001,295,176,119,294502
"73825","S01004693",2001,290,44,246,294502
"73826","S01004694",2001,251,106,145,294502
"73827","S01004695",2001,233,0,0,294502
"73828","S01004696",2001,347,225,122,294502
"73829","S01004697",2001,320,37,283,294502
"73830","S01004698",2001,215,4,211,294502
"73831","S01004699",2001,326,228,98,294502
"73832","S01004700",2001,332,83,249,294502
"73833","S01004701",2001,224,3,221,294502
"73834","S01004702",2001,235,38,197,294502
"73835","S01004703",2001,305,24,281,294502
"73836","S01004704",2001,244,119,125,294502
"73837","S01004705",2001,342,30,312,294502
"73838","S01004706",2001,195,2,193,294502
"73839","S01004707",2001,376,187,189,294502
"73840","S01004708",2001,277,127,150,294502
"73841","S01004709",2001,262,12,250,294502
"73842","S01004710",2001,413,203,210,294502
"73843","S01004711",2001,315,188,127,294502
"73844","S01004712",2001,225,113,112,294502
"73845","S01004713",2001,294,137,157,294502
"73846","S01004714",2001,305,94,211,294502
"73847","S01004715",2001,361,168,193,294502
"73848","S01004716",2001,381,133,248,294502
"73849","S01004717",2001,278,141,137,294502
"73850","S01004718",2001,408,180,228,294502
"73851","S01004719",2001,311,105,206,294502
"73852","S01004720",2001,282,153,129,294502
"73853","S01004721",2001,219,0,0,294502
"73854","S01004722",2001,289,150,139,294502
"73855","S01004723",2001,219,34,185,294502
"73856","S01004724",2001,441,205,236,294502
"73857","S01004725",2001,240,64,176,294502
"73858","S01004726",2001,226,123,103,294502
"73859","S01004727",2001,455,252,203,294502
"73860","S01004728",2001,237,8,229,294502
"73861","S01004729",2001,256,113,143,294502
"73862","S01004730",2001,447,260,187,294502
"73863","S01004731",2001,315,127,188,294502
"73864","S01004732",2001,233,16,217,294502
"73865","S01004733",2001,335,138,197,294502
"73866","S01004734",2001,251,135,116,294502
"73867","S01004735",2001,385,131,254,294502
"73868","S01004736",2001,301,147,154,294502
"73869","S01004737",2001,298,135,163,294502
"73870","S01004738",2001,389,222,167,294502
"73871","S01004739",2001,268,4,264,294502
"73872","S01004740",2001,247,22,225,294502
"73873","S01004741",2001,266,139,127,294502
"73874","S01004742",2001,383,135,248,294502
"73875","S01004743",2001,325,0,0,294502
"73876","S01004744",2001,240,132,108,294502
"73877","S01004745",2001,359,289,70,294502
"73878","S01004746",2001,293,151,142,294502
"73879","S01004747",2001,262,3,259,294502
"73880","S01004748",2001,261,111,150,294502
"73881","S01004749",2001,340,122,218,294502
"73882","S01004750",2001,294,171,123,294502
"73883","S01004751",2001,366,264,102,294502
"73884","S01004752",2001,294,142,152,294502
"73885","S01004753",2001,325,163,162,294502
"73886","S01004754",2001,285,88,197,294502
"73887","S01004755",2001,319,142,177,294502
"73888","S01004756",2001,262,67,195,294502
"73889","S01004757",2001,342,173,169,294502
"73890","S01004758",2001,372,154,218,294502
"73891","S01004759",2001,225,27,198,294502
"73892","S01004760",2001,285,150,135,294502
"73893","S01004761",2001,223,106,117,294502
"73894","S01004762",2001,286,130,156,294502
"73895","S01004763",2001,305,3,302,294502
"73896","S01004764",2001,318,198,120,294502
"73897","S01004765",2001,480,289,191,294502
"73898","S01004766",2001,330,182,148,294502
"73899","S01004767",2001,261,115,146,294502
"73900","S01004768",2001,372,257,115,294502
"73901","S01004769",2001,230,89,141,294502
"73902","S01004770",2001,337,159,178,294502
"73903","S01004771",2001,397,101,296,294502
"73904","S01004772",2001,283,88,195,294502
"73905","S01004773",2001,317,187,130,294502
"73906","S01004774",2001,354,9,345,294502
"73907","S01004775",2001,555,460,95,294502
"73908","S01004776",2001,328,77,251,294502
"73909","S01004777",2001,235,8,227,294502
"73910","S01004778",2001,296,127,169,294502
"73911","S01004779",2001,334,117,217,294502
"73912","S01004780",2001,213,86,127,294502
"73913","S01004781",2001,354,89,265,294502
"73914","S01004782",2001,335,139,196,294502
"73915","S01004783",2001,367,12,355,294502
"73916","S01004784",2001,312,91,221,294502
"73917","S01004785",2001,236,96,140,294502
"73918","S01004786",2001,268,64,204,294502
"73919","S01004787",2001,449,73,376,294502
"73920","S01004788",2001,259,29,230,294502
"73921","S01004789",2001,506,202,304,294502
"73922","S01004790",2001,262,6,256,294502
"73923","S01004791",2001,270,4,266,294502
"73924","S01004792",2001,310,8,302,294502
"73925","S01004793",2001,378,48,330,294502
"73926","S01004794",2001,314,139,175,294502
"73927","S01004795",2001,336,150,186,294502
"73928","S01004796",2001,312,40,272,294502
"73929","S01004797",2001,318,136,182,294502
"73930","S01004798",2001,420,256,164,294502
"73931","S01004799",2001,238,107,131,294502
"73932","S01004800",2001,312,158,154,294502
"73933","S01004801",2001,315,114,201,294502
"73934","S01004802",2001,370,95,275,294502
"73935","S01004803",2001,382,211,171,294502
"73936","S01004804",2001,442,262,180,294502
"73937","S01004805",2001,283,188,95,294502
"73938","S01004806",2001,237,82,155,294502
"73939","S01004807",2001,267,158,109,294502
"73940","S01004808",2001,328,220,108,294502
"73941","S01004809",2001,218,62,156,294502
"73942","S01004810",2001,237,136,101,294502
"73943","S01004811",2001,269,113,156,294502
"73944","S01004812",2001,339,213,126,294502
"73945","S01004813",2001,330,83,247,294502
"73946","S01004814",2001,363,155,208,294502
"73947","S01004815",2001,284,81,203,294502
"73948","S01004816",2001,304,130,174,294502
"73949","S01004817",2001,311,171,140,294502
"73950","S01004818",2001,324,148,176,294502
"73951","S01004819",2001,217,98,119,294502
"73952","S01004820",2001,391,221,170,294502
"73953","S01004821",2001,363,126,237,294502
"73954","S01004822",2001,280,143,137,294502
"73955","S01004823",2001,322,157,165,294502
"73956","S01004824",2001,301,27,274,294502
"73957","S01004825",2001,261,161,100,294502
"73958","S01004826",2001,352,259,93,294502
"73959","S01004827",2001,287,146,141,294502
"73960","S01004828",2001,393,61,332,294502
"73961","S01004829",2001,308,182,126,294502
"73962","S01004830",2001,333,198,135,294502
"73963","S01004831",2001,326,14,312,294502
"73964","S01004832",2001,293,74,219,294502
"73965","S01004833",2001,385,115,270,294502
"73966","S01004834",2001,361,95,266,294502
"73967","S01004835",2001,274,63,211,294502
"73968","S01004836",2001,259,1,258,294502
"73969","S01004837",2001,270,106,164,294502
"73970","S01004838",2001,367,82,285,294502
"73971","S01004839",2001,379,163,216,294502
"73972","S01004840",2001,259,107,152,294502
"73973","S01004841",2001,345,170,175,294502
"73974","S01004842",2001,205,19,186,294502
"73975","S01004843",2001,275,133,142,294502
"73976","S01004844",2001,387,67,320,294502
"73977","S01004845",2001,342,124,218,294502
"73978","S01004846",2001,281,92,189,294502
"73979","S01004847",2001,346,8,338,294502
"73980","S01004848",2001,251,13,238,294502
"73981","S01004849",2001,298,104,194,294502
"73982","S01004850",2001,323,58,265,294502
"73983","S01004851",2001,246,146,100,294502
"73984","S01004852",2001,331,215,116,294502
"73985","S01004853",2001,338,99,239,294502
"73986","S01004854",2001,420,87,333,294502
"73987","S01004855",2001,299,177,122,294502
"73988","S01004856",2001,296,84,212,294502
"73989","S01004857",2001,354,86,268,294502
"73990","S01004858",2001,368,62,306,294502
"73991","S01004859",2001,345,19,326,294502
"73992","S01004860",2001,192,12,180,294502
"73993","S01004861",2001,303,3,300,294502
"73994","S01004862",2001,219,1,218,294502
"73995","S01004863",2001,421,38,383,294502
"73996","S01004864",2001,207,1,206,294502
"73997","S01004865",2001,314,57,257,294502
"73998","S01004866",2001,347,62,285,294502
"73999","S01004867",2001,285,7,278,294502
"74000","S01004868",2001,311,133,178,294502
"74001","S01004869",2001,294,1,293,294502
"74002","S01004870",2001,344,55,289,294502
"74003","S01004871",2001,316,36,280,294502
"74004","S01004872",2001,349,84,265,294502
"74005","S01004873",2001,326,63,263,294502
"74006","S01004874",2001,361,93,268,294502
"74007","S01004875",2001,300,37,263,294502
"74008","S01004876",2001,388,89,299,294502
"74009","S01004877",2001,300,65,235,294502
"74010","S01004878",2001,340,54,286,294502
"74011","S01004879",2001,288,67,221,294502
"74012","S01004880",2001,285,103,182,294502
"74013","S01004881",2001,330,88,242,294502
"74014","S01004882",2001,220,46,174,294502
"74015","S01004883",2001,280,64,216,294502
"74016","S01004884",2001,205,0,0,294502
"74017","S01004885",2001,212,58,154,294502
"74018","S01004886",2001,346,82,264,294502
"74019","S01004887",2001,162,20,142,294502
"74020","S01004888",2001,218,0,0,294502
"74021","S01004889",2001,360,142,218,294502
"74022","S01004890",2001,334,97,237,294502
"74023","S01004891",2001,386,124,262,294502
"74024","S01004892",2001,263,1,262,294502
"74025","S01004893",2001,396,135,261,294502
"74026","S01004894",2001,416,126,290,294502
"74027","S01004895",2001,382,104,278,294502
"74028","S01004896",2001,381,97,284,294502
"74029","S01004897",2001,207,1,206,294502
"74030","S01004898",2001,441,107,334,294502
"74031","S01004899",2001,306,54,252,294502
"74032","S01004900",2001,240,1,239,294502
"74033","S01004901",2001,383,128,255,294502
"74034","S01004902",2001,370,93,277,294502
"74035","S01004903",2001,210,1,209,294502
"74036","S01004904",2001,520,141,379,294502
"74037","S01004905",2001,439,93,346,294502
"74038","S01004906",2001,384,55,329,294502
"74039","S01004907",2001,301,4,297,294502
"74040","S01004908",2001,254,48,206,294502
"74041","S01004909",2001,435,24,411,294502
"74042","S01004910",2001,336,57,279,294502
"74043","S01004911",2001,254,3,251,294502
"74044","S01004912",2001,304,82,222,294502
"74045","S01004913",2001,282,119,163,294502
"74046","S01004914",2001,269,36,233,294502
"74047","S01004915",2001,260,93,167,294502
"74048","S01004916",2001,335,103,232,294502
"74049","S01004917",2001,187,1,186,294502
"74050","S01004918",2001,252,21,231,294502
"74051","S01004919",2001,202,65,137,294502
"74052","S01004920",2001,413,87,326,294502
"74053","S01004921",2001,317,76,241,294502
"74054","S01004922",2001,227,1,226,294502
"74055","S01004923",2001,311,101,210,294502
"74056","S01004924",2001,346,86,260,294502
"74057","S01004925",2001,255,79,176,294502
"74058","S01004926",2001,308,2,306,294502
"74059","S01004927",2001,339,3,336,294502
"74060","S01004928",2001,236,1,235,294502
"74061","S01004929",2001,243,17,226,294502
"74062","S01004930",2001,289,135,154,294502
"74063","S01004931",2001,425,223,202,294502
"74064","S01004932",2001,348,183,165,294502
"74065","S01004933",2001,326,144,182,294502
"74066","S01004934",2001,298,118,180,294502
"74067","S01004935",2001,241,2,239,294502
"74068","S01004936",2001,488,196,292,294502
"74069","S01004937",2001,246,141,105,294502
"74070","S01004938",2001,356,171,185,294502
"74071","S01004939",2001,239,103,136,294502
"74072","S01004940",2001,217,79,138,294502
"74073","S01004941",2001,252,115,137,294502
"74074","S01004942",2001,361,69,292,294502
"74075","S01004943",2001,322,108,214,294502
"74076","S01004944",2001,205,43,162,294502
"74077","S01004945",2001,269,50,219,294502
"74078","S01004946",2001,245,9,236,294502
"74079","S01004947",2001,256,17,239,294502
"74080","S01004948",2001,284,38,246,294502
"74081","S01004949",2001,241,9,232,294502
"74082","S01004950",2001,189,1,188,294502
"74083","S01004951",2001,315,102,213,294502
"74084","S01004952",2001,386,31,355,294502
"74085","S01004953",2001,423,114,309,294502
"74086","S01004954",2001,313,131,182,294502
"74087","S01004955",2001,279,83,196,294502
"74088","S01004956",2001,306,48,258,294502
"74089","S01004957",2001,264,1,263,294502
"74090","S01004958",2001,401,116,285,294502
"74091","S01004959",2001,375,91,284,294502
"74092","S01004960",2001,253,46,207,294502
"74093","S01004961",2001,300,60,240,294502
"74094","S01004962",2001,217,4,213,294502
"74095","S01004963",2001,251,37,214,294502
"74096","S01004964",2001,392,15,377,294502
"74097","S01004965",2001,344,30,314,294502
"74098","S01004966",2001,321,0,0,294502
"74099","S01004967",2001,260,10,250,294502
"74100","S01004968",2001,242,30,212,294502
"74101","S01004969",2001,390,21,369,294502
"74102","S01004970",2001,350,37,313,294502
"74103","S01004971",2001,426,48,378,294502
"74104","S01004972",2001,319,40,279,294502
"74105","S01004973",2001,336,8,328,294502
"74106","S01004974",2001,341,14,327,294502
"74107","S01004975",2001,302,8,294,294502
"74108","S01004976",2001,336,86,250,294502
"74109","S01004977",2001,458,175,283,294502
"74110","S01004978",2001,365,32,333,294502
"74111","S01004979",2001,343,2,341,294502
"74112","S01004980",2001,443,7,436,294502
"74113","S01004981",2001,382,23,359,294502
"74114","S01004982",2001,232,3,229,294502
"74115","S01004983",2001,386,76,310,294502
"74116","S01004984",2001,322,53,269,294502
"74117","S01004985",2001,295,47,248,294502
"74118","S01004986",2001,242,13,229,294502
"74119","S01004987",2001,201,1,200,294502
"74120","S01004988",2001,203,1,202,294502
"74121","S01004989",2001,261,5,256,294502
"74122","S01004990",2001,214,32,182,294502
"74123","S01004991",2001,241,31,210,294502
"74124","S01004992",2001,356,161,195,294502
"74125","S01004993",2001,307,2,305,294502
"74126","S01004994",2001,329,38,291,294502
"74127","S01004995",2001,429,107,322,294502
"74128","S01004996",2001,272,28,244,294502
"74129","S01004997",2001,348,19,329,294502
"74130","S01004998",2001,326,19,307,294502
"74131","S01004999",2001,364,63,301,294502
"74132","S01005000",2001,254,40,214,294502
"74133","S01005001",2001,379,28,351,294502
"74134","S01005002",2001,372,6,366,294502
"74135","S01005003",2001,353,32,321,294502
"74136","S01005004",2001,248,40,208,294502
"74137","S01005005",2001,434,132,302,294502
"74138","S01005006",2001,276,10,266,294502
"74139","S01005007",2001,407,142,265,294502
"74140","S01005008",2001,361,20,341,294502
"74141","S01005009",2001,276,38,238,294502
"74142","S01005010",2001,265,55,210,294502
"74143","S01005011",2001,262,173,89,294502
"74144","S01005012",2001,347,34,313,294502
"74145","S01005013",2001,284,86,198,294502
"74146","S01005014",2001,333,117,216,294502
"74147","S01005015",2001,281,56,225,294502
"74148","S01005016",2001,382,49,333,294502
"74149","S01005017",2001,306,3,303,294502
"74150","S01005018",2001,232,54,178,294502
"74151","S01005019",2001,381,158,223,294502
"74152","S01005020",2001,326,40,286,294502
"74153","S01005021",2001,359,17,342,294502
"74154","S01005022",2001,282,34,248,294502
"74155","S01005023",2001,265,7,258,294502
"74156","S01005024",2001,420,69,351,294502
"74157","S01005025",2001,286,42,244,294502
"74158","S01005026",2001,258,1,257,294502
"74159","S01005027",2001,287,5,282,294502
"74160","S01005028",2001,264,8,256,294502
"74161","S01005029",2001,480,0,0,294502
"74162","S01005030",2001,424,38,386,294502
"74163","S01005031",2001,382,66,316,294502
"74164","S01005032",2001,427,53,374,294502
"74165","S01005033",2001,267,2,265,294502
"74166","S01005034",2001,351,5,346,294502
"74167","S01005035",2001,404,32,372,294502
"74168","S01005036",2001,214,1,213,294502
"74169","S01005037",2001,605,171,434,294502
"74170","S01005038",2001,338,3,335,294502
"74171","S01005039",2001,458,15,443,294502
"74172","S01005040",2001,650,202,448,294502
"74173","S01005041",2001,365,49,316,294502
"74174","S01005042",2001,347,2,345,294502
"74175","S01005043",2001,373,142,231,294502
"74176","S01005044",2001,490,80,410,294502
"74177","S01005045",2001,341,5,336,294502
"74178","S01005046",2001,419,58,361,294502
"74179","S01005047",2001,641,184,457,294502
"74180","S01005048",2001,227,1,226,294502
"74181","S01005049",2001,482,125,357,294502
"74182","S01005050",2001,455,273,182,294502
"74183","S01005051",2001,374,2,372,294502
"74184","S01005052",2001,272,3,269,294502
"74185","S01005053",2001,365,224,141,294502
"74186","S01005054",2001,230,126,104,294502
"74187","S01005055",2001,324,133,191,294502
"74188","S01005056",2001,376,45,331,294502
"74189","S01005057",2001,357,210,147,294502
"74190","S01005058",2001,284,130,154,294502
"74191","S01005059",2001,231,79,152,294502
"74192","S01005060",2001,330,170,160,294502
"74193","S01005061",2001,500,113,387,294502
"74194","S01005062",2001,217,111,106,294502
"74195","S01005063",2001,208,1,207,294502
"74196","S01005064",2001,331,13,318,294502
"74197","S01005065",2001,428,83,345,294502
"74198","S01005066",2001,357,256,101,294502
"74199","S01005067",2001,201,1,200,294502
"74200","S01005068",2001,286,110,176,294502
"74201","S01005069",2001,289,146,143,294502
"74202","S01005070",2001,421,35,386,294502
"74203","S01005071",2001,255,209,46,294502
"74204","S01005072",2001,265,106,159,294502
"74205","S01005073",2001,352,3,349,294502
"74206","S01005074",2001,330,76,254,294502
"74207","S01005075",2001,175,143,32,294502
"74208","S01005076",2001,328,165,163,294502
"74209","S01005077",2001,272,2,270,294502
"74210","S01005078",2001,324,134,190,294502
"74211","S01005079",2001,294,123,171,294502
"74212","S01005080",2001,233,115,118,294502
"74213","S01005081",2001,288,107,181,294502
"74214","S01005082",2001,289,26,263,294502
"74215","S01005083",2001,462,111,351,294502
"74216","S01005084",2001,281,122,159,294502
"74217","S01005085",2001,239,43,196,294502
"74218","S01005086",2001,311,140,171,294502
"74219","S01005087",2001,223,89,134,294502
"74220","S01005088",2001,243,64,179,294502
"74221","S01005089",2001,351,94,257,294502
"74222","S01005090",2001,386,43,343,294502
"74223","S01005091",2001,302,3,299,294502
"74224","S01005092",2001,303,76,227,294502
"74225","S01005093",2001,347,124,223,294502
"74226","S01005094",2001,224,0,0,294502
"74227","S01005095",2001,406,41,365,294502
"74228","S01005096",2001,242,25,217,294502
"74229","S01005097",2001,310,24,286,294502
"74230","S01005098",2001,337,78,259,294502
"74231","S01005099",2001,372,56,316,294502
"74232","S01005100",2001,231,16,215,294502
"74233","S01005101",2001,376,49,327,294502
"74234","S01005102",2001,382,24,358,294502
"74235","S01005103",2001,370,22,348,294502
"74236","S01005104",2001,282,5,277,294502
"74237","S01005105",2001,370,96,274,294502
"74238","S01005106",2001,241,81,160,294502
"74239","S01005107",2001,229,16,213,294502
"74240","S01005108",2001,270,61,209,294502
"74241","S01005109",2001,375,5,370,294502
"74242","S01005110",2001,439,16,423,294502
"74243","S01005111",2001,219,15,204,294502
"74244","S01005112",2001,365,31,334,294502
"74245","S01005113",2001,441,97,344,294502
"74246","S01005114",2001,412,165,247,294502
"74247","S01005115",2001,400,65,335,294502
"74248","S01005116",2001,284,31,253,294502
"74249","S01005117",2001,284,27,257,294502
"74250","S01005118",2001,359,66,293,294502
"74251","S01005119",2001,282,1,281,294502
"74252","S01005120",2001,261,18,243,294502
"74253","S01005121",2001,344,8,336,294502
"74254","S01005122",2001,335,51,284,294502
"74255","S01005123",2001,355,6,349,294502
"74256","S01005124",2001,304,68,236,294502
"74257","S01005125",2001,434,137,297,294502
"74258","S01005126",2001,236,32,204,294502
"74259","S01005127",2001,281,162,119,294502
"74260","S01005128",2001,376,11,365,294502
"74261","S01005129",2001,334,119,215,294502
"74262","S01005130",2001,291,179,112,294502
"74263","S01005131",2001,375,87,288,294502
"74264","S01005132",2001,270,11,259,294502
"74265","S01005133",2001,198,12,186,294502
"74266","S01005134",2001,429,123,306,294502
"74267","S01005135",2001,338,45,293,294502
"74268","S01005136",2001,402,144,258,294502
"74269","S01005137",2001,388,11,377,294502
"74270","S01005138",2001,457,140,317,294502
"74271","S01005139",2001,279,50,229,294502
"74272","S01005140",2001,246,9,237,294502
"74273","S01005141",2001,407,44,363,294502
"74274","S01005142",2001,284,78,206,294502
"74275","S01005143",2001,457,115,342,294502
"74276","S01005144",2001,495,25,470,294502
"74277","S01005145",2001,353,36,317,294502
"74278","S01005146",2001,320,49,271,294502
"74279","S01005147",2001,384,19,365,294502
"74280","S01005148",2001,304,21,283,294502
"74281","S01005149",2001,278,77,201,294502
"74282","S01005150",2001,264,72,192,294502
"74283","S01005151",2001,279,98,181,294502
"74284","S01005152",2001,290,25,265,294502
"74285","S01005153",2001,318,32,286,294502
"74286","S01005154",2001,226,5,221,294502
"74287","S01005155",2001,287,72,215,294502
"74288","S01005156",2001,300,134,166,294502
"74289","S01005157",2001,391,160,231,294502
"74290","S01005158",2001,291,59,232,294502
"74291","S01005159",2001,390,127,263,294502
"74292","S01005160",2001,438,187,251,294502
"74293","S01005161",2001,375,102,273,294502
"74294","S01005162",2001,445,204,241,294502
"74295","S01005163",2001,255,105,150,294502
"74296","S01005164",2001,378,76,302,294502
"74297","S01005165",2001,360,104,256,294502
"74298","S01005166",2001,428,171,257,294502
"74299","S01005167",2001,435,283,152,294502
"74300","S01005168",2001,266,47,219,294502
"74301","S01005169",2001,235,11,224,294502
"74302","S01005170",2001,301,16,285,294502
"74303","S01005171",2001,347,173,174,294502
"74304","S01005172",2001,301,13,288,294502
"74305","S01005173",2001,244,30,214,294502
"74306","S01005174",2001,483,322,161,294502
"74307","S01005175",2001,293,0,0,294502
"74308","S01005176",2001,339,182,157,294502
"74309","S01005177",2001,473,265,208,294502
"74310","S01005178",2001,417,157,260,294502
"74311","S01005179",2001,416,56,360,294502
"74312","S01005180",2001,353,2,351,294502
"74313","S01005181",2001,334,28,306,294502
"74314","S01005182",2001,414,248,166,294502
"74315","S01005183",2001,428,214,214,294502
"74316","S01005184",2001,411,301,110,294502
"74317","S01005185",2001,242,87,155,294502
"74318","S01005186",2001,412,130,282,294502
"74319","S01005187",2001,491,133,358,294502
"74320","S01005188",2001,349,1,348,294502
"74321","S01005189",2001,463,235,228,294502
"74322","S01005190",2001,354,0,0,294502
"74323","S01005191",2001,376,181,195,294502
"74324","S01005192",2001,335,32,303,294502
"74325","S01005193",2001,290,2,288,294502
"74326","S01005194",2001,280,89,191,294502
"74327","S01005195",2001,347,1,346,294502
"74328","S01005196",2001,342,223,119,294502
"74329","S01005197",2001,472,146,326,294502
"74330","S01005198",2001,377,1,376,294502
"74331","S01005199",2001,326,110,216,294502
"74332","S01005200",2001,240,2,238,294502
"74333","S01005201",2001,391,176,215,294502
"74334","S01005202",2001,396,173,223,294502
"74335","S01005203",2001,411,112,299,294502
"74336","S01005204",2001,214,0,0,294502
"74337","S01005205",2001,407,3,404,294502
"74338","S01005206",2001,349,23,326,294502
"74339","S01005207",2001,460,256,204,294502
"74340","S01005208",2001,369,200,169,294502
"74341","S01005209",2001,411,133,278,294502
"74342","S01005210",2001,620,396,224,294502
"74343","S01005211",2001,367,203,164,294502
"74344","S01005212",2001,311,4,307,294502
"74345","S01005213",2001,408,52,356,294502
"74346","S01005214",2001,444,207,237,294502
"74347","S01005215",2001,403,192,211,294502
"74348","S01005216",2001,256,100,156,294502
"74349","S01005217",2001,327,63,264,294502
"74350","S01005218",2001,500,279,221,294502
"74351","S01005219",2001,448,236,212,294502
"74352","S01005220",2001,340,65,275,294502
"74353","S01005221",2001,258,16,242,294502
"74354","S01005222",2001,338,170,168,294502
"74355","S01005223",2001,371,98,273,294502
"74356","S01005224",2001,261,4,257,294502
"74357","S01005225",2001,386,35,351,294502
"74358","S01005226",2001,214,45,169,294502
"74359","S01005227",2001,480,183,297,294502
"74360","S01005228",2001,406,1,405,294502
"74361","S01005229",2001,472,85,387,294502
"74362","S01005230",2001,349,89,260,294502
"74363","S01005231",2001,348,9,339,294502
"74364","S01005232",2001,589,329,260,294502
"74365","S01005233",2001,308,136,172,294502
"74366","S01005234",2001,466,18,448,294502
"74367","S01005235",2001,460,271,189,294502
"74368","S01005236",2001,400,73,327,294502
"74369","S01005237",2001,386,6,380,294502
"74370","S01005238",2001,356,86,270,294502
"74371","S01005239",2001,530,152,378,294502
"74372","S01005240",2001,587,364,223,294502
"74373","S01005241",2001,382,5,377,294502
"74374","S01005242",2001,574,276,298,294502
"74375","S01005243",2001,593,212,381,294502
"74376","S01005244",2001,381,3,378,294502
"74377","S01005245",2001,446,51,395,294502
"74378","S01005246",2001,569,353,216,294502
"74379","S01005247",2001,274,227,47,294502
"74380","S01005248",2001,419,154,265,294502
"74381","S01005249",2001,501,82,419,294502
"74382","S01005250",2001,453,167,286,294502
"74383","S01005251",2001,376,157,219,294502
"74384","S01005252",2001,261,142,119,294502
"74385","S01005253",2001,235,4,231,294502
"74386","S01005254",2001,391,105,286,294502
"74387","S01005255",2001,395,264,131,294502
"74388","S01005256",2001,264,0,0,294502
"74389","S01005257",2001,482,60,422,294502
"74390","S01005258",2001,404,21,383,294502
"74391","S01005259",2001,304,158,146,294502
"74392","S01005260",2001,359,190,169,294502
"74393","S01005261",2001,264,160,104,294502
"74394","S01005262",2001,488,56,432,294502
"74395","S01005263",2001,241,174,67,294502
"74396","S01005264",2001,351,141,210,294502
"74397","S01005265",2001,310,185,125,294502
"74398","S01005266",2001,387,172,215,294502
"74399","S01005267",2001,382,145,237,294502
"74400","S01005268",2001,604,236,368,294502
"74401","S01005269",2001,378,127,251,294502
"74402","S01005270",2001,444,22,422,294502
"74403","S01005271",2001,230,9,221,294502
"74404","S01005272",2001,283,209,74,294502
"74405","S01005273",2001,313,28,285,294502
"74406","S01005274",2001,410,195,215,294502
"74407","S01005275",2001,336,143,193,294502
"74408","S01005276",2001,287,136,151,294502
"74409","S01005277",2001,224,21,203,294502
"74410","S01005278",2001,401,139,262,294502
"74411","S01005279",2001,196,9,187,294502
"74412","S01005280",2001,389,172,217,294502
"74413","S01005281",2001,366,114,252,294502
"74414","S01005282",2001,369,198,171,294502
"74415","S01005283",2001,293,1,292,294502
"74416","S01005284",2001,497,322,175,294502
"74417","S01005285",2001,240,21,219,294502
"74418","S01005286",2001,287,1,286,294502
"74419","S01005287",2001,355,102,253,294502
"74420","S01005288",2001,383,196,187,294502
"74421","S01005289",2001,440,164,276,294502
"74422","S01005290",2001,307,78,229,294502
"74423","S01005291",2001,306,0,0,294502
"74424","S01005292",2001,343,224,119,294502
"74425","S01005293",2001,393,186,207,294502
"74426","S01005294",2001,231,1,230,294502
"74427","S01005295",2001,275,103,172,294502
"74428","S01005296",2001,282,1,281,294502
"74429","S01005297",2001,287,0,0,294502
"74430","S01005298",2001,373,31,342,294502
"74431","S01005299",2001,227,3,224,294502
"74432","S01005300",2001,386,3,383,294502
"74433","S01005301",2001,315,3,312,294502
"74434","S01005302",2001,441,136,305,294502
"74435","S01005303",2001,328,78,250,294502
"74436","S01005304",2001,289,1,288,294502
"74437","S01005305",2001,364,114,250,294502
"74438","S01005306",2001,339,12,327,294502
"74439","S01005307",2001,321,0,0,294502
"74440","S01005308",2001,226,143,83,294502
"74441","S01005309",2001,430,103,327,294502
"74442","S01005310",2001,516,186,330,294502
"74443","S01005311",2001,391,1,390,294502
"74444","S01005312",2001,281,32,249,294502
"74445","S01005313",2001,356,3,353,294502
"74446","S01005314",2001,192,1,191,294502
"74447","S01005315",2001,352,202,150,294502
"74448","S01005316",2001,375,21,354,294502
"74449","S01005317",2001,201,1,200,294502
"74450","S01005318",2001,271,69,202,294502
"74451","S01005319",2001,236,3,233,294502
"74452","S01005320",2001,288,40,248,294502
"74453","S01005321",2001,287,78,209,294502
"74454","S01005322",2001,418,89,329,294502
"74455","S01005323",2001,324,67,257,294502
"74456","S01005324",2001,433,141,292,294502
"74457","S01005325",2001,371,123,248,294502
"74458","S01005326",2001,443,230,213,294502
"74459","S01005327",2001,280,105,175,294502
"74460","S01005328",2001,461,119,342,294502
"74461","S01005329",2001,204,5,199,294502
"74462","S01005330",2001,333,99,234,294502
"74463","S01005331",2001,356,134,222,294502
"74464","S01005332",2001,229,21,208,294502
"74465","S01005333",2001,310,4,306,294502
"74466","S01005334",2001,287,39,248,294502
"74467","S01005335",2001,185,0,0,294502
"74468","S01005336",2001,235,31,204,294502
"74469","S01005337",2001,310,3,307,294502
"74470","S01005338",2001,176,0,0,294502
"74471","S01005339",2001,312,68,244,294502
"74472","S01005340",2001,203,5,198,294502
"74473","S01005341",2001,278,55,223,294502
"74474","S01005342",2001,302,67,235,294502
"74475","S01005343",2001,333,19,314,294502
"74476","S01005344",2001,303,93,210,294502
"74477","S01005345",2001,258,9,249,294502
"74478","S01005346",2001,262,0,0,294502
"74479","S01005347",2001,273,0,0,294502
"74480","S01005348",2001,331,68,263,294502
"74481","S01005349",2001,313,15,298,294502
"74482","S01005350",2001,274,6,268,294502
"74483","S01005351",2001,349,3,346,294502
"74484","S01005352",2001,384,86,298,294502
"74485","S01005353",2001,441,91,350,294502
"74486","S01005354",2001,326,0,0,294502
"74487","S01005355",2001,356,74,282,294502
"74488","S01005356",2001,278,0,0,294502
"74489","S01005357",2001,367,106,261,294502
"74490","S01005358",2001,377,94,283,294502
"74491","S01005359",2001,338,0,0,294502
"74492","S01005360",2001,302,1,301,294502
"74493","S01005361",2001,340,2,338,294502
"74494","S01005362",2001,370,78,292,294502
"74495","S01005363",2001,292,4,288,294502
"74496","S01005364",2001,384,14,370,294502
"74497","S01005365",2001,256,10,246,294502
"74498","S01005366",2001,293,65,228,294502
"74499","S01005367",2001,553,323,230,294502
"74500","S01005368",2001,317,110,207,294502
"74501","S01005369",2001,548,167,381,294502
"74502","S01005370",2001,383,53,330,294502
"74503","S01005371",2001,439,27,412,294502
"74504","S01005372",2001,519,46,473,294502
"74505","S01005373",2001,419,146,273,294502
"74506","S01005374",2001,497,48,449,294502
"74507","S01005375",2001,449,111,338,294502
"74508","S01005376",2001,424,90,334,294502
"74509","S01005377",2001,413,209,204,294502
"74510","S01005378",2001,317,199,118,294502
"74511","S01005379",2001,405,140,265,294502
"74512","S01005380",2001,297,187,110,294502
"74513","S01005381",2001,273,186,87,294502
"74514","S01005382",2001,285,234,51,294502
"74515","S01005383",2001,260,8,252,294502
"74516","S01005384",2001,346,3,343,294502
"74517","S01005385",2001,318,11,307,294502
"74518","S01005386",2001,301,53,248,294502
"74519","S01005387",2001,414,184,230,294502
"74520","S01005388",2001,315,109,206,294502
"74521","S01005389",2001,454,182,272,294502
"74522","S01005390",2001,332,137,195,294502
"74523","S01005391",2001,333,99,234,294502
"74524","S01005392",2001,377,21,356,294502
"74525","S01005393",2001,352,54,298,294502
"74526","S01005394",2001,356,35,321,294502
"74527","S01005395",2001,362,20,342,294502
"74528","S01005396",2001,268,10,258,294502
"74529","S01005397",2001,293,89,204,294502
"74530","S01005398",2001,420,57,363,294502
"74531","S01005399",2001,497,188,309,294502
"74532","S01005400",2001,420,252,168,294502
"74533","S01005401",2001,426,105,321,294502
"74534","S01005402",2001,431,62,369,294502
"74535","S01005403",2001,391,179,212,294502
"74536","S01005404",2001,374,34,340,294502
"74537","S01005405",2001,242,41,201,294502
"74538","S01005406",2001,267,97,170,294502
"74539","S01005407",2001,420,39,381,294502
"74540","S01005408",2001,262,118,144,294502
"74541","S01005409",2001,285,84,201,294502
"74542","S01005410",2001,340,11,329,294502
"74543","S01005411",2001,398,66,332,294502
"74544","S01005412",2001,439,104,335,294502
"74545","S01005413",2001,527,168,359,294502
"74546","S01005414",2001,437,57,380,294502
"74547","S01005415",2001,346,82,264,294502
"74548","S01005416",2001,496,255,241,294502
"74549","S01005417",2001,312,70,242,294502
"74550","S01005418",2001,341,10,331,294502
"74551","S01005419",2001,319,124,195,294502
"74552","S01005420",2001,347,75,272,294502
"74553","S01005421",2001,357,84,273,294502
"74554","S01005422",2001,378,105,273,294502
"74555","S01005423",2001,368,76,292,294502
"74556","S01005424",2001,346,82,264,294502
"74557","S01005425",2001,456,317,139,294502
"74558","S01005426",2001,336,206,130,294502
"74559","S01005427",2001,425,166,259,294502
"74560","S01005428",2001,418,206,212,294502
"74561","S01005429",2001,375,69,306,294502
"74562","S01005430",2001,289,51,238,294502
"74563","S01005431",2001,332,153,179,294502
"74564","S01005432",2001,374,50,324,294502
"74565","S01005433",2001,411,93,318,294502
"74566","S01005434",2001,371,46,325,294502
"74567","S01005435",2001,414,127,287,294502
"74568","S01005436",2001,394,103,291,294502
"74569","S01005437",2001,406,76,330,294502
"74570","S01005438",2001,348,162,186,294502
"74571","S01005439",2001,319,89,230,294502
"74572","S01005440",2001,380,8,372,294502
"74573","S01005441",2001,415,95,320,294502
"74574","S01005442",2001,378,15,363,294502
"74575","S01005443",2001,437,44,393,294502
"74576","S01005444",2001,387,18,369,294502
"74577","S01005445",2001,415,68,347,294502
"74578","S01005446",2001,343,106,237,294502
"74579","S01005447",2001,340,110,230,294502
"74580","S01005448",2001,364,63,301,294502
"74581","S01005449",2001,378,3,375,294502
"74582","S01005450",2001,450,188,262,294502
"74583","S01005451",2001,415,104,311,294502
"74584","S01005452",2001,413,32,381,294502
"74585","S01005453",2001,397,125,272,294502
"74586","S01005454",2001,388,34,354,294502
"74587","S01005455",2001,476,129,347,294502
"74588","S01005456",2001,383,45,338,294502
"74589","S01005457",2001,430,145,285,294502
"74590","S01005458",2001,375,175,200,294502
"74591","S01005459",2001,334,21,313,294502
"74592","S01005460",2001,330,45,285,294502
"74593","S01005461",2001,335,29,306,294502
"74594","S01005462",2001,426,24,402,294502
"74595","S01005463",2001,239,46,193,294502
"74596","S01005464",2001,267,76,191,294502
"74597","S01005465",2001,260,47,213,294502
"74598","S01005466",2001,341,23,318,294502
"74599","S01005467",2001,230,39,191,294502
"74600","S01005468",2001,347,19,328,294502
"74601","S01005469",2001,379,13,366,294502
"74602","S01005470",2001,292,63,229,294502
"74603","S01005471",2001,289,24,265,294502
"74604","S01005472",2001,320,6,314,294502
"74605","S01005473",2001,325,14,311,294502
"74606","S01005474",2001,433,176,257,294502
"74607","S01005475",2001,317,20,297,294502
"74608","S01005476",2001,322,3,319,294502
"74609","S01005477",2001,360,97,263,294502
"74610","S01005478",2001,384,161,223,294502
"74611","S01005479",2001,239,73,166,294502
"74612","S01005480",2001,343,15,328,294502
"74613","S01005481",2001,263,110,153,294502
"74614","S01005482",2001,266,10,256,294502
"74615","S01005483",2001,339,49,290,294502
"74616","S01005484",2001,235,55,180,294502
"74617","S01005485",2001,338,166,172,294502
"74618","S01005486",2001,419,174,245,294502
"74619","S01005487",2001,395,114,281,294502
"74620","S01005488",2001,331,159,172,294502
"74621","S01005489",2001,392,56,336,294502
"74622","S01005490",2001,264,29,235,294502
"74623","S01005491",2001,385,64,321,294502
"74624","S01005492",2001,384,90,294,294502
"74625","S01005493",2001,299,12,287,294502
"74626","S01005494",2001,269,65,204,294502
"74627","S01005495",2001,268,48,220,294502
"74628","S01005496",2001,383,45,338,294502
"74629","S01005497",2001,208,1,207,294502
"74630","S01005498",2001,388,132,256,294502
"74631","S01005499",2001,277,173,104,294502
"74632","S01005500",2001,298,94,204,294502
"74633","S01005501",2001,309,61,248,294502
"74634","S01005502",2001,415,133,282,294502
"74635","S01005503",2001,268,97,171,294502
"74636","S01005504",2001,335,88,247,294502
"74637","S01005505",2001,296,149,147,294502
"74638","S01005506",2001,429,150,279,294502
"74639","S01005507",2001,253,100,153,294502
"74640","S01005508",2001,328,149,179,294502
"74641","S01005509",2001,240,35,205,294502
"74642","S01005510",2001,235,4,231,294502
"74643","S01005511",2001,236,11,225,294502
"74644","S01005512",2001,263,42,221,294502
"74645","S01005513",2001,290,83,207,294502
"74646","S01005514",2001,224,32,192,294502
"74647","S01005515",2001,204,36,168,294502
"74648","S01005516",2001,204,24,180,294502
"74649","S01005517",2001,361,136,225,294502
"74650","S01005518",2001,386,120,266,294502
"74651","S01005519",2001,281,94,187,294502
"74652","S01005520",2001,417,68,349,294502
"74653","S01005521",2001,363,82,281,294502
"74654","S01005522",2001,283,53,230,294502
"74655","S01005523",2001,362,38,324,294502
"74656","S01005524",2001,301,32,269,294502
"74657","S01005525",2001,295,81,214,294502
"74658","S01005526",2001,306,154,152,294502
"74659","S01005527",2001,251,133,118,294502
"74660","S01005528",2001,273,26,247,294502
"74661","S01005529",2001,371,161,210,294502
"74662","S01005530",2001,313,173,140,294502
"74663","S01005531",2001,278,3,275,294502
"74664","S01005532",2001,359,47,312,294502
"74665","S01005533",2001,358,96,262,294502
"74666","S01005534",2001,316,66,250,294502
"74667","S01005535",2001,359,150,209,294502
"74668","S01005536",2001,362,37,325,294502
"74669","S01005537",2001,305,78,227,294502
"74670","S01005538",2001,357,44,313,294502
"74671","S01005539",2001,393,55,338,294502
"74672","S01005540",2001,356,148,208,294502
"74673","S01005541",2001,303,108,195,294502
"74674","S01005542",2001,338,124,214,294502
"74675","S01005543",2001,342,87,255,294502
"74676","S01005544",2001,323,99,224,294502
"74677","S01005545",2001,319,86,233,294502
"74678","S01005546",2001,270,47,223,294502
"74679","S01005547",2001,293,46,247,294502
"74680","S01005548",2001,333,14,319,294502
"74681","S01005549",2001,382,34,348,294502
"74682","S01005550",2001,253,1,252,294502
"74683","S01005551",2001,388,1,387,294502
"74684","S01005552",2001,311,2,309,294502
"74685","S01005553",2001,326,4,322,294502
"74686","S01005554",2001,304,3,301,294502
"74687","S01005555",2001,266,1,265,294502
"74688","S01005556",2001,254,3,251,294502
"74689","S01005557",2001,285,104,181,294502
"74690","S01005558",2001,321,2,319,294502
"74691","S01005559",2001,255,120,135,294502
"74692","S01005560",2001,269,100,169,294502
"74693","S01005561",2001,343,7,336,294502
"74694","S01005562",2001,400,3,397,294502
"74695","S01005563",2001,389,146,243,294502
"74696","S01005564",2001,311,3,308,294502
"74697","S01005565",2001,248,3,245,294502
"74698","S01005566",2001,260,73,187,294502
"74699","S01005567",2001,490,107,383,294502
"74700","S01005568",2001,255,83,172,294502
"74701","S01005569",2001,271,7,264,294502
"74702","S01005570",2001,319,48,271,294502
"74703","S01005571",2001,264,3,261,294502
"74704","S01005572",2001,335,2,333,294502
"74705","S01005573",2001,308,47,261,294502
"74706","S01005574",2001,373,88,285,294502
"74707","S01005575",2001,280,2,278,294502
"74708","S01005576",2001,348,44,304,294502
"74709","S01005577",2001,343,3,340,294502
"74710","S01005578",2001,425,105,320,294502
"74711","S01005579",2001,320,5,315,294502
"74712","S01005580",2001,265,5,260,294502
"74713","S01005581",2001,373,99,274,294502
"74714","S01005582",2001,354,25,329,294502
"74715","S01005583",2001,280,13,267,294502
"74716","S01005584",2001,219,1,218,294502
"74717","S01005585",2001,501,118,383,294502
"74718","S01005586",2001,375,4,371,294502
"74719","S01005587",2001,423,109,314,294502
"74720","S01005588",2001,395,194,201,294502
"74721","S01005589",2001,455,9,446,294502
"74722","S01005590",2001,479,234,245,294502
"74723","S01005591",2001,464,175,289,294502
"74724","S01005592",2001,285,160,125,294502
"74725","S01005593",2001,309,131,178,294502
"74726","S01005594",2001,518,180,338,294502
"74727","S01005595",2001,323,193,130,294502
"74728","S01005596",2001,237,113,124,294502
"74729","S01005597",2001,462,158,304,294502
"74730","S01005598",2001,503,216,287,294502
"74731","S01005599",2001,276,119,157,294502
"74732","S01005600",2001,374,208,166,294502
"74733","S01005601",2001,324,78,246,294502
"74734","S01005602",2001,334,165,169,294502
"74735","S01005603",2001,210,106,104,294502
"74736","S01005604",2001,231,112,119,294502
"74737","S01005605",2001,490,97,393,294502
"74738","S01005606",2001,302,68,234,294502
"74739","S01005607",2001,290,27,263,294502
"74740","S01005608",2001,360,19,341,294502
"74741","S01005609",2001,378,67,311,294502
"74742","S01005610",2001,248,14,234,294502
"74743","S01005611",2001,316,172,144,294502
"74744","S01005612",2001,327,2,325,294502
"74745","S01005613",2001,399,103,296,294502
"74746","S01005614",2001,325,99,226,294502
"74747","S01005615",2001,466,103,363,294502
"74748","S01005616",2001,290,69,221,294502
"74749","S01005617",2001,340,107,233,294502
"74750","S01005618",2001,315,145,170,294502
"74751","S01005619",2001,232,9,223,294502
"74752","S01005620",2001,244,40,204,294502
"74753","S01005621",2001,283,101,182,294502
"74754","S01005622",2001,404,9,395,294502
"74755","S01005623",2001,346,74,272,294502
"74756","S01005624",2001,353,2,351,294502
"74757","S01005625",2001,377,28,349,294502
"74758","S01005626",2001,340,112,228,294502
"74759","S01005627",2001,291,40,251,294502
"74760","S01005628",2001,413,120,293,294502
"74761","S01005629",2001,345,1,344,294502
"74762","S01005630",2001,288,12,276,294502
"74763","S01005631",2001,319,86,233,294502
"74764","S01005632",2001,281,7,274,294502
"74765","S01005633",2001,356,94,262,294502
"74766","S01005634",2001,345,6,339,294502
"74767","S01005635",2001,337,1,336,294502
"74768","S01005636",2001,411,25,386,294502
"74769","S01005637",2001,396,61,335,294502
"74770","S01005638",2001,439,24,415,294502
"74771","S01005639",2001,303,142,161,294502
"74772","S01005640",2001,217,35,182,294502
"74773","S01005641",2001,373,78,295,294502
"74774","S01005642",2001,307,2,305,294502
"74775","S01005643",2001,269,12,257,294502
"74776","S01005644",2001,266,0,0,294502
"74777","S01005645",2001,373,13,360,294502
"74778","S01005646",2001,485,63,422,294502
"74779","S01005647",2001,348,51,297,294502
"74780","S01005648",2001,324,48,276,294502
"74781","S01005649",2001,487,107,380,294502
"74782","S01005650",2001,261,128,133,294502
"74783","S01005651",2001,423,91,332,294502
"74784","S01005652",2001,271,29,242,294502
"74785","S01005653",2001,349,117,232,294502
"74786","S01005654",2001,367,79,288,294502
"74787","S01005655",2001,389,21,368,294502
"74788","S01005656",2001,334,161,173,294502
"74789","S01005657",2001,268,75,193,294502
"74790","S01005658",2001,318,2,316,294502
"74791","S01005659",2001,327,2,325,294502
"74792","S01005660",2001,275,102,173,294502
"74793","S01005661",2001,275,0,0,294502
"74794","S01005662",2001,220,1,219,294502
"74795","S01005663",2001,254,14,240,294502
"74796","S01005664",2001,211,0,0,294502
"74797","S01005665",2001,191,2,189,294502
"74798","S01005666",2001,389,147,242,294502
"74799","S01005667",2001,315,54,261,294502
"74800","S01005668",2001,329,69,260,294502
"74801","S01005669",2001,267,43,224,294502
"74802","S01005670",2001,280,61,219,294502
"74803","S01005671",2001,204,40,164,294502
"74804","S01005672",2001,349,217,132,294502
"74805","S01005673",2001,270,36,234,294502
"74806","S01005674",2001,394,132,262,294502
"74807","S01005675",2001,427,272,155,294502
"74808","S01005676",2001,359,175,184,294502
"74809","S01005677",2001,311,29,282,294502
"74810","S01005678",2001,337,49,288,294502
"74811","S01005679",2001,322,94,228,294502
"74812","S01005680",2001,232,12,220,294502
"74813","S01005681",2001,448,125,323,294502
"74814","S01005682",2001,310,21,289,294502
"74815","S01005683",2001,377,237,140,294502
"74816","S01005684",2001,375,167,208,294502
"74817","S01005685",2001,234,7,227,294502
"74818","S01005686",2001,301,78,223,294502
"74819","S01005687",2001,209,11,198,294502
"74820","S01005688",2001,335,61,274,294502
"74821","S01005689",2001,191,11,180,294502
"74822","S01005690",2001,323,72,251,294502
"74823","S01005691",2001,257,40,217,294502
"74824","S01005692",2001,252,71,181,294502
"74825","S01005693",2001,304,0,0,294502
"74826","S01005694",2001,231,120,111,294502
"74827","S01005695",2001,235,92,143,294502
"74828","S01005696",2001,253,63,190,294502
"74829","S01005697",2001,315,179,136,294502
"74830","S01005698",2001,233,24,209,294502
"74831","S01005699",2001,448,138,310,294502
"74832","S01005700",2001,206,10,196,294502
"74833","S01005701",2001,326,203,123,294502
"74834","S01005702",2001,316,114,202,294502
"74835","S01005703",2001,227,2,225,294502
"74836","S01005704",2001,319,150,169,294502
"74837","S01005705",2001,225,27,198,294502
"74838","S01005706",2001,308,11,297,294502
"74839","S01005707",2001,282,117,165,294502
"74840","S01005708",2001,346,96,250,294502
"74841","S01005709",2001,354,136,218,294502
"74842","S01005710",2001,224,9,215,294502
"74843","S01005711",2001,383,8,375,294502
"74844","S01005712",2001,251,102,149,294502
"74845","S01005713",2001,285,30,255,294502
"74846","S01005714",2001,356,23,333,294502
"74847","S01005715",2001,342,110,232,294502
"74848","S01005716",2001,233,5,228,294502
"74849","S01005717",2001,221,15,206,294502
"74850","S01005718",2001,419,37,382,294502
"74851","S01005719",2001,200,13,187,294502
"74852","S01005720",2001,269,3,266,294502
"74853","S01005721",2001,350,189,161,294502
"74854","S01005722",2001,201,18,183,294502
"74855","S01005723",2001,324,98,226,294502
"74856","S01005724",2001,226,6,220,294502
"74857","S01005725",2001,274,34,240,294502
"74858","S01005726",2001,342,88,254,294502
"74859","S01005727",2001,229,40,189,294502
"74860","S01005728",2001,300,94,206,294502
"74861","S01005729",2001,265,105,160,294502
"74862","S01005730",2001,326,148,178,294502
"74863","S01005731",2001,287,133,154,294502
"74864","S01005732",2001,422,212,210,294502
"74865","S01005733",2001,321,49,272,294502
"74866","S01005734",2001,282,61,221,294502
"74867","S01005735",2001,284,2,282,294502
"74868","S01005736",2001,314,38,276,294502
"74869","S01005737",2001,314,100,214,294502
"74870","S01005738",2001,328,137,191,294502
"74871","S01005739",2001,265,9,256,294502
"74872","S01005740",2001,294,29,265,294502
"74873","S01005741",2001,381,63,318,294502
"74874","S01005742",2001,324,58,266,294502
"74875","S01005743",2001,231,6,225,294502
"74876","S01005744",2001,364,119,245,294502
"74877","S01005745",2001,389,130,259,294502
"74878","S01005746",2001,306,32,274,294502
"74879","S01005747",2001,343,66,277,294502
"74880","S01005748",2001,274,154,120,294502
"74881","S01005749",2001,323,29,294,294502
"74882","S01005750",2001,305,98,207,294502
"74883","S01005751",2001,297,71,226,294502
"74884","S01005752",2001,312,188,124,294502
"74885","S01005753",2001,283,87,196,294502
"74886","S01005754",2001,381,42,339,294502
"74887","S01005755",2001,355,171,184,294502
"74888","S01005756",2001,371,209,162,294502
"74889","S01005757",2001,249,155,94,294502
"74890","S01005758",2001,363,145,218,294502
"74891","S01005759",2001,395,200,195,294502
"74892","S01005760",2001,235,8,227,294502
"74893","S01005761",2001,293,13,280,294502
"74894","S01005762",2001,342,174,168,294502
"74895","S01005763",2001,308,7,301,294502
"74896","S01005764",2001,267,136,131,294502
"74897","S01005765",2001,375,185,190,294502
"74898","S01005766",2001,304,15,289,294502
"74899","S01005767",2001,263,2,261,294502
"74900","S01005768",2001,379,142,237,294502
"74901","S01005769",2001,345,119,226,294502
"74902","S01005770",2001,321,147,174,294502
"74903","S01005771",2001,294,2,292,294502
"74904","S01005772",2001,299,2,297,294502
"74905","S01005773",2001,310,17,293,294502
"74906","S01005774",2001,267,103,164,294502
"74907","S01005775",2001,382,134,248,294502
"74908","S01005776",2001,294,3,291,294502
"74909","S01005777",2001,241,85,156,294502
"74910","S01005778",2001,336,154,182,294502
"74911","S01005779",2001,292,17,275,294502
"74912","S01005780",2001,220,3,217,294502
"74913","S01005781",2001,393,46,347,294502
"74914","S01005782",2001,384,142,242,294502
"74915","S01005783",2001,198,52,146,294502
"74916","S01005784",2001,170,2,168,294502
"74917","S01005785",2001,290,3,287,294502
"74918","S01005786",2001,248,79,169,294502
"74919","S01005787",2001,265,45,220,294502
"74920","S01005788",2001,262,77,185,294502
"74921","S01005789",2001,329,74,255,294502
"74922","S01005790",2001,203,45,158,294502
"74923","S01005791",2001,211,31,180,294502
"74924","S01005792",2001,292,120,172,294502
"74925","S01005793",2001,185,40,145,294502
"74926","S01005794",2001,408,12,396,294502
"74927","S01005795",2001,271,61,210,294502
"74928","S01005796",2001,224,35,189,294502
"74929","S01005797",2001,282,1,281,294502
"74930","S01005798",2001,265,103,162,294502
"74931","S01005799",2001,313,100,213,294502
"74932","S01005800",2001,293,69,224,294502
"74933","S01005801",2001,246,110,136,294502
"74934","S01005802",2001,247,8,239,294502
"74935","S01005803",2001,264,86,178,294502
"74936","S01005804",2001,245,67,178,294502
"74937","S01005805",2001,205,24,181,294502
"74938","S01005806",2001,290,151,139,294502
"74939","S01005807",2001,337,121,216,294502
"74940","S01005808",2001,286,100,186,294502
"74941","S01005809",2001,189,37,152,294502
"74942","S01005810",2001,210,81,129,294502
"74943","S01005811",2001,233,65,168,294502
"74944","S01005812",2001,246,47,199,294502
"74945","S01005813",2001,324,99,225,294502
"74946","S01005814",2001,291,133,158,294502
"74947","S01005815",2001,408,124,284,294502
"74948","S01005816",2001,321,88,233,294502
"74949","S01005817",2001,203,4,199,294502
"74950","S01005818",2001,263,1,262,294502
"74951","S01005819",2001,293,132,161,294502
"74952","S01005820",2001,313,81,232,294502
"74953","S01005821",2001,222,56,166,294502
"74954","S01005822",2001,378,68,310,294502
"74955","S01005823",2001,228,87,141,294502
"74956","S01005824",2001,249,5,244,294502
"74957","S01005825",2001,344,84,260,294502
"74958","S01005826",2001,319,4,315,294502
"74959","S01005827",2001,291,1,290,294502
"74960","S01005828",2001,351,104,247,294502
"74961","S01005829",2001,320,6,314,294502
"74962","S01005830",2001,478,287,191,294502
"74963","S01005831",2001,365,26,339,294502
"74964","S01005832",2001,335,130,205,294502
"74965","S01005833",2001,289,49,240,294502
"74966","S01005834",2001,342,127,215,294502
"74967","S01005835",2001,259,2,257,294502
"74968","S01005836",2001,239,1,238,294502
"74969","S01005837",2001,177,4,173,294502
"74970","S01005838",2001,285,141,144,294502
"74971","S01005839",2001,332,42,290,294502
"74972","S01005840",2001,353,63,290,294502
"74973","S01005841",2001,278,59,219,294502
"74974","S01005842",2001,274,112,162,294502
"74975","S01005843",2001,221,14,207,294502
"74976","S01005844",2001,305,30,275,294502
"74977","S01005845",2001,198,7,191,294502
"74978","S01005846",2001,485,151,334,294502
"74979","S01005847",2001,377,73,304,294502
"74980","S01005848",2001,268,119,149,294502
"74981","S01005849",2001,348,74,274,294502
"74982","S01005850",2001,320,167,153,294502
"74983","S01005851",2001,384,75,309,294502
"74984","S01005852",2001,246,31,215,294502
"74985","S01005853",2001,428,85,343,294502
"74986","S01005854",2001,342,122,220,294502
"74987","S01005855",2001,431,215,216,294502
"74988","S01005856",2001,356,91,265,294502
"74989","S01005857",2001,333,140,193,294502
"74990","S01005858",2001,294,106,188,294502
"74991","S01005859",2001,335,41,294,294502
"74992","S01005860",2001,373,102,271,294502
"74993","S01005861",2001,183,1,182,294502
"74994","S01005862",2001,342,47,295,294502
"74995","S01005863",2001,392,72,320,294502
"74996","S01005864",2001,469,108,361,294502
"74997","S01005865",2001,379,199,180,294502
"74998","S01005866",2001,305,29,276,294502
"74999","S01005867",2001,382,92,290,294502
"75000","S01005868",2001,269,13,256,294502
"75001","S01005869",2001,291,159,132,294502
"75002","S01005870",2001,364,92,272,294502
"75003","S01005871",2001,331,57,274,294502
"75004","S01005872",2001,339,39,300,294502
"75005","S01005873",2001,413,56,357,294502
"75006","S01005874",2001,348,238,110,294502
"75007","S01005875",2001,283,28,255,294502
"75008","S01005876",2001,310,4,306,294502
"75009","S01005877",2001,368,65,303,294502
"75010","S01005878",2001,275,1,274,294502
"75011","S01005879",2001,289,46,243,294502
"75012","S01005880",2001,426,228,198,294502
"75013","S01005881",2001,361,117,244,294502
"75014","S01005882",2001,240,1,239,294502
"75015","S01005883",2001,229,29,200,294502
"75016","S01005884",2001,357,25,332,294502
"75017","S01005885",2001,237,0,0,294502
"75018","S01005886",2001,273,5,268,294502
"75019","S01005887",2001,258,37,221,294502
"75020","S01005888",2001,231,72,159,294502
"75021","S01005889",2001,492,126,366,294502
"75022","S01005890",2001,278,2,276,294502
"75023","S01005891",2001,284,149,135,294502
"75024","S01005892",2001,365,195,170,294502
"75025","S01005893",2001,341,67,274,294502
"75026","S01005894",2001,311,48,263,294502
"75027","S01005895",2001,260,2,258,294502
"75028","S01005896",2001,259,1,258,294502
"75029","S01005897",2001,344,44,300,294502
"75030","S01005898",2001,313,64,249,294502
"75031","S01005899",2001,400,118,282,294502
"75032","S01005900",2001,299,9,290,294502
"75033","S01005901",2001,293,15,278,294502
"75034","S01005902",2001,353,22,331,294502
"75035","S01005903",2001,450,102,348,294502
"75036","S01005904",2001,342,41,301,294502
"75037","S01005905",2001,271,31,240,294502
"75038","S01005906",2001,348,90,258,294502
"75039","S01005907",2001,397,87,310,294502
"75040","S01005908",2001,421,85,336,294502
"75041","S01005909",2001,214,22,192,294502
"75042","S01005910",2001,308,34,274,294502
"75043","S01005911",2001,429,126,303,294502
"75044","S01005912",2001,339,77,262,294502
"75045","S01005913",2001,367,232,135,294502
"75046","S01005914",2001,455,126,329,294502
"75047","S01005915",2001,349,91,258,294502
"75048","S01005916",2001,242,4,238,294502
"75049","S01005917",2001,379,188,191,294502
"75050","S01005918",2001,422,81,341,294502
"75051","S01005919",2001,209,2,207,294502
"75052","S01005920",2001,448,88,360,294502
"75053","S01005921",2001,264,41,223,294502
"75054","S01005922",2001,481,64,417,294502
"75055","S01005923",2001,346,54,292,294502
"75056","S01005924",2001,218,0,0,294502
"75057","S01005925",2001,269,3,266,294502
"75058","S01005926",2001,366,43,323,294502
"75059","S01005927",2001,332,19,313,294502
"75060","S01005928",2001,326,137,189,294502
"75061","S01005929",2001,271,67,204,294502
"75062","S01005930",2001,290,93,197,294502
"75063","S01005931",2001,358,91,267,294502
"75064","S01005932",2001,314,161,153,294502
"75065","S01005933",2001,264,1,263,294502
"75066","S01005934",2001,353,78,275,294502
"75067","S01005935",2001,335,74,261,294502
"75068","S01005936",2001,404,135,269,294502
"75069","S01005937",2001,201,0,0,294502
"75070","S01005938",2001,336,163,173,294502
"75071","S01005939",2001,323,168,155,294502
"75072","S01005940",2001,341,82,259,294502
"75073","S01005941",2001,152,1,151,294502
"75074","S01005942",2001,447,219,228,294502
"75075","S01005943",2001,414,79,335,294502
"75076","S01005944",2001,494,117,377,294502
"75077","S01005945",2001,376,81,295,294502
"75078","S01005946",2001,377,125,252,294502
"75079","S01005947",2001,395,216,179,294502
"75080","S01005948",2001,287,128,159,294502
"75081","S01005949",2001,277,126,151,294502
"75082","S01005950",2001,301,201,100,294502
"75083","S01005951",2001,466,238,228,294502
"75084","S01005952",2001,504,213,291,294502
"75085","S01005953",2001,403,67,336,294502
"75086","S01005954",2001,289,172,117,294502
"75087","S01005955",2001,290,18,272,294502
"75088","S01005956",2001,366,147,219,294502
"75089","S01005957",2001,403,241,162,294502
"75090","S01005958",2001,252,102,150,294502
"75091","S01005959",2001,283,156,127,294502
"75092","S01005960",2001,257,99,158,294502
"75093","S01005961",2001,316,124,192,294502
"75094","S01005962",2001,239,101,138,294502
"75095","S01005963",2001,247,91,156,294502
"75096","S01005964",2001,331,150,181,294502
"75097","S01005965",2001,328,157,171,294502
"75098","S01005966",2001,374,233,141,294502
"75099","S01005967",2001,374,188,186,294502
"75100","S01005968",2001,228,10,218,294502
"75101","S01005969",2001,297,47,250,294502
"75102","S01005970",2001,363,136,227,294502
"75103","S01005971",2001,192,89,103,294502
"75104","S01005972",2001,393,128,265,294502
"75105","S01005973",2001,372,95,277,294502
"75106","S01005974",2001,345,157,188,294502
"75107","S01005975",2001,292,139,153,294502
"75108","S01005976",2001,397,22,375,294502
"75109","S01005977",2001,294,115,179,294502
"75110","S01005978",2001,321,43,278,294502
"75111","S01005979",2001,385,120,265,294502
"75112","S01005980",2001,229,0,0,294502
"75113","S01005981",2001,286,111,175,294502
"75114","S01005982",2001,333,164,169,294502
"75115","S01005983",2001,347,7,340,294502
"75116","S01005984",2001,280,4,276,294502
"75117","S01005985",2001,354,160,194,294502
"75118","S01005986",2001,267,2,265,294502
"75119","S01005987",2001,288,115,173,294502
"75120","S01005988",2001,320,146,174,294502
"75121","S01005989",2001,264,2,262,294502
"75122","S01005990",2001,519,445,74,294502
"75123","S01005991",2001,363,159,204,294502
"75124","S01005992",2001,387,209,178,294502
"75125","S01005993",2001,302,2,300,294502
"75126","S01005994",2001,384,154,230,294502
"75127","S01005995",2001,380,243,137,294502
"75128","S01005996",2001,305,2,303,294502
"75129","S01005997",2001,269,127,142,294502
"75130","S01005998",2001,335,244,91,294502
"75131","S01005999",2001,314,15,299,294502
"75132","S01006000",2001,406,186,220,294502
"75133","S01006001",2001,303,83,220,294502
"75134","S01006002",2001,284,144,140,294502
"75135","S01006003",2001,325,132,193,294502
"75136","S01006004",2001,238,8,230,294502
"75137","S01006005",2001,308,152,156,294502
"75138","S01006006",2001,297,10,287,294502
"75139","S01006007",2001,280,133,147,294502
"75140","S01006008",2001,355,219,136,294502
"75141","S01006009",2001,202,2,200,294502
"75142","S01006010",2001,354,4,350,294502
"75143","S01006011",2001,374,161,213,294502
"75144","S01006012",2001,367,150,217,294502
"75145","S01006013",2001,193,1,192,294502
"75146","S01006014",2001,288,110,178,294502
"75147","S01006015",2001,357,8,349,294502
"75148","S01006016",2001,369,4,365,294502
"75149","S01006017",2001,275,150,125,294502
"75150","S01006018",2001,272,17,255,294502
"75151","S01006019",2001,373,128,245,294502
"75152","S01006020",2001,329,9,320,294502
"75153","S01006021",2001,389,76,313,294502
"75154","S01006022",2001,239,105,134,294502
"75155","S01006023",2001,257,1,256,294502
"75156","S01006024",2001,381,172,209,294502
"75157","S01006025",2001,378,105,273,294502
"75158","S01006026",2001,332,101,231,294502
"75159","S01006027",2001,307,2,305,294502
"75160","S01006028",2001,311,20,291,294502
"75161","S01006029",2001,271,13,258,294502
"75162","S01006030",2001,373,12,361,294502
"75163","S01006031",2001,398,105,293,294502
"75164","S01006032",2001,472,252,220,294502
"75165","S01006033",2001,296,29,267,294502
"75166","S01006034",2001,338,191,147,294502
"75167","S01006035",2001,451,76,375,294502
"75168","S01006036",2001,288,25,263,294502
"75169","S01006037",2001,398,6,392,294502
"75170","S01006038",2001,326,7,319,294502
"75171","S01006039",2001,343,86,257,294502
"75172","S01006040",2001,339,186,153,294502
"75173","S01006041",2001,491,247,244,294502
"75174","S01006042",2001,385,93,292,294502
"75175","S01006043",2001,253,57,196,294502
"75176","S01006044",2001,299,24,275,294502
"75177","S01006045",2001,275,53,222,294502
"75178","S01006046",2001,341,3,338,294502
"75179","S01006047",2001,337,122,215,294502
"75180","S01006048",2001,329,4,325,294502
"75181","S01006049",2001,389,125,264,294502
"75182","S01006050",2001,381,94,287,294502
"75183","S01006051",2001,388,9,379,294502
"75184","S01006052",2001,323,1,322,294502
"75185","S01006053",2001,342,5,337,294502
"75186","S01006054",2001,331,11,320,294502
"75187","S01006055",2001,253,7,246,294502
"75188","S01006056",2001,368,7,361,294502
"75189","S01006057",2001,331,159,172,294502
"75190","S01006058",2001,399,195,204,294502
"75191","S01006059",2001,465,171,294,294502
"75192","S01006060",2001,367,134,233,294502
"75193","S01006061",2001,445,241,204,294502
"75194","S01006062",2001,381,151,230,294502
"75195","S01006063",2001,246,174,72,294502
"75196","S01006064",2001,400,186,214,294502
"75197","S01006065",2001,459,206,253,294502
"75198","S01006066",2001,429,94,335,294502
"75199","S01006067",2001,422,12,410,294502
"75200","S01006068",2001,206,59,147,294502
"75201","S01006069",2001,317,14,303,294502
"75202","S01006070",2001,258,5,253,294502
"75203","S01006071",2001,342,7,335,294502
"75204","S01006072",2001,248,16,232,294502
"75205","S01006073",2001,201,41,160,294502
"75206","S01006074",2001,274,17,257,294502
"75207","S01006075",2001,388,206,182,294502
"75208","S01006076",2001,353,168,185,294502
"75209","S01006077",2001,316,120,196,294502
"75210","S01006078",2001,412,70,342,294502
"75211","S01006079",2001,300,100,200,294502
"75212","S01006080",2001,422,133,289,294502
"75213","S01006081",2001,301,25,276,294502
"75214","S01006082",2001,373,213,160,294502
"75215","S01006083",2001,422,65,357,294502
"75216","S01006084",2001,324,127,197,294502
"75217","S01006085",2001,293,64,229,294502
"75218","S01006086",2001,287,97,190,294502
"75219","S01006087",2001,352,119,233,294502
"75220","S01006088",2001,283,31,252,294502
"75221","S01006089",2001,354,96,258,294502
"75222","S01006090",2001,324,194,130,294502
"75223","S01006091",2001,228,10,218,294502
"75224","S01006092",2001,253,115,138,294502
"75225","S01006093",2001,225,76,149,294502
"75226","S01006094",2001,403,111,292,294502
"75227","S01006095",2001,331,35,296,294502
"75228","S01006096",2001,315,109,206,294502
"75229","S01006097",2001,461,174,287,294502
"75230","S01006098",2001,325,81,244,294502
"75231","S01006099",2001,223,4,219,294502
"75232","S01006100",2001,407,308,99,294502
"75233","S01006101",2001,297,97,200,294502
"75234","S01006102",2001,369,149,220,294502
"75235","S01006103",2001,338,4,334,294502
"75236","S01006104",2001,346,129,217,294502
"75237","S01006105",2001,302,107,195,294502
"75238","S01006106",2001,248,77,171,294502
"75239","S01006107",2001,276,133,143,294502
"75240","S01006108",2001,332,165,167,294502
"75241","S01006109",2001,379,41,338,294502
"75242","S01006110",2001,326,196,130,294502
"75243","S01006111",2001,374,106,268,294502
"75244","S01006112",2001,336,4,332,294502
"75245","S01006113",2001,365,3,362,294502
"75246","S01006114",2001,323,131,192,294502
"75247","S01006115",2001,416,12,404,294502
"75248","S01006116",2001,345,2,343,294502
"75249","S01006117",2001,373,95,278,294502
"75250","S01006118",2001,223,56,167,294502
"75251","S01006119",2001,420,2,418,294502
"75252","S01006120",2001,413,72,341,294502
"75253","S01006121",2001,271,65,206,294502
"75254","S01006122",2001,365,18,347,294502
"75255","S01006123",2001,329,118,211,294502
"75256","S01006124",2001,316,119,197,294502
"75257","S01006125",2001,265,15,250,294502
"75258","S01006126",2001,376,62,314,294502
"75259","S01006127",2001,328,14,314,294502
"75260","S01006128",2001,381,69,312,294502
"75261","S01006129",2001,311,55,256,294502
"75262","S01006130",2001,293,230,63,294502
"75263","S01006131",2001,366,59,307,294502
"75264","S01006132",2001,426,293,133,294502
"75265","S01006133",2001,244,31,213,294502
"75266","S01006134",2001,231,25,206,294502
"75267","S01006135",2001,266,185,81,294502
"75268","S01006136",2001,350,256,94,294502
"75269","S01006137",2001,257,126,131,294502
"75270","S01006138",2001,270,0,0,294502
"75271","S01006139",2001,289,155,134,294502
"75272","S01006140",2001,378,72,306,294502
"75273","S01006141",2001,291,143,148,294502
"75274","S01006142",2001,295,0,0,294502
"75275","S01006143",2001,232,3,229,294502
"75276","S01006144",2001,399,16,383,294502
"75277","S01006145",2001,432,116,316,294502
"75278","S01006146",2001,346,2,344,294502
"75279","S01006147",2001,405,48,357,294502
"75280","S01006148",2001,350,72,278,294502
"75281","S01006149",2001,392,33,359,294502
"75282","S01006150",2001,417,60,357,294502
"75283","S01006151",2001,248,10,238,294502
"75284","S01006152",2001,297,5,292,294502
"75285","S01006153",2001,218,5,213,294502
"75286","S01006154",2001,266,2,264,294502
"75287","S01006155",2001,349,73,276,294502
"75288","S01006156",2001,242,41,201,294502
"75289","S01006157",2001,387,107,280,294502
"75290","S01006158",2001,336,6,330,294502
"75291","S01006159",2001,393,13,380,294502
"75292","S01006160",2001,279,2,277,294502
"75293","S01006161",2001,303,2,301,294502
"75294","S01006162",2001,249,23,226,294502
"75295","S01006163",2001,407,46,361,294502
"75296","S01006164",2001,254,68,186,294502
"75297","S01006165",2001,223,57,166,294502
"75298","S01006166",2001,348,3,345,294502
"75299","S01006167",2001,362,32,330,294502
"75300","S01006168",2001,321,98,223,294502
"75301","S01006169",2001,311,30,281,294502
"75302","S01006170",2001,411,38,373,294502
"75303","S01006171",2001,394,86,308,294502
"75304","S01006172",2001,205,46,159,294502
"75305","S01006173",2001,254,20,234,294502
"75306","S01006174",2001,241,58,183,294502
"75307","S01006175",2001,356,60,296,294502
"75308","S01006176",2001,239,35,204,294502
"75309","S01006177",2001,378,272,106,294502
"75310","S01006178",2001,376,100,276,294502
"75311","S01006179",2001,352,144,208,294502
"75312","S01006180",2001,411,182,229,294502
"75313","S01006181",2001,366,252,114,294502
"75314","S01006182",2001,364,116,248,294502
"75315","S01006183",2001,294,194,100,294502
"75316","S01006184",2001,311,127,184,294502
"75317","S01006185",2001,403,153,250,294502
"75318","S01006186",2001,401,200,201,294502
"75319","S01006187",2001,435,309,126,294502
"75320","S01006188",2001,355,220,135,294502
"75321","S01006189",2001,357,260,97,294502
"75322","S01006190",2001,357,118,239,294502
"75323","S01006191",2001,283,209,74,294502
"75324","S01006192",2001,354,225,129,294502
"75325","S01006193",2001,327,267,60,294502
"75326","S01006194",2001,425,272,153,294502
"75327","S01006195",2001,465,389,76,294502
"75328","S01006196",2001,402,198,204,294502
"75329","S01006197",2001,371,217,154,294502
"75330","S01006198",2001,582,481,101,294502
"75331","S01006199",2001,369,185,184,294502
"75332","S01006200",2001,379,114,265,294502
"75333","S01006201",2001,434,197,237,294502
"75334","S01006202",2001,444,340,104,294502
"75335","S01006203",2001,253,85,168,294502
"75336","S01006204",2001,425,163,262,294502
"75337","S01006205",2001,316,76,240,294502
"75338","S01006206",2001,323,126,197,294502
"75339","S01006207",2001,469,227,242,294502
"75340","S01006208",2001,337,128,209,294502
"75341","S01006209",2001,298,45,253,294502
"75342","S01006210",2001,340,65,275,294502
"75343","S01006211",2001,278,156,122,294502
"75344","S01006212",2001,281,4,277,294502
"75345","S01006213",2001,413,189,224,294502
"75346","S01006214",2001,367,91,276,294502
"75347","S01006215",2001,358,117,241,294502
"75348","S01006216",2001,282,73,209,294502
"75349","S01006217",2001,434,199,235,294502
"75350","S01006218",2001,257,24,233,294502
"75351","S01006219",2001,468,116,352,294502
"75352","S01006220",2001,336,62,274,294502
"75353","S01006221",2001,428,201,227,294502
"75354","S01006222",2001,417,188,229,294502
"75355","S01006223",2001,295,19,276,294502
"75356","S01006224",2001,297,30,267,294502
"75357","S01006225",2001,374,244,130,294502
"75358","S01006226",2001,244,23,221,294502
"75359","S01006227",2001,315,83,232,294502
"75360","S01006228",2001,262,7,255,294502
"75361","S01006229",2001,396,262,134,294502
"75362","S01006230",2001,357,238,119,294502
"75363","S01006231",2001,375,270,105,294502
"75364","S01006232",2001,288,2,286,294502
"75365","S01006233",2001,317,63,254,294502
"75366","S01006234",2001,282,35,247,294502
"75367","S01006235",2001,313,41,272,294502
"75368","S01006236",2001,320,31,289,294502
"75369","S01006237",2001,454,183,271,294502
"75370","S01006238",2001,416,62,354,294502
"75371","S01006239",2001,177,4,173,294502
"75372","S01006240",2001,382,270,112,294502
"75373","S01006241",2001,474,111,363,294502
"75374","S01006242",2001,354,144,210,294502
"75375","S01006243",2001,211,7,204,294502
"75376","S01006244",2001,283,142,141,294502
"75377","S01006245",2001,241,112,129,294502
"75378","S01006246",2001,271,102,169,294502
"75379","S01006247",2001,359,99,260,294502
"75380","S01006248",2001,307,47,260,294502
"75381","S01006249",2001,411,39,372,294502
"75382","S01006250",2001,331,157,174,294502
"75383","S01006251",2001,263,51,212,294502
"75384","S01006252",2001,238,24,214,294502
"75385","S01006253",2001,264,173,91,294502
"75386","S01006254",2001,295,31,264,294502
"75387","S01006255",2001,371,97,274,294502
"75388","S01006256",2001,274,135,139,294502
"75389","S01006257",2001,336,128,208,294502
"75390","S01006258",2001,335,173,162,294502
"75391","S01006259",2001,288,153,135,294502
"75392","S01006260",2001,449,322,127,294502
"75393","S01006261",2001,363,168,195,294502
"75394","S01006262",2001,309,124,185,294502
"75395","S01006263",2001,382,151,231,294502
"75396","S01006264",2001,316,4,312,294502
"75397","S01006265",2001,372,61,311,294502
"75398","S01006266",2001,357,191,166,294502
"75399","S01006267",2001,234,113,121,294502
"75400","S01006268",2001,295,127,168,294502
"75401","S01006269",2001,240,152,88,294502
"75402","S01006270",2001,399,93,306,294502
"75403","S01006271",2001,313,159,154,294502
"75404","S01006272",2001,438,137,301,294502
"75405","S01006273",2001,270,170,100,294502
"75406","S01006274",2001,242,100,142,294502
"75407","S01006275",2001,288,75,213,294502
"75408","S01006276",2001,355,116,239,294502
"75409","S01006277",2001,338,52,286,294502
"75410","S01006278",2001,420,220,200,294502
"75411","S01006279",2001,366,208,158,294502
"75412","S01006280",2001,366,210,156,294502
"75413","S01006281",2001,342,139,203,294502
"75414","S01006282",2001,331,106,225,294502
"75415","S01006283",2001,326,117,209,294502
"75416","S01006284",2001,371,172,199,294502
"75417","S01006285",2001,343,70,273,294502
"75418","S01006286",2001,411,79,332,294502
"75419","S01006287",2001,263,55,208,294502
"75420","S01006288",2001,438,278,160,294502
"75421","S01006289",2001,406,68,338,294502
"75422","S01006290",2001,432,300,132,294502
"75423","S01006291",2001,219,134,85,294502
"75424","S01006292",2001,354,39,315,294502
"75425","S01006293",2001,342,8,334,294502
"75426","S01006294",2001,246,17,229,294502
"75427","S01006295",2001,241,85,156,294502
"75428","S01006296",2001,372,50,322,294502
"75429","S01006297",2001,311,139,172,294502
"75430","S01006298",2001,352,129,223,294502
"75431","S01006299",2001,330,159,171,294502
"75432","S01006300",2001,337,181,156,294502
"75433","S01006301",2001,292,183,109,294502
"75434","S01006302",2001,361,100,261,294502
"75435","S01006303",2001,288,121,167,294502
"75436","S01006304",2001,298,213,85,294502
"75437","S01006305",2001,287,80,207,294502
"75438","S01006306",2001,292,123,169,294502
"75439","S01006307",2001,393,132,261,294502
"75440","S01006308",2001,281,177,104,294502
"75441","S01006309",2001,384,9,375,294502
"75442","S01006310",2001,332,58,274,294502
"75443","S01006311",2001,331,99,232,294502
"75444","S01006312",2001,254,145,109,294502
"75445","S01006313",2001,393,153,240,294502
"75446","S01006314",2001,246,1,245,294502
"75447","S01006315",2001,375,223,152,294502
"75448","S01006316",2001,345,133,212,294502
"75449","S01006317",2001,348,151,197,294502
"75450","S01006318",2001,315,160,155,294502
"75451","S01006319",2001,430,179,251,294502
"75452","S01006320",2001,411,280,131,294502
"75453","S01006321",2001,232,2,230,294502
"75454","S01006322",2001,215,0,0,294502
"75455","S01006323",2001,321,46,275,294502
"75456","S01006324",2001,205,3,202,294502
"75457","S01006325",2001,333,153,180,294502
"75458","S01006326",2001,447,276,171,294502
"75459","S01006327",2001,263,121,142,294502
"75460","S01006328",2001,332,198,134,294502
"75461","S01006329",2001,396,62,334,294502
"75462","S01006330",2001,326,167,159,294502
"75463","S01006331",2001,273,78,195,294502
"75464","S01006332",2001,267,117,150,294502
"75465","S01006333",2001,403,241,162,294502
"75466","S01006334",2001,385,155,230,294502
"75467","S01006335",2001,346,120,226,294502
"75468","S01006336",2001,273,12,261,294502
"75469","S01006337",2001,257,15,242,294502
"75470","S01006338",2001,345,3,342,294502
"75471","S01006339",2001,365,100,265,294502
"75472","S01006340",2001,268,45,223,294502
"75473","S01006341",2001,262,3,259,294502
"75474","S01006342",2001,305,152,153,294502
"75475","S01006343",2001,328,175,153,294502
"75476","S01006344",2001,292,104,188,294502
"75477","S01006345",2001,236,104,132,294502
"75478","S01006346",2001,259,82,177,294502
"75479","S01006347",2001,220,2,218,294502
"75480","S01006348",2001,234,31,203,294502
"75481","S01006349",2001,222,84,138,294502
"75482","S01006350",2001,333,194,139,294502
"75483","S01006351",2001,398,139,259,294502
"75484","S01006352",2001,280,132,148,294502
"75485","S01006353",2001,252,63,189,294502
"75486","S01006354",2001,389,124,265,294502
"75487","S01006355",2001,298,159,139,294502
"75488","S01006356",2001,324,0,0,294502
"75489","S01006357",2001,296,24,272,294502
"75490","S01006358",2001,295,181,114,294502
"75491","S01006359",2001,395,125,270,294502
"75492","S01006360",2001,269,2,267,294502
"75493","S01006361",2001,326,125,201,294502
"75494","S01006362",2001,317,21,296,294502
"75495","S01006363",2001,287,3,284,294502
"75496","S01006364",2001,256,64,192,294502
"75497","S01006365",2001,388,10,378,294502
"75498","S01006366",2001,267,5,262,294502
"75499","S01006367",2001,306,46,260,294502
"75500","S01006368",2001,281,3,278,294502
"75501","S01006369",2001,341,139,202,294502
"75502","S01006370",2001,344,15,329,294502
"75503","S01006371",2001,227,1,226,294502
"75504","S01006372",2001,308,160,148,294502
"75505","S01006373",2001,342,64,278,294502
"75506","S01006374",2001,273,86,187,294502
"75507","S01006375",2001,313,101,212,294502
"75508","S01006376",2001,293,95,198,294502
"75509","S01006377",2001,237,105,132,294502
"75510","S01006378",2001,178,2,176,294502
"75511","S01006379",2001,309,64,245,294502
"75512","S01006380",2001,258,98,160,294502
"75513","S01006381",2001,242,71,171,294502
"75514","S01006382",2001,295,97,198,294502
"75515","S01006383",2001,230,72,158,294502
"75516","S01006384",2001,274,6,268,294502
"75517","S01006385",2001,403,170,233,294502
"75518","S01006386",2001,400,187,213,294502
"75519","S01006387",2001,339,127,212,294502
"75520","S01006388",2001,485,238,247,294502
"75521","S01006389",2001,286,158,128,294502
"75522","S01006390",2001,275,74,201,294502
"75523","S01006391",2001,310,1,309,294502
"75524","S01006392",2001,377,205,172,294502
"75525","S01006393",2001,366,270,96,294502
"75526","S01006394",2001,276,132,144,294502
"75527","S01006395",2001,347,148,199,294502
"75528","S01006396",2001,256,138,118,294502
"75529","S01006397",2001,274,66,208,294502
"75530","S01006398",2001,389,80,309,294502
"75531","S01006399",2001,310,115,195,294502
"75532","S01006400",2001,392,107,285,294502
"75533","S01006401",2001,321,121,200,294502
"75534","S01006402",2001,311,218,93,294502
"75535","S01006403",2001,340,135,205,294502
"75536","S01006404",2001,381,122,259,294502
"75537","S01006405",2001,421,174,247,294502
"75538","S01006406",2001,331,205,126,294502
"75539","S01006407",2001,278,1,277,294502
"75540","S01006408",2001,425,221,204,294502
"75541","S01006409",2001,240,51,189,294502
"75542","S01006410",2001,348,198,150,294502
"75543","S01006411",2001,295,141,154,294502
"75544","S01006412",2001,274,117,157,294502
"75545","S01006413",2001,262,120,142,294502
"75546","S01006414",2001,210,40,170,294502
"75547","S01006415",2001,325,79,246,294502
"75548","S01006416",2001,341,101,240,294502
"75549","S01006417",2001,253,88,165,294502
"75550","S01006418",2001,275,155,120,294502
"75551","S01006419",2001,255,117,138,294502
"75552","S01006420",2001,332,165,167,294502
"75553","S01006421",2001,268,66,202,294502
"75554","S01006422",2001,299,167,132,294502
"75555","S01006423",2001,236,7,229,294502
"75556","S01006424",2001,268,137,131,294502
"75557","S01006425",2001,310,146,164,294502
"75558","S01006426",2001,212,50,162,294502
"75559","S01006427",2001,379,134,245,294502
"75560","S01006428",2001,319,87,232,294502
"75561","S01006429",2001,266,142,124,294502
"75562","S01006430",2001,228,0,0,294502
"75563","S01006431",2001,201,9,192,294502
"75564","S01006432",2001,287,100,187,294502
"75565","S01006433",2001,253,97,156,294502
"75566","S01006434",2001,350,105,245,294502
"75567","S01006435",2001,211,32,179,294502
"75568","S01006436",2001,283,96,187,294502
"75569","S01006437",2001,355,88,267,294502
"75570","S01006438",2001,366,214,152,294502
"75571","S01006439",2001,390,174,216,294502
"75572","S01006440",2001,341,153,188,294502
"75573","S01006441",2001,277,124,153,294502
"75574","S01006442",2001,328,126,202,294502
"75575","S01006443",2001,211,90,121,294502
"75576","S01006444",2001,235,43,192,294502
"75577","S01006445",2001,283,71,212,294502
"75578","S01006446",2001,324,48,276,294502
"75579","S01006447",2001,274,160,114,294502
"75580","S01006448",2001,338,6,332,294502
"75581","S01006449",2001,198,1,197,294502
"75582","S01006450",2001,241,171,70,294502
"75583","S01006451",2001,276,135,141,294502
"75584","S01006452",2001,257,100,157,294502
"75585","S01006453",2001,300,138,162,294502
"75586","S01006454",2001,229,4,225,294502
"75587","S01006455",2001,247,151,96,294502
"75588","S01006456",2001,378,100,278,294502
"75589","S01006457",2001,225,103,122,294502
"75590","S01006458",2001,332,7,325,294502
"75591","S01006459",2001,249,26,223,294502
"75592","S01006460",2001,214,51,163,294502
"75593","S01006461",2001,321,37,284,294502
"75594","S01006462",2001,316,53,263,294502
"75595","S01006463",2001,256,90,166,294502
"75596","S01006464",2001,331,47,284,294502
"75597","S01006465",2001,395,114,281,294502
"75598","S01006466",2001,313,22,291,294502
"75599","S01006467",2001,366,45,321,294502
"75600","S01006468",2001,390,2,388,294502
"75601","S01006469",2001,274,54,220,294502
"75602","S01006470",2001,365,131,234,294502
"75603","S01006471",2001,357,162,195,294502
"75604","S01006472",2001,285,105,180,294502
"75605","S01006473",2001,325,65,260,294502
"75606","S01006474",2001,327,121,206,294502
"75607","S01006475",2001,372,153,219,294502
"75608","S01006476",2001,312,93,219,294502
"75609","S01006477",2001,397,201,196,294502
"75610","S01006478",2001,360,142,218,294502
"75611","S01006479",2001,327,113,214,294502
"75612","S01006480",2001,349,36,313,294502
"75613","S01006481",2001,224,73,151,294502
"75614","S01006482",2001,339,66,273,294502
"75615","S01006483",2001,364,182,182,294502
"75616","S01006484",2001,379,162,217,294502
"75617","S01006485",2001,238,5,233,294502
"75618","S01006486",2001,269,1,268,294502
"75619","S01006487",2001,326,241,85,294502
"75620","S01006488",2001,259,43,216,294502
"75621","S01006489",2001,320,144,176,294502
"75622","S01006490",2001,267,0,0,294502
"75623","S01006491",2001,299,0,0,294502
"75624","S01006492",2001,247,111,136,294502
"75625","S01006493",2001,288,113,175,294502
"75626","S01006494",2001,241,8,233,294502
"75627","S01006495",2001,333,36,297,294502
"75628","S01006496",2001,497,207,290,294502
"75629","S01006497",2001,268,35,233,294502
"75630","S01006498",2001,423,47,376,294502
"75631","S01006499",2001,348,11,337,294502
"75632","S01006500",2001,304,95,209,294502
"75633","S01006501",2001,301,1,300,294502
"75634","S01006502",2001,250,1,249,294502
"75635","S01006503",2001,273,1,272,294502
"75636","S01006504",2001,285,2,283,294502
"75637","S01006505",2001,245,0,0,294502
"75638","Footnotes:",2001,0,0,0,294502
"75639","1. The terms used to describe tenure are defined as:",2001,0,0,0,294502
"75640","Owned: either owned outright, owned with a mortgage or loan, or paying rent and part mortgage (shared ownership).",2001,0,0,0,294502
"75641","Other social rented includes rented from Registered Social Landlord, Housing Association, Housing Co-operative and Charitable Trust.",2001,0,0,0,294502
"75642","Private rented: renting from a private landlord or letting agency, employer of a household member, or relative or friend of a household member or other person.",2001,0,0,0,294502
"75643","2. 'Living rent free' could include households that are living in accommodation other than private rented.",2001,0,0,0,294502
"75644","3. It is possible that form-fillers on housing benefit may have ticked 'living rent free' in response to the Census question on 'owns/rents'. Households recorded as living rent free are not analysed by type of landlord in this table. Users who wish to count these households by landlord and, possibly,make adjustments to this table can do so using tables UV91, UV92, T54 and T55.",2001,0,0,0,294502
"75645","Crown copyright",2001,0,0,0,294502
"75646","Scotland",2011,2372777,576419,1796358,294892
"75647","S01006506",2011,424,42,382,80
"75648","S01006507",2011,364,90,274,14
"75649","S01006508",2011,340,19,321,38
"75650","S01006509",2011,274,62,212,18
"75651","S01006510",2011,256,58,198,24
"75652","S01006511",2011,315,35,280,15
"75653","S01006512",2011,170,4,166,19
"75654","S01006513",2011,230,2,228,17
"75655","S01006514",2011,339,7,332,41
"75656","S01006515",2011,271,7,264,30
"75657","S01006516",2011,185,4,181,15
"75658","S01006517",2011,403,27,376,27
"75659","S01006518",2011,247,1,246,18
"75660","S01006519",2011,281,2,279,11
"75661","S01006520",2011,222,1,221,47
"75662","S01006521",2011,243,3,240,42
"75663","S01006522",2011,218,2,216,14
"75664","S01006523",2011,427,9,418,54
"75665","S01006524",2011,314,11,303,45
"75666","S01006525",2011,339,24,315,28
"75667","S01006526",2011,439,195,244,62
"75668","S01006527",2011,286,122,164,37
"75669","S01006528",2011,433,120,313,86
"75670","S01006529",2011,496,112,384,161
"75671","S01006530",2011,356,134,222,55
"75672","S01006531",2011,429,202,227,68
"75673","S01006532",2011,337,10,327,72
"75674","S01006533",2011,305,2,303,23
"75675","S01006534",2011,398,6,392,58
"75676","S01006535",2011,564,15,549,170
"75677","S01006536",2011,589,25,564,204
"75678","S01006537",2011,341,7,334,14
"75679","S01006538",2011,240,3,237,6
"75680","S01006539",2011,330,7,323,26
"75681","S01006540",2011,451,7,444,74
"75682","S01006541",2011,392,72,320,19
"75683","S01006542",2011,496,7,489,63
"75684","S01006543",2011,363,4,359,12
"75685","S01006544",2011,507,10,497,140
"75686","S01006545",2011,586,39,547,84
"75687","S01006546",2011,262,0,0,14
"75688","S01006547",2011,442,131,311,33
"75689","S01006548",2011,312,2,310,11
"75690","S01006549",2011,366,8,358,46
"75691","S01006550",2011,389,1,388,21
"75692","S01006551",2011,392,192,200,26
"75693","S01006552",2011,417,9,408,49
"75694","S01006553",2011,407,116,291,16
"75695","S01006554",2011,330,70,260,27
"75696","S01006555",2011,374,143,231,49
"75697","S01006556",2011,399,183,216,26
"75698","S01006557",2011,338,180,158,20
"75699","S01006558",2011,354,2,352,100
"75700","S01006559",2011,272,16,256,60
"75701","S01006560",2011,432,40,392,57
"75702","S01006561",2011,323,5,318,34
"75703","S01006562",2011,334,77,257,27
"75704","S01006563",2011,366,25,341,65
"75705","S01006564",2011,578,165,413,157
"75706","S01006565",2011,565,115,450,206
"75707","S01006566",2011,437,18,419,150
"75708","S01006567",2011,552,161,391,191
"75709","S01006568",2011,575,17,558,272
"75710","S01006569",2011,311,36,275,110
"75711","S01006570",2011,371,8,363,108
"75712","S01006571",2011,427,18,409,108
"75713","S01006572",2011,374,4,370,51
"75714","S01006573",2011,290,4,286,53
"75715","S01006574",2011,427,8,419,87
"75716","S01006575",2011,399,4,395,90
"75717","S01006576",2011,325,4,321,84
"75718","S01006577",2011,430,12,418,149
"75719","S01006578",2011,633,49,584,244
"75720","S01006579",2011,640,17,623,327
"75721","S01006580",2011,422,11,411,149
"75722","S01006581",2011,402,4,398,45
"75723","S01006582",2011,466,55,411,230
"75724","S01006583",2011,404,14,390,203
"75725","S01006584",2011,354,15,339,166
"75726","S01006585",2011,465,159,306,146
"75727","S01006586",2011,650,200,450,241
"75728","S01006587",2011,318,90,228,161
"75729","S01006588",2011,338,44,294,199
"75730","S01006589",2011,367,104,263,169
"75731","S01006590",2011,379,29,350,179
"75732","S01006591",2011,367,20,347,132
"75733","S01006592",2011,374,4,370,144
"75734","S01006593",2011,411,5,406,158
"75735","S01006594",2011,345,58,287,104
"75736","S01006595",2011,555,32,523,233
"75737","S01006596",2011,359,20,339,134
"75738","S01006597",2011,352,19,333,155
"75739","S01006598",2011,435,3,432,99
"75740","S01006599",2011,499,130,369,119
"75741","S01006600",2011,587,122,465,136
"75742","S01006601",2011,572,93,479,114
"75743","S01006602",2011,414,4,410,74
"75744","S01006603",2011,385,166,219,21
"75745","S01006604",2011,291,64,227,12
"75746","S01006605",2011,409,196,213,17
"75747","S01006606",2011,390,70,320,22
"75748","S01006607",2011,385,108,277,12
"75749","S01006608",2011,284,14,270,18
"75750","S01006609",2011,490,163,327,21
"75751","S01006610",2011,212,79,133,9
"75752","S01006611",2011,425,159,266,19
"75753","S01006612",2011,373,61,312,13
"75754","S01006613",2011,259,2,257,20
"75755","S01006614",2011,265,4,261,13
"75756","S01006615",2011,270,7,263,14
"75757","S01006616",2011,337,8,329,27
"75758","S01006617",2011,297,34,263,8
"75759","S01006618",2011,246,2,244,8
"75760","S01006619",2011,372,29,343,11
"75761","S01006620",2011,390,50,340,23
"75762","S01006621",2011,235,18,217,5
"75763","S01006622",2011,292,5,287,24
"75764","S01006623",2011,359,102,257,41
"75765","S01006624",2011,481,109,372,145
"75766","S01006625",2011,288,72,216,43
"75767","S01006626",2011,377,201,176,33
"75768","S01006627",2011,511,163,348,138
"75769","S01006628",2011,635,153,482,268
"75770","S01006629",2011,315,196,119,14
"75771","S01006630",2011,256,133,123,7
"75772","S01006631",2011,493,242,251,52
"75773","S01006632",2011,423,272,151,36
"75774","S01006633",2011,288,187,101,18
"75775","S01006634",2011,291,239,52,10
"75776","S01006635",2011,289,139,150,20
"75777","S01006636",2011,386,324,62,16
"75778","S01006637",2011,413,129,284,119
"75779","S01006638",2011,504,136,368,179
"75780","S01006639",2011,592,247,345,181
"75781","S01006640",2011,376,31,345,193
"75782","S01006641",2011,602,127,475,243
"75783","S01006642",2011,492,98,394,199
"75784","S01006643",2011,419,31,388,222
"75785","S01006644",2011,553,137,416,221
"75786","S01006645",2011,393,272,121,51
"75787","S01006646",2011,340,84,256,162
"75788","S01006647",2011,341,161,180,88
"75789","S01006648",2011,651,185,466,273
"75790","S01006649",2011,583,204,379,218
"75791","S01006650",2011,481,78,403,202
"75792","S01006651",2011,382,129,253,151
"75793","S01006652",2011,308,51,257,136
"75794","S01006653",2011,296,21,275,106
"75795","S01006654",2011,504,240,264,75
"75796","S01006655",2011,334,45,289,99
"75797","S01006656",2011,524,116,408,204
"75798","S01006657",2011,286,87,199,85
"75799","S01006658",2011,525,204,321,189
"75800","S01006659",2011,287,11,276,109
"75801","S01006660",2011,247,81,166,99
"75802","S01006661",2011,301,22,279,119
"75803","S01006662",2011,285,153,132,74
"75804","S01006663",2011,245,14,231,135
"75805","S01006664",2011,237,25,212,110
"75806","S01006665",2011,316,36,280,150
"75807","S01006666",2011,499,426,73,21
"75808","S01006667",2011,447,340,107,45
"75809","S01006668",2011,413,75,338,154
"75810","S01006669",2011,444,215,229,122
"75811","S01006670",2011,347,97,250,95
"75812","S01006671",2011,233,62,171,65
"75813","S01006672",2011,366,206,160,67
"75814","S01006673",2011,367,209,158,60
"75815","S01006674",2011,544,445,99,26
"75816","S01006675",2011,315,284,31,12
"75817","S01006676",2011,358,252,106,33
"75818","S01006677",2011,398,237,161,48
"75819","S01006678",2011,525,366,159,29
"75820","S01006679",2011,315,40,275,30
"75821","S01006680",2011,416,345,71,9
"75822","S01006681",2011,464,222,242,55
"75823","S01006682",2011,384,299,85,27
"75824","S01006683",2011,370,217,153,64
"75825","S01006684",2011,401,247,154,53
"75826","S01006685",2011,427,223,204,54
"75827","S01006686",2011,305,111,194,32
"75828","S01006687",2011,419,134,285,57
"75829","S01006688",2011,510,173,337,31
"75830","S01006689",2011,288,6,282,55
"75831","S01006690",2011,308,40,268,64
"75832","S01006691",2011,271,21,250,68
"75833","S01006692",2011,361,37,324,53
"75834","S01006693",2011,497,119,378,114
"75835","S01006694",2011,480,343,137,11
"75836","S01006695",2011,346,105,241,20
"75837","S01006696",2011,390,187,203,41
"75838","S01006697",2011,435,192,243,31
"75839","S01006698",2011,409,251,158,46
"75840","S01006699",2011,209,28,181,30
"75841","S01006700",2011,431,150,281,57
"75842","S01006701",2011,321,168,153,10
"75843","S01006702",2011,332,90,242,10
"75844","S01006703",2011,301,134,167,14
"75845","S01006704",2011,301,186,115,9
"75846","S01006705",2011,364,164,200,10
"75847","S01006706",2011,272,117,155,10
"75848","S01006707",2011,311,171,140,16
"75849","S01006708",2011,364,144,220,15
"75850","S01006709",2011,376,186,190,20
"75851","S01006710",2011,415,166,249,7
"75852","S01006711",2011,511,245,266,20
"75853","S01006712",2011,250,70,180,6
"75854","S01006713",2011,420,187,233,9
"75855","S01006714",2011,304,104,200,16
"75856","S01006715",2011,218,122,96,9
"75857","S01006716",2011,242,113,129,4
"75858","S01006717",2011,445,210,235,10
"75859","S01006718",2011,248,101,147,11
"75860","S01006719",2011,350,131,219,13
"75861","S01006720",2011,242,91,151,13
"75862","S01006721",2011,386,166,220,7
"75863","S01006722",2011,312,112,200,12
"75864","S01006723",2011,283,93,190,13
"75865","S01006724",2011,343,263,80,11
"75866","S01006725",2011,265,124,141,9
"75867","S01006726",2011,505,411,94,24
"75868","S01006727",2011,395,319,76,16
"75869","S01006728",2011,334,148,186,7
"75870","S01006729",2011,349,234,115,15
"75871","S01006730",2011,276,81,195,6
"75872","S01006731",2011,257,123,134,5
"75873","S01006732",2011,353,26,327,57
"75874","S01006733",2011,309,7,302,18
"75875","S01006734",2011,352,5,347,33
"75876","S01006735",2011,245,4,241,11
"75877","S01006736",2011,395,15,380,25
"75878","S01006737",2011,265,16,249,23
"75879","S01006738",2011,453,88,365,89
"75880","S01006739",2011,309,8,301,72
"75881","S01006740",2011,335,91,244,11
"75882","S01006741",2011,342,108,234,12
"75883","S01006742",2011,233,79,154,10
"75884","S01006743",2011,271,48,223,11
"75885","S01006744",2011,302,55,247,22
"75886","S01006745",2011,409,165,244,23
"75887","S01006746",2011,350,112,238,13
"75888","S01006747",2011,368,8,360,27
"75889","S01006748",2011,408,50,358,38
"75890","S01006749",2011,419,95,324,29
"75891","S01006750",2011,292,62,230,11
"75892","S01006751",2011,241,94,147,12
"75893","S01006752",2011,339,93,246,14
"75894","S01006753",2011,410,40,370,26
"75895","S01006754",2011,400,13,387,18
"75896","S01006755",2011,289,15,274,48
"75897","S01006756",2011,286,5,281,69
"75898","S01006757",2011,343,5,338,29
"75899","S01006758",2011,318,1,317,20
"75900","S01006759",2011,251,6,245,17
"75901","S01006760",2011,235,1,234,23
"75902","S01006761",2011,334,2,332,13
"75903","S01006762",2011,416,77,339,39
"75904","S01006763",2011,334,2,332,29
"75905","S01006764",2011,345,3,342,31
"75906","S01006765",2011,273,2,271,22
"75907","S01006766",2011,240,4,236,8
"75908","S01006767",2011,283,35,248,16
"75909","S01006768",2011,212,1,211,2
"75910","S01006769",2011,392,41,351,18
"75911","S01006770",2011,273,3,270,6
"75912","S01006771",2011,150,1,149,4
"75913","S01006772",2011,375,3,372,20
"75914","S01006773",2011,255,5,250,10
"75915","S01006774",2011,221,2,219,5
"75916","S01006775",2011,319,80,239,23
"75917","S01006776",2011,271,117,154,14
"75918","S01006777",2011,262,3,259,6
"75919","S01006778",2011,287,25,262,9
"75920","S01006779",2011,293,111,182,12
"75921","S01006780",2011,254,41,213,9
"75922","S01006781",2011,295,9,286,12
"75923","S01006782",2011,341,25,316,37
"75924","S01006783",2011,299,38,261,6
"75925","S01006784",2011,302,1,301,48
"75926","S01006785",2011,223,2,221,13
"75927","S01006786",2011,339,13,326,23
"75928","S01006787",2011,281,32,249,17
"75929","S01006788",2011,302,3,299,44
"75930","S01006789",2011,290,14,276,58
"75931","S01006790",2011,444,129,315,43
"75932","S01006791",2011,253,21,232,76
"75933","S01006792",2011,214,3,211,89
"75934","S01006793",2011,245,40,205,42
"75935","S01006794",2011,280,69,211,13
"75936","S01006795",2011,319,29,290,40
"75937","S01006796",2011,222,21,201,21
"75938","S01006797",2011,243,5,238,76
"75939","S01006798",2011,225,9,216,57
"75940","S01006799",2011,403,112,291,22
"75941","S01006800",2011,320,4,316,42
"75942","S01006801",2011,353,2,351,54
"75943","S01006802",2011,298,53,245,75
"75944","S01006803",2011,313,104,209,23
"75945","S01006804",2011,295,38,257,24
"75946","S01006805",2011,442,63,379,57
"75947","S01006806",2011,429,29,400,59
"75948","S01006807",2011,243,4,239,42
"75949","S01006808",2011,248,7,241,24
"75950","S01006809",2011,354,116,238,26
"75951","S01006810",2011,370,76,294,25
"75952","S01006811",2011,430,55,375,58
"75953","S01006812",2011,304,45,259,36
"75954","S01006813",2011,322,62,260,19
"75955","S01006814",2011,282,8,274,11
"75956","S01006815",2011,285,124,161,7
"75957","S01006816",2011,298,54,244,10
"75958","S01006817",2011,261,47,214,27
"75959","S01006818",2011,278,17,261,16
"75960","S01006819",2011,313,10,303,50
"75961","S01006820",2011,180,4,176,12
"75962","S01006821",2011,229,3,226,43
"75963","S01006822",2011,279,5,274,48
"75964","S01006823",2011,302,4,298,43
"75965","S01006824",2011,367,171,196,12
"75966","S01006825",2011,333,34,299,14
"75967","S01006826",2011,344,51,293,20
"75968","S01006827",2011,419,131,288,32
"75969","S01006828",2011,485,99,386,71
"75970","S01006829",2011,139,1,138,5
"75971","S01006830",2011,301,70,231,7
"75972","S01006831",2011,221,1,220,10
"75973","S01006832",2011,424,47,377,43
"75974","S01006833",2011,175,3,172,15
"75975","S01006834",2011,163,15,148,14
"75976","S01006835",2011,478,128,350,84
"75977","S01006836",2011,210,29,181,32
"75978","S01006837",2011,230,27,203,6
"75979","S01006838",2011,249,39,210,10
"75980","S01006839",2011,450,71,379,21
"75981","S01006840",2011,366,4,362,10
"75982","S01006841",2011,344,12,332,11
"75983","S01006842",2011,308,6,302,8
"75984","S01006843",2011,312,5,307,12
"75985","S01006844",2011,332,4,328,22
"75986","S01006845",2011,366,4,362,14
"75987","S01006846",2011,240,22,218,11
"75988","S01006847",2011,238,0,0,4
"75989","S01006848",2011,364,8,356,80
"75990","S01006849",2011,355,56,299,8
"75991","S01006850",2011,365,61,304,13
"75992","S01006851",2011,337,107,230,7
"75993","S01006852",2011,229,6,223,14
"75994","S01006853",2011,318,2,316,69
"75995","S01006854",2011,364,73,291,13
"75996","S01006855",2011,294,11,283,52
"75997","S01006856",2011,254,1,253,71
"75998","S01006857",2011,398,25,373,127
"75999","S01006858",2011,240,2,238,30
"76000","S01006859",2011,421,1,420,35
"76001","S01006860",2011,264,107,157,21
"76002","S01006861",2011,195,2,193,24
"76003","S01006862",2011,312,68,244,17
"76004","S01006863",2011,295,48,247,24
"76005","S01006864",2011,165,62,103,13
"76006","S01006865",2011,424,18,406,74
"76007","S01006866",2011,220,5,215,14
"76008","S01006867",2011,293,23,270,23
"76009","S01006868",2011,364,106,258,25
"76010","S01006869",2011,197,14,183,65
"76011","S01006870",2011,196,18,178,17
"76012","S01006871",2011,265,47,218,11
"76013","S01006872",2011,252,1,251,53
"76014","S01006873",2011,426,15,411,83
"76015","S01006874",2011,216,6,210,61
"76016","S01006875",2011,321,90,231,35
"76017","S01006876",2011,396,44,352,31
"76018","S01006877",2011,372,7,365,74
"76019","S01006878",2011,322,48,274,67
"76020","S01006879",2011,322,5,317,114
"76021","S01006880",2011,227,9,218,26
"76022","S01006881",2011,227,3,224,32
"76023","S01006882",2011,207,91,116,11
"76024","S01006883",2011,217,41,176,19
"76025","S01006884",2011,390,44,346,18
"76026","S01006885",2011,220,9,211,17
"76027","S01006886",2011,321,30,291,58
"76028","S01006887",2011,213,18,195,21
"76029","S01006888",2011,309,22,287,24
"76030","S01006889",2011,350,147,203,9
"76031","S01006890",2011,264,28,236,8
"76032","S01006891",2011,400,94,306,22
"76033","S01006892",2011,275,128,147,6
"76034","S01006893",2011,196,64,132,5
"76035","S01006894",2011,448,114,334,14
"76036","S01006895",2011,266,61,205,34
"76037","S01006896",2011,361,50,311,33
"76038","S01006897",2011,290,17,273,17
"76039","S01006898",2011,340,48,292,25
"76040","S01006899",2011,242,5,237,12
"76041","S01006900",2011,234,3,231,12
"76042","S01006901",2011,270,106,164,19
"76043","S01006902",2011,296,125,171,18
"76044","S01006903",2011,349,123,226,21
"76045","S01006904",2011,330,53,277,53
"76046","S01006905",2011,395,85,310,17
"76047","S01006906",2011,441,223,218,14
"76048","S01006907",2011,305,53,252,71
"76049","S01006908",2011,426,100,326,52
"76050","S01006909",2011,275,3,272,15
"76051","S01006910",2011,353,6,347,57
"76052","S01006911",2011,224,30,194,6
"76053","S01006912",2011,170,4,166,26
"76054","S01006913",2011,182,1,181,15
"76055","S01006914",2011,273,6,267,40
"76056","S01006915",2011,301,17,284,22
"76057","S01006916",2011,207,53,154,12
"76058","S01006917",2011,320,23,297,15
"76059","S01006918",2011,195,25,170,10
"76060","S01006919",2011,205,22,183,13
"76061","S01006920",2011,243,63,180,18
"76062","S01006921",2011,270,6,264,10
"76063","S01006922",2011,201,2,199,18
"76064","S01006923",2011,331,38,293,14
"76065","S01006924",2011,208,1,207,28
"76066","S01006925",2011,215,26,189,11
"76067","S01006926",2011,263,13,250,17
"76068","S01006927",2011,358,27,331,35
"76069","S01006928",2011,416,32,384,68
"76070","S01006929",2011,280,1,279,14
"76071","S01006930",2011,358,2,356,11
"76072","S01006931",2011,159,2,157,57
"76073","S01006932",2011,195,32,163,6
"76074","S01006933",2011,220,1,219,8
"76075","S01006934",2011,234,25,209,46
"76076","S01006935",2011,301,2,299,12
"76077","S01006936",2011,274,22,252,13
"76078","S01006937",2011,316,5,311,25
"76079","S01006938",2011,254,51,203,17
"76080","S01006939",2011,234,2,232,6
"76081","S01006940",2011,378,6,372,34
"76082","S01006941",2011,255,15,240,9
"76083","S01006942",2011,390,13,377,23
"76084","S01006943",2011,208,1,207,14
"76085","S01006944",2011,327,39,288,29
"76086","S01006945",2011,215,4,211,8
"76087","S01006946",2011,314,6,308,24
"76088","S01006947",2011,306,39,267,15
"76089","S01006948",2011,372,54,318,24
"76090","S01006949",2011,248,4,244,15
"76091","S01006950",2011,199,37,162,10
"76092","S01006951",2011,204,26,178,8
"76093","S01006952",2011,364,23,341,48
"76094","S01006953",2011,301,4,297,17
"76095","S01006954",2011,317,5,312,13
"76096","S01006955",2011,267,86,181,21
"76097","S01006956",2011,394,35,359,23
"76098","S01006957",2011,387,8,379,38
"76099","S01006958",2011,435,8,427,23
"76100","S01006959",2011,347,133,214,32
"76101","S01006960",2011,318,32,286,12
"76102","S01006961",2011,321,1,320,18
"76103","S01006962",2011,409,4,405,25
"76104","S01006963",2011,275,3,272,24
"76105","S01006964",2011,348,3,345,56
"76106","S01006965",2011,216,21,195,20
"76107","S01006966",2011,253,84,169,13
"76108","S01006967",2011,237,1,236,8
"76109","S01006968",2011,224,45,179,15
"76110","S01006969",2011,412,47,365,38
"76111","S01006970",2011,258,10,248,18
"76112","S01006971",2011,248,101,147,12
"76113","S01006972",2011,192,5,187,19
"76114","S01006973",2011,234,24,210,13
"76115","S01006974",2011,393,33,360,22
"76116","S01006975",2011,386,9,377,50
"76117","S01006976",2011,172,1,171,23
"76118","S01006977",2011,316,11,305,91
"76119","S01006978",2011,371,46,325,49
"76120","S01006979",2011,369,68,301,37
"76121","S01006980",2011,326,6,320,52
"76122","S01006981",2011,321,41,280,41
"76123","S01006982",2011,359,59,300,20
"76124","S01006983",2011,289,15,274,25
"76125","S01006984",2011,275,13,262,41
"76126","S01006985",2011,432,94,338,20
"76127","S01006986",2011,243,29,214,13
"76128","S01006987",2011,294,61,233,28
"76129","S01006988",2011,218,33,185,18
"76130","S01006989",2011,375,12,363,28
"76131","S01006990",2011,313,10,303,45
"76132","S01006991",2011,216,69,147,21
"76133","S01006992",2011,241,2,239,30
"76134","S01006993",2011,202,4,198,26
"76135","S01006994",2011,226,6,220,39
"76136","S01006995",2011,331,12,319,52
"76137","S01006996",2011,306,75,231,10
"76138","S01006997",2011,292,19,273,22
"76139","S01006998",2011,450,31,419,40
"76140","S01006999",2011,334,6,328,64
"76141","S01007000",2011,414,107,307,16
"76142","S01007001",2011,388,55,333,29
"76143","S01007002",2011,230,45,185,30
"76144","S01007003",2011,205,10,195,34
"76145","S01007004",2011,304,12,292,46
"76146","S01007005",2011,348,15,333,42
"76147","S01007006",2011,394,70,324,59
"76148","S01007007",2011,338,26,312,58
"76149","S01007008",2011,450,153,297,33
"76150","S01007009",2011,496,112,384,48
"76151","S01007010",2011,392,79,313,37
"76152","S01007011",2011,463,179,284,60
"76153","S01007012",2011,322,160,162,16
"76154","S01007013",2011,222,5,217,25
"76155","S01007014",2011,381,9,372,48
"76156","S01007015",2011,247,17,230,63
"76157","S01007016",2011,213,8,205,36
"76158","S01007017",2011,476,162,314,29
"76159","S01007018",2011,421,55,366,20
"76160","S01007019",2011,309,64,245,29
"76161","S01007020",2011,411,89,322,57
"76162","S01007021",2011,403,68,335,22
"76163","S01007022",2011,209,62,147,10
"76164","S01007023",2011,203,30,173,45
"76165","S01007024",2011,416,32,384,44
"76166","S01007025",2011,389,144,245,14
"76167","S01007026",2011,412,69,343,22
"76168","S01007027",2011,481,98,383,38
"76169","S01007028",2011,315,21,294,50
"76170","S01007029",2011,221,6,215,8
"76171","S01007030",2011,338,95,243,18
"76172","S01007031",2011,285,92,193,35
"76173","S01007032",2011,507,153,354,75
"76174","S01007033",2011,338,114,224,14
"76175","S01007034",2011,266,74,192,19
"76176","S01007035",2011,375,174,201,18
"76177","S01007036",2011,401,86,315,24
"76178","S01007037",2011,453,158,295,17
"76179","S01007038",2011,328,75,253,35
"76180","S01007039",2011,368,120,248,13
"76181","S01007040",2011,301,102,199,12
"76182","S01007041",2011,344,90,254,13
"76183","S01007042",2011,318,64,254,23
"76184","S01007043",2011,382,10,372,77
"76185","S01007044",2011,306,37,269,31
"76186","S01007045",2011,325,7,318,28
"76187","S01007046",2011,259,14,245,21
"76188","S01007047",2011,261,7,254,17
"76189","S01007048",2011,359,27,332,28
"76190","S01007049",2011,415,133,282,30
"76191","S01007050",2011,295,49,246,18
"76192","S01007051",2011,332,65,267,30
"76193","S01007052",2011,233,22,211,14
"76194","S01007053",2011,191,1,190,20
"76195","S01007054",2011,434,98,336,32
"76196","S01007055",2011,196,3,193,23
"76197","S01007056",2011,221,6,215,21
"76198","S01007057",2011,247,31,216,7
"76199","S01007058",2011,288,100,188,6
"76200","S01007059",2011,433,79,354,27
"76201","S01007060",2011,231,90,141,8
"76202","S01007061",2011,346,7,339,42
"76203","S01007062",2011,272,8,264,23
"76204","S01007063",2011,282,40,242,26
"76205","S01007064",2011,253,31,222,22
"76206","S01007065",2011,249,23,226,19
"76207","S01007066",2011,252,12,240,24
"76208","S01007067",2011,254,5,249,13
"76209","S01007068",2011,329,105,224,20
"76210","S01007069",2011,338,70,268,32
"76211","S01007070",2011,247,69,178,15
"76212","S01007071",2011,356,92,264,13
"76213","S01007072",2011,246,16,230,12
"76214","S01007073",2011,358,20,338,6
"76215","S01007074",2011,292,94,198,11
"76216","S01007075",2011,305,106,199,23
"76217","S01007076",2011,289,60,229,15
"76218","S01007077",2011,311,54,257,11
"76219","S01007078",2011,398,121,277,23
"76220","S01007079",2011,522,187,335,41
"76221","S01007080",2011,386,121,265,32
"76222","S01007081",2011,370,130,240,37
"76223","S01007082",2011,233,66,167,23
"76224","S01007083",2011,451,244,207,50
"76225","S01007084",2011,273,43,230,29
"76226","S01007085",2011,366,61,305,94
"76227","S01007086",2011,573,286,287,142
"76228","S01007087",2011,439,169,270,102
"76229","S01007088",2011,247,122,125,30
"76230","S01007089",2011,217,5,212,12
"76231","S01007090",2011,243,4,239,30
"76232","S01007091",2011,280,114,166,8
"76233","S01007092",2011,307,133,174,10
"76234","S01007093",2011,417,12,405,27
"76235","S01007094",2011,354,21,333,17
"76236","S01007095",2011,209,4,205,21
"76237","S01007096",2011,316,38,278,13
"76238","S01007097",2011,188,3,185,13
"76239","S01007098",2011,288,2,286,16
"76240","S01007099",2011,338,42,296,14
"76241","S01007100",2011,298,41,257,12
"76242","S01007101",2011,342,154,188,26
"76243","S01007102",2011,260,6,254,38
"76244","S01007103",2011,330,66,264,4
"76245","S01007104",2011,197,2,195,28
"76246","S01007105",2011,238,40,198,12
"76247","S01007106",2011,319,51,268,15
"76248","S01007107",2011,256,6,250,13
"76249","S01007108",2011,226,8,218,26
"76250","S01007109",2011,371,157,214,24
"76251","S01007110",2011,324,110,214,14
"76252","S01007111",2011,225,40,185,8
"76253","S01007112",2011,214,8,206,12
"76254","S01007113",2011,231,12,219,21
"76255","S01007114",2011,378,41,337,10
"76256","S01007115",2011,257,37,220,9
"76257","S01007116",2011,315,6,309,6
"76258","S01007117",2011,177,7,170,6
"76259","S01007118",2011,282,143,139,22
"76260","S01007119",2011,330,158,172,16
"76261","S01007120",2011,483,213,270,70
"76262","S01007121",2011,294,148,146,55
"76263","S01007122",2011,287,88,199,27
"76264","S01007123",2011,313,82,231,24
"76265","S01007124",2011,380,80,300,23
"76266","S01007125",2011,351,107,244,29
"76267","S01007126",2011,399,247,152,37
"76268","S01007127",2011,446,179,267,125
"76269","S01007128",2011,411,203,208,23
"76270","S01007129",2011,374,10,364,33
"76271","S01007130",2011,280,21,259,22
"76272","S01007131",2011,341,45,296,20
"76273","S01007132",2011,297,7,290,18
"76274","S01007133",2011,262,11,251,32
"76275","S01007134",2011,317,39,278,38
"76276","S01007135",2011,221,6,215,12
"76277","S01007136",2011,185,0,0,27
"76278","S01007137",2011,248,4,244,19
"76279","S01007138",2011,243,6,237,27
"76280","S01007139",2011,324,24,300,25
"76281","S01007140",2011,405,37,368,50
"76282","S01007141",2011,249,9,240,15
"76283","S01007142",2011,153,1,152,9
"76284","S01007143",2011,203,3,200,11
"76285","S01007144",2011,240,9,231,56
"76286","S01007145",2011,408,45,363,20
"76287","S01007146",2011,334,37,297,25
"76288","S01007147",2011,305,12,293,9
"76289","S01007148",2011,204,5,199,7
"76290","S01007149",2011,237,4,233,6
"76291","S01007150",2011,350,13,337,11
"76292","S01007151",2011,331,3,328,14
"76293","S01007152",2011,237,13,224,10
"76294","S01007153",2011,286,31,255,11
"76295","S01007154",2011,453,90,363,50
"76296","S01007155",2011,305,40,265,21
"76297","S01007156",2011,308,32,276,31
"76298","S01007157",2011,279,73,206,21
"76299","S01007158",2011,386,35,351,24
"76300","S01007159",2011,407,112,295,37
"76301","S01007160",2011,377,104,273,22
"76302","S01007161",2011,317,41,276,33
"76303","S01007162",2011,271,90,181,63
"76304","S01007163",2011,392,60,332,23
"76305","S01007164",2011,257,19,238,23
"76306","S01007165",2011,330,16,314,44
"76307","S01007166",2011,328,33,295,37
"76308","S01007167",2011,331,7,324,14
"76309","S01007168",2011,415,3,412,15
"76310","S01007169",2011,326,59,267,17
"76311","S01007170",2011,268,7,261,49
"76312","S01007171",2011,364,12,352,124
"76313","S01007172",2011,333,7,326,49
"76314","S01007173",2011,327,18,309,22
"76315","S01007174",2011,286,65,221,13
"76316","S01007175",2011,294,35,259,42
"76317","S01007176",2011,290,45,245,52
"76318","S01007177",2011,303,129,174,19
"76319","S01007178",2011,505,289,216,39
"76320","S01007179",2011,384,13,371,11
"76321","S01007180",2011,347,34,313,13
"76322","S01007181",2011,317,23,294,26
"76323","S01007182",2011,526,87,439,63
"76324","S01007183",2011,560,158,402,62
"76325","S01007184",2011,594,172,422,106
"76326","S01007185",2011,422,203,219,58
"76327","S01007186",2011,327,181,146,51
"76328","S01007187",2011,498,205,293,129
"76329","S01007188",2011,328,69,259,89
"76330","S01007189",2011,461,227,234,49
"76331","S01007190",2011,378,77,301,32
"76332","S01007191",2011,274,66,208,47
"76333","S01007192",2011,286,125,161,12
"76334","S01007193",2011,289,95,194,12
"76335","S01007194",2011,276,148,128,31
"76336","S01007195",2011,237,102,135,13
"76337","S01007196",2011,278,130,148,20
"76338","S01007197",2011,286,222,64,18
"76339","S01007198",2011,229,113,116,17
"76340","S01007199",2011,306,177,129,15
"76341","S01007200",2011,405,130,275,29
"76342","S01007201",2011,350,116,234,13
"76343","S01007202",2011,350,126,224,16
"76344","S01007203",2011,250,53,197,12
"76345","S01007204",2011,426,68,358,69
"76346","S01007205",2011,263,11,252,58
"76347","S01007206",2011,212,45,167,39
"76348","S01007207",2011,420,76,344,37
"76349","S01007208",2011,550,201,349,126
"76350","S01007209",2011,389,78,311,117
"76351","S01007210",2011,387,151,236,64
"76352","S01007211",2011,498,242,256,48
"76353","S01007212",2011,259,20,239,46
"76354","S01007213",2011,423,58,365,63
"76355","S01007214",2011,424,208,216,51
"76356","S01007215",2011,397,108,289,77
"76357","S01007216",2011,315,31,284,24
"76358","S01007217",2011,460,171,289,41
"76359","S01007218",2011,353,14,339,17
"76360","S01007219",2011,386,146,240,19
"76361","S01007220",2011,330,107,223,32
"76362","S01007221",2011,273,24,249,17
"76363","S01007222",2011,320,82,238,23
"76364","S01007223",2011,200,3,197,20
"76365","S01007224",2011,279,52,227,19
"76366","S01007225",2011,369,18,351,77
"76367","S01007226",2011,322,8,314,54
"76368","S01007227",2011,425,73,352,28
"76369","S01007228",2011,260,18,242,74
"76370","S01007229",2011,455,15,440,130
"76371","S01007230",2011,358,221,137,16
"76372","S01007231",2011,372,162,210,69
"76373","S01007232",2011,381,236,145,48
"76374","S01007233",2011,347,87,260,44
"76375","S01007234",2011,263,60,203,33
"76376","S01007235",2011,407,94,313,100
"76377","S01007236",2011,305,51,254,46
"76378","S01007237",2011,325,21,304,24
"76379","S01007238",2011,417,123,294,27
"76380","S01007239",2011,367,26,341,24
"76381","S01007240",2011,233,8,225,74
"76382","S01007241",2011,242,4,238,35
"76383","S01007242",2011,447,54,393,40
"76384","S01007243",2011,255,25,230,17
"76385","S01007244",2011,303,16,287,48
"76386","S01007245",2011,310,67,243,47
"76387","S01007246",2011,237,25,212,35
"76388","S01007247",2011,279,28,251,81
"76389","S01007248",2011,310,6,304,13
"76390","S01007249",2011,174,21,153,19
"76391","S01007250",2011,432,90,342,73
"76392","S01007251",2011,250,100,150,16
"76393","S01007252",2011,315,52,263,36
"76394","S01007253",2011,358,31,327,18
"76395","S01007254",2011,401,181,220,52
"76396","S01007255",2011,374,215,159,27
"76397","S01007256",2011,407,137,270,72
"76398","S01007257",2011,296,130,166,48
"76399","S01007258",2011,410,150,260,47
"76400","S01007259",2011,414,150,264,47
"76401","S01007260",2011,418,210,208,21
"76402","S01007261",2011,356,56,300,10
"76403","S01007262",2011,301,83,218,16
"76404","S01007263",2011,366,100,266,16
"76405","S01007264",2011,339,91,248,10
"76406","S01007265",2011,472,182,290,33
"76407","S01007266",2011,305,68,237,40
"76408","S01007267",2011,222,14,208,70
"76409","S01007268",2011,249,6,243,84
"76410","S01007269",2011,224,24,200,14
"76411","S01007270",2011,205,15,190,67
"76412","S01007271",2011,448,54,394,57
"76413","S01007272",2011,417,229,188,22
"76414","S01007273",2011,296,62,234,26
"76415","S01007274",2011,456,146,310,93
"76416","S01007275",2011,243,41,202,11
"76417","S01007276",2011,369,75,294,25
"76418","S01007277",2011,327,25,302,15
"76419","S01007278",2011,227,3,224,9
"76420","S01007279",2011,240,8,232,47
"76421","S01007280",2011,237,12,225,94
"76422","S01007281",2011,361,13,348,75
"76423","S01007282",2011,228,18,210,79
"76424","S01007283",2011,482,92,390,55
"76425","S01007284",2011,403,58,345,47
"76426","S01007285",2011,358,40,318,50
"76427","S01007286",2011,460,93,367,83
"76428","S01007287",2011,281,42,239,44
"76429","S01007288",2011,252,14,238,55
"76430","S01007289",2011,323,10,313,27
"76431","S01007290",2011,276,131,145,24
"76432","S01007291",2011,329,108,221,40
"76433","S01007292",2011,320,31,289,18
"76434","S01007293",2011,310,140,170,18
"76435","S01007294",2011,378,66,312,34
"76436","S01007295",2011,307,200,107,39
"76437","S01007296",2011,354,73,281,93
"76438","S01007297",2011,444,25,419,96
"76439","S01007298",2011,244,55,189,19
"76440","S01007299",2011,387,85,302,76
"76441","S01007300",2011,241,99,142,15
"76442","S01007301",2011,311,18,293,45
"76443","S01007302",2011,280,83,197,19
"76444","S01007303",2011,366,34,332,45
"76445","S01007304",2011,310,29,281,52
"76446","S01007305",2011,305,39,266,29
"76447","S01007306",2011,342,69,273,34
"76448","S01007307",2011,337,6,331,61
"76449","S01007308",2011,339,28,311,46
"76450","S01007309",2011,277,30,247,40
"76451","S01007310",2011,380,34,346,61
"76452","S01007311",2011,343,84,259,68
"76453","S01007312",2011,355,36,319,41
"76454","S01007313",2011,436,22,414,54
"76455","S01007314",2011,292,30,262,33
"76456","S01007315",2011,434,67,367,30
"76457","S01007316",2011,449,165,284,37
"76458","S01007317",2011,266,60,206,31
"76459","S01007318",2011,274,94,180,19
"76460","S01007319",2011,369,87,282,40
"76461","S01007320",2011,353,16,337,58
"76462","S01007321",2011,271,16,255,45
"76463","S01007322",2011,376,102,274,35
"76464","S01007323",2011,227,39,188,18
"76465","S01007324",2011,167,30,137,32
"76466","S01007325",2011,393,61,332,56
"76467","S01007326",2011,346,45,301,75
"76468","S01007327",2011,350,110,240,34
"76469","S01007328",2011,390,148,242,29
"76470","S01007329",2011,314,58,256,65
"76471","S01007330",2011,375,53,322,35
"76472","S01007331",2011,419,86,333,41
"76473","S01007332",2011,219,18,201,13
"76474","S01007333",2011,367,64,303,29
"76475","S01007334",2011,391,250,141,33
"76476","S01007335",2011,412,186,226,17
"76477","S01007336",2011,302,67,235,118
"76478","S01007337",2011,380,144,236,37
"76479","S01007338",2011,302,88,214,4
"76480","S01007339",2011,302,56,246,19
"76481","S01007340",2011,273,82,191,30
"76482","S01007341",2011,394,39,355,48
"76483","S01007342",2011,359,5,354,29
"76484","S01007343",2011,302,18,284,108
"76485","S01007344",2011,242,31,211,32
"76486","S01007345",2011,315,201,114,17
"76487","S01007346",2011,351,184,167,57
"76488","S01007347",2011,351,162,189,25
"76489","S01007348",2011,280,139,141,23
"76490","S01007349",2011,189,74,115,20
"76491","S01007350",2011,331,72,259,82
"76492","S01007351",2011,355,42,313,32
"76493","S01007352",2011,230,13,217,48
"76494","S01007353",2011,282,29,253,18
"76495","S01007354",2011,403,38,365,50
"76496","S01007355",2011,464,30,434,72
"76497","S01007356",2011,350,48,302,33
"76498","S01007357",2011,388,58,330,45
"76499","S01007358",2011,368,39,329,32
"76500","S01007359",2011,371,96,275,29
"76501","S01007360",2011,236,19,217,19
"76502","S01007361",2011,507,53,454,69
"76503","S01007362",2011,316,24,292,41
"76504","S01007363",2011,348,78,270,32
"76505","S01007364",2011,409,204,205,23
"76506","S01007365",2011,215,58,157,12
"76507","S01007366",2011,276,139,137,38
"76508","S01007367",2011,295,54,241,56
"76509","S01007368",2011,233,117,116,16
"76510","S01007369",2011,378,85,293,49
"76511","S01007370",2011,389,58,331,86
"76512","S01007371",2011,320,31,289,47
"76513","S01007372",2011,374,18,356,41
"76514","S01007373",2011,283,5,278,19
"76515","S01007374",2011,217,32,185,10
"76516","S01007375",2011,216,4,212,25
"76517","S01007376",2011,371,134,237,25
"76518","S01007377",2011,279,5,274,11
"76519","S01007378",2011,231,14,217,22
"76520","S01007379",2011,234,79,155,11
"76521","S01007380",2011,229,61,168,14
"76522","S01007381",2011,191,4,187,24
"76523","S01007382",2011,281,23,258,22
"76524","S01007383",2011,349,40,309,42
"76525","S01007384",2011,332,18,314,67
"76526","S01007385",2011,404,35,369,35
"76527","S01007386",2011,337,2,335,20
"76528","S01007387",2011,289,4,285,12
"76529","S01007388",2011,256,3,253,11
"76530","S01007389",2011,198,55,143,86
"76531","S01007390",2011,193,63,130,75
"76532","S01007391",2011,223,2,221,8
"76533","S01007392",2011,200,3,197,10
"76534","S01007393",2011,308,58,250,27
"76535","S01007394",2011,335,6,329,38
"76536","S01007395",2011,516,69,447,169
"76537","S01007396",2011,477,58,419,123
"76538","S01007397",2011,443,40,403,63
"76539","S01007398",2011,279,135,144,15
"76540","S01007399",2011,324,196,128,26
"76541","S01007400",2011,344,30,314,31
"76542","S01007401",2011,290,6,284,31
"76543","S01007402",2011,260,5,255,8
"76544","S01007403",2011,261,16,245,112
"76545","S01007404",2011,193,23,170,50
"76546","S01007405",2011,277,5,272,29
"76547","S01007406",2011,252,2,250,11
"76548","S01007407",2011,315,32,283,16
"76549","S01007408",2011,256,59,197,15
"76550","S01007409",2011,308,59,249,21
"76551","S01007410",2011,291,166,125,19
"76552","S01007411",2011,437,238,199,37
"76553","S01007412",2011,212,62,150,6
"76554","S01007413",2011,360,27,333,20
"76555","S01007414",2011,244,7,237,12
"76556","S01007415",2011,374,162,212,10
"76557","S01007416",2011,223,140,83,15
"76558","S01007417",2011,406,16,390,45
"76559","S01007418",2011,292,93,199,19
"76560","S01007419",2011,332,171,161,17
"76561","S01007420",2011,296,16,280,25
"76562","S01007421",2011,282,48,234,23
"76563","S01007422",2011,261,38,223,14
"76564","S01007423",2011,325,54,271,26
"76565","S01007424",2011,340,8,332,16
"76566","S01007425",2011,373,64,309,16
"76567","S01007426",2011,344,99,245,46
"76568","S01007427",2011,309,120,189,17
"76569","S01007428",2011,465,123,342,65
"76570","S01007429",2011,324,62,262,46
"76571","S01007430",2011,211,30,181,45
"76572","S01007431",2011,218,10,208,6
"76573","S01007432",2011,354,56,298,21
"76574","S01007433",2011,350,70,280,34
"76575","S01007434",2011,242,111,131,22
"76576","S01007435",2011,327,62,265,33
"76577","S01007436",2011,356,185,171,30
"76578","S01007437",2011,230,91,139,27
"76579","S01007438",2011,338,117,221,23
"76580","S01007439",2011,337,69,268,31
"76581","S01007440",2011,295,102,193,4
"76582","S01007441",2011,226,7,219,6
"76583","S01007442",2011,198,2,196,6
"76584","S01007443",2011,387,68,319,26
"76585","S01007444",2011,427,35,392,21
"76586","S01007445",2011,265,10,255,10
"76587","S01007446",2011,201,4,197,15
"76588","S01007447",2011,209,7,202,12
"76589","S01007448",2011,367,28,339,23
"76590","S01007449",2011,458,166,292,31
"76591","S01007450",2011,332,157,175,27
"76592","S01007451",2011,283,60,223,13
"76593","S01007452",2011,209,79,130,20
"76594","S01007453",2011,212,5,207,12
"76595","S01007454",2011,190,61,129,15
"76596","S01007455",2011,388,210,178,28
"76597","S01007456",2011,394,199,195,43
"76598","S01007457",2011,465,190,275,34
"76599","S01007458",2011,224,23,201,7
"76600","S01007459",2011,291,74,217,14
"76601","S01007460",2011,345,130,215,20
"76602","S01007461",2011,372,237,135,43
"76603","S01007462",2011,371,86,285,68
"76604","S01007463",2011,377,250,127,19
"76605","S01007464",2011,313,201,112,20
"76606","S01007465",2011,380,262,118,33
"76607","S01007466",2011,581,302,279,118
"76608","S01007467",2011,523,159,364,88
"76609","S01007468",2011,333,13,320,28
"76610","S01007469",2011,250,77,173,11
"76611","S01007470",2011,335,180,155,29
"76612","S01007471",2011,203,68,135,12
"76613","S01007472",2011,273,102,171,19
"76614","S01007473",2011,227,96,131,7
"76615","S01007474",2011,213,22,191,7
"76616","S01007475",2011,257,27,230,19
"76617","S01007476",2011,317,47,270,11
"76618","S01007477",2011,247,25,222,26
"76619","S01007478",2011,433,83,350,61
"76620","S01007479",2011,275,39,236,44
"76621","S01007480",2011,327,35,292,39
"76622","S01007481",2011,394,4,390,22
"76623","S01007482",2011,253,92,161,23
"76624","S01007483",2011,340,78,262,26
"76625","S01007484",2011,285,87,198,51
"76626","S01007485",2011,219,153,66,18
"76627","S01007486",2011,255,193,62,14
"76628","S01007487",2011,498,184,314,125
"76629","S01007488",2011,483,89,394,91
"76630","S01007489",2011,406,71,335,43
"76631","S01007490",2011,378,105,273,23
"76632","S01007491",2011,460,155,305,44
"76633","S01007492",2011,332,109,223,17
"76634","S01007493",2011,368,113,255,23
"76635","S01007494",2011,239,26,213,29
"76636","S01007495",2011,345,19,326,41
"76637","S01007496",2011,470,50,420,80
"76638","S01007497",2011,264,54,210,62
"76639","S01007498",2011,416,67,349,63
"76640","S01007499",2011,358,86,272,57
"76641","S01007500",2011,288,52,236,91
"76642","S01007501",2011,325,45,280,49
"76643","S01007502",2011,248,37,211,44
"76644","S01007503",2011,482,83,399,76
"76645","S01007504",2011,321,39,282,69
"76646","S01007505",2011,179,31,148,35
"76647","S01007506",2011,237,6,231,43
"76648","S01007507",2011,455,105,350,61
"76649","S01007508",2011,329,50,279,46
"76650","S01007509",2011,274,25,249,38
"76651","S01007510",2011,459,79,380,53
"76652","S01007511",2011,370,143,227,35
"76653","S01007512",2011,247,37,210,35
"76654","S01007513",2011,468,161,307,52
"76655","S01007514",2011,247,34,213,72
"76656","S01007515",2011,254,9,245,33
"76657","S01007516",2011,257,85,172,48
"76658","S01007517",2011,224,37,187,29
"76659","S01007518",2011,381,119,262,30
"76660","S01007519",2011,215,12,203,34
"76661","S01007520",2011,446,63,383,64
"76662","S01007521",2011,202,7,195,58
"76663","S01007522",2011,476,99,377,41
"76664","S01007523",2011,229,11,218,44
"76665","S01007524",2011,385,25,360,68
"76666","S01007525",2011,237,39,198,29
"76667","S01007526",2011,385,119,266,67
"76668","S01007527",2011,374,59,315,31
"76669","S01007528",2011,363,102,261,79
"76670","S01007529",2011,308,33,275,23
"76671","S01007530",2011,223,3,220,59
"76672","S01007531",2011,313,42,271,60
"76673","S01007532",2011,248,33,215,33
"76674","S01007533",2011,222,13,209,53
"76675","S01007534",2011,428,127,301,36
"76676","S01007535",2011,492,203,289,23
"76677","S01007536",2011,443,66,377,85
"76678","S01007537",2011,518,117,401,81
"76679","S01007538",2011,366,14,352,73
"76680","S01007539",2011,331,1,330,27
"76681","S01007540",2011,450,134,316,51
"76682","S01007541",2011,337,27,310,33
"76683","S01007542",2011,416,111,305,39
"76684","S01007543",2011,481,142,339,53
"76685","S01007544",2011,496,9,487,61
"76686","S01007545",2011,359,30,329,51
"76687","S01007546",2011,223,13,210,15
"76688","S01007547",2011,239,16,223,43
"76689","S01007548",2011,304,49,255,39
"76690","S01007549",2011,298,50,248,47
"76691","S01007550",2011,449,67,382,73
"76692","S01007551",2011,395,18,377,74
"76693","S01007552",2011,401,173,228,32
"76694","S01007553",2011,376,189,187,12
"76695","S01007554",2011,221,137,84,5
"76696","S01007555",2011,238,34,204,18
"76697","S01007556",2011,227,103,124,17
"76698","S01007557",2011,478,196,282,31
"76699","S01007558",2011,189,10,179,25
"76700","S01007559",2011,308,14,294,88
"76701","S01007560",2011,440,92,348,55
"76702","S01007561",2011,357,80,277,38
"76703","S01007562",2011,365,53,312,74
"76704","S01007563",2011,396,45,351,82
"76705","S01007564",2011,323,28,295,66
"76706","S01007565",2011,396,47,349,59
"76707","S01007566",2011,275,26,249,36
"76708","S01007567",2011,233,9,224,47
"76709","S01007568",2011,295,18,277,69
"76710","S01007569",2011,342,35,307,76
"76711","S01007570",2011,295,48,247,24
"76712","S01007571",2011,240,7,233,55
"76713","S01007572",2011,370,82,288,16
"76714","S01007573",2011,329,9,320,43
"76715","S01007574",2011,438,155,283,24
"76716","S01007575",2011,452,219,233,24
"76717","S01007576",2011,344,237,107,16
"76718","S01007577",2011,296,176,120,12
"76719","S01007578",2011,332,192,140,27
"76720","S01007579",2011,298,179,119,22
"76721","S01007580",2011,293,135,158,28
"76722","S01007581",2011,198,75,123,19
"76723","S01007582",2011,285,127,158,21
"76724","S01007583",2011,519,338,181,47
"76725","S01007584",2011,279,100,179,27
"76726","S01007585",2011,438,37,401,21
"76727","S01007586",2011,377,139,238,31
"76728","S01007587",2011,306,39,267,43
"76729","S01007588",2011,360,24,336,25
"76730","S01007589",2011,408,20,388,110
"76731","S01007590",2011,289,2,287,16
"76732","S01007591",2011,272,41,231,47
"76733","S01007592",2011,353,122,231,80
"76734","S01007593",2011,453,55,398,41
"76735","S01007594",2011,334,35,299,27
"76736","S01007595",2011,443,57,386,91
"76737","S01007596",2011,275,4,271,66
"76738","S01007597",2011,254,10,244,55
"76739","S01007598",2011,266,12,254,52
"76740","S01007599",2011,361,67,294,63
"76741","S01007600",2011,510,91,419,55
"76742","S01007601",2011,300,21,279,47
"76743","S01007602",2011,269,3,266,28
"76744","S01007603",2011,309,5,304,24
"76745","S01007604",2011,389,8,381,15
"76746","S01007605",2011,364,1,363,29
"76747","S01007606",2011,314,3,311,55
"76748","S01007607",2011,294,1,293,19
"76749","S01007608",2011,308,6,302,18
"76750","S01007609",2011,447,168,279,48
"76751","S01007610",2011,255,77,178,41
"76752","S01007611",2011,538,193,345,107
"76753","S01007612",2011,609,203,406,221
"76754","S01007613",2011,324,8,316,63
"76755","S01007614",2011,358,7,351,21
"76756","S01007615",2011,515,66,449,87
"76757","S01007616",2011,387,92,295,62
"76758","S01007617",2011,234,80,154,21
"76759","S01007618",2011,294,99,195,14
"76760","S01007619",2011,280,83,197,19
"76761","S01007620",2011,271,1,270,27
"76762","S01007621",2011,291,2,289,21
"76763","S01007622",2011,256,46,210,52
"76764","S01007623",2011,250,16,234,27
"76765","S01007624",2011,268,2,266,22
"76766","S01007625",2011,224,4,220,19
"76767","S01007626",2011,269,3,266,33
"76768","S01007627",2011,251,29,222,21
"76769","S01007628",2011,314,4,310,40
"76770","S01007629",2011,286,22,264,33
"76771","S01007630",2011,338,5,333,36
"76772","S01007631",2011,269,8,261,40
"76773","S01007632",2011,437,98,339,45
"76774","S01007633",2011,441,112,329,31
"76775","S01007634",2011,241,16,225,51
"76776","S01007635",2011,321,9,312,23
"76777","S01007636",2011,416,114,302,40
"76778","S01007637",2011,403,124,279,46
"76779","S01007638",2011,373,90,283,43
"76780","S01007639",2011,451,157,294,31
"76781","S01007640",2011,303,17,286,130
"76782","S01007641",2011,369,74,295,49
"76783","S01007642",2011,415,67,348,69
"76784","S01007643",2011,424,69,355,41
"76785","S01007644",2011,384,106,278,24
"76786","S01007645",2011,219,13,206,61
"76787","S01007646",2011,260,19,241,90
"76788","S01007647",2011,361,55,306,58
"76789","S01007648",2011,446,41,405,116
"76790","S01007649",2011,339,62,277,61
"76791","S01007650",2011,420,39,381,98
"76792","S01007651",2011,227,17,210,68
"76793","S01007652",2011,257,46,211,30
"76794","S01007653",2011,378,51,327,28
"76795","S01007654",2011,465,125,340,68
"76796","S01007655",2011,341,17,324,96
"76797","S01007656",2011,358,7,351,190
"76798","S01007657",2011,176,11,165,48
"76799","S01007658",2011,231,4,227,59
"76800","S01007659",2011,366,69,297,56
"76801","S01007660",2011,400,204,196,46
"76802","S01007661",2011,327,57,270,55
"76803","S01007662",2011,493,128,365,66
"76804","S01007663",2011,387,67,320,33
"76805","S01007664",2011,283,105,178,29
"76806","S01007665",2011,275,46,229,35
"76807","S01007666",2011,198,7,191,10
"76808","S01007667",2011,283,9,274,18
"76809","S01007668",2011,468,169,299,33
"76810","S01007669",2011,268,165,103,15
"76811","S01007670",2011,299,150,149,24
"76812","S01007671",2011,289,9,280,28
"76813","S01007672",2011,389,5,384,20
"76814","S01007673",2011,304,13,291,39
"76815","S01007674",2011,376,116,260,27
"76816","S01007675",2011,251,14,237,18
"76817","S01007676",2011,279,8,271,30
"76818","S01007677",2011,201,9,192,19
"76819","S01007678",2011,368,119,249,34
"76820","S01007679",2011,381,133,248,22
"76821","S01007680",2011,386,2,384,20
"76822","S01007681",2011,192,37,155,13
"76823","S01007682",2011,403,4,399,84
"76824","S01007683",2011,301,8,293,94
"76825","S01007684",2011,332,3,329,14
"76826","S01007685",2011,273,3,270,17
"76827","S01007686",2011,320,5,315,66
"76828","S01007687",2011,399,8,391,145
"76829","S01007688",2011,545,76,469,306
"76830","S01007689",2011,288,45,243,143
"76831","S01007690",2011,393,73,320,205
"76832","S01007691",2011,515,182,333,269
"76833","S01007692",2011,434,73,361,259
"76834","S01007693",2011,347,96,251,208
"76835","S01007694",2011,523,207,316,236
"76836","S01007695",2011,614,209,405,221
"76837","S01007696",2011,437,132,305,230
"76838","S01007697",2011,608,177,431,201
"76839","S01007698",2011,589,129,460,351
"76840","S01007699",2011,454,90,364,264
"76841","S01007700",2011,450,37,413,64
"76842","S01007701",2011,318,161,157,96
"76843","S01007702",2011,266,17,249,164
"76844","S01007703",2011,398,73,325,91
"76845","S01007704",2011,517,348,169,89
"76846","S01007705",2011,262,31,231,204
"76847","S01007706",2011,370,37,333,289
"76848","S01007707",2011,465,20,445,312
"76849","S01007708",2011,357,141,216,94
"76850","S01007709",2011,309,124,185,88
"76851","S01007710",2011,450,166,284,212
"76852","S01007711",2011,493,248,245,154
"76853","S01007712",2011,360,56,304,153
"76854","S01007713",2011,229,76,153,55
"76855","S01007714",2011,321,86,235,79
"76856","S01007715",2011,267,108,159,86
"76857","S01007716",2011,598,255,343,224
"76858","S01007717",2011,567,244,323,200
"76859","S01007718",2011,467,158,309,166
"76860","S01007719",2011,651,266,385,147
"76861","S01007720",2011,404,120,284,40
"76862","S01007721",2011,435,137,298,91
"76863","S01007722",2011,548,297,251,91
"76864","S01007723",2011,604,316,288,119
"76865","S01007724",2011,358,92,266,188
"76866","S01007725",2011,498,153,345,189
"76867","S01007726",2011,453,143,310,178
"76868","S01007727",2011,591,238,353,231
"76869","S01007728",2011,414,104,310,207
"76870","S01007729",2011,439,90,349,226
"76871","S01007730",2011,464,54,410,268
"76872","S01007731",2011,396,105,291,163
"76873","S01007732",2011,374,93,281,149
"76874","S01007733",2011,338,3,335,56
"76875","S01007734",2011,384,26,358,48
"76876","S01007735",2011,359,21,338,34
"76877","S01007736",2011,309,15,294,43
"76878","S01007737",2011,554,147,407,127
"76879","S01007738",2011,358,58,300,29
"76880","S01007739",2011,347,159,188,18
"76881","S01007740",2011,265,27,238,35
"76882","S01007741",2011,435,203,232,32
"76883","S01007742",2011,328,85,243,34
"76884","S01007743",2011,457,188,269,49
"76885","S01007744",2011,403,243,160,28
"76886","S01007745",2011,378,163,215,34
"76887","S01007746",2011,409,181,228,18
"76888","S01007747",2011,242,88,154,31
"76889","S01007748",2011,369,257,112,19
"76890","S01007749",2011,281,5,276,15
"76891","S01007750",2011,358,5,353,16
"76892","S01007751",2011,337,0,0,25
"76893","S01007752",2011,356,40,316,22
"76894","S01007753",2011,241,102,139,17
"76895","S01007754",2011,414,208,206,19
"76896","S01007755",2011,417,223,194,26
"76897","S01007756",2011,298,124,174,29
"76898","S01007757",2011,371,2,369,17
"76899","S01007758",2011,468,8,460,67
"76900","S01007759",2011,618,110,508,245
"76901","S01007760",2011,262,3,259,16
"76902","S01007761",2011,383,5,378,49
"76903","S01007762",2011,474,23,451,183
"76904","S01007763",2011,329,184,145,20
"76905","S01007764",2011,310,4,306,15
"76906","S01007765",2011,308,2,306,16
"76907","S01007766",2011,382,5,377,10
"76908","S01007767",2011,398,1,397,26
"76909","S01007768",2011,356,51,305,75
"76910","S01007769",2011,325,14,311,20
"76911","S01007770",2011,318,4,314,31
"76912","S01007771",2011,235,0,0,8
"76913","S01007772",2011,546,172,374,92
"76914","S01007773",2011,314,3,311,5
"76915","S01007774",2011,323,5,318,19
"76916","S01007775",2011,346,2,344,24
"76917","S01007776",2011,282,1,281,37
"76918","S01007777",2011,314,1,313,21
"76919","S01007778",2011,155,1,154,6
"76920","S01007779",2011,311,17,294,24
"76921","S01007780",2011,331,7,324,27
"76922","S01007781",2011,381,62,319,27
"76923","S01007782",2011,239,69,170,69
"76924","S01007783",2011,405,276,129,13
"76925","S01007784",2011,276,65,211,31
"76926","S01007785",2011,276,213,63,11
"76927","S01007786",2011,333,86,247,36
"76928","S01007787",2011,277,87,190,29
"76929","S01007788",2011,268,256,12,2
"76930","S01007789",2011,231,196,35,7
"76931","S01007790",2011,330,284,46,11
"76932","S01007791",2011,174,6,168,13
"76933","S01007792",2011,384,107,277,22
"76934","S01007793",2011,457,289,168,31
"76935","S01007794",2011,234,51,183,16
"76936","S01007795",2011,243,56,187,27
"76937","S01007796",2011,311,129,182,32
"76938","S01007797",2011,258,145,113,17
"76939","S01007798",2011,226,7,219,33
"76940","S01007799",2011,193,7,186,9
"76941","S01007800",2011,365,188,177,29
"76942","S01007801",2011,388,266,122,26
"76943","S01007802",2011,199,10,189,16
"76944","S01007803",2011,524,384,140,24
"76945","S01007804",2011,259,192,67,20
"76946","S01007805",2011,207,105,102,20
"76947","S01007806",2011,296,115,181,17
"76948","S01007807",2011,258,20,238,14
"76949","S01007808",2011,304,88,216,23
"76950","S01007809",2011,398,12,386,16
"76951","S01007810",2011,369,180,189,18
"76952","S01007811",2011,325,130,195,9
"76953","S01007812",2011,328,230,98,17
"76954","S01007813",2011,306,154,152,20
"76955","S01007814",2011,229,43,186,16
"76956","S01007815",2011,343,9,334,10
"76957","S01007816",2011,273,9,264,20
"76958","S01007817",2011,207,32,175,14
"76959","S01007818",2011,314,29,285,27
"76960","S01007819",2011,353,29,324,26
"76961","S01007820",2011,408,92,316,27
"76962","S01007821",2011,244,33,211,24
"76963","S01007822",2011,349,77,272,17
"76964","S01007823",2011,306,10,296,22
"76965","S01007824",2011,342,14,328,40
"76966","S01007825",2011,482,63,419,36
"76967","S01007826",2011,260,173,87,11
"76968","S01007827",2011,291,47,244,65
"76969","S01007828",2011,592,235,357,103
"76970","S01007829",2011,348,141,207,24
"76971","S01007830",2011,545,229,316,80
"76972","S01007831",2011,501,247,254,92
"76973","S01007832",2011,362,136,226,58
"76974","S01007833",2011,479,192,287,40
"76975","S01007834",2011,416,153,263,89
"76976","S01007835",2011,325,80,245,39
"76977","S01007836",2011,285,38,247,26
"76978","S01007837",2011,357,5,352,9
"76979","S01007838",2011,392,19,373,28
"76980","S01007839",2011,281,114,167,25
"76981","S01007840",2011,425,139,286,68
"76982","S01007841",2011,341,147,194,34
"76983","S01007842",2011,391,242,149,41
"76984","S01007843",2011,354,152,202,61
"76985","S01007844",2011,520,244,276,81
"76986","S01007845",2011,427,236,191,28
"76987","S01007846",2011,337,107,230,29
"76988","S01007847",2011,437,215,222,38
"76989","S01007848",2011,447,299,148,37
"76990","S01007849",2011,413,176,237,31
"76991","S01007850",2011,293,107,186,18
"76992","S01007851",2011,479,162,317,17
"76993","S01007852",2011,356,209,147,26
"76994","S01007853",2011,413,275,138,56
"76995","S01007854",2011,548,351,197,48
"76996","S01007855",2011,310,140,170,77
"76997","S01007856",2011,348,61,287,30
"76998","S01007857",2011,233,172,61,6
"76999","S01007858",2011,533,369,164,22
"77000","S01007859",2011,246,196,50,12
"77001","S01007860",2011,237,129,108,11
"77002","S01007861",2011,254,76,178,10
"77003","S01007862",2011,308,85,223,23
"77004","S01007863",2011,441,272,169,23
"77005","S01007864",2011,486,172,314,32
"77006","S01007865",2011,229,7,222,8
"77007","S01007866",2011,209,2,207,12
"77008","S01007867",2011,195,17,178,36
"77009","S01007868",2011,351,8,343,8
"77010","S01007869",2011,362,6,356,48
"77011","S01007870",2011,199,9,190,31
"77012","S01007871",2011,285,211,74,6
"77013","S01007872",2011,322,241,81,6
"77014","S01007873",2011,295,71,224,29
"77015","S01007874",2011,367,150,217,27
"77016","S01007875",2011,242,64,178,9
"77017","S01007876",2011,420,102,318,23
"77018","S01007877",2011,336,127,209,11
"77019","S01007878",2011,281,151,130,7
"77020","S01007879",2011,320,147,173,17
"77021","S01007880",2011,178,21,157,12
"77022","S01007881",2011,244,119,125,16
"77023","S01007882",2011,268,9,259,25
"77024","S01007883",2011,468,69,399,35
"77025","S01007884",2011,269,69,200,21
"77026","S01007885",2011,345,201,144,19
"77027","S01007886",2011,433,138,295,28
"77028","S01007887",2011,230,8,222,63
"77029","S01007888",2011,451,230,221,20
"77030","S01007889",2011,242,88,154,8
"77031","S01007890",2011,300,90,210,9
"77032","S01007891",2011,370,95,275,19
"77033","S01007892",2011,341,48,293,32
"77034","S01007893",2011,423,23,400,27
"77035","S01007894",2011,386,88,298,35
"77036","S01007895",2011,249,34,215,30
"77037","S01007896",2011,387,156,231,43
"77038","S01007897",2011,165,4,161,22
"77039","S01007898",2011,166,5,161,18
"77040","S01007899",2011,145,6,139,31
"77041","S01007900",2011,232,120,112,7
"77042","S01007901",2011,317,143,174,27
"77043","S01007902",2011,394,226,168,17
"77044","S01007903",2011,322,110,212,26
"77045","S01007904",2011,312,17,295,63
"77046","S01007905",2011,292,189,103,9
"77047","S01007906",2011,382,201,181,14
"77048","S01007907",2011,254,112,142,12
"77049","S01007908",2011,419,74,345,32
"77050","S01007909",2011,226,74,152,16
"77051","S01007910",2011,369,160,209,35
"77052","S01007911",2011,348,106,242,22
"77053","S01007912",2011,346,95,251,25
"77054","S01007913",2011,304,132,172,44
"77055","S01007914",2011,279,129,150,14
"77056","S01007915",2011,361,134,227,11
"77057","S01007916",2011,399,131,268,22
"77058","S01007917",2011,369,112,257,22
"77059","S01007918",2011,446,164,282,37
"77060","S01007919",2011,303,10,293,6
"77061","S01007920",2011,245,10,235,12
"77062","S01007921",2011,422,246,176,13
"77063","S01007922",2011,386,200,186,22
"77064","S01007923",2011,412,49,363,29
"77065","S01007924",2011,430,182,248,36
"77066","S01007925",2011,176,4,172,20
"77067","S01007926",2011,175,7,168,13
"77068","S01007927",2011,237,16,221,20
"77069","S01007928",2011,418,51,367,18
"77070","S01007929",2011,268,11,257,28
"77071","S01007930",2011,216,10,206,11
"77072","S01007931",2011,481,117,364,21
"77073","S01007932",2011,364,15,349,13
"77074","S01007933",2011,316,14,302,29
"77075","S01007934",2011,300,93,207,19
"77076","S01007935",2011,444,115,329,100
"77077","S01007936",2011,389,6,383,49
"77078","S01007937",2011,435,14,421,42
"77079","S01007938",2011,372,102,270,27
"77080","S01007939",2011,412,182,230,25
"77081","S01007940",2011,497,138,359,25
"77082","S01007941",2011,257,7,250,12
"77083","S01007942",2011,207,46,161,38
"77084","S01007943",2011,319,51,268,34
"77085","S01007944",2011,442,118,324,44
"77086","S01007945",2011,443,145,298,52
"77087","S01007946",2011,396,114,282,46
"77088","S01007947",2011,327,48,279,26
"77089","S01007948",2011,304,156,148,19
"77090","S01007949",2011,347,42,305,23
"77091","S01007950",2011,376,22,354,24
"77092","S01007951",2011,321,52,269,20
"77093","S01007952",2011,357,171,186,39
"77094","S01007953",2011,414,124,290,30
"77095","S01007954",2011,324,177,147,19
"77096","S01007955",2011,322,142,180,20
"77097","S01007956",2011,297,123,174,18
"77098","S01007957",2011,455,185,270,24
"77099","S01007958",2011,388,194,194,19
"77100","S01007959",2011,380,40,340,17
"77101","S01007960",2011,291,108,183,11
"77102","S01007961",2011,278,16,262,41
"77103","S01007962",2011,246,73,173,26
"77104","S01007963",2011,408,323,85,19
"77105","S01007964",2011,353,162,191,21
"77106","S01007965",2011,256,119,137,13
"77107","S01007966",2011,418,242,176,22
"77108","S01007967",2011,245,159,86,13
"77109","S01007968",2011,397,101,296,23
"77110","S01007969",2011,390,150,240,15
"77111","S01007970",2011,408,137,271,31
"77112","S01007971",2011,469,214,255,31
"77113","S01007972",2011,377,110,267,24
"77114","S01007973",2011,355,5,350,6
"77115","S01007974",2011,426,215,211,29
"77116","S01007975",2011,324,98,226,43
"77117","S01007976",2011,456,175,281,61
"77118","S01007977",2011,304,42,262,37
"77119","S01007978",2011,353,71,282,101
"77120","S01007979",2011,363,31,332,32
"77121","S01007980",2011,340,57,283,21
"77122","S01007981",2011,252,5,247,6
"77123","S01007982",2011,210,24,186,3
"77124","S01007983",2011,387,197,190,18
"77125","S01007984",2011,374,77,297,16
"77126","S01007985",2011,412,188,224,24
"77127","S01007986",2011,238,47,191,18
"77128","S01007987",2011,313,40,273,20
"77129","S01007988",2011,336,87,249,20
"77130","S01007989",2011,290,80,210,47
"77131","S01007990",2011,339,60,279,38
"77132","S01007991",2011,334,7,327,20
"77133","S01007992",2011,224,2,222,13
"77134","S01007993",2011,329,11,318,12
"77135","S01007994",2011,293,11,282,16
"77136","S01007995",2011,309,5,304,10
"77137","S01007996",2011,187,9,178,14
"77138","S01007997",2011,296,4,292,17
"77139","S01007998",2011,225,13,212,18
"77140","S01007999",2011,301,145,156,17
"77141","S01008000",2011,390,241,149,16
"77142","S01008001",2011,372,261,111,15
"77143","S01008002",2011,330,232,98,10
"77144","S01008003",2011,241,74,167,27
"77145","S01008004",2011,230,32,198,38
"77146","S01008005",2011,220,77,143,17
"77147","S01008006",2011,248,185,63,10
"77148","S01008007",2011,208,70,138,58
"77149","S01008008",2011,267,184,83,15
"77150","S01008009",2011,373,231,142,39
"77151","S01008010",2011,476,220,256,51
"77152","S01008011",2011,455,261,194,76
"77153","S01008012",2011,471,76,395,164
"77154","S01008013",2011,363,93,270,92
"77155","S01008014",2011,312,40,272,47
"77156","S01008015",2011,437,135,302,93
"77157","S01008016",2011,433,117,316,58
"77158","S01008017",2011,375,6,369,14
"77159","S01008018",2011,308,3,305,30
"77160","S01008019",2011,271,10,261,21
"77161","S01008020",2011,313,10,303,67
"77162","S01008021",2011,244,4,240,15
"77163","S01008022",2011,286,1,285,10
"77164","S01008023",2011,246,2,244,6
"77165","S01008024",2011,224,9,215,13
"77166","S01008025",2011,283,6,277,10
"77167","S01008026",2011,466,142,324,39
"77168","S01008027",2011,259,79,180,23
"77169","S01008028",2011,239,42,197,15
"77170","S01008029",2011,345,45,300,51
"77171","S01008030",2011,476,74,402,26
"77172","S01008031",2011,403,148,255,24
"77173","S01008032",2011,377,97,280,19
"77174","S01008033",2011,269,8,261,11
"77175","S01008034",2011,271,2,269,8
"77176","S01008035",2011,281,23,258,9
"77177","S01008036",2011,246,3,243,4
"77178","S01008037",2011,421,159,262,23
"77179","S01008038",2011,303,108,195,14
"77180","S01008039",2011,363,97,266,17
"77181","S01008040",2011,332,36,296,11
"77182","S01008041",2011,354,42,312,46
"77183","S01008042",2011,280,12,268,20
"77184","S01008043",2011,398,15,383,4
"77185","S01008044",2011,431,5,426,29
"77186","S01008045",2011,449,40,409,26
"77187","S01008046",2011,527,178,349,50
"77188","S01008047",2011,292,2,290,7
"77189","S01008048",2011,238,2,236,5
"77190","S01008049",2011,357,2,355,6
"77191","S01008050",2011,245,8,237,9
"77192","S01008051",2011,328,3,325,9
"77193","S01008052",2011,337,2,335,6
"77194","S01008053",2011,263,1,262,14
"77195","S01008054",2011,361,55,306,28
"77196","S01008055",2011,384,1,383,8
"77197","S01008056",2011,332,30,302,6
"77198","S01008057",2011,400,32,368,15
"77199","S01008058",2011,304,1,303,12
"77200","S01008059",2011,260,1,259,9
"77201","S01008060",2011,326,5,321,9
"77202","S01008061",2011,283,0,0,10
"77203","S01008062",2011,371,5,366,14
"77204","S01008063",2011,381,4,377,19
"77205","S01008064",2011,296,120,176,23
"77206","S01008065",2011,348,1,347,7
"77207","S01008066",2011,326,0,0,10
"77208","S01008067",2011,257,2,255,8
"77209","S01008068",2011,384,16,368,17
"77210","S01008069",2011,385,7,378,21
"77211","S01008070",2011,356,1,355,9
"77212","S01008071",2011,287,14,273,8
"77213","S01008072",2011,350,2,348,55
"77214","S01008073",2011,178,1,177,4
"77215","S01008074",2011,378,4,374,3
"77216","S01008075",2011,246,1,245,7
"77217","S01008076",2011,301,5,296,15
"77218","S01008077",2011,349,3,346,13
"77219","S01008078",2011,350,10,340,22
"77220","S01008079",2011,341,3,338,6
"77221","S01008080",2011,279,1,278,15
"77222","S01008081",2011,235,1,234,7
"77223","S01008082",2011,328,8,320,11
"77224","S01008083",2011,270,2,268,6
"77225","S01008084",2011,353,32,321,20
"77226","S01008085",2011,339,6,333,10
"77227","S01008086",2011,418,43,375,31
"77228","S01008087",2011,330,3,327,8
"77229","S01008088",2011,398,4,394,30
"77230","S01008089",2011,243,1,242,6
"77231","S01008090",2011,305,16,289,11
"77232","S01008091",2011,146,1,145,4
"77233","S01008092",2011,368,21,347,3
"77234","S01008093",2011,331,1,330,17
"77235","S01008094",2011,257,3,254,8
"77236","S01008095",2011,345,2,343,40
"77237","S01008096",2011,334,1,333,7
"77238","S01008097",2011,281,0,0,12
"77239","S01008098",2011,293,2,291,9
"77240","S01008099",2011,209,5,204,13
"77241","S01008100",2011,401,35,366,16
"77242","S01008101",2011,351,17,334,54
"77243","S01008102",2011,310,20,290,23
"77244","S01008103",2011,338,92,246,46
"77245","S01008104",2011,390,97,293,33
"77246","S01008105",2011,518,195,323,47
"77247","S01008106",2011,371,109,262,36
"77248","S01008107",2011,281,1,280,31
"77249","S01008108",2011,244,3,241,12
"77250","S01008109",2011,332,10,322,17
"77251","S01008110",2011,316,2,314,16
"77252","S01008111",2011,349,6,343,12
"77253","S01008112",2011,322,2,320,4
"77254","S01008113",2011,359,4,355,19
"77255","S01008114",2011,262,2,260,6
"77256","S01008115",2011,368,7,361,39
"77257","S01008116",2011,350,6,344,11
"77258","S01008117",2011,329,29,300,11
"77259","S01008118",2011,361,42,319,18
"77260","S01008119",2011,260,104,156,14
"77261","S01008120",2011,288,41,247,20
"77262","S01008121",2011,269,1,268,1
"77263","S01008122",2011,266,2,264,17
"77264","S01008123",2011,366,2,364,27
"77265","S01008124",2011,306,1,305,7
"77266","S01008125",2011,378,3,375,36
"77267","S01008126",2011,308,1,307,7
"77268","S01008127",2011,194,4,190,9
"77269","S01008128",2011,350,20,330,10
"77270","S01008129",2011,426,132,294,38
"77271","S01008130",2011,462,105,357,91
"77272","S01008131",2011,398,112,286,66
"77273","S01008132",2011,423,6,417,16
"77274","S01008133",2011,338,92,246,49
"77275","S01008134",2011,325,24,301,69
"77276","S01008135",2011,478,57,421,96
"77277","S01008136",2011,448,91,357,41
"77278","S01008137",2011,414,305,109,20
"77279","S01008138",2011,374,235,139,25
"77280","S01008139",2011,393,126,267,31
"77281","S01008140",2011,239,124,115,18
"77282","S01008141",2011,318,9,309,6
"77283","S01008142",2011,293,5,288,5
"77284","S01008143",2011,428,121,307,39
"77285","S01008144",2011,229,2,227,12
"77286","S01008145",2011,328,159,169,12
"77287","S01008146",2011,218,107,111,11
"77288","S01008147",2011,339,98,241,7
"77289","S01008148",2011,328,56,272,24
"77290","S01008149",2011,313,80,233,20
"77291","S01008150",2011,428,131,297,26
"77292","S01008151",2011,321,92,229,21
"77293","S01008152",2011,511,186,325,34
"77294","S01008153",2011,295,6,289,12
"77295","S01008154",2011,355,34,321,10
"77296","S01008155",2011,275,19,256,9
"77297","S01008156",2011,391,89,302,19
"77298","S01008157",2011,293,31,262,14
"77299","S01008158",2011,287,5,282,7
"77300","S01008159",2011,461,227,234,52
"77301","S01008160",2011,397,162,235,14
"77302","S01008161",2011,399,20,379,22
"77303","S01008162",2011,430,88,342,22
"77304","S01008163",2011,327,115,212,43
"77305","S01008164",2011,289,100,189,31
"77306","S01008165",2011,266,7,259,22
"77307","S01008166",2011,226,77,149,11
"77308","S01008167",2011,294,136,158,22
"77309","S01008168",2011,349,173,176,11
"77310","S01008169",2011,320,117,203,21
"77311","S01008170",2011,231,20,211,12
"77312","S01008171",2011,373,117,256,44
"77313","S01008172",2011,250,41,209,11
"77314","S01008173",2011,260,37,223,6
"77315","S01008174",2011,226,27,199,8
"77316","S01008175",2011,378,78,300,50
"77317","S01008176",2011,327,17,310,48
"77318","S01008177",2011,371,113,258,21
"77319","S01008178",2011,278,36,242,18
"77320","S01008179",2011,170,2,168,7
"77321","S01008180",2011,167,0,0,9
"77322","S01008181",2011,284,12,272,11
"77323","S01008182",2011,563,115,448,130
"77324","S01008183",2011,282,20,262,37
"77325","S01008184",2011,481,120,361,88
"77326","S01008185",2011,573,148,425,84
"77327","S01008186",2011,366,41,325,92
"77328","S01008187",2011,284,108,176,21
"77329","S01008188",2011,485,188,297,91
"77330","S01008189",2011,271,48,223,27
"77331","S01008190",2011,365,164,201,17
"77332","S01008191",2011,187,68,119,9
"77333","S01008192",2011,360,82,278,70
"77334","S01008193",2011,327,54,273,21
"77335","S01008194",2011,244,66,178,21
"77336","S01008195",2011,331,153,178,27
"77337","S01008196",2011,333,150,183,22
"77338","S01008197",2011,390,60,330,39
"77339","S01008198",2011,300,101,199,9
"77340","S01008199",2011,298,184,114,14
"77341","S01008200",2011,300,166,134,8
"77342","S01008201",2011,354,179,175,16
"77343","S01008202",2011,261,86,175,9
"77344","S01008203",2011,283,118,165,49
"77345","S01008204",2011,480,188,292,26
"77346","S01008205",2011,276,99,177,13
"77347","S01008206",2011,295,125,170,10
"77348","S01008207",2011,246,148,98,7
"77349","S01008208",2011,344,56,288,35
"77350","S01008209",2011,200,5,195,18
"77351","S01008210",2011,417,118,299,27
"77352","S01008211",2011,420,100,320,38
"77353","S01008212",2011,212,10,202,12
"77354","S01008213",2011,370,33,337,16
"77355","S01008214",2011,354,100,254,22
"77356","S01008215",2011,324,48,276,23
"77357","S01008216",2011,205,4,201,12
"77358","S01008217",2011,226,4,222,11
"77359","S01008218",2011,376,11,365,13
"77360","S01008219",2011,424,98,326,62
"77361","S01008220",2011,223,117,106,7
"77362","S01008221",2011,309,176,133,28
"77363","S01008222",2011,287,139,148,14
"77364","S01008223",2011,280,131,149,12
"77365","S01008224",2011,406,15,391,34
"77366","S01008225",2011,290,77,213,8
"77367","S01008226",2011,379,204,175,20
"77368","S01008227",2011,389,192,197,22
"77369","S01008228",2011,279,46,233,16
"77370","S01008229",2011,300,137,163,6
"77371","S01008230",2011,305,22,283,28
"77372","S01008231",2011,243,6,237,11
"77373","S01008232",2011,259,56,203,22
"77374","S01008233",2011,178,41,137,15
"77375","S01008234",2011,187,75,112,2
"77376","S01008235",2011,368,134,234,10
"77377","S01008236",2011,386,101,285,29
"77378","S01008237",2011,376,127,249,31
"77379","S01008238",2011,341,139,202,14
"77380","S01008239",2011,331,81,250,24
"77381","S01008240",2011,358,7,351,24
"77382","S01008241",2011,271,4,267,8
"77383","S01008242",2011,430,110,320,58
"77384","S01008243",2011,361,63,298,44
"77385","S01008244",2011,255,37,218,35
"77386","S01008245",2011,410,64,346,19
"77387","S01008246",2011,353,33,320,39
"77388","S01008247",2011,319,48,271,38
"77389","S01008248",2011,397,109,288,38
"77390","S01008249",2011,401,40,361,63
"77391","S01008250",2011,447,16,431,107
"77392","S01008251",2011,255,6,249,12
"77393","S01008252",2011,338,17,321,25
"77394","S01008253",2011,370,133,237,18
"77395","S01008254",2011,428,130,298,40
"77396","S01008255",2011,292,58,234,15
"77397","S01008256",2011,361,147,214,41
"77398","S01008257",2011,357,110,247,44
"77399","S01008258",2011,401,10,391,72
"77400","S01008259",2011,376,70,306,79
"77401","S01008260",2011,355,144,211,38
"77402","S01008261",2011,368,152,216,19
"77403","S01008262",2011,252,43,209,33
"77404","S01008263",2011,284,36,248,56
"77405","S01008264",2011,330,125,205,17
"77406","S01008265",2011,332,7,325,29
"77407","S01008266",2011,319,19,300,17
"77408","S01008267",2011,350,69,281,55
"77409","S01008268",2011,355,5,350,34
"77410","S01008269",2011,400,48,352,16
"77411","S01008270",2011,394,19,375,39
"77412","S01008271",2011,386,68,318,104
"77413","S01008272",2011,414,51,363,46
"77414","S01008273",2011,346,27,319,23
"77415","S01008274",2011,322,107,215,21
"77416","S01008275",2011,258,51,207,18
"77417","S01008276",2011,199,17,182,12
"77418","S01008277",2011,213,7,206,63
"77419","S01008278",2011,334,6,328,53
"77420","S01008279",2011,331,88,243,15
"77421","S01008280",2011,425,85,340,67
"77422","S01008281",2011,316,35,281,85
"77423","S01008282",2011,299,35,264,39
"77424","S01008283",2011,184,11,173,19
"77425","S01008284",2011,348,75,273,28
"77426","S01008285",2011,355,164,191,30
"77427","S01008286",2011,303,115,188,16
"77428","S01008287",2011,311,98,213,19
"77429","S01008288",2011,413,90,323,41
"77430","S01008289",2011,319,88,231,59
"77431","S01008290",2011,397,79,318,66
"77432","S01008291",2011,369,14,355,33
"77433","S01008292",2011,310,131,179,13
"77434","S01008293",2011,199,3,196,8
"77435","S01008294",2011,326,40,286,19
"77436","S01008295",2011,380,20,360,22
"77437","S01008296",2011,320,117,203,14
"77438","S01008297",2011,295,39,256,12
"77439","S01008298",2011,303,6,297,26
"77440","S01008299",2011,370,182,188,30
"77441","S01008300",2011,377,127,250,23
"77442","S01008301",2011,316,3,313,11
"77443","S01008302",2011,300,14,286,18
"77444","S01008303",2011,272,50,222,37
"77445","S01008304",2011,212,37,175,17
"77446","S01008305",2011,315,3,312,10
"77447","S01008306",2011,239,5,234,5
"77448","S01008307",2011,216,13,203,6
"77449","S01008308",2011,238,3,235,7
"77450","S01008309",2011,372,161,211,47
"77451","S01008310",2011,467,124,343,40
"77452","S01008311",2011,172,54,118,10
"77453","S01008312",2011,171,41,130,8
"77454","S01008313",2011,403,166,237,27
"77455","S01008314",2011,311,192,119,29
"77456","S01008315",2011,450,246,204,63
"77457","S01008316",2011,265,187,78,15
"77458","S01008317",2011,316,109,207,26
"77459","S01008318",2011,368,17,351,20
"77460","S01008319",2011,373,96,277,21
"77461","S01008320",2011,308,58,250,10
"77462","S01008321",2011,195,4,191,4
"77463","S01008322",2011,501,143,358,45
"77464","S01008323",2011,324,141,183,25
"77465","S01008324",2011,254,65,189,24
"77466","S01008325",2011,291,106,185,19
"77467","S01008326",2011,455,192,263,40
"77468","S01008327",2011,386,101,285,20
"77469","S01008328",2011,242,2,240,14
"77470","S01008329",2011,291,3,288,13
"77471","S01008330",2011,290,3,287,10
"77472","S01008331",2011,246,3,243,29
"77473","S01008332",2011,378,6,372,33
"77474","S01008333",2011,454,34,420,64
"77475","S01008334",2011,321,3,318,19
"77476","S01008335",2011,330,80,250,17
"77477","S01008336",2011,268,75,193,10
"77478","S01008337",2011,365,61,304,15
"77479","S01008338",2011,262,2,260,11
"77480","S01008339",2011,227,2,225,13
"77481","S01008340",2011,313,2,311,24
"77482","S01008341",2011,204,1,203,3
"77483","S01008342",2011,327,81,246,7
"77484","S01008343",2011,328,0,0,5
"77485","S01008344",2011,355,5,350,12
"77486","S01008345",2011,350,1,349,16
"77487","S01008346",2011,359,1,358,10
"77488","S01008347",2011,489,6,483,41
"77489","S01008348",2011,326,3,323,17
"77490","S01008349",2011,313,1,312,12
"77491","S01008350",2011,257,5,252,6
"77492","S01008351",2011,347,2,345,13
"77493","S01008352",2011,248,0,0,10
"77494","S01008353",2011,198,1,197,7
"77495","S01008354",2011,286,25,261,15
"77496","S01008355",2011,299,65,234,23
"77497","S01008356",2011,259,3,256,14
"77498","S01008357",2011,296,4,292,23
"77499","S01008358",2011,346,70,276,35
"77500","S01008359",2011,250,7,243,13
"77501","S01008360",2011,319,4,315,10
"77502","S01008361",2011,201,4,197,7
"77503","S01008362",2011,409,1,408,37
"77504","S01008363",2011,320,2,318,34
"77505","S01008364",2011,322,10,312,19
"77506","S01008365",2011,288,1,287,10
"77507","S01008366",2011,424,105,319,13
"77508","S01008367",2011,368,123,245,39
"77509","S01008368",2011,311,12,299,22
"77510","S01008369",2011,235,28,207,11
"77511","S01008370",2011,300,17,283,17
"77512","S01008371",2011,302,2,300,6
"77513","S01008372",2011,288,1,287,7
"77514","S01008373",2011,269,0,0,2
"77515","S01008374",2011,264,2,262,11
"77516","S01008375",2011,285,1,284,3
"77517","S01008376",2011,212,5,207,13
"77518","S01008377",2011,291,0,0,20
"77519","S01008378",2011,421,14,407,24
"77520","S01008379",2011,206,1,205,2
"77521","S01008380",2011,238,1,237,3
"77522","S01008381",2011,229,0,0,0
"77523","S01008382",2011,248,1,247,4
"77524","S01008383",2011,181,2,179,5
"77525","S01008384",2011,387,3,384,6
"77526","S01008385",2011,252,6,246,3
"77527","S01008386",2011,337,6,331,9
"77528","S01008387",2011,241,4,237,10
"77529","S01008388",2011,243,2,241,13
"77530","S01008389",2011,312,28,284,7
"77531","S01008390",2011,255,3,252,1
"77532","S01008391",2011,349,35,314,25
"77533","S01008392",2011,330,7,323,6
"77534","S01008393",2011,369,3,366,17
"77535","S01008394",2011,276,1,275,6
"77536","S01008395",2011,189,0,0,4
"77537","S01008396",2011,303,1,302,3
"77538","S01008397",2011,346,0,0,9
"77539","S01008398",2011,238,21,217,13
"77540","S01008399",2011,257,1,256,11
"77541","S01008400",2011,261,0,0,12
"77542","S01008401",2011,404,1,403,11
"77543","S01008402",2011,415,5,410,8
"77544","S01008403",2011,218,1,217,2
"77545","S01008404",2011,349,4,345,15
"77546","S01008405",2011,266,3,263,6
"77547","S01008406",2011,451,101,350,55
"77548","S01008407",2011,284,29,255,38
"77549","S01008408",2011,265,9,256,18
"77550","S01008409",2011,390,73,317,41
"77551","S01008410",2011,269,3,266,15
"77552","S01008411",2011,247,12,235,11
"77553","S01008412",2011,274,31,243,11
"77554","S01008413",2011,222,49,173,12
"77555","S01008414",2011,152,1,151,4
"77556","S01008415",2011,347,27,320,26
"77557","S01008416",2011,437,134,303,35
"77558","S01008417",2011,299,6,293,22
"77559","S01008418",2011,312,4,308,29
"77560","S01008419",2011,193,35,158,13
"77561","S01008420",2011,190,4,186,7
"77562","S01008421",2011,394,67,327,33
"77563","S01008422",2011,241,2,239,9
"77564","S01008423",2011,398,6,392,41
"77565","S01008424",2011,338,2,336,3
"77566","S01008425",2011,409,19,390,10
"77567","S01008426",2011,264,52,212,22
"77568","S01008427",2011,397,2,395,16
"77569","S01008428",2011,316,73,243,14
"77570","S01008429",2011,352,11,341,9
"77571","S01008430",2011,276,17,259,19
"77572","S01008431",2011,352,42,310,4
"77573","S01008432",2011,293,9,284,8
"77574","S01008433",2011,348,6,342,14
"77575","S01008434",2011,322,10,312,10
"77576","S01008435",2011,301,4,297,9
"77577","S01008436",2011,356,9,347,23
"77578","S01008437",2011,367,58,309,54
"77579","S01008438",2011,189,5,184,42
"77580","S01008439",2011,434,2,432,22
"77581","S01008440",2011,403,17,386,15
"77582","S01008441",2011,186,1,185,3
"77583","S01008442",2011,303,3,300,42
"77584","S01008443",2011,252,13,239,10
"77585","S01008444",2011,260,8,252,62
"77586","S01008445",2011,403,171,232,97
"77587","S01008446",2011,323,2,321,15
"77588","S01008447",2011,286,3,283,20
"77589","S01008448",2011,315,14,301,19
"77590","S01008449",2011,351,242,109,29
"77591","S01008450",2011,256,167,89,30
"77592","S01008451",2011,325,279,46,14
"77593","S01008452",2011,271,217,54,25
"77594","S01008453",2011,215,128,87,27
"77595","S01008454",2011,393,293,100,22
"77596","S01008455",2011,501,275,226,75
"77597","S01008456",2011,528,337,191,50
"77598","S01008457",2011,353,168,185,40
"77599","S01008458",2011,428,120,308,58
"77600","S01008459",2011,393,250,143,37
"77601","S01008460",2011,368,272,96,29
"77602","S01008461",2011,450,303,147,29
"77603","S01008462",2011,349,308,41,7
"77604","S01008463",2011,355,223,132,29
"77605","S01008464",2011,413,11,402,80
"77606","S01008465",2011,346,16,330,92
"77607","S01008466",2011,318,12,306,86
"77608","S01008467",2011,330,9,321,57
"77609","S01008468",2011,232,62,170,28
"77610","S01008469",2011,229,32,197,45
"77611","S01008470",2011,298,147,151,36
"77612","S01008471",2011,347,235,112,36
"77613","S01008472",2011,277,80,197,50
"77614","S01008473",2011,307,127,180,46
"77615","S01008474",2011,440,214,226,77
"77616","S01008475",2011,327,86,241,72
"77617","S01008476",2011,406,125,281,66
"77618","S01008477",2011,465,146,319,64
"77619","S01008478",2011,439,166,273,80
"77620","S01008479",2011,407,89,318,77
"77621","S01008480",2011,279,97,182,72
"77622","S01008481",2011,373,111,262,27
"77623","S01008482",2011,316,94,222,43
"77624","S01008483",2011,327,116,211,50
"77625","S01008484",2011,342,44,298,25
"77626","S01008485",2011,408,21,387,113
"77627","S01008486",2011,459,114,345,49
"77628","S01008487",2011,417,61,356,93
"77629","S01008488",2011,416,72,344,78
"77630","S01008489",2011,305,60,245,43
"77631","S01008490",2011,528,56,472,127
"77632","S01008491",2011,487,66,421,155
"77633","S01008492",2011,515,154,361,114
"77634","S01008493",2011,420,103,317,84
"77635","S01008494",2011,409,52,357,160
"77636","S01008495",2011,589,57,532,305
"77637","S01008496",2011,676,37,639,370
"77638","S01008497",2011,572,48,524,285
"77639","S01008498",2011,525,111,414,208
"77640","S01008499",2011,591,96,495,293
"77641","S01008500",2011,209,125,84,52
"77642","S01008501",2011,316,28,288,180
"77643","S01008502",2011,373,4,369,192
"77644","S01008503",2011,443,14,429,168
"77645","S01008504",2011,543,5,538,138
"77646","S01008505",2011,330,2,328,56
"77647","S01008506",2011,442,22,420,95
"77648","S01008507",2011,386,21,365,112
"77649","S01008508",2011,358,1,357,38
"77650","S01008509",2011,509,11,498,58
"77651","S01008510",2011,390,3,387,36
"77652","S01008511",2011,358,4,354,23
"77653","S01008512",2011,201,0,0,4
"77654","S01008513",2011,258,3,255,3
"77655","S01008514",2011,397,14,383,38
"77656","S01008515",2011,297,1,296,28
"77657","S01008516",2011,592,29,563,243
"77658","S01008517",2011,463,7,456,165
"77659","S01008518",2011,378,5,373,66
"77660","S01008519",2011,324,3,321,28
"77661","S01008520",2011,433,4,429,15
"77662","S01008521",2011,338,2,336,5
"77663","S01008522",2011,228,0,0,24
"77664","S01008523",2011,434,3,431,47
"77665","S01008524",2011,442,206,236,50
"77666","S01008525",2011,380,210,170,41
"77667","S01008526",2011,448,77,371,56
"77668","S01008527",2011,333,15,318,71
"77669","S01008528",2011,304,8,296,69
"77670","S01008529",2011,349,62,287,32
"77671","S01008530",2011,369,153,216,40
"77672","S01008531",2011,394,142,252,44
"77673","S01008532",2011,213,71,142,13
"77674","S01008533",2011,179,32,147,105
"77675","S01008534",2011,274,10,264,59
"77676","S01008535",2011,284,2,282,7
"77677","S01008536",2011,263,7,256,12
"77678","S01008537",2011,280,0,0,7
"77679","S01008538",2011,242,0,0,3
"77680","S01008539",2011,346,0,0,21
"77681","S01008540",2011,373,2,371,14
"77682","S01008541",2011,323,1,322,14
"77683","S01008542",2011,337,1,336,12
"77684","S01008543",2011,259,1,258,12
"77685","S01008544",2011,216,2,214,11
"77686","S01008545",2011,334,3,331,23
"77687","S01008546",2011,337,0,0,5
"77688","S01008547",2011,424,16,408,34
"77689","S01008548",2011,347,32,315,44
"77690","S01008549",2011,439,45,394,57
"77691","S01008550",2011,346,6,340,38
"77692","S01008551",2011,496,27,469,26
"77693","S01008552",2011,383,16,367,34
"77694","S01008553",2011,244,52,192,14
"77695","S01008554",2011,368,203,165,39
"77696","S01008555",2011,528,336,192,45
"77697","S01008556",2011,346,136,210,36
"77698","S01008557",2011,429,204,225,45
"77699","S01008558",2011,433,144,289,55
"77700","S01008559",2011,295,73,222,29
"77701","S01008560",2011,295,81,214,28
"77702","S01008561",2011,277,75,202,27
"77703","S01008562",2011,344,266,78,12
"77704","S01008563",2011,369,114,255,49
"77705","S01008564",2011,315,68,247,34
"77706","S01008565",2011,414,185,229,27
"77707","S01008566",2011,433,140,293,34
"77708","S01008567",2011,289,106,183,24
"77709","S01008568",2011,350,15,335,66
"77710","S01008569",2011,400,316,84,35
"77711","S01008570",2011,426,261,165,31
"77712","S01008571",2011,323,87,236,28
"77713","S01008572",2011,346,44,302,43
"77714","S01008573",2011,321,20,301,25
"77715","S01008574",2011,293,7,286,20
"77716","S01008575",2011,335,5,330,29
"77717","S01008576",2011,386,7,379,48
"77718","S01008577",2011,363,6,357,25
"77719","S01008578",2011,291,3,288,10
"77720","S01008579",2011,301,5,296,24
"77721","S01008580",2011,261,40,221,36
"77722","S01008581",2011,464,150,314,59
"77723","S01008582",2011,486,136,350,54
"77724","S01008583",2011,352,86,266,62
"77725","S01008584",2011,394,86,308,90
"77726","S01008585",2011,249,57,192,36
"77727","S01008586",2011,360,105,255,39
"77728","S01008587",2011,316,7,309,45
"77729","S01008588",2011,344,4,340,48
"77730","S01008589",2011,172,43,129,5
"77731","S01008590",2011,413,11,402,83
"77732","S01008591",2011,327,15,312,69
"77733","S01008592",2011,356,49,307,75
"77734","S01008593",2011,309,5,304,15
"77735","S01008594",2011,428,11,417,76
"77736","S01008595",2011,508,212,296,83
"77737","S01008596",2011,455,122,333,119
"77738","S01008597",2011,388,8,380,36
"77739","S01008598",2011,329,34,295,136
"77740","S01008599",2011,366,8,358,107
"77741","S01008600",2011,306,16,290,89
"77742","S01008601",2011,314,28,286,163
"77743","S01008602",2011,323,24,299,142
"77744","S01008603",2011,544,59,485,283
"77745","S01008604",2011,418,9,409,185
"77746","S01008605",2011,337,9,328,147
"77747","S01008606",2011,287,8,279,53
"77748","S01008607",2011,283,37,246,19
"77749","S01008608",2011,326,0,0,36
"77750","S01008609",2011,410,31,379,36
"77751","S01008610",2011,416,13,403,79
"77752","S01008611",2011,592,12,580,320
"77753","S01008612",2011,376,44,332,225
"77754","S01008613",2011,371,12,359,130
"77755","S01008614",2011,307,33,274,177
"77756","S01008615",2011,331,14,317,159
"77757","S01008616",2011,259,0,0,154
"77758","S01008617",2011,281,3,278,148
"77759","S01008618",2011,267,0,0,153
"77760","S01008619",2011,203,1,202,96
"77761","S01008620",2011,290,9,281,158
"77762","S01008621",2011,272,3,269,142
"77763","S01008622",2011,200,0,0,84
"77764","S01008623",2011,343,3,340,117
"77765","S01008624",2011,346,49,297,32
"77766","S01008625",2011,239,15,224,15
"77767","S01008626",2011,388,4,384,84
"77768","S01008627",2011,256,2,254,28
"77769","S01008628",2011,262,7,255,81
"77770","S01008629",2011,301,33,268,81
"77771","S01008630",2011,277,1,276,118
"77772","S01008631",2011,453,11,442,187
"77773","S01008632",2011,420,10,410,173
"77774","S01008633",2011,452,20,432,60
"77775","S01008634",2011,276,4,272,59
"77776","S01008635",2011,362,3,359,91
"77777","S01008636",2011,367,2,365,104
"77778","S01008637",2011,309,12,297,95
"77779","S01008638",2011,344,104,240,118
"77780","S01008639",2011,430,5,425,180
"77781","S01008640",2011,351,1,350,160
"77782","S01008641",2011,351,2,349,165
"77783","S01008642",2011,433,2,431,170
"77784","S01008643",2011,323,5,318,111
"77785","S01008644",2011,386,66,320,136
"77786","S01008645",2011,360,10,350,137
"77787","S01008646",2011,453,29,424,187
"77788","S01008647",2011,330,4,326,140
"77789","S01008648",2011,339,44,295,172
"77790","S01008649",2011,560,41,519,269
"77791","S01008650",2011,470,39,431,225
"77792","S01008651",2011,497,105,392,218
"77793","S01008652",2011,387,137,250,143
"77794","S01008653",2011,402,122,280,179
"77795","S01008654",2011,585,126,459,263
"77796","S01008655",2011,442,59,383,225
"77797","S01008656",2011,426,135,291,181
"77798","S01008657",2011,361,103,258,125
"77799","S01008658",2011,555,157,398,232
"77800","S01008659",2011,446,82,364,243
"77801","S01008660",2011,444,53,391,255
"77802","S01008661",2011,437,161,276,181
"77803","S01008662",2011,276,70,206,155
"77804","S01008663",2011,434,92,342,208
"77805","S01008664",2011,396,46,350,190
"77806","S01008665",2011,524,92,432,234
"77807","S01008666",2011,311,12,299,171
"77808","S01008667",2011,308,50,258,109
"77809","S01008668",2011,280,11,269,142
"77810","S01008669",2011,173,6,167,130
"77811","S01008670",2011,260,10,250,169
"77812","S01008671",2011,331,22,309,201
"77813","S01008672",2011,341,16,325,193
"77814","S01008673",2011,649,109,540,310
"77815","S01008674",2011,413,73,340,240
"77816","S01008675",2011,476,112,364,254
"77817","S01008676",2011,338,44,294,157
"77818","S01008677",2011,420,46,374,246
"77819","S01008678",2011,393,65,328,242
"77820","S01008679",2011,546,236,310,231
"77821","S01008680",2011,326,84,242,177
"77822","S01008681",2011,540,155,385,242
"77823","S01008682",2011,431,93,338,195
"77824","S01008683",2011,576,320,256,137
"77825","S01008684",2011,532,268,264,138
"77826","S01008685",2011,489,147,342,185
"77827","S01008686",2011,585,281,304,158
"77828","S01008687",2011,419,22,397,199
"77829","S01008688",2011,457,47,410,167
"77830","S01008689",2011,548,68,480,235
"77831","S01008690",2011,598,20,578,246
"77832","S01008691",2011,678,65,613,272
"77833","S01008692",2011,391,93,298,111
"77834","S01008693",2011,224,6,218,15
"77835","S01008694",2011,537,25,512,176
"77836","S01008695",2011,338,11,327,75
"77837","S01008696",2011,285,2,283,25
"77838","S01008697",2011,453,4,449,48
"77839","S01008698",2011,209,5,204,15
"77840","S01008699",2011,470,121,349,66
"77841","S01008700",2011,248,6,242,37
"77842","S01008701",2011,200,154,46,6
"77843","S01008702",2011,312,38,274,154
"77844","S01008703",2011,456,328,128,41
"77845","S01008704",2011,307,183,124,30
"77846","S01008705",2011,236,127,109,33
"77847","S01008706",2011,243,189,54,15
"77848","S01008707",2011,387,271,116,30
"77849","S01008708",2011,452,390,62,25
"77850","S01008709",2011,299,138,161,40
"77851","S01008710",2011,208,116,92,23
"77852","S01008711",2011,353,189,164,39
"77853","S01008712",2011,499,345,154,36
"77854","S01008713",2011,292,190,102,25
"77855","S01008714",2011,297,81,216,42
"77856","S01008715",2011,367,123,244,25
"77857","S01008716",2011,295,106,189,26
"77858","S01008717",2011,181,5,176,28
"77859","S01008718",2011,222,9,213,20
"77860","S01008719",2011,420,17,403,88
"77861","S01008720",2011,243,29,214,49
"77862","S01008721",2011,310,4,306,20
"77863","S01008722",2011,480,80,400,20
"77864","S01008723",2011,257,16,241,12
"77865","S01008724",2011,400,51,349,29
"77866","S01008725",2011,343,36,307,28
"77867","S01008726",2011,241,3,238,11
"77868","S01008727",2011,454,39,415,57
"77869","S01008728",2011,229,48,181,32
"77870","S01008729",2011,277,14,263,28
"77871","S01008730",2011,411,42,369,130
"77872","S01008731",2011,226,39,187,29
"77873","S01008732",2011,340,72,268,89
"77874","S01008733",2011,473,27,446,113
"77875","S01008734",2011,266,28,238,27
"77876","S01008735",2011,385,2,383,20
"77877","S01008736",2011,290,30,260,6
"77878","S01008737",2011,339,6,333,15
"77879","S01008738",2011,299,3,296,5
"77880","S01008739",2011,240,12,228,13
"77881","S01008740",2011,227,5,222,7
"77882","S01008741",2011,395,10,385,10
"77883","S01008742",2011,280,50,230,35
"77884","S01008743",2011,485,124,361,98
"77885","S01008744",2011,519,79,440,71
"77886","S01008745",2011,241,4,237,34
"77887","S01008746",2011,572,214,358,126
"77888","S01008747",2011,234,4,230,21
"77889","S01008748",2011,283,7,276,11
"77890","S01008749",2011,402,13,389,17
"77891","S01008750",2011,313,8,305,9
"77892","S01008751",2011,304,84,220,28
"77893","S01008752",2011,459,194,265,76
"77894","S01008753",2011,314,109,205,56
"77895","S01008754",2011,362,140,222,59
"77896","S01008755",2011,541,180,361,126
"77897","S01008756",2011,418,172,246,48
"77898","S01008757",2011,397,236,161,43
"77899","S01008758",2011,444,173,271,43
"77900","S01008759",2011,322,147,175,32
"77901","S01008760",2011,500,300,200,47
"77902","S01008761",2011,295,35,260,138
"77903","S01008762",2011,301,12,289,30
"77904","S01008763",2011,433,15,418,61
"77905","S01008764",2011,306,41,265,32
"77906","S01008765",2011,393,10,383,77
"77907","S01008766",2011,413,19,394,30
"77908","S01008767",2011,266,39,227,25
"77909","S01008768",2011,256,56,200,49
"77910","S01008769",2011,380,7,373,153
"77911","S01008770",2011,431,13,418,226
"77912","S01008771",2011,411,106,305,115
"77913","S01008772",2011,395,51,344,57
"77914","S01008773",2011,596,130,466,157
"77915","S01008774",2011,495,130,365,146
"77916","S01008775",2011,218,9,209,51
"77917","S01008776",2011,467,165,302,127
"77918","S01008777",2011,637,336,301,112
"77919","S01008778",2011,664,113,551,283
"77920","S01008779",2011,402,9,393,180
"77921","S01008780",2011,329,48,281,133
"77922","S01008781",2011,530,196,334,166
"77923","S01008782",2011,400,57,343,158
"77924","S01008783",2011,236,45,191,98
"77925","S01008784",2011,268,53,215,122
"77926","S01008785",2011,485,235,250,123
"77927","S01008786",2011,540,49,491,233
"77928","S01008787",2011,200,173,27,20
"77929","S01008788",2011,376,64,312,140
"77930","S01008789",2011,375,159,216,63
"77931","S01008790",2011,353,118,235,109
"77932","S01008791",2011,421,33,388,206
"77933","S01008792",2011,415,74,341,112
"77934","S01008793",2011,266,101,165,82
"77935","S01008794",2011,492,199,293,88
"77936","S01008795",2011,618,34,584,264
"77937","S01008796",2011,622,158,464,265
"77938","S01008797",2011,579,66,513,231
"77939","S01008798",2011,502,91,411,169
"77940","S01008799",2011,322,52,270,161
"77941","S01008800",2011,651,33,618,291
"77942","S01008801",2011,582,52,530,263
"77943","S01008802",2011,614,86,528,260
"77944","S01008803",2011,575,163,412,224
"77945","S01008804",2011,332,86,246,133
"77946","S01008805",2011,334,12,322,192
"77947","S01008806",2011,558,69,489,259
"77948","S01008807",2011,490,39,451,200
"77949","S01008808",2011,391,74,317,118
"77950","S01008809",2011,324,18,306,157
"77951","S01008810",2011,383,3,380,164
"77952","S01008811",2011,389,9,380,175
"77953","S01008812",2011,260,2,258,116
"77954","S01008813",2011,508,182,326,136
"77955","S01008814",2011,403,35,368,134
"77956","S01008815",2011,557,119,438,189
"77957","S01008816",2011,321,51,270,80
"77958","S01008817",2011,425,130,295,109
"77959","S01008818",2011,371,32,339,85
"77960","S01008819",2011,368,23,345,91
"77961","S01008820",2011,616,223,393,148
"77962","S01008821",2011,271,12,259,34
"77963","S01008822",2011,286,6,280,21
"77964","S01008823",2011,269,3,266,35
"77965","S01008824",2011,510,23,487,89
"77966","S01008825",2011,296,8,288,42
"77967","S01008826",2011,378,73,305,81
"77968","S01008827",2011,273,1,272,12
"77969","S01008828",2011,439,27,412,77
"77970","S01008829",2011,297,31,266,29
"77971","S01008830",2011,334,10,324,38
"77972","S01008831",2011,359,22,337,27
"77973","S01008832",2011,350,2,348,55
"77974","S01008833",2011,526,55,471,85
"77975","S01008834",2011,519,5,514,95
"77976","S01008835",2011,407,22,385,35
"77977","S01008836",2011,413,90,323,95
"77978","S01008837",2011,630,52,578,240
"77979","S01008838",2011,606,20,586,241
"77980","S01008839",2011,549,47,502,182
"77981","S01008840",2011,510,8,502,152
"77982","S01008841",2011,291,14,277,89
"77983","S01008842",2011,433,20,413,203
"77984","S01008843",2011,464,15,449,201
"77985","S01008844",2011,355,30,325,152
"77986","S01008845",2011,420,8,412,214
"77987","S01008846",2011,386,34,352,157
"77988","S01008847",2011,263,3,260,122
"77989","S01008848",2011,384,29,355,142
"77990","S01008849",2011,396,3,393,197
"77991","S01008850",2011,401,5,396,166
"77992","S01008851",2011,634,135,499,231
"77993","S01008852",2011,503,0,0,175
"77994","S01008853",2011,352,4,348,160
"77995","S01008854",2011,483,4,479,227
"77996","S01008855",2011,620,10,610,285
"77997","S01008856",2011,296,7,289,137
"77998","S01008857",2011,434,3,431,148
"77999","S01008858",2011,328,2,326,103
"78000","S01008859",2011,712,97,615,337
"78001","S01008860",2011,500,31,469,182
"78002","S01008861",2011,349,3,346,74
"78003","S01008862",2011,561,40,521,269
"78004","S01008863",2011,392,16,376,139
"78005","S01008864",2011,410,4,406,111
"78006","S01008865",2011,455,5,450,148
"78007","S01008866",2011,467,2,465,183
"78008","S01008867",2011,421,3,418,101
"78009","S01008868",2011,391,5,386,222
"78010","S01008869",2011,615,66,549,217
"78011","S01008870",2011,426,5,421,153
"78012","S01008871",2011,503,0,0,178
"78013","S01008872",2011,401,8,393,162
"78014","S01008873",2011,334,1,333,79
"78015","S01008874",2011,514,55,459,141
"78016","S01008875",2011,502,32,470,182
"78017","S01008876",2011,291,3,288,21
"78018","S01008877",2011,243,10,233,32
"78019","S01008878",2011,459,72,387,50
"78020","S01008879",2011,411,36,375,54
"78021","S01008880",2011,291,16,275,34
"78022","S01008881",2011,264,4,260,40
"78023","S01008882",2011,401,0,0,35
"78024","S01008883",2011,362,3,359,23
"78025","S01008884",2011,316,1,315,16
"78026","S01008885",2011,345,4,341,20
"78027","S01008886",2011,425,6,419,86
"78028","S01008887",2011,358,8,350,39
"78029","S01008888",2011,373,4,369,124
"78030","S01008889",2011,267,4,263,27
"78031","S01008890",2011,308,16,292,10
"78032","S01008891",2011,329,0,0,8
"78033","S01008892",2011,533,66,467,86
"78034","S01008893",2011,353,4,349,14
"78035","S01008894",2011,337,6,331,12
"78036","S01008895",2011,301,2,299,15
"78037","S01008896",2011,208,0,0,26
"78038","S01008897",2011,304,4,300,21
"78039","S01008898",2011,331,1,330,11
"78040","S01008899",2011,389,169,220,31
"78041","S01008900",2011,415,102,313,56
"78042","S01008901",2011,374,102,272,44
"78043","S01008902",2011,485,164,321,71
"78044","S01008903",2011,463,132,331,27
"78045","S01008904",2011,431,125,306,108
"78046","S01008905",2011,510,244,266,93
"78047","S01008906",2011,386,213,173,67
"78048","S01008907",2011,249,201,48,18
"78049","S01008908",2011,421,148,273,85
"78050","S01008909",2011,347,15,332,88
"78051","S01008910",2011,211,5,206,58
"78052","S01008911",2011,432,7,425,209
"78053","S01008912",2011,333,14,319,37
"78054","S01008913",2011,272,3,269,75
"78055","S01008914",2011,398,63,335,29
"78056","S01008915",2011,236,18,218,21
"78057","S01008916",2011,593,306,287,67
"78058","S01008917",2011,379,254,125,33
"78059","S01008918",2011,293,248,45,20
"78060","S01008919",2011,264,213,51,19
"78061","S01008920",2011,586,100,486,220
"78062","S01008921",2011,375,263,112,30
"78063","S01008922",2011,400,140,260,78
"78064","S01008923",2011,394,183,211,62
"78065","S01008924",2011,372,266,106,41
"78066","S01008925",2011,266,24,242,83
"78067","S01008926",2011,242,51,191,36
"78068","S01008927",2011,416,97,319,119
"78069","S01008928",2011,298,124,174,54
"78070","S01008929",2011,475,424,51,19
"78071","S01008930",2011,427,355,72,16
"78072","S01008931",2011,339,235,104,18
"78073","S01008932",2011,404,81,323,129
"78074","S01008933",2011,289,201,88,19
"78075","S01008934",2011,354,115,239,62
"78076","S01008935",2011,377,10,367,24
"78077","S01008936",2011,157,1,156,6
"78078","S01008937",2011,424,13,411,63
"78079","S01008938",2011,285,3,282,13
"78080","S01008939",2011,323,3,320,20
"78081","S01008940",2011,255,0,0,16
"78082","S01008941",2011,350,14,336,32
"78083","S01008942",2011,333,2,331,42
"78084","S01008943",2011,340,2,338,8
"78085","S01008944",2011,429,2,427,24
"78086","S01008945",2011,299,1,298,11
"78087","S01008946",2011,397,5,392,26
"78088","S01008947",2011,449,3,446,15
"78089","S01008948",2011,285,13,272,16
"78090","S01008949",2011,393,74,319,33
"78091","S01008950",2011,420,66,354,29
"78092","S01008951",2011,435,138,297,55
"78093","S01008952",2011,421,140,281,69
"78094","S01008953",2011,424,119,305,38
"78095","S01008954",2011,434,132,302,44
"78096","S01008955",2011,282,20,262,23
"78097","S01008956",2011,406,30,376,48
"78098","S01008957",2011,429,101,328,47
"78099","S01008958",2011,404,184,220,35
"78100","S01008959",2011,380,60,320,37
"78101","S01008960",2011,328,7,321,31
"78102","S01008961",2011,319,5,314,39
"78103","S01008962",2011,275,5,270,15
"78104","S01008963",2011,349,7,342,23
"78105","S01008964",2011,211,0,0,8
"78106","S01008965",2011,321,17,304,5
"78107","S01008966",2011,252,1,251,10
"78108","S01008967",2011,430,3,427,9
"78109","S01008968",2011,398,17,381,7
"78110","S01008969",2011,460,20,440,39
"78111","S01008970",2011,438,11,427,33
"78112","S01008971",2011,273,1,272,12
"78113","S01008972",2011,304,2,302,24
"78114","S01008973",2011,361,28,333,36
"78115","S01008974",2011,374,15,359,68
"78116","S01008975",2011,449,135,314,63
"78117","S01008976",2011,212,2,210,5
"78118","S01008977",2011,256,3,253,13
"78119","S01008978",2011,252,7,245,53
"78120","S01008979",2011,308,9,299,84
"78121","S01008980",2011,334,15,319,94
"78122","S01008981",2011,316,9,307,12
"78123","S01008982",2011,352,9,343,96
"78124","S01008983",2011,314,14,300,75
"78125","S01008984",2011,227,5,222,72
"78126","S01008985",2011,326,4,322,49
"78127","S01008986",2011,343,1,342,23
"78128","S01008987",2011,330,1,329,11
"78129","S01008988",2011,481,39,442,111
"78130","S01008989",2011,323,5,318,78
"78131","S01008990",2011,383,2,381,91
"78132","S01008991",2011,381,5,376,49
"78133","S01008992",2011,270,31,239,32
"78134","S01008993",2011,476,7,469,99
"78135","S01008994",2011,337,100,237,25
"78136","S01008995",2011,352,16,336,31
"78137","S01008996",2011,251,57,194,19
"78138","S01008997",2011,411,52,359,59
"78139","S01008998",2011,236,111,125,21
"78140","S01008999",2011,411,82,329,37
"78141","S01009000",2011,393,8,385,35
"78142","S01009001",2011,323,29,294,16
"78143","S01009002",2011,348,35,313,122
"78144","S01009003",2011,394,24,370,41
"78145","S01009004",2011,270,15,255,22
"78146","S01009005",2011,327,9,318,37
"78147","S01009006",2011,318,44,274,28
"78148","S01009007",2011,290,42,248,22
"78149","S01009008",2011,445,51,394,59
"78150","S01009009",2011,252,99,153,30
"78151","S01009010",2011,404,35,369,48
"78152","S01009011",2011,319,5,314,22
"78153","S01009012",2011,296,3,293,18
"78154","S01009013",2011,363,15,348,28
"78155","S01009014",2011,284,69,215,25
"78156","S01009015",2011,303,48,255,25
"78157","S01009016",2011,250,28,222,12
"78158","S01009017",2011,278,83,195,24
"78159","S01009018",2011,326,60,266,29
"78160","S01009019",2011,221,40,181,13
"78161","S01009020",2011,366,75,291,50
"78162","S01009021",2011,344,37,307,27
"78163","S01009022",2011,447,80,367,31
"78164","S01009023",2011,435,49,386,17
"78165","S01009024",2011,476,102,374,29
"78166","S01009025",2011,433,42,391,15
"78167","S01009026",2011,411,36,375,21
"78168","S01009027",2011,373,36,337,18
"78169","S01009028",2011,232,28,204,4
"78170","S01009029",2011,286,41,245,13
"78171","S01009030",2011,321,52,269,11
"78172","S01009031",2011,356,45,311,31
"78173","S01009032",2011,299,19,280,16
"78174","S01009033",2011,359,12,347,21
"78175","S01009034",2011,283,18,265,13
"78176","S01009035",2011,381,41,340,17
"78177","S01009036",2011,437,87,350,38
"78178","S01009037",2011,367,81,286,18
"78179","S01009038",2011,440,80,360,30
"78180","S01009039",2011,313,155,158,17
"78181","S01009040",2011,338,105,233,39
"78182","S01009041",2011,503,154,349,86
"78183","S01009042",2011,401,108,293,30
"78184","S01009043",2011,293,104,189,18
"78185","S01009044",2011,412,117,295,28
"78186","S01009045",2011,287,66,221,17
"78187","S01009046",2011,363,33,330,31
"78188","S01009047",2011,336,30,306,15
"78189","S01009048",2011,348,25,323,15
"78190","S01009049",2011,274,26,248,14
"78191","S01009050",2011,370,73,297,22
"78192","S01009051",2011,292,74,218,14
"78193","S01009052",2011,305,54,251,25
"78194","S01009053",2011,259,187,72,3
"78195","S01009054",2011,249,81,168,8
"78196","S01009055",2011,361,57,304,15
"78197","S01009056",2011,217,101,116,11
"78198","S01009057",2011,282,137,145,23
"78199","S01009058",2011,385,151,234,20
"78200","S01009059",2011,347,69,278,22
"78201","S01009060",2011,188,2,186,14
"78202","S01009061",2011,326,84,242,9
"78203","S01009062",2011,298,128,170,2
"78204","S01009063",2011,291,28,263,10
"78205","S01009064",2011,264,76,188,9
"78206","S01009065",2011,328,140,188,33
"78207","S01009066",2011,319,107,212,19
"78208","S01009067",2011,302,16,286,13
"78209","S01009068",2011,386,94,292,29
"78210","S01009069",2011,249,4,245,4
"78211","S01009070",2011,269,16,253,21
"78212","S01009071",2011,228,73,155,3
"78213","S01009072",2011,199,33,166,9
"78214","S01009073",2011,251,119,132,5
"78215","S01009074",2011,290,150,140,12
"78216","S01009075",2011,233,79,154,11
"78217","S01009076",2011,381,9,372,26
"78218","S01009077",2011,259,51,208,11
"78219","S01009078",2011,271,10,261,10
"78220","S01009079",2011,388,185,203,20
"78221","S01009080",2011,430,168,262,15
"78222","S01009081",2011,311,74,237,5
"78223","S01009082",2011,426,169,257,16
"78224","S01009083",2011,349,106,243,31
"78225","S01009084",2011,177,37,140,17
"78226","S01009085",2011,280,9,271,16
"78227","S01009086",2011,305,97,208,10
"78228","S01009087",2011,247,109,138,16
"78229","S01009088",2011,385,34,351,22
"78230","S01009089",2011,325,4,321,16
"78231","S01009090",2011,333,6,327,58
"78232","S01009091",2011,223,3,220,10
"78233","S01009092",2011,482,105,377,39
"78234","S01009093",2011,343,116,227,50
"78235","S01009094",2011,290,11,279,7
"78236","S01009095",2011,360,80,280,45
"78237","S01009096",2011,384,64,320,47
"78238","S01009097",2011,347,9,338,26
"78239","S01009098",2011,190,6,184,7
"78240","S01009099",2011,384,100,284,42
"78241","S01009100",2011,397,194,203,35
"78242","S01009101",2011,369,180,189,9
"78243","S01009102",2011,317,205,112,6
"78244","S01009103",2011,246,21,225,5
"78245","S01009104",2011,352,118,234,26
"78246","S01009105",2011,337,74,263,26
"78247","S01009106",2011,264,56,208,28
"78248","S01009107",2011,333,36,297,20
"78249","S01009108",2011,313,7,306,13
"78250","S01009109",2011,263,3,260,7
"78251","S01009110",2011,263,62,201,6
"78252","S01009111",2011,372,32,340,40
"78253","S01009112",2011,238,3,235,9
"78254","S01009113",2011,381,5,376,24
"78255","S01009114",2011,303,61,242,11
"78256","S01009115",2011,259,52,207,24
"78257","S01009116",2011,191,3,188,3
"78258","S01009117",2011,391,97,294,35
"78259","S01009118",2011,215,13,202,5
"78260","S01009119",2011,297,126,171,13
"78261","S01009120",2011,233,70,163,13
"78262","S01009121",2011,380,89,291,29
"78263","S01009122",2011,417,97,320,39
"78264","S01009123",2011,215,25,190,10
"78265","S01009124",2011,217,49,168,13
"78266","S01009125",2011,301,83,218,11
"78267","S01009126",2011,281,195,86,17
"78268","S01009127",2011,269,190,79,4
"78269","S01009128",2011,467,289,178,43
"78270","S01009129",2011,205,111,94,7
"78271","S01009130",2011,271,97,174,10
"78272","S01009131",2011,260,82,178,35
"78273","S01009132",2011,329,21,308,38
"78274","S01009133",2011,301,118,183,38
"78275","S01009134",2011,409,74,335,25
"78276","S01009135",2011,264,10,254,69
"78277","S01009136",2011,275,13,262,55
"78278","S01009137",2011,203,4,199,7
"78279","S01009138",2011,395,11,384,61
"78280","S01009139",2011,239,115,124,47
"78281","S01009140",2011,381,155,226,51
"78282","S01009141",2011,473,250,223,68
"78283","S01009142",2011,393,72,321,114
"78284","S01009143",2011,312,175,137,24
"78285","S01009144",2011,306,5,301,77
"78286","S01009145",2011,497,145,352,24
"78287","S01009146",2011,417,116,301,95
"78288","S01009147",2011,353,161,192,22
"78289","S01009148",2011,260,98,162,8
"78290","S01009149",2011,384,39,345,66
"78291","S01009150",2011,574,464,110,6
"78292","S01009151",2011,474,164,310,71
"78293","S01009152",2011,462,161,301,153
"78294","S01009153",2011,266,8,258,93
"78295","S01009154",2011,438,12,426,81
"78296","S01009155",2011,234,10,224,30
"78297","S01009156",2011,247,12,235,17
"78298","S01009157",2011,366,48,318,22
"78299","S01009158",2011,277,65,212,20
"78300","S01009159",2011,250,161,89,13
"78301","S01009160",2011,327,147,180,33
"78302","S01009161",2011,349,181,168,47
"78303","S01009162",2011,436,159,277,83
"78304","S01009163",2011,233,31,202,33
"78305","S01009164",2011,307,96,211,12
"78306","S01009165",2011,324,148,176,35
"78307","S01009166",2011,399,227,172,18
"78308","S01009167",2011,198,94,104,4
"78309","S01009168",2011,297,2,295,25
"78310","S01009169",2011,420,231,189,12
"78311","S01009170",2011,282,88,194,28
"78312","S01009171",2011,297,99,198,19
"78313","S01009172",2011,288,3,285,27
"78314","S01009173",2011,309,13,296,16
"78315","S01009174",2011,162,4,158,7
"78316","S01009175",2011,300,6,294,8
"78317","S01009176",2011,400,5,395,18
"78318","S01009177",2011,367,145,222,19
"78319","S01009178",2011,320,156,164,13
"78320","S01009179",2011,273,72,201,14
"78321","S01009180",2011,437,148,289,22
"78322","S01009181",2011,361,142,219,14
"78323","S01009182",2011,419,52,367,13
"78324","S01009183",2011,267,2,265,7
"78325","S01009184",2011,376,176,200,12
"78326","S01009185",2011,354,151,203,18
"78327","S01009186",2011,312,99,213,12
"78328","S01009187",2011,215,20,195,15
"78329","S01009188",2011,383,151,232,12
"78330","S01009189",2011,336,169,167,6
"78331","S01009190",2011,309,23,286,16
"78332","S01009191",2011,229,7,222,6
"78333","S01009192",2011,258,17,241,15
"78334","S01009193",2011,127,6,121,3
"78335","S01009194",2011,323,5,318,10
"78336","S01009195",2011,353,13,340,28
"78337","S01009196",2011,298,63,235,18
"78338","S01009197",2011,401,25,376,24
"78339","S01009198",2011,306,39,267,9
"78340","S01009199",2011,248,40,208,7
"78341","S01009200",2011,439,47,392,11
"78342","S01009201",2011,268,76,192,23
"78343","S01009202",2011,190,11,179,6
"78344","S01009203",2011,269,141,128,10
"78345","S01009204",2011,343,118,225,16
"78346","S01009205",2011,307,2,305,21
"78347","S01009206",2011,362,10,352,27
"78348","S01009207",2011,375,3,372,24
"78349","S01009208",2011,294,45,249,19
"78350","S01009209",2011,304,13,291,29
"78351","S01009210",2011,234,19,215,20
"78352","S01009211",2011,259,50,209,29
"78353","S01009212",2011,363,133,230,13
"78354","S01009213",2011,355,139,216,12
"78355","S01009214",2011,397,57,340,9
"78356","S01009215",2011,439,173,266,14
"78357","S01009216",2011,397,123,274,20
"78358","S01009217",2011,279,165,114,11
"78359","S01009218",2011,395,85,310,15
"78360","S01009219",2011,313,99,214,17
"78361","S01009220",2011,264,89,175,19
"78362","S01009221",2011,239,65,174,8
"78363","S01009222",2011,238,102,136,14
"78364","S01009223",2011,244,67,177,12
"78365","S01009224",2011,277,110,167,11
"78366","S01009225",2011,268,87,181,8
"78367","S01009226",2011,507,210,297,30
"78368","S01009227",2011,355,125,230,32
"78369","S01009228",2011,313,137,176,25
"78370","S01009229",2011,293,84,209,27
"78371","S01009230",2011,319,31,288,57
"78372","S01009231",2011,437,44,393,29
"78373","S01009232",2011,309,206,103,9
"78374","S01009233",2011,267,71,196,10
"78375","S01009234",2011,476,287,189,37
"78376","S01009235",2011,457,205,252,22
"78377","S01009236",2011,224,33,191,5
"78378","S01009237",2011,378,10,368,23
"78379","S01009238",2011,335,76,259,14
"78380","S01009239",2011,420,193,227,24
"78381","S01009240",2011,387,278,109,13
"78382","S01009241",2011,453,263,190,10
"78383","S01009242",2011,321,56,265,7
"78384","S01009243",2011,398,80,318,35
"78385","S01009244",2011,337,5,332,16
"78386","S01009245",2011,361,41,320,19
"78387","S01009246",2011,383,127,256,20
"78388","S01009247",2011,429,135,294,25
"78389","S01009248",2011,300,51,249,9
"78390","S01009249",2011,375,158,217,29
"78391","S01009250",2011,278,82,196,12
"78392","S01009251",2011,221,52,169,5
"78393","S01009252",2011,163,3,160,3
"78394","S01009253",2011,239,99,140,9
"78395","S01009254",2011,371,211,160,12
"78396","S01009255",2011,376,133,243,102
"78397","S01009256",2011,222,37,185,12
"78398","S01009257",2011,330,74,256,64
"78399","S01009258",2011,282,26,256,21
"78400","S01009259",2011,380,36,344,17
"78401","S01009260",2011,526,117,409,61
"78402","S01009261",2011,386,230,156,28
"78403","S01009262",2011,293,183,110,17
"78404","S01009263",2011,365,15,350,50
"78405","S01009264",2011,231,2,229,22
"78406","S01009265",2011,376,103,273,27
"78407","S01009266",2011,374,71,303,26
"78408","S01009267",2011,377,35,342,57
"78409","S01009268",2011,431,104,327,41
"78410","S01009269",2011,351,192,159,12
"78411","S01009270",2011,306,128,178,18
"78412","S01009271",2011,349,4,345,13
"78413","S01009272",2011,264,105,159,10
"78414","S01009273",2011,211,8,203,6
"78415","S01009274",2011,255,25,230,10
"78416","S01009275",2011,244,2,242,41
"78417","S01009276",2011,373,48,325,13
"78418","S01009277",2011,218,2,216,16
"78419","S01009278",2011,235,14,221,17
"78420","S01009279",2011,283,39,244,32
"78421","S01009280",2011,406,238,168,18
"78422","S01009281",2011,375,182,193,18
"78423","S01009282",2011,346,52,294,48
"78424","S01009283",2011,180,21,159,14
"78425","S01009284",2011,311,12,299,11
"78426","S01009285",2011,350,14,336,23
"78427","S01009286",2011,351,6,345,28
"78428","S01009287",2011,339,12,327,24
"78429","S01009288",2011,392,10,382,78
"78430","S01009289",2011,409,19,390,22
"78431","S01009290",2011,288,1,287,3
"78432","S01009291",2011,394,9,385,23
"78433","S01009292",2011,228,69,159,15
"78434","S01009293",2011,297,47,250,21
"78435","S01009294",2011,192,1,191,10
"78436","S01009295",2011,264,3,261,9
"78437","S01009296",2011,187,14,173,5
"78438","S01009297",2011,328,5,323,26
"78439","S01009298",2011,553,235,318,72
"78440","S01009299",2011,484,98,386,86
"78441","S01009300",2011,287,80,207,46
"78442","S01009301",2011,551,256,295,74
"78443","S01009302",2011,450,216,234,73
"78444","S01009303",2011,322,24,298,25
"78445","S01009304",2011,395,80,315,17
"78446","S01009305",2011,412,95,317,42
"78447","S01009306",2011,565,114,451,134
"78448","S01009307",2011,544,60,484,171
"78449","S01009308",2011,304,52,252,89
"78450","S01009309",2011,400,42,358,132
"78451","S01009310",2011,399,11,388,41
"78452","S01009311",2011,274,107,167,15
"78453","S01009312",2011,366,35,331,104
"78454","S01009313",2011,285,114,171,32
"78455","S01009314",2011,258,13,245,14
"78456","S01009315",2011,270,85,185,15
"78457","S01009316",2011,326,17,309,37
"78458","S01009317",2011,358,3,355,12
"78459","S01009318",2011,236,3,233,8
"78460","S01009319",2011,416,14,402,13
"78461","S01009320",2011,352,110,242,13
"78462","S01009321",2011,295,3,292,9
"78463","S01009322",2011,355,42,313,24
"78464","S01009323",2011,327,63,264,25
"78465","S01009324",2011,256,48,208,21
"78466","S01009325",2011,308,10,298,30
"78467","S01009326",2011,210,46,164,6
"78468","S01009327",2011,258,28,230,7
"78469","S01009328",2011,237,0,0,40
"78470","S01009329",2011,203,17,186,26
"78471","S01009330",2011,183,64,119,18
"78472","S01009331",2011,180,0,0,8
"78473","S01009332",2011,333,7,326,10
"78474","S01009333",2011,355,72,283,59
"78475","S01009334",2011,310,146,164,25
"78476","S01009335",2011,337,113,224,25
"78477","S01009336",2011,318,179,139,30
"78478","S01009337",2011,318,138,180,16
"78479","S01009338",2011,401,222,179,17
"78480","S01009339",2011,391,216,175,28
"78481","S01009340",2011,283,107,176,21
"78482","S01009341",2011,270,78,192,19
"78483","S01009342",2011,333,82,251,27
"78484","S01009343",2011,242,27,215,22
"78485","S01009344",2011,288,109,179,15
"78486","S01009345",2011,379,47,332,46
"78487","S01009346",2011,228,2,226,7
"78488","S01009347",2011,216,0,0,5
"78489","S01009348",2011,161,0,0,9
"78490","S01009349",2011,288,3,285,30
"78491","S01009350",2011,240,44,196,35
"78492","S01009351",2011,213,2,211,59
"78493","S01009352",2011,290,1,289,26
"78494","S01009353",2011,147,1,146,8
"78495","S01009354",2011,297,1,296,21
"78496","S01009355",2011,367,8,359,24
"78497","S01009356",2011,411,3,408,17
"78498","S01009357",2011,179,2,177,45
"78499","S01009358",2011,256,0,0,4
"78500","S01009359",2011,277,7,270,22
"78501","S01009360",2011,376,21,355,43
"78502","S01009361",2011,342,30,312,26
"78503","S01009362",2011,417,4,413,23
"78504","S01009363",2011,373,79,294,31
"78505","S01009364",2011,325,34,291,30
"78506","S01009365",2011,277,36,241,30
"78507","S01009366",2011,351,72,279,29
"78508","S01009367",2011,296,80,216,33
"78509","S01009368",2011,211,80,131,11
"78510","S01009369",2011,255,47,208,26
"78511","S01009370",2011,381,68,313,20
"78512","S01009371",2011,242,43,199,24
"78513","S01009372",2011,219,51,168,19
"78514","S01009373",2011,398,145,253,41
"78515","S01009374",2011,432,168,264,25
"78516","S01009375",2011,337,107,230,25
"78517","S01009376",2011,271,102,169,17
"78518","S01009377",2011,373,34,339,95
"78519","S01009378",2011,388,146,242,36
"78520","S01009379",2011,337,66,271,26
"78521","S01009380",2011,200,9,191,43
"78522","S01009381",2011,284,22,262,51
"78523","S01009382",2011,377,131,246,31
"78524","S01009383",2011,439,105,334,98
"78525","S01009384",2011,248,15,233,26
"78526","S01009385",2011,220,25,195,20
"78527","S01009386",2011,279,61,218,11
"78528","S01009387",2011,260,94,166,20
"78529","S01009388",2011,423,243,180,54
"78530","S01009389",2011,460,70,390,91
"78531","S01009390",2011,270,1,269,17
"78532","S01009391",2011,259,0,0,25
"78533","S01009392",2011,193,0,0,14
"78534","S01009393",2011,265,4,261,14
"78535","S01009394",2011,451,5,446,126
"78536","S01009395",2011,305,1,304,9
"78537","S01009396",2011,301,3,298,15
"78538","S01009397",2011,330,2,328,41
"78539","S01009398",2011,308,4,304,49
"78540","S01009399",2011,311,11,300,29
"78541","S01009400",2011,221,22,199,12
"78542","S01009401",2011,284,8,276,11
"78543","S01009402",2011,397,2,395,16
"78544","S01009403",2011,206,18,188,10
"78545","S01009404",2011,232,78,154,29
"78546","S01009405",2011,157,6,151,9
"78547","S01009406",2011,429,80,349,51
"78548","S01009407",2011,227,36,191,13
"78549","S01009408",2011,307,27,280,33
"78550","S01009409",2011,308,78,230,19
"78551","S01009410",2011,351,165,186,24
"78552","S01009411",2011,364,136,228,26
"78553","S01009412",2011,407,186,221,15
"78554","S01009489",2011,389,147,242,44
"78555","S01009490",2011,394,222,172,23
"78556","S01009491",2011,332,119,213,10
"78557","S01009492",2011,310,103,207,19
"78558","S01009413",2011,456,108,348,37
"78559","S01009414",2011,292,63,229,11
"78560","S01009415",2011,386,95,291,70
"78561","S01009416",2011,201,15,186,4
"78562","S01009417",2011,114,13,101,11
"78563","S01009418",2011,517,161,356,66
"78564","S01009419",2011,245,94,151,11
"78565","S01009420",2011,253,153,100,11
"78566","S01009421",2011,295,143,152,10
"78567","S01009422",2011,369,92,277,20
"78568","S01009423",2011,336,10,326,24
"78569","S01009424",2011,250,50,200,19
"78570","S01009425",2011,372,84,288,35
"78571","S01009426",2011,415,199,216,40
"78572","S01009427",2011,326,148,178,19
"78573","S01009428",2011,235,79,156,12
"78574","S01009429",2011,341,174,167,21
"78575","S01009430",2011,338,133,205,31
"78576","S01009431",2011,330,106,224,35
"78577","S01009432",2011,321,179,142,16
"78578","S01009433",2011,330,168,162,17
"78579","S01009434",2011,248,112,136,10
"78580","S01009435",2011,347,236,111,12
"78581","S01009436",2011,298,116,182,19
"78582","S01009437",2011,318,108,210,20
"78583","S01009438",2011,410,206,204,15
"78584","S01009439",2011,386,203,183,14
"78585","S01009440",2011,328,158,170,21
"78586","S01009441",2011,370,237,133,22
"78587","S01009442",2011,216,10,206,40
"78588","S01009443",2011,288,49,239,31
"78589","S01009444",2011,305,18,287,14
"78590","S01009445",2011,320,94,226,12
"78591","S01009446",2011,471,239,232,46
"78592","S01009447",2011,238,78,160,23
"78593","S01009448",2011,343,71,272,21
"78594","S01009449",2011,231,60,171,17
"78595","S01009450",2011,307,169,138,35
"78596","S01009451",2011,427,190,237,32
"78597","S01009452",2011,269,114,155,30
"78598","S01009453",2011,493,175,318,42
"78599","S01009454",2011,397,24,373,54
"78600","S01009455",2011,386,12,374,50
"78601","S01009456",2011,358,109,249,38
"78602","S01009457",2011,254,17,237,44
"78603","S01009458",2011,332,65,267,44
"78604","S01009459",2011,457,132,325,76
"78605","S01009460",2011,399,237,162,40
"78606","S01009461",2011,201,6,195,6
"78607","S01009462",2011,292,63,229,13
"78608","S01009463",2011,306,63,243,11
"78609","S01009464",2011,378,29,349,25
"78610","S01009465",2011,269,58,211,14
"78611","S01009466",2011,256,3,253,8
"78612","S01009467",2011,330,18,312,26
"78613","S01009468",2011,385,129,256,33
"78614","S01009469",2011,393,44,349,33
"78615","S01009470",2011,232,34,198,14
"78616","S01009471",2011,414,261,153,38
"78617","S01009472",2011,435,193,242,48
"78618","S01009473",2011,464,143,321,167
"78619","S01009474",2011,403,185,218,40
"78620","S01009475",2011,222,3,219,21
"78621","S01009476",2011,169,2,167,25
"78622","S01009477",2011,358,45,313,44
"78623","S01009478",2011,480,102,378,121
"78624","S01009479",2011,420,85,335,100
"78625","S01009480",2011,420,50,370,36
"78626","S01009481",2011,489,36,453,131
"78627","S01009482",2011,332,17,315,116
"78628","S01009483",2011,403,6,397,115
"78629","S01009484",2011,427,97,330,64
"78630","S01009485",2011,362,116,246,38
"78631","S01009486",2011,313,51,262,21
"78632","S01009487",2011,385,120,265,32
"78633","S01009488",2011,267,58,209,10
"78634","S01009493",2011,366,8,358,7
"78635","S01009494",2011,387,6,381,54
"78636","S01009495",2011,375,5,370,29
"78637","S01009496",2011,371,112,259,29
"78638","S01009497",2011,426,74,352,35
"78639","S01009498",2011,276,6,270,7
"78640","S01009499",2011,357,79,278,14
"78641","S01009500",2011,382,192,190,18
"78642","S01009501",2011,315,137,178,17
"78643","S01009502",2011,374,176,198,19
"78644","S01009503",2011,338,113,225,22
"78645","S01009504",2011,314,171,143,15
"78646","S01009505",2011,355,219,136,22
"78647","S01009506",2011,348,187,161,21
"78648","S01009507",2011,346,103,243,15
"78649","S01009508",2011,397,224,173,27
"78650","S01009509",2011,421,176,245,32
"78651","S01009510",2011,301,6,295,4
"78652","S01009511",2011,257,6,251,10
"78653","S01009512",2011,313,5,308,15
"78654","S01009513",2011,245,4,241,8
"78655","S01009514",2011,282,4,278,11
"78656","S01009515",2011,362,143,219,9
"78657","S01009516",2011,399,112,287,26
"78658","S01009517",2011,347,14,333,44
"78659","S01009518",2011,319,12,307,29
"78660","S01009519",2011,195,42,153,8
"78661","S01009520",2011,328,46,282,24
"78662","S01009521",2011,363,144,219,20
"78663","S01009522",2011,376,119,257,60
"78664","S01009523",2011,263,123,140,17
"78665","S01009524",2011,341,144,197,57
"78666","S01009525",2011,254,71,183,49
"78667","S01009526",2011,365,18,347,162
"78668","S01009527",2011,384,95,289,115
"78669","S01009528",2011,355,133,222,40
"78670","S01009529",2011,247,30,217,21
"78671","S01009530",2011,255,5,250,7
"78672","S01009531",2011,432,187,245,48
"78673","S01009532",2011,437,206,231,33
"78674","S01009533",2011,440,162,278,78
"78675","S01009534",2011,427,267,160,49
"78676","S01009535",2011,297,199,98,20
"78677","S01009536",2011,228,91,137,22
"78678","S01009537",2011,280,87,193,27
"78679","S01009538",2011,401,179,222,67
"78680","S01009539",2011,389,97,292,21
"78681","S01009540",2011,459,213,246,36
"78682","S01009541",2011,321,25,296,64
"78683","S01009542",2011,380,226,154,24
"78684","S01009543",2011,279,78,201,29
"78685","S01009544",2011,432,135,297,96
"78686","S01009545",2011,344,96,248,35
"78687","S01009546",2011,414,121,293,12
"78688","S01009547",2011,337,114,223,43
"78689","S01009548",2011,317,80,237,34
"78690","S01009549",2011,348,52,296,36
"78691","S01009550",2011,208,22,186,12
"78692","S01009551",2011,229,29,200,41
"78693","S01009552",2011,398,99,299,26
"78694","S01009553",2011,421,201,220,30
"78695","S01009554",2011,311,109,202,36
"78696","S01009555",2011,364,59,305,52
"78697","S01009556",2011,338,134,204,31
"78698","S01009557",2011,300,112,188,40
"78699","S01009558",2011,291,108,183,40
"78700","S01009559",2011,374,131,243,45
"78701","S01009560",2011,351,100,251,73
"78702","S01009561",2011,258,84,174,44
"78703","S01009562",2011,316,52,264,33
"78704","S01009563",2011,373,62,311,54
"78705","S01009564",2011,315,71,244,22
"78706","S01009565",2011,246,61,185,30
"78707","S01009566",2011,431,64,367,44
"78708","S01009567",2011,414,77,337,63
"78709","S01009568",2011,333,85,248,30
"78710","S01009569",2011,363,68,295,39
"78711","S01009570",2011,240,65,175,27
"78712","S01009571",2011,297,116,181,59
"78713","S01009572",2011,499,206,293,66
"78714","S01009573",2011,329,125,204,44
"78715","S01009574",2011,447,117,330,52
"78716","S01009575",2011,232,68,164,17
"78717","S01009576",2011,223,3,220,16
"78718","S01009577",2011,253,23,230,9
"78719","S01009578",2011,312,50,262,42
"78720","S01009579",2011,443,197,246,24
"78721","S01009580",2011,355,10,345,19
"78722","S01009581",2011,258,44,214,30
"78723","S01009582",2011,240,48,192,29
"78724","S01009583",2011,336,91,245,38
"78725","S01009584",2011,219,9,210,25
"78726","S01009585",2011,408,91,317,44
"78727","S01009586",2011,313,85,228,20
"78728","S01009587",2011,370,79,291,30
"78729","S01009588",2011,436,97,339,28
"78730","S01009589",2011,356,79,277,20
"78731","S01009590",2011,267,4,263,6
"78732","S01009591",2011,307,5,302,33
"78733","S01009592",2011,246,8,238,9
"78734","S01009593",2011,223,5,218,9
"78735","S01009594",2011,263,2,261,9
"78736","S01009595",2011,174,11,163,9
"78737","S01009596",2011,355,131,224,34
"78738","S01009597",2011,361,192,169,38
"78739","S01009598",2011,303,237,66,10
"78740","S01009599",2011,403,126,277,37
"78741","S01009600",2011,330,199,131,35
"78742","S01009601",2011,296,87,209,43
"78743","S01009602",2011,291,8,283,10
"78744","S01009603",2011,234,44,190,10
"78745","S01009604",2011,377,107,270,30
"78746","S01009605",2011,348,201,147,15
"78747","S01009606",2011,218,11,207,13
"78748","S01009607",2011,208,9,199,8
"78749","S01009608",2011,287,75,212,26
"78750","S01009609",2011,358,30,328,42
"78751","S01009610",2011,500,88,412,51
"78752","S01009611",2011,218,7,211,34
"78753","S01009612",2011,272,71,201,16
"78754","S01009613",2011,181,2,179,14
"78755","S01009614",2011,223,11,212,37
"78756","S01009615",2011,174,22,152,4
"78757","S01009616",2011,324,62,262,33
"78758","S01009617",2011,297,6,291,23
"78759","S01009618",2011,333,76,257,57
"78760","S01009619",2011,302,113,189,30
"78761","S01009620",2011,391,175,216,32
"78762","S01009621",2011,394,105,289,60
"78763","S01009622",2011,394,218,176,40
"78764","S01009623",2011,243,89,154,16
"78765","S01009624",2011,408,142,266,18
"78766","S01009625",2011,378,134,244,28
"78767","S01009626",2011,231,123,108,6
"78768","S01009627",2011,342,124,218,18
"78769","S01009628",2011,265,133,132,9
"78770","S01009629",2011,435,124,311,44
"78771","S01009630",2011,343,173,170,22
"78772","S01009631",2011,406,224,182,76
"78773","S01009632",2011,306,159,147,50
"78774","S01009633",2011,297,159,138,26
"78775","S01009634",2011,253,112,141,15
"78776","S01009635",2011,414,119,295,42
"78777","S01009636",2011,521,173,348,125
"78778","S01009637",2011,340,98,242,37
"78779","S01009638",2011,292,148,144,21
"78780","S01009639",2011,325,9,316,15
"78781","S01009640",2011,363,165,198,43
"78782","S01009641",2011,479,155,324,82
"78783","S01009642",2011,482,96,386,88
"78784","S01009643",2011,218,25,193,8
"78785","S01009644",2011,339,93,246,15
"78786","S01009645",2011,301,91,210,22
"78787","S01009646",2011,244,74,170,9
"78788","S01009647",2011,318,134,184,24
"78789","S01009648",2011,394,114,280,22
"78790","S01009649",2011,451,142,309,14
"78791","S01009650",2011,343,8,335,6
"78792","S01009651",2011,427,57,370,65
"78793","S01009652",2011,399,9,390,35
"78794","S01009653",2011,229,5,224,11
"78795","S01009654",2011,274,37,237,28
"78796","S01009655",2011,351,139,212,12
"78797","S01009656",2011,387,191,196,23
"78798","S01009657",2011,332,79,253,12
"78799","S01009658",2011,286,98,188,15
"78800","S01009659",2011,230,79,151,8
"78801","S01009660",2011,430,152,278,14
"78802","S01009661",2011,331,2,329,39
"78803","S01009662",2011,292,36,256,20
"78804","S01009663",2011,281,45,236,30
"78805","S01009664",2011,377,25,352,54
"78806","S01009665",2011,293,62,231,19
"78807","S01009666",2011,342,58,284,50
"78808","S01009667",2011,223,15,208,9
"78809","S01009668",2011,243,7,236,23
"78810","S01009669",2011,240,19,221,22
"78811","S01009670",2011,340,66,274,29
"78812","S01009671",2011,262,18,244,53
"78813","S01009672",2011,355,126,229,24
"78814","S01009673",2011,351,48,303,37
"78815","S01009674",2011,392,37,355,53
"78816","S01009675",2011,379,35,344,37
"78817","S01009676",2011,356,55,301,40
"78818","S01009677",2011,268,19,249,48
"78819","S01009678",2011,273,46,227,26
"78820","S01009679",2011,434,120,314,62
"78821","S01009680",2011,356,78,278,44
"78822","S01009681",2011,245,45,200,18
"78823","S01009682",2011,278,17,261,37
"78824","S01009683",2011,364,40,324,35
"78825","S01009684",2011,395,20,375,63
"78826","S01009685",2011,264,79,185,30
"78827","S01009686",2011,544,160,384,124
"78828","S01009687",2011,299,44,255,49
"78829","S01009688",2011,456,275,181,43
"78830","S01009689",2011,333,80,253,89
"78831","S01009690",2011,347,72,275,60
"78832","S01009691",2011,260,4,256,18
"78833","S01009692",2011,484,21,463,46
"78834","S01009693",2011,252,9,243,16
"78835","S01009694",2011,453,18,435,28
"78836","S01009695",2011,278,20,258,30
"78837","S01009696",2011,443,42,401,52
"78838","S01009697",2011,314,33,281,38
"78839","S01009698",2011,232,3,229,63
"78840","S01009699",2011,236,26,210,25
"78841","S01009700",2011,297,42,255,64
"78842","S01009701",2011,229,45,184,12
"78843","S01009702",2011,265,31,234,45
"78844","S01009703",2011,285,83,202,13
"78845","S01009704",2011,440,56,384,48
"78846","S01009705",2011,363,113,250,28
"78847","S01009706",2011,295,55,240,47
"78848","S01009707",2011,218,1,217,49
"78849","S01009708",2011,258,42,216,23
"78850","S01009709",2011,394,59,335,50
"78851","S01009710",2011,246,45,201,30
"78852","S01009711",2011,341,109,232,36
"78853","S01009712",2011,277,29,248,42
"78854","S01009713",2011,444,70,374,69
"78855","S01009714",2011,453,47,406,53
"78856","S01009715",2011,334,33,301,88
"78857","S01009716",2011,329,25,304,55
"78858","S01009717",2011,327,115,212,87
"78859","S01009718",2011,327,106,221,53
"78860","S01009719",2011,342,113,229,42
"78861","S01009720",2011,379,118,261,76
"78862","S01009721",2011,221,1,220,172
"78863","S01009722",2011,387,39,348,214
"78864","S01009723",2011,302,55,247,178
"78865","S01009724",2011,495,184,311,183
"78866","S01009725",2011,251,14,237,153
"78867","S01009726",2011,209,10,199,128
"78868","S01009727",2011,331,47,284,65
"78869","S01009728",2011,333,7,326,29
"78870","S01009729",2011,282,3,279,23
"78871","S01009730",2011,241,33,208,45
"78872","S01009731",2011,274,2,272,33
"78873","S01009732",2011,344,24,320,136
"78874","S01009733",2011,227,6,221,28
"78875","S01009734",2011,385,20,365,78
"78876","S01009735",2011,327,3,324,35
"78877","S01009736",2011,332,31,301,170
"78878","S01009737",2011,323,72,251,126
"78879","S01009738",2011,214,25,189,63
"78880","S01009739",2011,275,40,235,114
"78881","S01009740",2011,243,69,174,35
"78882","S01009741",2011,164,23,141,115
"78883","S01009742",2011,206,6,200,51
"78884","S01009743",2011,425,26,399,44
"78885","S01009744",2011,306,6,300,34
"78886","S01009745",2011,455,29,426,42
"78887","S01009746",2011,237,4,233,61
"78888","S01009747",2011,344,63,281,62
"78889","S01009748",2011,299,28,271,25
"78890","S01009749",2011,425,54,371,30
"78891","S01009750",2011,311,70,241,37
"78892","S01009751",2011,355,97,258,39
"78893","S01009752",2011,260,5,255,23
"78894","S01009753",2011,333,61,272,28
"78895","S01009754",2011,383,59,324,35
"78896","S01009755",2011,281,14,267,28
"78897","S01009756",2011,320,28,292,26
"78898","S01009757",2011,271,19,252,14
"78899","S01009758",2011,242,9,233,24
"78900","S01009759",2011,417,369,48,8
"78901","S01009760",2011,407,232,175,32
"78902","S01009761",2011,377,22,355,36
"78903","S01009762",2011,416,359,57,11
"78904","S01009763",2011,264,9,255,16
"78905","S01009764",2011,291,166,125,17
"78906","S01009765",2011,382,129,253,38
"78907","S01009766",2011,231,7,224,21
"78908","S01009767",2011,227,136,91,8
"78909","S01009768",2011,279,158,121,26
"78910","S01009769",2011,249,14,235,40
"78911","S01009770",2011,257,6,251,26
"78912","S01009771",2011,294,5,289,23
"78913","S01009772",2011,271,2,269,27
"78914","S01009773",2011,179,4,175,23
"78915","S01009774",2011,151,4,147,5
"78916","S01009775",2011,359,201,158,34
"78917","S01009776",2011,307,259,48,7
"78918","S01009777",2011,266,64,202,97
"78919","S01009778",2011,415,276,139,21
"78920","S01009779",2011,290,216,74,18
"78921","S01009780",2011,219,195,24,8
"78922","S01009781",2011,224,150,74,6
"78923","S01009782",2011,200,65,135,21
"78924","S01009783",2011,310,193,117,14
"78925","S01009784",2011,309,254,55,15
"78926","S01009785",2011,339,221,118,10
"78927","S01009786",2011,425,271,154,21
"78928","S01009787",2011,366,197,169,21
"78929","S01009788",2011,404,104,300,27
"78930","S01009789",2011,399,135,264,28
"78931","S01009790",2011,259,73,186,18
"78932","S01009791",2011,281,125,156,32
"78933","S01009792",2011,323,9,314,34
"78934","S01009793",2011,416,33,383,44
"78935","S01009794",2011,199,3,196,8
"78936","S01009795",2011,287,5,282,19
"78937","S01009796",2011,310,7,303,17
"78938","S01009797",2011,306,6,300,20
"78939","S01009798",2011,255,3,252,11
"78940","S01009799",2011,363,258,105,13
"78941","S01009800",2011,424,142,282,43
"78942","S01009801",2011,344,150,194,21
"78943","S01009802",2011,431,200,231,16
"78944","S01009803",2011,371,197,174,30
"78945","S01009804",2011,208,30,178,36
"78946","S01009805",2011,374,145,229,39
"78947","S01009806",2011,446,125,321,66
"78948","S01009807",2011,461,158,303,53
"78949","S01009808",2011,428,249,179,34
"78950","S01009809",2011,338,77,261,50
"78951","S01009810",2011,453,266,187,29
"78952","S01009811",2011,520,222,298,39
"78953","S01009812",2011,376,117,259,36
"78954","S01009813",2011,335,288,47,13
"78955","S01009814",2011,362,71,291,21
"78956","S01009815",2011,346,63,283,45
"78957","S01009816",2011,326,16,310,42
"78958","S01009817",2011,343,122,221,16
"78959","S01009818",2011,421,8,413,8
"78960","S01009819",2011,306,71,235,21
"78961","S01009820",2011,445,106,339,23
"78962","S01009821",2011,255,14,241,18
"78963","S01009822",2011,191,38,153,17
"78964","S01009823",2011,306,92,214,40
"78965","S01009824",2011,365,100,265,23
"78966","S01009825",2011,449,209,240,21
"78967","S01009826",2011,228,88,140,12
"78968","S01009827",2011,367,134,233,25
"78969","S01009828",2011,394,264,130,19
"78970","S01009829",2011,512,160,352,76
"78971","S01009830",2011,329,45,284,66
"78972","S01009831",2011,313,8,305,75
"78973","S01009832",2011,474,61,413,70
"78974","S01009833",2011,238,32,206,38
"78975","S01009834",2011,372,191,181,22
"78976","S01009835",2011,258,161,97,11
"78977","S01009836",2011,414,68,346,30
"78978","S01009837",2011,368,194,174,16
"78979","S01009838",2011,433,177,256,59
"78980","S01009839",2011,615,453,162,55
"78981","S01009840",2011,475,169,306,27
"78982","S01009841",2011,461,371,90,28
"78983","S01009842",2011,332,240,92,31
"78984","S01009843",2011,310,230,80,10
"78985","S01009844",2011,361,325,36,19
"78986","S01009845",2011,440,362,78,50
"78987","S01009846",2011,461,278,183,37
"78988","S01009847",2011,322,233,89,26
"78989","S01009848",2011,383,147,236,27
"78990","S01009849",2011,445,136,309,53
"78991","S01009850",2011,472,105,367,63
"78992","S01009851",2011,470,213,257,29
"78993","S01009852",2011,257,52,205,20
"78994","S01009853",2011,413,107,306,33
"78995","S01009854",2011,398,187,211,43
"78996","S01009855",2011,250,53,197,14
"78997","S01009856",2011,308,57,251,28
"78998","S01009857",2011,374,95,279,19
"78999","S01009858",2011,337,81,256,22
"79000","S01009859",2011,580,351,229,70
"79001","S01009860",2011,503,355,148,59
"79002","S01009861",2011,524,315,209,96
"79003","S01009862",2011,607,252,355,218
"79004","S01009863",2011,461,128,333,186
"79005","S01009864",2011,317,88,229,96
"79006","S01009865",2011,245,52,193,72
"79007","S01009866",2011,455,94,361,95
"79008","S01009867",2011,595,95,500,222
"79009","S01009868",2011,308,18,290,132
"79010","S01009869",2011,269,7,262,131
"79011","S01009870",2011,274,73,201,89
"79012","S01009871",2011,587,283,304,87
"79013","S01009872",2011,365,8,357,169
"79014","S01009873",2011,445,126,319,57
"79015","S01009874",2011,497,216,281,32
"79016","S01009875",2011,307,126,181,118
"79017","S01009876",2011,322,217,105,44
"79018","S01009877",2011,360,18,342,58
"79019","S01009878",2011,252,67,185,60
"79020","S01009879",2011,332,7,325,25
"79021","S01009880",2011,258,8,250,48
"79022","S01009881",2011,179,15,164,68
"79023","S01009882",2011,613,61,552,299
"79024","S01009883",2011,280,6,274,116
"79025","S01009884",2011,316,27,289,82
"79026","S01009885",2011,251,7,244,59
"79027","S01009886",2011,277,57,220,70
"79028","S01009887",2011,490,154,336,212
"79029","S01009888",2011,280,30,250,129
"79030","S01009889",2011,370,96,274,110
"79031","S01009890",2011,278,167,111,58
"79032","S01009891",2011,430,105,325,156
"79033","S01009892",2011,468,295,173,86
"79034","S01009893",2011,420,28,392,195
"79035","S01009894",2011,476,296,180,74
"79036","S01009895",2011,408,249,159,83
"79037","S01009896",2011,470,287,183,51
"79038","S01009897",2011,497,117,380,91
"79039","S01009898",2011,259,118,141,30
"79040","S01009899",2011,464,39,425,137
"79041","S01009900",2011,499,10,489,141
"79042","S01009901",2011,456,11,445,163
"79043","S01009902",2011,495,153,342,62
"79044","S01009903",2011,272,6,266,65
"79045","S01009904",2011,456,86,370,136
"79046","S01009905",2011,372,21,351,164
"79047","S01009906",2011,331,25,306,129
"79048","S01009907",2011,592,96,496,297
"79049","S01009908",2011,492,31,461,143
"79050","S01009909",2011,471,16,455,207
"79051","S01009910",2011,278,5,273,125
"79052","S01009911",2011,415,8,407,75
"79053","S01009912",2011,365,36,329,34
"79054","S01009913",2011,232,7,225,37
"79055","S01009914",2011,408,6,402,38
"79056","S01009915",2011,402,6,396,47
"79057","S01009916",2011,315,6,309,26
"79058","S01009917",2011,331,3,328,57
"79059","S01009918",2011,277,11,266,19
"79060","S01009919",2011,587,91,496,221
"79061","S01009920",2011,519,15,504,190
"79062","S01009921",2011,398,11,387,146
"79063","S01009922",2011,619,5,614,246
"79064","S01009923",2011,566,22,544,186
"79065","S01009924",2011,581,68,513,231
"79066","S01009925",2011,408,4,404,190
"79067","S01009926",2011,375,24,351,121
"79068","S01009927",2011,278,40,238,62
"79069","S01009928",2011,429,2,427,79
"79070","S01009929",2011,234,7,227,41
"79071","S01009930",2011,460,31,429,166
"79072","S01009931",2011,463,6,457,128
"79073","S01009932",2011,374,36,338,107
"79074","S01009933",2011,534,315,219,102
"79075","S01009934",2011,436,31,405,114
"79076","S01009935",2011,386,264,122,20
"79077","S01009936",2011,397,238,159,48
"79078","S01009937",2011,266,213,53,20
"79079","S01009938",2011,570,300,270,40
"79080","S01009939",2011,521,480,41,17
"79081","S01009940",2011,438,283,155,21
"79082","S01009941",2011,320,13,307,31
"79083","S01009942",2011,486,271,215,36
"79084","S01009943",2011,424,275,149,14
"79085","S01009944",2011,344,84,260,51
"79086","S01009945",2011,500,202,298,63
"79087","S01009946",2011,348,85,263,28
"79088","S01009947",2011,266,71,195,30
"79089","S01009948",2011,431,279,152,17
"79090","S01009949",2011,368,84,284,41
"79091","S01009950",2011,256,3,253,12
"79092","S01009951",2011,259,7,252,12
"79093","S01009952",2011,311,9,302,19
"79094","S01009953",2011,358,26,332,26
"79095","S01009954",2011,214,10,204,23
"79096","S01009955",2011,447,47,400,58
"79097","S01009956",2011,324,49,275,47
"79098","S01009957",2011,294,4,290,16
"79099","S01009958",2011,371,4,367,15
"79100","S01009959",2011,288,5,283,22
"79101","S01009960",2011,395,25,370,34
"79102","S01009961",2011,293,48,245,16
"79103","S01009962",2011,599,72,527,180
"79104","S01009963",2011,301,0,0,16
"79105","S01009964",2011,344,9,335,48
"79106","S01009965",2011,298,30,268,6
"79107","S01009966",2011,292,3,289,10
"79108","S01009967",2011,383,10,373,29
"79109","S01009968",2011,232,5,227,8
"79110","S01009969",2011,364,36,328,17
"79111","S01009970",2011,476,348,128,25
"79112","S01009971",2011,488,312,176,22
"79113","S01009972",2011,364,119,245,19
"79114","S01009973",2011,283,124,159,13
"79115","S01009974",2011,294,268,26,5
"79116","S01009975",2011,398,347,51,16
"79117","S01009976",2011,255,169,86,11
"79118","S01009977",2011,555,489,66,9
"79119","S01009978",2011,444,335,109,17
"79120","S01009979",2011,258,215,43,4
"79121","S01009980",2011,250,198,52,13
"79122","S01009981",2011,303,247,56,12
"79123","S01009982",2011,428,230,198,23
"79124","S01009983",2011,289,272,17,8
"79125","S01009984",2011,350,170,180,23
"79126","S01009985",2011,270,239,31,6
"79127","S01009986",2011,280,229,51,11
"79128","S01009987",2011,472,312,160,14
"79129","S01009988",2011,270,202,68,9
"79130","S01009989",2011,354,54,300,52
"79131","S01009990",2011,302,3,299,64
"79132","S01009991",2011,333,3,330,73
"79133","S01009992",2011,330,225,105,18
"79134","S01009993",2011,349,2,347,67
"79135","S01009994",2011,302,2,300,64
"79136","S01009995",2011,269,1,268,57
"79137","S01009996",2011,310,27,283,79
"79138","S01009997",2011,251,3,248,50
"79139","S01009998",2011,246,9,237,21
"79140","S01009999",2011,285,3,282,30
"79141","S01010000",2011,269,4,265,63
"79142","S01010001",2011,332,31,301,77
"79143","S01010002",2011,336,10,326,64
"79144","S01010003",2011,279,8,271,18
"79145","S01010004",2011,273,6,267,10
"79146","S01010005",2011,488,85,403,137
"79147","S01010006",2011,586,79,507,155
"79148","S01010007",2011,429,7,422,66
"79149","S01010008",2011,410,79,331,124
"79150","S01010009",2011,416,55,361,157
"79151","S01010010",2011,451,15,436,52
"79152","S01010011",2011,544,194,350,113
"79153","S01010012",2011,348,6,342,34
"79154","S01010013",2011,457,34,423,175
"79155","S01010014",2011,523,80,443,74
"79156","S01010015",2011,392,33,359,117
"79157","S01010016",2011,325,104,221,13
"79158","S01010017",2011,339,187,152,26
"79159","S01010018",2011,525,271,254,40
"79160","S01010019",2011,409,336,73,19
"79161","S01010020",2011,346,125,221,25
"79162","S01010021",2011,400,319,81,38
"79163","S01010022",2011,468,262,206,71
"79164","S01010023",2011,387,327,60,8
"79165","S01010024",2011,402,255,147,60
"79166","S01010025",2011,316,255,61,19
"79167","S01010026",2011,492,299,193,61
"79168","S01010027",2011,483,210,273,93
"79169","S01010028",2011,381,254,127,45
"79170","S01010029",2011,398,258,140,12
"79171","S01010030",2011,429,97,332,102
"79172","S01010031",2011,423,13,410,217
"79173","S01010032",2011,298,26,272,163
"79174","S01010033",2011,503,278,225,110
"79175","S01010034",2011,498,290,208,57
"79176","S01010035",2011,401,303,98,42
"79177","S01010036",2011,423,16,407,320
"79178","S01010037",2011,376,246,130,19
"79179","S01010038",2011,568,301,267,109
"79180","S01010039",2011,593,40,553,342
"79181","S01010040",2011,415,62,353,142
"79182","S01010041",2011,451,172,279,133
"79183","S01010042",2011,621,104,517,331
"79184","S01010043",2011,451,212,239,102
"79185","S01010044",2011,649,225,424,183
"79186","S01010045",2011,258,207,51,12
"79187","S01010046",2011,431,221,210,76
"79188","S01010047",2011,471,383,88,10
"79189","S01010048",2011,551,376,175,59
"79190","S01010049",2011,395,312,83,44
"79191","S01010050",2011,540,416,124,63
"79192","S01010051",2011,431,297,134,49
"79193","S01010052",2011,372,190,182,89
"79194","S01010053",2011,384,182,202,119
"79195","S01010054",2011,248,229,19,1
"79196","S01010055",2011,457,190,267,81
"79197","S01010056",2011,214,178,36,10
"79198","S01010057",2011,216,82,134,54
"79199","S01010058",2011,355,173,182,58
"79200","S01010059",2011,371,92,279,108
"79201","S01010060",2011,493,292,201,65
"79202","S01010061",2011,253,37,216,56
"79203","S01010062",2011,344,170,174,39
"79204","S01010063",2011,546,327,219,87
"79205","S01010064",2011,264,115,149,34
"79206","S01010065",2011,413,223,190,32
"79207","S01010066",2011,342,188,154,37
"79208","S01010067",2011,297,235,62,15
"79209","S01010068",2011,338,135,203,95
"79210","S01010069",2011,340,23,317,21
"79211","S01010070",2011,238,4,234,11
"79212","S01010071",2011,367,89,278,26
"79213","S01010072",2011,370,82,288,15
"79214","S01010073",2011,349,38,311,10
"79215","S01010074",2011,306,10,296,14
"79216","S01010075",2011,303,80,223,15
"79217","S01010076",2011,276,68,208,19
"79218","S01010077",2011,302,143,159,20
"79219","S01010078",2011,229,13,216,7
"79220","S01010079",2011,349,9,340,13
"79221","S01010080",2011,284,5,279,5
"79222","S01010081",2011,300,12,288,15
"79223","S01010082",2011,407,5,402,82
"79224","S01010083",2011,348,99,249,28
"79225","S01010084",2011,442,156,286,34
"79226","S01010085",2011,311,11,300,11
"79227","S01010086",2011,414,170,244,19
"79228","S01010087",2011,247,5,242,5
"79229","S01010088",2011,295,13,282,33
"79230","S01010089",2011,365,87,278,68
"79231","S01010090",2011,435,50,385,66
"79232","S01010091",2011,343,90,253,45
"79233","S01010092",2011,446,180,266,43
"79234","S01010093",2011,386,35,351,50
"79235","S01010094",2011,291,41,250,10
"79236","S01010095",2011,279,0,0,7
"79237","S01010096",2011,292,5,287,8
"79238","S01010097",2011,286,28,258,23
"79239","S01010098",2011,277,2,275,5
"79240","S01010099",2011,285,4,281,12
"79241","S01010100",2011,382,23,359,15
"79242","S01010101",2011,299,10,289,22
"79243","S01010102",2011,324,9,315,15
"79244","S01010103",2011,355,3,352,19
"79245","S01010104",2011,267,5,262,17
"79246","S01010105",2011,165,85,80,32
"79247","S01010106",2011,219,128,91,9
"79248","S01010107",2011,404,159,245,95
"79249","S01010108",2011,374,152,222,19
"79250","S01010109",2011,326,84,242,81
"79251","S01010110",2011,431,313,118,20
"79252","S01010111",2011,446,378,68,15
"79253","S01010112",2011,419,383,36,3
"79254","S01010113",2011,244,153,91,34
"79255","S01010114",2011,366,330,36,5
"79256","S01010115",2011,230,29,201,26
"79257","S01010116",2011,397,47,350,63
"79258","S01010117",2011,261,44,217,22
"79259","S01010118",2011,277,249,28,7
"79260","S01010119",2011,209,170,39,7
"79261","S01010120",2011,444,380,64,10
"79262","S01010121",2011,321,289,32,6
"79263","S01010122",2011,198,168,30,9
"79264","S01010123",2011,299,250,49,10
"79265","S01010124",2011,293,26,267,59
"79266","S01010125",2011,242,150,92,9
"79267","S01010126",2011,312,101,211,13
"79268","S01010127",2011,296,171,125,8
"79269","S01010128",2011,214,188,26,4
"79270","S01010129",2011,350,289,61,16
"79271","S01010130",2011,206,155,51,3
"79272","S01010131",2011,376,5,371,10
"79273","S01010132",2011,497,279,218,42
"79274","S01010133",2011,380,225,155,18
"79275","S01010134",2011,551,223,328,47
"79276","S01010135",2011,365,146,219,23
"79277","S01010136",2011,367,56,311,51
"79278","S01010137",2011,583,192,391,81
"79279","S01010138",2011,660,535,125,16
"79280","S01010139",2011,552,249,303,63
"79281","S01010140",2011,384,20,364,132
"79282","S01010141",2011,447,323,124,44
"79283","S01010142",2011,288,118,170,41
"79284","S01010143",2011,391,158,233,18
"79285","S01010144",2011,372,160,212,83
"79286","S01010145",2011,397,108,289,106
"79287","S01010146",2011,406,262,144,46
"79288","S01010147",2011,494,351,143,63
"79289","S01010148",2011,356,200,156,50
"79290","S01010149",2011,231,32,199,52
"79291","S01010150",2011,325,164,161,34
"79292","S01010151",2011,329,194,135,10
"79293","S01010152",2011,425,104,321,57
"79294","S01010153",2011,491,205,286,45
"79295","S01010154",2011,432,144,288,37
"79296","S01010155",2011,362,132,230,19
"79297","S01010156",2011,281,158,123,11
"79298","S01010157",2011,267,219,48,5
"79299","S01010158",2011,461,138,323,45
"79300","S01010159",2011,353,143,210,22
"79301","S01010160",2011,308,281,27,9
"79302","S01010161",2011,259,143,116,4
"79303","S01010162",2011,360,319,41,6
"79304","S01010163",2011,239,139,100,8
"79305","S01010164",2011,282,126,156,17
"79306","S01010165",2011,275,204,71,7
"79307","S01010166",2011,347,159,188,16
"79308","S01010167",2011,472,260,212,38
"79309","S01010168",2011,236,93,143,28
"79310","S01010169",2011,367,187,180,46
"79311","S01010170",2011,271,141,130,26
"79312","S01010171",2011,489,390,99,22
"79313","S01010172",2011,481,233,248,44
"79314","S01010173",2011,331,86,245,8
"79315","S01010174",2011,250,50,200,15
"79316","S01010175",2011,216,72,144,23
"79317","S01010176",2011,369,129,240,22
"79318","S01010177",2011,315,248,67,12
"79319","S01010178",2011,391,321,70,23
"79320","S01010179",2011,387,230,157,27
"79321","S01010180",2011,215,71,144,25
"79322","S01010181",2011,272,159,113,13
"79323","S01010182",2011,307,13,294,27
"79324","S01010183",2011,232,116,116,13
"79325","S01010184",2011,286,150,136,18
"79326","S01010185",2011,282,174,108,9
"79327","S01010186",2011,246,5,241,19
"79328","S01010187",2011,294,9,285,32
"79329","S01010188",2011,304,9,295,30
"79330","S01010189",2011,336,4,332,25
"79331","S01010190",2011,253,8,245,11
"79332","S01010191",2011,266,7,259,21
"79333","S01010192",2011,294,7,287,16
"79334","S01010193",2011,329,11,318,43
"79335","S01010194",2011,268,65,203,4
"79336","S01010195",2011,212,56,156,18
"79337","S01010196",2011,274,151,123,11
"79338","S01010197",2011,260,149,111,12
"79339","S01010198",2011,394,156,238,16
"79340","S01010199",2011,232,144,88,8
"79341","S01010200",2011,305,114,191,11
"79342","S01010201",2011,253,40,213,11
"79343","S01010202",2011,365,328,37,6
"79344","S01010203",2011,260,9,251,42
"79345","S01010204",2011,381,264,117,18
"79346","S01010205",2011,355,174,181,35
"79347","S01010206",2011,255,131,124,25
"79348","S01010207",2011,285,155,130,35
"79349","S01010208",2011,565,183,382,108
"79350","S01010209",2011,468,253,215,41
"79351","S01010210",2011,416,103,313,38
"79352","S01010211",2011,452,268,184,32
"79353","S01010212",2011,559,410,149,51
"79354","S01010213",2011,476,187,289,42
"79355","S01010214",2011,396,36,360,38
"79356","S01010215",2011,492,415,77,13
"79357","S01010216",2011,361,287,74,28
"79358","S01010217",2011,406,245,161,80
"79359","S01010218",2011,587,329,258,57
"79360","S01010219",2011,274,231,43,17
"79361","S01010220",2011,279,18,261,94
"79362","S01010221",2011,260,218,42,16
"79363","S01010222",2011,285,127,158,68
"79364","S01010223",2011,337,193,144,42
"79365","S01010224",2011,469,416,53,9
"79366","S01010225",2011,431,241,190,46
"79367","S01010226",2011,394,355,39,13
"79368","S01010227",2011,294,260,34,15
"79369","S01010228",2011,384,251,133,15
"79370","S01010229",2011,508,326,182,24
"79371","S01010230",2011,577,525,52,17
"79372","S01010231",2011,514,473,41,17
"79373","S01010232",2011,485,381,104,27
"79374","S01010233",2011,476,388,88,15
"79375","S01010234",2011,562,80,482,202
"79376","S01010235",2011,446,5,441,238
"79377","S01010236",2011,378,39,339,122
"79378","S01010237",2011,353,54,299,101
"79379","S01010238",2011,455,58,397,162
"79380","S01010239",2011,424,226,198,64
"79381","S01010240",2011,398,145,253,92
"79382","S01010241",2011,623,183,440,173
"79383","S01010242",2011,455,217,238,121
"79384","S01010243",2011,610,279,331,209
"79385","S01010244",2011,440,316,124,47
"79386","S01010245",2011,509,446,63,28
"79387","S01010246",2011,433,284,149,75
"79388","S01010247",2011,356,97,259,17
"79389","S01010248",2011,456,22,434,151
"79390","S01010249",2011,403,16,387,182
"79391","S01010250",2011,390,10,380,186
"79392","S01010251",2011,317,7,310,197
"79393","S01010252",2011,297,34,263,106
"79394","S01010253",2011,364,235,129,43
"79395","S01010254",2011,581,321,260,86
"79396","S01010255",2011,353,254,99,45
"79397","S01010256",2011,516,420,96,31
"79398","S01010257",2011,497,135,362,297
"79399","S01010258",2011,424,16,408,282
"79400","S01010259",2011,468,364,104,46
"79401","S01010260",2011,685,154,531,268
"79402","S01010261",2011,526,280,246,129
"79403","S01010262",2011,535,340,195,83
"79404","S01010263",2011,422,32,390,240
"79405","S01010264",2011,557,134,423,267
"79406","S01010265",2011,573,2,571,334
"79407","S01010266",2011,237,30,207,103
"79408","S01010267",2011,318,16,302,231
"79409","S01010268",2011,417,93,324,147
"79410","S01010269",2011,320,56,264,164
"79411","S01010270",2011,817,494,323,161
"79412","S01010271",2011,327,52,275,173
"79413","S01010272",2011,703,402,301,169
"79414","S01010273",2011,409,13,396,276
"79415","S01010274",2011,342,17,325,196
"79416","S01010275",2011,357,10,347,227
"79417","S01010276",2011,625,13,612,347
"79418","S01010277",2011,305,194,111,61
"79419","S01010278",2011,330,215,115,52
"79420","S01010279",2011,312,126,186,107
"79421","S01010280",2011,426,82,344,216
"79422","S01010281",2011,466,62,404,229
"79423","S01010282",2011,645,278,367,189
"79424","S01010283",2011,296,59,237,145
"79425","S01010284",2011,638,96,542,303
"79426","S01010285",2011,420,135,285,171
"79427","S01010286",2011,365,57,308,171
"79428","S01010287",2011,387,26,361,214
"79429","S01010288",2011,349,31,318,181
"79430","S01010289",2011,380,11,369,111
"79431","S01010290",2011,278,66,212,118
"79432","S01010291",2011,481,126,355,222
"79433","S01010292",2011,409,11,398,195
"79434","S01010293",2011,373,89,284,177
"79435","S01010294",2011,275,16,259,142
"79436","S01010295",2011,427,23,404,233
"79437","S01010296",2011,291,96,195,98
"79438","S01010297",2011,676,332,344,167
"79439","S01010298",2011,515,266,249,115
"79440","S01010299",2011,292,189,103,34
"79441","S01010300",2011,478,194,284,166
"79442","S01010301",2011,283,23,260,133
"79443","S01010302",2011,388,291,97,35
"79444","S01010303",2011,250,205,45,16
"79445","S01010304",2011,332,194,138,54
"79446","S01010305",2011,478,219,259,100
"79447","S01010306",2011,449,91,358,172
"79448","S01010307",2011,428,31,397,162
"79449","S01010308",2011,480,48,432,192
"79450","S01010309",2011,264,173,91,20
"79451","S01010310",2011,381,216,165,88
"79452","S01010311",2011,351,262,89,26
"79453","S01010312",2011,425,418,7,3
"79454","S01010313",2011,356,316,40,19
"79455","S01010314",2011,550,393,157,45
"79456","S01010315",2011,409,137,272,89
"79457","S01010316",2011,304,232,72,34
"79458","S01010317",2011,394,44,350,152
"79459","S01010318",2011,304,205,99,56
"79460","S01010319",2011,407,96,311,114
"79461","S01010320",2011,437,211,226,109
"79462","S01010321",2011,432,158,274,125
"79463","S01010322",2011,549,19,530,212
"79464","S01010323",2011,377,358,19,7
"79465","S01010324",2011,403,235,168,29
"79466","S01010325",2011,501,242,259,32
"79467","S01010326",2011,494,410,84,23
"79468","S01010327",2011,362,186,176,38
"79469","S01010328",2011,445,128,317,52
"79470","S01010329",2011,290,108,182,31
"79471","S01010330",2011,299,213,86,13
"79472","S01010331",2011,520,247,273,40
"79473","S01010332",2011,279,130,149,20
"79474","S01010333",2011,487,193,294,56
"79475","S01010334",2011,433,134,299,38
"79476","S01010335",2011,345,159,186,19
"79477","S01010336",2011,379,338,41,6
"79478","S01010337",2011,278,133,145,14
"79479","S01010338",2011,356,251,105,11
"79480","S01010339",2011,284,99,185,13
"79481","S01010340",2011,349,214,135,12
"79482","S01010341",2011,253,57,196,14
"79483","S01010342",2011,302,10,292,27
"79484","S01010343",2011,365,9,356,26
"79485","S01010344",2011,419,347,72,7
"79486","S01010345",2011,160,4,156,20
"79487","S01010346",2011,410,40,370,29
"79488","S01010347",2011,466,270,196,49
"79489","S01010348",2011,483,179,304,30
"79490","S01010349",2011,443,201,242,17
"79491","S01010350",2011,475,326,149,18
"79492","S01010351",2011,398,147,251,68
"79493","S01010352",2011,276,122,154,27
"79494","S01010353",2011,562,516,46,11
"79495","S01010354",2011,375,183,192,61
"79496","S01010355",2011,402,234,168,44
"79497","S01010356",2011,308,80,228,46
"79498","S01010357",2011,340,236,104,16
"79499","S01010358",2011,507,332,175,35
"79500","S01010359",2011,456,379,77,19
"79501","S01010360",2011,285,185,100,26
"79502","S01010361",2011,402,356,46,17
"79503","S01010362",2011,611,497,114,22
"79504","S01010363",2011,394,35,359,85
"79505","S01010364",2011,337,11,326,12
"79506","S01010365",2011,449,4,445,78
"79507","S01010366",2011,502,14,488,96
"79508","S01010367",2011,507,15,492,94
"79509","S01010368",2011,355,5,350,61
"79510","S01010369",2011,433,112,321,123
"79511","S01010370",2011,335,13,322,113
"79512","S01010371",2011,461,6,455,166
"79513","S01010372",2011,226,11,215,50
"79514","S01010373",2011,408,37,371,138
"79515","S01010374",2011,469,21,448,156
"79516","S01010375",2011,219,5,214,138
"79517","S01010376",2011,367,32,335,205
"79518","S01010377",2011,375,36,339,197
"79519","S01010378",2011,272,14,258,150
"79520","S01010379",2011,446,75,371,194
"79521","S01010380",2011,521,69,452,172
"79522","S01010381",2011,372,31,341,227
"79523","S01010382",2011,483,97,386,186
"79524","S01010383",2011,393,193,200,131
"79525","S01010384",2011,454,47,407,204
"79526","S01010385",2011,498,163,335,170
"79527","S01010386",2011,528,259,269,124
"79528","S01010387",2011,587,154,433,257
"79529","S01010388",2011,584,268,316,123
"79530","S01010389",2011,668,45,623,361
"79531","S01010390",2011,716,118,598,287
"79532","S01010391",2011,541,86,455,221
"79533","S01010392",2011,416,12,404,264
"79534","S01010393",2011,634,69,565,252
"79535","S01010394",2011,516,361,155,49
"79536","S01010395",2011,637,159,478,181
"79537","S01010396",2011,585,189,396,198
"79538","S01010397",2011,294,50,244,96
"79539","S01010398",2011,583,12,571,210
"79540","S01010399",2011,615,4,611,261
"79541","S01010400",2011,530,29,501,105
"79542","S01010401",2011,400,76,324,118
"79543","S01010402",2011,513,34,479,124
"79544","S01010403",2011,509,4,505,115
"79545","S01010404",2011,406,37,369,89
"79546","S01010405",2011,408,7,401,107
"79547","S01010406",2011,435,9,426,183
"79548","S01010407",2011,418,4,414,210
"79549","S01010408",2011,272,89,183,26
"79550","S01010409",2011,245,8,237,4
"79551","S01010410",2011,248,5,243,23
"79552","S01010411",2011,365,8,357,16
"79553","S01010412",2011,424,7,417,165
"79554","S01010413",2011,340,6,334,32
"79555","S01010414",2011,497,73,424,67
"79556","S01010415",2011,555,275,280,51
"79557","S01010416",2011,322,8,314,59
"79558","S01010417",2011,286,10,276,46
"79559","S01010418",2011,561,31,530,135
"79560","S01010419",2011,500,21,479,79
"79561","S01010420",2011,290,14,276,12
"79562","S01010421",2011,346,23,323,28
"79563","S01010422",2011,483,83,400,39
"79564","S01010423",2011,490,304,186,76
"79565","S01010424",2011,471,228,243,70
"79566","S01010425",2011,621,374,247,99
"79567","S01010426",2011,406,183,223,60
"79568","S01010427",2011,499,283,216,16
"79569","S01010428",2011,319,64,255,20
"79570","S01010429",2011,388,19,369,24
"79571","S01010430",2011,451,285,166,30
"79572","S01010431",2011,258,12,246,11
"79573","S01010432",2011,464,258,206,62
"79574","S01010433",2011,338,304,34,9
"79575","S01010434",2011,331,216,115,48
"79576","S01010435",2011,291,97,194,14
"79577","S01010436",2011,433,275,158,60
"79578","S01010437",2011,269,115,154,14
"79579","S01010438",2011,370,238,132,14
"79580","S01010439",2011,512,242,270,103
"79581","S01010440",2011,322,181,141,13
"79582","S01010441",2011,488,103,385,112
"79583","S01010442",2011,383,193,190,61
"79584","S01010443",2011,228,49,179,25
"79585","S01010444",2011,289,89,200,22
"79586","S01010445",2011,307,129,178,15
"79587","S01010446",2011,329,66,263,10
"79588","S01010447",2011,521,310,211,34
"79589","S01010448",2011,360,69,291,20
"79590","S01010449",2011,370,102,268,36
"79591","S01010450",2011,407,138,269,30
"79592","S01010451",2011,438,284,154,13
"79593","S01010452",2011,408,109,299,36
"79594","S01010453",2011,372,264,108,17
"79595","S01010454",2011,383,93,290,28
"79596","S01010455",2011,604,442,162,25
"79597","S01010456",2011,313,98,215,24
"79598","S01010457",2011,340,171,169,7
"79599","S01010458",2011,411,185,226,16
"79600","S01010459",2011,258,50,208,22
"79601","S01010460",2011,346,20,326,48
"79602","S01010461",2011,386,167,219,32
"79603","S01010462",2011,437,413,24,10
"79604","S01010463",2011,376,84,292,24
"79605","S01010464",2011,248,57,191,12
"79606","S01010465",2011,451,23,428,55
"79607","S01010466",2011,458,7,451,125
"79608","S01010467",2011,476,10,466,91
"79609","S01010468",2011,417,3,414,92
"79610","S01010469",2011,405,119,286,118
"79611","S01010470",2011,364,95,269,26
"79612","S01010471",2011,316,106,210,32
"79613","S01010472",2011,290,41,249,69
"79614","S01010473",2011,435,39,396,99
"79615","S01010474",2011,431,83,348,129
"79616","S01010475",2011,384,7,377,75
"79617","S01010476",2011,523,106,417,66
"79618","S01010477",2011,354,74,280,30
"79619","S01010478",2011,628,334,294,53
"79620","S01010479",2011,512,188,324,39
"79621","S01010480",2011,285,65,220,15
"79622","S01010481",2011,267,162,105,22
"79623","S01010482",2011,354,97,257,15
"79624","S01010483",2011,526,163,363,33
"79625","S01010484",2011,246,95,151,18
"79626","S01010485",2011,396,88,308,14
"79627","S01010486",2011,371,11,360,10
"79628","S01010487",2011,432,92,340,20
"79629","S01010488",2011,338,216,122,24
"79630","S01010489",2011,450,240,210,11
"79631","S01010490",2011,308,223,85,17
"79632","S01010491",2011,417,360,57,8
"79633","S01010492",2011,255,234,21,8
"79634","S01010493",2011,308,293,15,3
"79635","S01010494",2011,252,119,133,11
"79636","S01010495",2011,418,353,65,12
"79637","S01010496",2011,388,319,69,14
"79638","S01010497",2011,285,193,92,6
"79639","S01010498",2011,357,303,54,10
"79640","S01010499",2011,451,410,41,12
"79641","S01010500",2011,398,310,88,12
"79642","S01010501",2011,430,258,172,16
"79643","S01010502",2011,331,168,163,15
"79644","S01010503",2011,321,227,94,13
"79645","S01010504",2011,247,26,221,50
"79646","S01010505",2011,244,34,210,38
"79647","S01010506",2011,380,65,315,37
"79648","S01010507",2011,345,80,265,46
"79649","S01010508",2011,449,84,365,53
"79650","S01010509",2011,393,32,361,61
"79651","S01010510",2011,340,67,273,16
"79652","S01010511",2011,369,181,188,15
"79653","S01010512",2011,281,90,191,16
"79654","S01010513",2011,300,23,277,30
"79655","S01010514",2011,287,77,210,17
"79656","S01010515",2011,350,116,234,20
"79657","S01010516",2011,270,55,215,30
"79658","S01010517",2011,362,113,249,36
"79659","S01010518",2011,293,52,241,52
"79660","S01010519",2011,282,103,179,24
"79661","S01010520",2011,410,56,354,35
"79662","S01010521",2011,339,116,223,32
"79663","S01010522",2011,283,122,161,40
"79664","S01010523",2011,258,170,88,15
"79665","S01010524",2011,234,20,214,24
"79666","S01010525",2011,259,16,243,27
"79667","S01010526",2011,364,82,282,42
"79668","S01010527",2011,455,176,279,35
"79669","S01010528",2011,265,36,229,41
"79670","S01010529",2011,283,47,236,21
"79671","S01010530",2011,278,20,258,35
"79672","S01010531",2011,496,74,422,52
"79673","S01010532",2011,245,12,233,44
"79674","S01010533",2011,272,49,223,31
"79675","S01010534",2011,374,90,284,29
"79676","S01010535",2011,305,28,277,69
"79677","S01010536",2011,397,139,258,43
"79678","S01010537",2011,330,73,257,53
"79679","S01010538",2011,337,112,225,60
"79680","S01010539",2011,496,59,437,116
"79681","S01010540",2011,298,22,276,60
"79682","S01010541",2011,362,37,325,55
"79683","S01010542",2011,388,53,335,42
"79684","S01010543",2011,255,12,243,49
"79685","S01010544",2011,370,76,294,37
"79686","S01010545",2011,344,68,276,46
"79687","S01010546",2011,369,62,307,65
"79688","S01010547",2011,313,21,292,47
"79689","S01010548",2011,299,5,294,60
"79690","S01010549",2011,366,19,347,52
"79691","S01010550",2011,236,48,188,23
"79692","S01010551",2011,267,27,240,45
"79693","S01010552",2011,334,28,306,77
"79694","S01010553",2011,261,5,256,90
"79695","S01010554",2011,396,29,367,86
"79696","S01010555",2011,450,55,395,108
"79697","S01010556",2011,410,204,206,22
"79698","S01010557",2011,278,85,193,15
"79699","S01010558",2011,385,83,302,22
"79700","S01010559",2011,351,43,308,27
"79701","S01010560",2011,291,8,283,22
"79702","S01010561",2011,301,7,294,25
"79703","S01010562",2011,314,16,298,20
"79704","S01010563",2011,211,63,148,15
"79705","S01010564",2011,269,160,109,11
"79706","S01010565",2011,276,65,211,16
"79707","S01010566",2011,453,35,418,77
"79708","S01010567",2011,379,2,377,43
"79709","S01010568",2011,391,58,333,40
"79710","S01010569",2011,295,7,288,73
"79711","S01010570",2011,467,169,298,30
"79712","S01010571",2011,398,8,390,67
"79713","S01010572",2011,336,79,257,74
"79714","S01010573",2011,222,50,172,10
"79715","S01010574",2011,236,4,232,14
"79716","S01010575",2011,284,8,276,16
"79717","S01010576",2011,326,9,317,13
"79718","S01010577",2011,354,157,197,14
"79719","S01010578",2011,203,49,154,13
"79720","S01010579",2011,325,7,318,25
"79721","S01010580",2011,305,33,272,120
"79722","S01010581",2011,243,11,232,46
"79723","S01010582",2011,185,4,181,32
"79724","S01010583",2011,440,4,436,65
"79725","S01010584",2011,312,55,257,26
"79726","S01010585",2011,304,19,285,50
"79727","S01010586",2011,305,4,301,20
"79728","S01010587",2011,293,7,286,22
"79729","S01010588",2011,268,21,247,25
"79730","S01010589",2011,299,80,219,43
"79731","S01010590",2011,293,3,290,17
"79732","S01010591",2011,303,39,264,44
"79733","S01010592",2011,273,8,265,82
"79734","S01010593",2011,259,5,254,24
"79735","S01010594",2011,281,17,264,80
"79736","S01010595",2011,310,29,281,74
"79737","S01010596",2011,310,6,304,60
"79738","S01010597",2011,274,37,237,37
"79739","S01010598",2011,404,35,369,94
"79740","S01010599",2011,248,2,246,41
"79741","S01010600",2011,427,29,398,44
"79742","S01010601",2011,302,19,283,22
"79743","S01010602",2011,260,3,257,41
"79744","S01010603",2011,369,9,360,43
"79745","S01010604",2011,193,2,191,9
"79746","S01010605",2011,387,7,380,30
"79747","S01010606",2011,371,98,273,37
"79748","S01010607",2011,346,4,342,32
"79749","S01010608",2011,306,156,150,27
"79750","S01010609",2011,242,83,159,20
"79751","S01010610",2011,318,15,303,40
"79752","S01010611",2011,496,107,389,78
"79753","S01010612",2011,316,45,271,30
"79754","S01010613",2011,341,120,221,38
"79755","S01010614",2011,264,117,147,23
"79756","S01010615",2011,383,36,347,101
"79757","S01010616",2011,359,6,353,30
"79758","S01010617",2011,360,6,354,32
"79759","S01010618",2011,307,6,301,24
"79760","S01010619",2011,318,81,237,100
"79761","S01010620",2011,369,125,244,155
"79762","S01010621",2011,432,51,381,113
"79763","S01010622",2011,333,135,198,47
"79764","S01010623",2011,278,54,224,149
"79765","S01010624",2011,244,53,191,41
"79766","S01010625",2011,333,6,327,30
"79767","S01010626",2011,368,19,349,26
"79768","S01010627",2011,401,40,361,123
"79769","S01010628",2011,472,16,456,127
"79770","S01010629",2011,445,80,365,83
"79771","S01010630",2011,252,94,158,27
"79772","S01010631",2011,326,56,270,102
"79773","S01010632",2011,486,140,346,57
"79774","S01010633",2011,476,221,255,29
"79775","S01010634",2011,264,80,184,21
"79776","S01010635",2011,351,140,211,27
"79777","S01010636",2011,386,29,357,57
"79778","S01010637",2011,352,127,225,104
"79779","S01010638",2011,417,111,306,60
"79780","S01010639",2011,555,194,361,106
"79781","S01010640",2011,411,44,367,165
"79782","S01010641",2011,531,323,208,71
"79783","S01010642",2011,451,268,183,22
"79784","S01010643",2011,287,214,73,6
"79785","S01010644",2011,346,272,74,12
"79786","S01010645",2011,278,5,273,62
"79787","S01010646",2011,287,8,279,32
"79788","S01010647",2011,306,9,297,37
"79789","S01010648",2011,306,55,251,32
"79790","S01010649",2011,280,8,272,36
"79791","S01010650",2011,196,41,155,42
"79792","S01010651",2011,295,89,206,21
"79793","S01010652",2011,309,36,273,42
"79794","S01010653",2011,300,10,290,33
"79795","S01010654",2011,348,91,257,27
"79796","S01010655",2011,380,17,363,64
"79797","S01010656",2011,182,37,145,8
"79798","S01010657",2011,248,6,242,19
"79799","S01010658",2011,296,7,289,34
"79800","S01010659",2011,276,3,273,52
"79801","S01010660",2011,285,49,236,32
"79802","S01010661",2011,307,79,228,42
"79803","S01010662",2011,310,30,280,16
"79804","S01010663",2011,381,13,368,42
"79805","S01010664",2011,337,6,331,28
"79806","S01010665",2011,430,25,405,60
"79807","S01010666",2011,416,78,338,50
"79808","S01010667",2011,288,16,272,45
"79809","S01010668",2011,503,72,431,55
"79810","S01010669",2011,266,24,242,28
"79811","S01010670",2011,296,35,261,23
"79812","S01010671",2011,329,43,286,25
"79813","S01010672",2011,321,123,198,25
"79814","S01010673",2011,419,110,309,44
"79815","S01010674",2011,419,69,350,44
"79816","S01010675",2011,273,25,248,19
"79817","S01010676",2011,392,53,339,50
"79818","S01010677",2011,224,14,210,24
"79819","S01010678",2011,273,25,248,24
"79820","S01010679",2011,282,77,205,26
"79821","S01010680",2011,315,138,177,16
"79822","S01010681",2011,461,188,273,29
"79823","S01010682",2011,398,27,371,41
"79824","S01010683",2011,423,48,375,23
"79825","S01010684",2011,361,25,336,38
"79826","S01010685",2011,294,28,266,19
"79827","S01010686",2011,309,33,276,29
"79828","S01010687",2011,379,58,321,23
"79829","S01010688",2011,335,47,288,34
"79830","S01010689",2011,378,41,337,44
"79831","S01010690",2011,330,76,254,39
"79832","S01010691",2011,325,6,319,57
"79833","S01010692",2011,307,79,228,27
"79834","S01010693",2011,216,18,198,13
"79835","S01010694",2011,270,34,236,19
"79836","S01010695",2011,304,5,299,54
"79837","S01010696",2011,402,68,334,35
"79838","S01010697",2011,458,33,425,68
"79839","S01010698",2011,338,41,297,56
"79840","S01010699",2011,250,12,238,46
"79841","S01010700",2011,258,21,237,30
"79842","S01010701",2011,432,88,344,44
"79843","S01010702",2011,417,8,409,36
"79844","S01010703",2011,341,5,336,52
"79845","S01010704",2011,300,87,213,14
"79846","S01010705",2011,463,81,382,29
"79847","S01010706",2011,293,95,198,26
"79848","S01010707",2011,265,2,263,40
"79849","S01010708",2011,252,37,215,12
"79850","S01010709",2011,299,28,271,16
"79851","S01010710",2011,316,152,164,5
"79852","S01010711",2011,319,32,287,14
"79853","S01010712",2011,269,107,162,18
"79854","S01010713",2011,322,81,241,24
"79855","S01010714",2011,380,173,207,38
"79856","S01010715",2011,340,93,247,26
"79857","S01010716",2011,444,85,359,95
"79858","S01010717",2011,272,3,269,13
"79859","S01010718",2011,393,62,331,35
"79860","S01010719",2011,282,44,238,27
"79861","S01010720",2011,336,46,290,13
"79862","S01010721",2011,296,4,292,36
"79863","S01010722",2011,394,78,316,31
"79864","S01010723",2011,329,10,319,51
"79865","S01010724",2011,354,41,313,50
"79866","S01010725",2011,287,1,286,38
"79867","S01010726",2011,415,58,357,26
"79868","S01010727",2011,243,8,235,20
"79869","S01010728",2011,204,4,200,22
"79870","S01010729",2011,269,8,261,25
"79871","S01010730",2011,343,8,335,31
"79872","S01010731",2011,399,79,320,49
"79873","S01010732",2011,334,153,181,14
"79874","S01010733",2011,246,149,97,7
"79875","S01010734",2011,362,205,157,11
"79876","S01010735",2011,244,177,67,5
"79877","S01010736",2011,218,7,211,13
"79878","S01010737",2011,487,130,357,43
"79879","S01010738",2011,235,73,162,8
"79880","S01010739",2011,388,114,274,35
"79881","S01010740",2011,260,192,68,10
"79882","S01010741",2011,249,45,204,14
"79883","S01010742",2011,308,87,221,24
"79884","S01010743",2011,273,156,117,10
"79885","S01010744",2011,459,85,374,31
"79886","S01010745",2011,327,80,247,48
"79887","S01010746",2011,441,48,393,81
"79888","S01010747",2011,357,120,237,29
"79889","S01010748",2011,280,22,258,26
"79890","S01010749",2011,261,13,248,43
"79891","S01010750",2011,287,8,279,35
"79892","S01010751",2011,333,166,167,32
"79893","S01010752",2011,332,107,225,45
"79894","S01010753",2011,434,167,267,19
"79895","S01010754",2011,357,107,250,36
"79896","S01010755",2011,298,82,216,32
"79897","S01010756",2011,286,17,269,23
"79898","S01010757",2011,365,41,324,37
"79899","S01010758",2011,305,28,277,43
"79900","S01010759",2011,279,76,203,31
"79901","S01010760",2011,306,61,245,24
"79902","S01010761",2011,222,2,220,39
"79903","S01010762",2011,263,31,232,28
"79904","S01010763",2011,316,85,231,26
"79905","S01010764",2011,289,27,262,34
"79906","S01010765",2011,471,85,386,44
"79907","S01010766",2011,359,74,285,36
"79908","S01010767",2011,347,122,225,19
"79909","S01010768",2011,284,78,206,19
"79910","S01010769",2011,217,4,213,22
"79911","S01010770",2011,385,100,285,40
"79912","S01010771",2011,445,101,344,35
"79913","S01010772",2011,376,48,328,43
"79914","S01010773",2011,336,35,301,22
"79915","S01010774",2011,325,76,249,20
"79916","S01010775",2011,266,15,251,13
"79917","S01010776",2011,266,65,201,26
"79918","S01010777",2011,270,122,148,18
"79919","S01010778",2011,239,155,84,11
"79920","S01010779",2011,355,154,201,23
"79921","S01010780",2011,261,54,207,10
"79922","S01010781",2011,350,49,301,33
"79923","S01010782",2011,293,73,220,32
"79924","S01010783",2011,275,89,186,21
"79925","S01010784",2011,345,154,191,22
"79926","S01010785",2011,301,33,268,13
"79927","S01010786",2011,255,28,227,13
"79928","S01010787",2011,384,64,320,37
"79929","S01010788",2011,274,30,244,30
"79930","S01010789",2011,292,62,230,18
"79931","S01010790",2011,282,22,260,18
"79932","S01010791",2011,369,26,343,27
"79933","S01010792",2011,287,115,172,14
"79934","S01010793",2011,275,20,255,22
"79935","S01010794",2011,234,21,213,36
"79936","S01010795",2011,445,59,386,44
"79937","S01010796",2011,341,15,326,41
"79938","S01010797",2011,329,22,307,29
"79939","S01010798",2011,293,27,266,23
"79940","S01010799",2011,530,135,395,72
"79941","S01010800",2011,360,129,231,18
"79942","S01010801",2011,354,120,234,18
"79943","S01010802",2011,263,69,194,14
"79944","S01010803",2011,280,107,173,28
"79945","S01010804",2011,283,58,225,24
"79946","S01010805",2011,377,74,303,29
"79947","S01010806",2011,458,211,247,28
"79948","S01010807",2011,244,77,167,16
"79949","S01010808",2011,230,59,171,10
"79950","S01010809",2011,328,36,292,29
"79951","S01010810",2011,249,46,203,18
"79952","S01010811",2011,414,50,364,53
"79953","S01010812",2011,238,35,203,12
"79954","S01010813",2011,249,63,186,21
"79955","S01010814",2011,307,29,278,32
"79956","S01010815",2011,208,42,166,28
"79957","S01010816",2011,293,26,267,24
"79958","S01010817",2011,376,6,370,38
"79959","S01010818",2011,507,20,487,65
"79960","S01010819",2011,374,44,330,34
"79961","S01010820",2011,217,1,216,23
"79962","S01010821",2011,245,10,235,20
"79963","S01010822",2011,280,7,273,48
"79964","S01010823",2011,147,17,130,15
"79965","S01010824",2011,250,11,239,11
"79966","S01010825",2011,125,1,124,10
"79967","S01010826",2011,315,5,310,49
"79968","S01010827",2011,221,3,218,2
"79969","S01010828",2011,441,22,419,12
"79970","S01010829",2011,464,31,433,75
"79971","S01010830",2011,231,17,214,28
"79972","S01010831",2011,197,8,189,5
"79973","S01010832",2011,284,8,276,33
"79974","S01010833",2011,348,1,347,10
"79975","S01010834",2011,422,4,418,33
"79976","S01010835",2011,270,0,0,7
"79977","S01010836",2011,384,5,379,54
"79978","S01010837",2011,289,22,267,12
"79979","S01010838",2011,330,47,283,16
"79980","S01010839",2011,339,36,303,21
"79981","S01010840",2011,300,13,287,64
"79982","S01010841",2011,390,13,377,78
"79983","S01010842",2011,613,178,435,163
"79984","S01010843",2011,407,90,317,92
"79985","S01010844",2011,289,10,279,11
"79986","S01010845",2011,259,24,235,14
"79987","S01010846",2011,296,61,235,18
"79988","S01010847",2011,259,6,253,13
"79989","S01010848",2011,260,113,147,17
"79990","S01010849",2011,364,148,216,15
"79991","S01010850",2011,373,178,195,17
"79992","S01010851",2011,347,136,211,31
"79993","S01010852",2011,306,62,244,10
"79994","S01010853",2011,358,66,292,16
"79995","S01010854",2011,384,181,203,15
"79996","S01010855",2011,223,57,166,20
"79997","S01010856",2011,455,165,290,28
"79998","S01010857",2011,324,77,247,17
"79999","S01010858",2011,330,98,232,20
"80000","S01010859",2011,304,117,187,14
"80001","S01010860",2011,279,69,210,15
"80002","S01010861",2011,332,125,207,38
"80003","S01010862",2011,266,202,64,15
"80004","S01010863",2011,317,21,296,28
"80005","S01010864",2011,250,2,248,18
"80006","S01010865",2011,345,10,335,20
"80007","S01010866",2011,312,30,282,33
"80008","S01010867",2011,285,35,250,23
"80009","S01010868",2011,306,40,266,13
"80010","S01010869",2011,290,6,284,13
"80011","S01010870",2011,407,33,374,86
"80012","S01010871",2011,408,15,393,93
"80013","S01010872",2011,403,53,350,90
"80014","S01010873",2011,400,247,153,69
"80015","S01010874",2011,307,9,298,37
"80016","S01010875",2011,257,32,225,61
"80017","S01010876",2011,393,160,233,85
"80018","S01010877",2011,467,132,335,75
"80019","S01010878",2011,512,96,416,76
"80020","S01010879",2011,387,69,318,26
"80021","S01010880",2011,268,113,155,12
"80022","S01010881",2011,285,33,252,11
"80023","S01010882",2011,203,39,164,5
"80024","S01010883",2011,336,66,270,8
"80025","S01010884",2011,408,232,176,32
"80026","S01010885",2011,541,303,238,73
"80027","S01010886",2011,250,75,175,58
"80028","S01010887",2011,458,291,167,30
"80029","S01010888",2011,437,140,297,74
"80030","S01010889",2011,344,184,160,61
"80031","S01010890",2011,507,234,273,63
"80032","S01010891",2011,280,152,128,74
"80033","S01010892",2011,531,259,272,72
"80034","S01010893",2011,327,202,125,43
"80035","S01010894",2011,312,108,204,53
"80036","S01010895",2011,256,136,120,15
"80037","S01010896",2011,339,151,188,29
"80038","S01010897",2011,380,253,127,7
"80039","S01010898",2011,253,134,119,9
"80040","S01010899",2011,221,30,191,17
"80041","S01010900",2011,298,74,224,70
"80042","S01010901",2011,205,132,73,8
"80043","S01010902",2011,453,154,299,18
"80044","S01010903",2011,427,292,135,20
"80045","S01010904",2011,271,162,109,15
"80046","S01010905",2011,290,117,173,51
"80047","S01010906",2011,383,166,217,27
"80048","S01010907",2011,199,6,193,16
"80049","S01010908",2011,274,101,173,23
"80050","S01010909",2011,284,14,270,20
"80051","S01010910",2011,273,105,168,72
"80052","S01010911",2011,360,163,197,60
"80053","S01010912",2011,392,228,164,57
"80054","S01010913",2011,293,19,274,51
"80055","S01010914",2011,255,15,240,16
"80056","S01010915",2011,271,26,245,27
"80057","S01010916",2011,333,92,241,121
"80058","S01010917",2011,369,68,301,54
"80059","S01010918",2011,334,103,231,18
"80060","S01010919",2011,335,107,228,18
"80061","S01010920",2011,254,172,82,23
"80062","S01010921",2011,257,94,163,18
"80063","S01010922",2011,346,163,183,14
"80064","S01010923",2011,398,136,262,22
"80065","S01010924",2011,260,76,184,16
"80066","S01010925",2011,386,180,206,20
"80067","S01010926",2011,352,145,207,24
"80068","S01010927",2011,251,72,179,16
"80069","S01010928",2011,311,120,191,32
"80070","S01010929",2011,271,125,146,17
"80071","S01010930",2011,357,12,345,69
"80072","S01010931",2011,203,21,182,65
"80073","S01010932",2011,277,130,147,17
"80074","S01010933",2011,276,21,255,20
"80075","S01010934",2011,424,12,412,51
"80076","S01010935",2011,323,53,270,19
"80077","S01010936",2011,404,138,266,42
"80078","S01010937",2011,323,53,270,17
"80079","S01010938",2011,369,186,183,31
"80080","S01010939",2011,199,27,172,10
"80081","S01010940",2011,268,1,267,4
"80082","S01010941",2011,323,4,319,6
"80083","S01010942",2011,268,1,267,4
"80084","S01010943",2011,244,85,159,13
"80085","S01010944",2011,295,138,157,28
"80086","S01010945",2011,222,69,153,11
"80087","S01010946",2011,344,128,216,18
"80088","S01010947",2011,242,88,154,19
"80089","S01010948",2011,288,107,181,8
"80090","S01010949",2011,344,7,337,8
"80091","S01010950",2011,380,88,292,19
"80092","S01010951",2011,258,44,214,14
"80093","S01010952",2011,199,34,165,12
"80094","S01010953",2011,225,42,183,11
"80095","S01010954",2011,206,11,195,10
"80096","S01010955",2011,345,44,301,112
"80097","S01010956",2011,304,28,276,54
"80098","S01010957",2011,231,10,221,9
"80099","S01010958",2011,224,42,182,12
"80100","S01010959",2011,290,66,224,35
"80101","S01010960",2011,441,116,325,47
"80102","S01010961",2011,246,86,160,14
"80103","S01010962",2011,314,3,311,10
"80104","S01010963",2011,395,56,339,32
"80105","S01010964",2011,216,31,185,7
"80106","S01010965",2011,230,116,114,19
"80107","S01010966",2011,309,79,230,23
"80108","S01010967",2011,309,125,184,20
"80109","S01010968",2011,316,31,285,29
"80110","S01010969",2011,264,37,227,14
"80111","S01010970",2011,428,89,339,32
"80112","S01010971",2011,401,38,363,34
"80113","S01010972",2011,333,166,167,17
"80114","S01010973",2011,205,27,178,9
"80115","S01010974",2011,298,131,167,6
"80116","S01010975",2011,195,101,94,13
"80117","S01010976",2011,211,71,140,9
"80118","S01010977",2011,312,75,237,19
"80119","S01010978",2011,354,141,213,39
"80120","S01010979",2011,324,117,207,18
"80121","S01010980",2011,348,113,235,34
"80122","S01010981",2011,330,120,210,30
"80123","S01010982",2011,447,33,414,41
"80124","S01010983",2011,388,79,309,39
"80125","S01010984",2011,300,33,267,4
"80126","S01010985",2011,244,60,184,22
"80127","S01010986",2011,179,3,176,5
"80128","S01010987",2011,219,3,216,6
"80129","S01010988",2011,205,4,201,4
"80130","S01010989",2011,357,5,352,25
"80131","S01010990",2011,319,73,246,28
"80132","S01010991",2011,198,23,175,15
"80133","S01010992",2011,184,6,178,10
"80134","S01010993",2011,252,34,218,7
"80135","S01010994",2011,390,9,381,29
"80136","S01010995",2011,290,7,283,10
"80137","S01010996",2011,235,6,229,14
"80138","S01010997",2011,290,7,283,12
"80139","S01010998",2011,216,2,214,11
"80140","S01010999",2011,412,72,340,40
"80141","S01011000",2011,345,56,289,37
"80142","S01011001",2011,273,81,192,14
"80143","S01011002",2011,314,116,198,17
"80144","S01011003",2011,280,90,190,13
"80145","S01011004",2011,249,37,212,10
"80146","S01011005",2011,337,125,212,33
"80147","S01011006",2011,422,99,323,35
"80148","S01011007",2011,280,130,150,15
"80149","S01011008",2011,332,119,213,11
"80150","S01011009",2011,222,107,115,8
"80151","S01011010",2011,335,102,233,78
"80152","S01011011",2011,435,244,191,51
"80153","S01011012",2011,313,217,96,14
"80154","S01011013",2011,375,135,240,15
"80155","S01011014",2011,364,93,271,26
"80156","S01011015",2011,200,76,124,7
"80157","S01011016",2011,311,56,255,16
"80158","S01011017",2011,352,23,329,62
"80159","S01011018",2011,366,132,234,30
"80160","S01011019",2011,408,93,315,73
"80161","S01011020",2011,202,13,189,13
"80162","S01011021",2011,351,108,243,20
"80163","S01011022",2011,233,105,128,8
"80164","S01011023",2011,350,93,257,20
"80165","S01011024",2011,302,154,148,15
"80166","S01011025",2011,276,155,121,14
"80167","S01011026",2011,235,137,98,7
"80168","S01011027",2011,418,259,159,19
"80169","S01011028",2011,425,230,195,14
"80170","S01011029",2011,264,98,166,14
"80171","S01011030",2011,369,45,324,17
"80172","S01011031",2011,320,157,163,14
"80173","S01011032",2011,353,114,239,34
"80174","S01011033",2011,275,57,218,15
"80175","S01011034",2011,331,136,195,26
"80176","S01011035",2011,252,121,131,13
"80177","S01011036",2011,285,64,221,28
"80178","S01011037",2011,409,173,236,39
"80179","S01011038",2011,337,218,119,10
"80180","S01011039",2011,392,142,250,46
"80181","S01011040",2011,285,115,170,16
"80182","S01011041",2011,292,175,117,7
"80183","S01011042",2011,333,48,285,29
"80184","S01011043",2011,310,117,193,8
"80185","S01011044",2011,307,134,173,22
"80186","S01011045",2011,369,58,311,82
"80187","S01011046",2011,362,19,343,52
"80188","S01011047",2011,396,25,371,46
"80189","S01011048",2011,440,109,331,29
"80190","S01011049",2011,322,62,260,25
"80191","S01011050",2011,323,18,305,44
"80192","S01011051",2011,428,81,347,37
"80193","S01011052",2011,366,55,311,44
"80194","S01011053",2011,295,91,204,24
"80195","S01011054",2011,244,49,195,18
"80196","S01011055",2011,228,19,209,58
"80197","S01011056",2011,271,13,258,22
"80198","S01011057",2011,238,23,215,20
"80199","S01011058",2011,251,5,246,26
"80200","S01011059",2011,248,16,232,33
"80201","S01011060",2011,402,75,327,21
"80202","S01011061",2011,404,155,249,42
"80203","S01011062",2011,423,76,347,61
"80204","S01011063",2011,472,191,281,11
"80205","S01011064",2011,480,85,395,37
"80206","S01011065",2011,289,53,236,44
"80207","S01011066",2011,231,45,186,20
"80208","S01011067",2011,284,50,234,22
"80209","S01011068",2011,238,54,184,13
"80210","S01011069",2011,251,60,191,12
"80211","S01011070",2011,274,41,233,14
"80212","S01011071",2011,357,37,320,24
"80213","S01011072",2011,407,63,344,21
"80214","S01011073",2011,286,14,272,23
"80215","S01011074",2011,280,41,239,15
"80216","S01011075",2011,322,140,182,13
"80217","S01011076",2011,348,125,223,18
"80218","S01011077",2011,337,220,117,6
"80219","S01011078",2011,466,52,414,31
"80220","S01011079",2011,488,24,464,64
"80221","S01011080",2011,461,90,371,28
"80222","S01011081",2011,352,101,251,9
"80223","S01011082",2011,269,142,127,8
"80224","S01011083",2011,347,64,283,18
"80225","S01011084",2011,330,22,308,33
"80226","S01011085",2011,383,35,348,29
"80227","S01011086",2011,273,27,246,30
"80228","S01011087",2011,262,61,201,14
"80229","S01011088",2011,453,68,385,56
"80230","S01011089",2011,310,126,184,16
"80231","S01011090",2011,304,4,300,50
"80232","S01011091",2011,260,4,256,42
"80233","S01011092",2011,181,106,75,16
"80234","S01011093",2011,239,5,234,19
"80235","S01011094",2011,196,4,192,26
"80236","S01011095",2011,318,8,310,52
"80237","S01011096",2011,223,7,216,59
"80238","S01011097",2011,284,10,274,51
"80239","S01011098",2011,346,48,298,44
"80240","S01011099",2011,358,186,172,22
"80241","S01011100",2011,210,45,165,8
"80242","S01011101",2011,247,120,127,12
"80243","S01011102",2011,330,156,174,53
"80244","S01011103",2011,312,112,200,75
"80245","S01011104",2011,294,66,228,36
"80246","S01011105",2011,405,98,307,77
"80247","S01011106",2011,352,133,219,124
"80248","S01011107",2011,324,82,242,70
"80249","S01011108",2011,216,69,147,12
"80250","S01011109",2011,389,41,348,37
"80251","S01011110",2011,314,107,207,20
"80252","S01011111",2011,407,172,235,27
"80253","S01011112",2011,328,25,303,41
"80254","S01011113",2011,446,93,353,23
"80255","S01011114",2011,296,30,266,12
"80256","S01011115",2011,411,166,245,24
"80257","S01011116",2011,269,31,238,30
"80258","S01011117",2011,359,11,348,74
"80259","S01011118",2011,399,38,361,58
"80260","S01011119",2011,422,38,384,49
"80261","S01011120",2011,293,3,290,7
"80262","S01011121",2011,313,102,211,97
"80263","S01011122",2011,302,51,251,45
"80264","S01011123",2011,490,118,372,29
"80265","S01011124",2011,277,53,224,35
"80266","S01011125",2011,220,125,95,20
"80267","S01011126",2011,184,64,120,42
"80268","S01011127",2011,153,17,136,123
"80269","S01011128",2011,341,83,258,46
"80270","S01011129",2011,356,14,342,88
"80271","S01011130",2011,296,88,208,35
"80272","S01011131",2011,318,13,305,82
"80273","S01011132",2011,374,11,363,43
"80274","S01011133",2011,190,39,151,15
"80275","S01011134",2011,401,62,339,80
"80276","S01011135",2011,337,89,248,28
"80277","S01011136",2011,284,45,239,36
"80278","S01011137",2011,186,52,134,21
"80279","S01011138",2011,254,104,150,50
"80280","S01011139",2011,281,9,272,118
"80281","S01011140",2011,232,89,143,23
"80282","S01011141",2011,230,110,120,12
"80283","S01011142",2011,334,6,328,54
"80284","S01011143",2011,398,10,388,36
"80285","S01011144",2011,303,41,262,32
"80286","S01011145",2011,267,7,260,41
"80287","S01011146",2011,306,88,218,16
"80288","S01011147",2011,450,50,400,47
"80289","S01011148",2011,329,24,305,81
"80290","S01011149",2011,265,9,256,106
"80291","S01011150",2011,175,25,150,29
"80292","S01011151",2011,218,23,195,104
"80293","S01011152",2011,341,32,309,74
"80294","S01011153",2011,455,86,369,94
"80295","S01011154",2011,348,121,227,59
"80296","S01011155",2011,348,112,236,41
"80297","S01011156",2011,249,3,246,18
"80298","S01011157",2011,284,13,271,14
"80299","S01011158",2011,233,3,230,13
"80300","S01011159",2011,300,114,186,25
"80301","S01011160",2011,393,82,311,70
"80302","S01011161",2011,269,67,202,41
"80303","S01011162",2011,187,54,133,29
"80304","S01011163",2011,352,140,212,26
"80305","S01011164",2011,282,59,223,26
"80306","S01011165",2011,356,166,190,24
"80307","S01011166",2011,229,16,213,17
"80308","S01011167",2011,279,8,271,39
"80309","S01011168",2011,355,9,346,133
"80310","S01011169",2011,346,26,320,53
"80311","S01011170",2011,400,23,377,83
"80312","S01011171",2011,409,40,369,45
"80313","S01011172",2011,339,40,299,35
"80314","S01011173",2011,224,18,206,20
"80315","S01011174",2011,219,17,202,31
"80316","S01011175",2011,259,72,187,21
"80317","S01011176",2011,274,8,266,29
"80318","S01011177",2011,402,68,334,46
"80319","S01011178",2011,206,17,189,48
"80320","S01011179",2011,272,98,174,20
"80321","S01011180",2011,301,166,135,13
"80322","S01011181",2011,198,6,192,20
"80323","S01011182",2011,166,3,163,8
"80324","S01011183",2011,226,44,182,11
"80325","S01011184",2011,307,3,304,3
"80326","S01011185",2011,296,17,279,9
"80327","S01011186",2011,456,134,322,33
"80328","S01011187",2011,287,22,265,12
"80329","S01011188",2011,442,112,330,33
"80330","S01011189",2011,356,48,308,45
"80331","S01011190",2011,288,112,176,23
"80332","S01011191",2011,241,77,164,16
"80333","S01011192",2011,290,84,206,32
"80334","S01011193",2011,286,110,176,38
"80335","S01011194",2011,302,137,165,30
"80336","S01011195",2011,318,102,216,30
"80337","S01011196",2011,409,207,202,23
"80338","S01011197",2011,348,138,210,42
"80339","S01011198",2011,241,92,149,23
"80340","S01011199",2011,342,121,221,34
"80341","S01011200",2011,356,71,285,32
"80342","S01011201",2011,267,63,204,5
"80343","S01011202",2011,390,127,263,32
"80344","S01011203",2011,364,89,275,22
"80345","S01011204",2011,235,14,221,16
"80346","S01011205",2011,237,39,198,11
"80347","S01011206",2011,264,25,239,17
"80348","S01011207",2011,326,133,193,10
"80349","S01011208",2011,345,19,326,13
"80350","S01011209",2011,283,131,152,14
"80351","S01011210",2011,272,64,208,4
"80352","S01011211",2011,252,33,219,11
"80353","S01011212",2011,213,72,141,23
"80354","S01011213",2011,421,130,291,56
"80355","S01011214",2011,349,107,242,46
"80356","S01011215",2011,260,154,106,17
"80357","S01011216",2011,240,100,140,26
"80358","S01011217",2011,380,170,210,43
"80359","S01011218",2011,282,166,116,31
"80360","S01011219",2011,352,154,198,28
"80361","S01011220",2011,425,150,275,36
"80362","S01011221",2011,449,128,321,45
"80363","S01011222",2011,312,115,197,19
"80364","S01011223",2011,361,99,262,29
"80365","S01011224",2011,350,144,206,25
"80366","S01011225",2011,327,163,164,46
"80367","S01011226",2011,455,66,389,26
"80368","S01011227",2011,397,99,298,73
"80369","S01011228",2011,450,156,294,79
"80370","S01011229",2011,286,129,157,32
"80371","S01011230",2011,500,401,99,17
"80372","S01011231",2011,298,159,139,22
"80373","S01011232",2011,513,280,233,68
"80374","S01011233",2011,158,43,115,19
"80375","S01011234",2011,456,230,226,31
"80376","S01011235",2011,195,95,100,24
"80377","S01011236",2011,284,89,195,30
"80378","S01011237",2011,331,148,183,25
"80379","S01011238",2011,334,187,147,38
"80380","S01011239",2011,427,165,262,84
"80381","S01011240",2011,481,190,291,122
"80382","S01011241",2011,540,107,433,114
"80383","S01011242",2011,383,115,268,38
"80384","S01011243",2011,545,305,240,106
"80385","S01011244",2011,409,203,206,81
"80386","S01011245",2011,446,243,203,22
"80387","S01011246",2011,439,50,389,76
"80388","S01011247",2011,357,20,337,22
"80389","S01011248",2011,317,43,274,22
"80390","S01011249",2011,308,12,296,15
"80391","S01011250",2011,446,204,242,27
"80392","S01011251",2011,385,143,242,35
"80393","S01011252",2011,344,186,158,23
"80394","S01011253",2011,391,233,158,25
"80395","S01011254",2011,359,6,353,13
"80396","S01011255",2011,267,6,261,4
"80397","S01011256",2011,169,7,162,12
"80398","S01011257",2011,188,5,183,3
"80399","S01011258",2011,229,28,201,9
"80400","S01011259",2011,383,106,277,40
"80401","S01011260",2011,336,35,301,21
"80402","S01011261",2011,310,148,162,18
"80403","S01011262",2011,223,63,160,18
"80404","S01011263",2011,431,104,327,43
"80405","S01011264",2011,259,106,153,29
"80406","S01011265",2011,468,277,191,35
"80407","S01011266",2011,383,95,288,23
"80408","S01011267",2011,266,48,218,16
"80409","S01011268",2011,186,37,149,27
"80410","S01011269",2011,279,112,167,21
"80411","S01011270",2011,349,138,211,62
"80412","S01011271",2011,357,113,244,37
"80413","S01011272",2011,380,159,221,44
"80414","S01011273",2011,339,140,199,19
"80415","S01011274",2011,395,135,260,72
"80416","S01011275",2011,277,172,105,15
"80417","S01011276",2011,405,143,262,24
"80418","S01011277",2011,284,7,277,21
"80419","S01011278",2011,230,6,224,28
"80420","S01011279",2011,302,24,278,33
"80421","S01011280",2011,231,11,220,4
"80422","S01011281",2011,238,8,230,17
"80423","S01011282",2011,341,56,285,15
"80424","S01011283",2011,251,4,247,7
"80425","S01011284",2011,192,4,188,7
"80426","S01011285",2011,297,136,161,22
"80427","S01011286",2011,298,141,157,18
"80428","S01011287",2011,337,145,192,21
"80429","S01011288",2011,318,108,210,25
"80430","S01011289",2011,431,166,265,25
"80431","S01011290",2011,503,210,293,30
"80432","S01011291",2011,407,147,260,25
"80433","S01011292",2011,332,208,124,12
"80434","S01011293",2011,341,161,180,14
"80435","S01011294",2011,487,232,255,56
"80436","S01011295",2011,448,70,378,31
"80437","S01011296",2011,280,92,188,12
"80438","S01011297",2011,311,143,168,15
"80439","S01011298",2011,230,115,115,14
"80440","S01011299",2011,197,3,194,27
"80441","S01011300",2011,423,213,210,16
"80442","S01011301",2011,309,8,301,31
"80443","S01011302",2011,522,232,290,43
"80444","S01011303",2011,427,11,416,50
"80445","S01011304",2011,282,131,151,13
"80446","S01011305",2011,342,135,207,17
"80447","S01011306",2011,282,94,188,23
"80448","S01011307",2011,188,4,184,22
"80449","S01011308",2011,186,4,182,29
"80450","S01011309",2011,333,4,329,11
"80451","S01011310",2011,341,44,297,42
"80452","S01011311",2011,305,6,299,17
"80453","S01011312",2011,493,7,486,22
"80454","S01011313",2011,368,45,323,45
"80455","S01011314",2011,487,43,444,68
"80456","S01011315",2011,168,55,113,15
"80457","S01011316",2011,311,112,199,20
"80458","S01011317",2011,392,1,391,26
"80459","S01011318",2011,520,6,514,78
"80460","S01011319",2011,398,2,396,24
"80461","S01011320",2011,303,48,255,35
"80462","S01011321",2011,252,27,225,20
"80463","S01011322",2011,251,40,211,14
"80464","S01011323",2011,374,102,272,34
"80465","S01011324",2011,202,31,171,13
"80466","S01011325",2011,472,77,395,128
"80467","S01011326",2011,521,60,461,167
"80468","S01011327",2011,400,60,340,71
"80469","S01011328",2011,355,45,310,41
"80470","S01011329",2011,484,45,439,72
"80471","S01011330",2011,324,13,311,13
"80472","S01011331",2011,336,3,333,7
"80473","S01011332",2011,385,2,383,16
"80474","S01011333",2011,386,3,383,36
"80475","S01011334",2011,297,29,268,39
"80476","S01011335",2011,438,5,433,47
"80477","S01011336",2011,266,52,214,31
"80478","S01011337",2011,287,6,281,16
"80479","S01011338",2011,270,79,191,16
"80480","S01011339",2011,219,91,128,7
"80481","S01011340",2011,290,150,140,10
"80482","S01011341",2011,346,129,217,44
"80483","S01011342",2011,325,36,289,49
"80484","S01011343",2011,434,191,243,33
"80485","S01011344",2011,401,223,178,11
"80486","S01011345",2011,357,228,129,13
"80487","S01011346",2011,325,100,225,24
"80488","S01011347",2011,547,149,398,45
"80489","S01011348",2011,424,208,216,16
"80490","S01011349",2011,367,10,357,22
"80491","S01011350",2011,275,14,261,6
"80492","S01011351",2011,353,178,175,22
"80493","S01011352",2011,328,83,245,47
"80494","S01011353",2011,274,89,185,12
"80495","S01011354",2011,313,46,267,12
"80496","S01011355",2011,433,134,299,15
"80497","S01011356",2011,392,26,366,26
"80498","S01011357",2011,354,95,259,14
"80499","S01011358",2011,186,4,182,12
"80500","S01011359",2011,368,120,248,20
"80501","S01011360",2011,354,271,83,11
"80502","S01011361",2011,343,322,21,1
"80503","S01011362",2011,199,10,189,7
"80504","S01011363",2011,429,156,273,33
"80505","S01011364",2011,272,40,232,13
"80506","S01011365",2011,207,12,195,8
"80507","S01011366",2011,238,68,170,13
"80508","S01011367",2011,400,162,238,16
"80509","S01011368",2011,291,7,284,49
"80510","S01011369",2011,380,157,223,7
"80511","S01011370",2011,307,50,257,27
"80512","S01011371",2011,503,382,121,11
"80513","S01011372",2011,411,372,39,5
"80514","S01011373",2011,350,258,92,14
"80515","S01011374",2011,276,48,228,28
"80516","S01011375",2011,295,136,159,6
"80517","S01011376",2011,326,298,28,4
"80518","S01011377",2011,262,26,236,8
"80519","S01011378",2011,362,71,291,14
"80520","S01011379",2011,342,15,327,18
"80521","S01011380",2011,357,115,242,38
"80522","S01011381",2011,302,58,244,34
"80523","S01011382",2011,286,127,159,70
"80524","S01011383",2011,394,277,117,19
"80525","S01011384",2011,328,258,70,6
"80526","S01011385",2011,441,255,186,23
"80527","S01011386",2011,208,138,70,13
"80528","S01011387",2011,366,196,170,48
"80529","S01011388",2011,435,84,351,40
"80530","S01011389",2011,415,175,240,74
"80531","S01011390",2011,342,163,179,11
"80532","S01011391",2011,254,118,136,8
"80533","S01011392",2011,287,157,130,14
"80534","S01011393",2011,374,114,260,23
"80535","S01011394",2011,212,38,174,7
"80536","S01011395",2011,409,190,219,52
"80537","S01011396",2011,402,186,216,28
"80538","S01011397",2011,364,180,184,17
"80539","S01011398",2011,322,158,164,19
"80540","S01011399",2011,240,131,109,13
"80541","S01011400",2011,357,83,274,61
"80542","S01011401",2011,287,73,214,14
"80543","S01011402",2011,492,95,397,29
"80544","S01011403",2011,208,63,145,13
"80545","S01011404",2011,468,195,273,32
"80546","S01011405",2011,298,84,214,12
"80547","S01011406",2011,287,88,199,12
"80548","S01011407",2011,506,94,412,30
"80549","S01011408",2011,369,122,247,18
"80550","S01011409",2011,362,207,155,9
"80551","S01011410",2011,316,106,210,6
"80552","S01011411",2011,285,90,195,8
"80553","S01011412",2011,357,15,342,2
"80554","S01011413",2011,218,7,211,15
"80555","S01011414",2011,377,149,228,17
"80556","S01011415",2011,408,101,307,17
"80557","S01011416",2011,240,5,235,8
"80558","S01011417",2011,374,76,298,32
"80559","S01011418",2011,264,128,136,9
"80560","S01011419",2011,253,92,161,13
"80561","S01011420",2011,250,150,100,26
"80562","S01011421",2011,233,11,222,32
"80563","S01011422",2011,264,97,167,17
"80564","S01011423",2011,221,113,108,17
"80565","S01011424",2011,237,63,174,13
"80566","S01011425",2011,348,153,195,17
"80567","S01011426",2011,356,15,341,21
"80568","S01011427",2011,303,123,180,17
"80569","S01011428",2011,243,91,152,6
"80570","S01011429",2011,240,9,231,9
"80571","S01011430",2011,368,40,328,38
"80572","S01011431",2011,506,216,290,34
"80573","S01011432",2011,467,163,304,18
"80574","S01011433",2011,369,251,118,16
"80575","S01011434",2011,250,67,183,11
"80576","S01011435",2011,374,17,357,33
"80577","S01011436",2011,370,198,172,28
"80578","S01011437",2011,354,162,192,25
"80579","S01011438",2011,241,176,65,8
"80580","S01011439",2011,396,152,244,24
"80581","S01011440",2011,276,119,157,12
"80582","S01011441",2011,343,161,182,22
"80583","S01011442",2011,327,125,202,32
"80584","S01011443",2011,288,114,174,8
"80585","S01011444",2011,334,172,162,9
"80586","S01011445",2011,251,70,181,14
"80587","S01011446",2011,231,56,175,12
"80588","S01011447",2011,369,170,199,17
"80589","S01011448",2011,377,58,319,35
"80590","S01011449",2011,276,134,142,29
"80591","S01011450",2011,239,31,208,14
"80592","S01011451",2011,212,22,190,15
"80593","S01011452",2011,412,57,355,34
"80594","S01011453",2011,301,68,233,19
"80595","S01011454",2011,351,153,198,19
"80596","S01011455",2011,329,147,182,14
"80597","S01011456",2011,356,160,196,8
"80598","S01011457",2011,382,193,189,17
"80599","S01011458",2011,374,49,325,12
"80600","S01011459",2011,420,79,341,37
"80601","S01011460",2011,292,133,159,9
"80602","S01011461",2011,332,130,202,52
"80603","S01011462",2011,404,95,309,33
"80604","S01011463",2011,307,54,253,19
"80605","S01011464",2011,223,26,197,20
"80606","S01011465",2011,223,135,88,7
"80607","S01011466",2011,316,168,148,20
"80608","S01011467",2011,231,77,154,20
"80609","S01011468",2011,310,9,301,36
"80610","S01011469",2011,318,173,145,42
"80611","S01011470",2011,491,170,321,45
"80612","S01011471",2011,455,142,313,32
"80613","S01011472",2011,535,366,169,33
"80614","S01011473",2011,431,311,120,25
"80615","S01011474",2011,481,301,180,68
"80616","S01011475",2011,391,336,55,14
"80617","S01011476",2011,198,6,192,8
"80618","S01011477",2011,335,8,327,5
"80619","S01011478",2011,442,21,421,44
"80620","S01011479",2011,380,13,367,41
"80621","S01011480",2011,467,12,455,54
"80622","S01011481",2011,336,60,276,16
"80623","S01011482",2011,424,173,251,43
"80624","S01011483",2011,221,4,217,16
"80625","S01011484",2011,381,202,179,9
"80626","S01011485",2011,371,185,186,27
"80627","S01011486",2011,235,155,80,8
"80628","S01011487",2011,429,223,206,22
"80629","S01011488",2011,284,146,138,18
"80630","S01011489",2011,260,58,202,10
"80631","S01011490",2011,473,178,295,38
"80632","S01011491",2011,262,151,111,15
"80633","S01011492",2011,395,140,255,146
"80634","S01011493",2011,170,3,167,3
"80635","S01011494",2011,332,132,200,11
"80636","S01011495",2011,369,190,179,20
"80637","S01011496",2011,308,246,62,10
"80638","S01011497",2011,256,14,242,35
"80639","S01011498",2011,230,11,219,10
"80640","S01011499",2011,370,88,282,29
"80641","S01011500",2011,219,55,164,14
"80642","S01011501",2011,325,196,129,18
"80643","S01011502",2011,305,110,195,8
"80644","S01011503",2011,253,72,181,8
"80645","S01011504",2011,237,52,185,10
"80646","S01011505",2011,322,145,177,40
"80647","S01011506",2011,237,57,180,5
"80648","S01011507",2011,293,110,183,11
"80649","S01011508",2011,468,138,330,73
"80650","S01011509",2011,247,50,197,12
"80651","S01011510",2011,435,179,256,33
"80652","S01011511",2011,255,143,112,5
"80653","S01011512",2011,482,360,122,13
"80654","S01011513",2011,358,215,143,12
"80655","S01011514",2011,337,182,155,7
"80656","S01011515",2011,280,15,265,59
"80657","S01011516",2011,358,12,346,28
"80658","S01011517",2011,225,56,169,8
"80659","S01011518",2011,302,149,153,13
"80660","S01011519",2011,310,129,181,11
"80661","S01011520",2011,273,177,96,9
"80662","S01011521",2011,441,196,245,51
"80663","S01011522",2011,463,222,241,47
"80664","S01011523",2011,340,109,231,72
"80665","S01011524",2011,396,60,336,24
"80666","S01011525",2011,348,66,282,17
"80667","S01011526",2011,422,106,316,41
"80668","S01011527",2011,290,40,250,16
"80669","S01011528",2011,495,216,279,30
"80670","S01011529",2011,291,184,107,14
"80671","S01011530",2011,468,215,253,22
"80672","S01011531",2011,473,92,381,41
"80673","S01011532",2011,237,19,218,16
"80674","S01011533",2011,315,172,143,13
"80675","S01011534",2011,341,138,203,18
"80676","S01011535",2011,467,338,129,13
"80677","S01011536",2011,269,7,262,15
"80678","S01011537",2011,252,4,248,28
"80679","S01011538",2011,259,3,256,17
"80680","S01011539",2011,312,127,185,12
"80681","S01011540",2011,431,130,301,17
"80682","S01011541",2011,382,227,155,11
"80683","S01011542",2011,374,155,219,14
"80684","S01011543",2011,325,201,124,7
"80685","S01011544",2011,295,148,147,9
"80686","S01011545",2011,252,90,162,9
"80687","S01011546",2011,236,4,232,5
"80688","S01011547",2011,216,6,210,18
"80689","S01011548",2011,331,63,268,18
"80690","S01011549",2011,318,31,287,4
"80691","S01011550",2011,277,9,268,2
"80692","S01011551",2011,227,46,181,13
"80693","S01011552",2011,269,15,254,11
"80694","S01011553",2011,267,9,258,19
"80695","S01011554",2011,372,92,280,13
"80696","S01011555",2011,236,98,138,16
"80697","S01011556",2011,251,105,146,21
"80698","S01011557",2011,303,102,201,17
"80699","S01011558",2011,242,125,117,8
"80700","S01011559",2011,246,101,145,17
"80701","S01011560",2011,318,130,188,9
"80702","S01011561",2011,302,126,176,11
"80703","S01011562",2011,270,184,86,13
"80704","S01011563",2011,287,174,113,14
"80705","S01011564",2011,410,100,310,23
"80706","S01011565",2011,365,129,236,27
"80707","S01011566",2011,374,198,176,20
"80708","S01011567",2011,454,196,258,15
"80709","S01011568",2011,320,56,264,18
"80710","S01011569",2011,414,102,312,20
"80711","S01011570",2011,329,106,223,34
"80712","S01011571",2011,389,236,153,37
"80713","S01011572",2011,294,108,186,42
"80714","S01011573",2011,474,128,346,37
"80715","S01011574",2011,296,55,241,18
"80716","S01011575",2011,229,67,162,36
"80717","S01011576",2011,374,287,87,8
"80718","S01011577",2011,328,89,239,46
"80719","S01011578",2011,355,189,166,14
"80720","S01011579",2011,413,8,405,18
"80721","S01011580",2011,311,130,181,22
"80722","S01011581",2011,463,296,167,26
"80723","S01011582",2011,477,8,469,50
"80724","S01011583",2011,332,100,232,47
"80725","S01011584",2011,325,113,212,22
"80726","S01011585",2011,336,91,245,38
"80727","S01011586",2011,239,81,158,32
"80728","S01011587",2011,236,111,125,21
"80729","S01011588",2011,302,116,186,19
"80730","S01011589",2011,347,91,256,10
"80731","S01011590",2011,287,126,161,10
"80732","S01011591",2011,268,145,123,13
"80733","S01011592",2011,353,211,142,40
"80734","S01011593",2011,325,95,230,15
"80735","S01011594",2011,221,61,160,28
"80736","S01011595",2011,301,6,295,62
"80737","S01011596",2011,489,71,418,108
"80738","S01011597",2011,268,13,255,55
"80739","S01011598",2011,544,506,38,7
"80740","S01011599",2011,362,91,271,32
"80741","S01011600",2011,392,108,284,65
"80742","S01011601",2011,316,8,308,29
"80743","S01011602",2011,266,128,138,11
"80744","S01011603",2011,443,232,211,29
"80745","S01011604",2011,293,139,154,5
"80746","S01011605",2011,376,96,280,20
"80747","S01011606",2011,342,15,327,11
"80748","S01011607",2011,231,3,228,14
"80749","S01011608",2011,360,16,344,36
"80750","S01011609",2011,479,330,149,34
"80751","S01011610",2011,362,210,152,27
"80752","S01011611",2011,258,27,231,19
"80753","S01011612",2011,211,5,206,11
"80754","S01011613",2011,374,12,362,22
"80755","S01011614",2011,183,40,143,7
"80756","S01011615",2011,296,112,184,19
"80757","S01011616",2011,211,92,119,21
"80758","S01011617",2011,388,121,267,20
"80759","S01011618",2011,277,78,199,28
"80760","S01011619",2011,406,20,386,28
"80761","S01011620",2011,394,14,380,18
"80762","S01011621",2011,286,40,246,23
"80763","S01011622",2011,230,6,224,18
"80764","S01011623",2011,314,108,206,25
"80765","S01011624",2011,294,45,249,23
"80766","S01011625",2011,240,98,142,9
"80767","S01011626",2011,289,10,279,15
"80768","S01011627",2011,260,10,250,20
"80769","S01011628",2011,410,23,387,18
"80770","S01011629",2011,240,64,176,13
"80771","S01011630",2011,255,76,179,11
"80772","S01011631",2011,245,173,72,8
"80773","S01011632",2011,315,144,171,19
"80774","S01011633",2011,321,161,160,18
"80775","S01011634",2011,235,123,112,20
"80776","S01011635",2011,274,153,121,27
"80777","S01011636",2011,283,122,161,18
"80778","S01011637",2011,299,108,191,24
"80779","S01011638",2011,260,81,179,30
"80780","S01011639",2011,250,98,152,26
"80781","S01011640",2011,259,102,157,14
"80782","S01011641",2011,195,3,192,2
"80783","S01011642",2011,352,100,252,9
"80784","S01011643",2011,238,40,198,37
"80785","S01011644",2011,339,81,258,23
"80786","S01011645",2011,257,67,190,19
"80787","S01011646",2011,262,4,258,6
"80788","S01011647",2011,330,10,320,25
"80789","S01011648",2011,276,90,186,12
"80790","S01011649",2011,243,103,140,23
"80791","S01011650",2011,308,62,246,20
"80792","S01011651",2011,446,74,372,72
"80793","S01011652",2011,311,14,297,34
"80794","S01011653",2011,340,113,227,27
"80795","S01011654",2011,521,206,315,81
"80796","S01011655",2011,471,236,235,68
"80797","S01011656",2011,287,184,103,20
"80798","S01011657",2011,281,160,121,36
"80799","S01011658",2011,304,101,203,17
"80800","S01011659",2011,353,156,197,19
"80801","S01011660",2011,379,50,329,23
"80802","S01011661",2011,246,64,182,15
"80803","S01011662",2011,237,4,233,13
"80804","S01011663",2011,428,256,172,36
"80805","S01011664",2011,408,177,231,18
"80806","S01011665",2011,428,229,199,48
"80807","S01011666",2011,454,252,202,27
"80808","S01011667",2011,375,150,225,35
"80809","S01011668",2011,429,226,203,36
"80810","S01011669",2011,299,40,259,34
"80811","S01011670",2011,234,99,135,24
"80812","S01011671",2011,316,50,266,30
"80813","S01011672",2011,275,104,171,22
"80814","S01011673",2011,275,108,167,16
"80815","S01011674",2011,434,96,338,24
"80816","S01011675",2011,387,133,254,21
"80817","S01011676",2011,311,153,158,16
"80818","S01011677",2011,258,37,221,69
"80819","S01011678",2011,222,114,108,16
"80820","S01011679",2011,204,8,196,16
"80821","S01011680",2011,454,253,201,19
"80822","S01011681",2011,345,130,215,16
"80823","S01011682",2011,182,3,179,16
"80824","S01011683",2011,306,84,222,25
"80825","S01011684",2011,234,49,185,13
"80826","S01011685",2011,279,9,270,15
"80827","S01011686",2011,344,11,333,21
"80828","S01011687",2011,386,149,237,21
"80829","S01011688",2011,307,56,251,20
"80830","S01011689",2011,248,11,237,9
"80831","S01011690",2011,396,83,313,16
"80832","S01011691",2011,224,23,201,20
"80833","S01011692",2011,455,211,244,23
"80834","S01011693",2011,367,49,318,41
"80835","S01011694",2011,200,24,176,13
"80836","S01011695",2011,333,17,316,21
"80837","S01011696",2011,351,4,347,12
"80838","S01011697",2011,398,63,335,22
"80839","S01011698",2011,271,71,200,8
"80840","S01011699",2011,387,20,367,29
"80841","S01011700",2011,354,77,277,19
"80842","S01011701",2011,444,29,415,45
"80843","S01011702",2011,335,68,267,14
"80844","S01011703",2011,255,12,243,24
"80845","S01011704",2011,274,17,257,11
"80846","S01011705",2011,318,104,214,16
"80847","S01011706",2011,450,81,369,31
"80848","S01011707",2011,283,14,269,6
"80849","S01011708",2011,448,130,318,31
"80850","S01011709",2011,370,71,299,11
"80851","S01011710",2011,257,153,104,6
"80852","S01011711",2011,321,184,137,21
"80853","S01011712",2011,294,94,200,27
"80854","S01011713",2011,389,67,322,17
"80855","S01011714",2011,194,5,189,1
"80856","S01011715",2011,297,122,175,29
"80857","S01011716",2011,351,19,332,23
"80858","S01011717",2011,294,5,289,7
"80859","S01011718",2011,289,12,277,21
"80860","S01011719",2011,224,3,221,12
"80861","S01011720",2011,213,5,208,14
"80862","S01011721",2011,305,49,256,8
"80863","S01011722",2011,317,60,257,24
"80864","S01011723",2011,397,65,332,31
"80865","S01011724",2011,261,63,198,20
"80866","S01011725",2011,219,3,216,10
"80867","S01011726",2011,208,3,205,6
"80868","S01011727",2011,261,4,257,23
"80869","S01011728",2011,393,73,320,38
"80870","S01011729",2011,302,118,184,19
"80871","S01011730",2011,431,35,396,26
"80872","S01011731",2011,352,49,303,16
"80873","S01011732",2011,299,5,294,4
"80874","S01011733",2011,352,44,308,22
"80875","S01011734",2011,335,56,279,21
"80876","S01011735",2011,288,6,282,6
"80877","S01011736",2011,317,31,286,55
"80878","S01011737",2011,294,44,250,59
"80879","S01011738",2011,466,117,349,92
"80880","S01011739",2011,226,45,181,14
"80881","S01011740",2011,356,160,196,40
"80882","S01011741",2011,296,78,218,31
"80883","S01011742",2011,333,95,238,18
"80884","S01011743",2011,379,70,309,49
"80885","S01011744",2011,462,145,317,69
"80886","S01011745",2011,398,162,236,29
"80887","S01011746",2011,215,63,152,28
"80888","S01011747",2011,413,155,258,59
"80889","S01011748",2011,375,82,293,88
"80890","S01011749",2011,370,128,242,122
"80891","S01011750",2011,398,103,295,39
"80892","S01011751",2011,532,179,353,122
"80893","S01011752",2011,460,71,389,66
"80894","S01011753",2011,366,12,354,36
"80895","S01011754",2011,339,58,281,28
"80896","S01011755",2011,456,106,350,75
"80897","S01011756",2011,430,76,354,60
"80898","S01011757",2011,327,102,225,37
"80899","S01011758",2011,252,43,209,19
"80900","S01011759",2011,340,55,285,19
"80901","S01011760",2011,411,86,325,37
"80902","S01011761",2011,272,66,206,33
"80903","S01011762",2011,322,85,237,58
"80904","S01011763",2011,350,71,279,16
"80905","S01011764",2011,136,12,124,3
"80906","S01011765",2011,380,10,370,24
"80907","S01011766",2011,209,15,194,9
"80908","S01011767",2011,443,138,305,51
"80909","S01011768",2011,342,134,208,46
"80910","S01011769",2011,321,63,258,41
"80911","S01011770",2011,409,99,310,58
"80912","S01011771",2011,238,7,231,7
"80913","S01011772",2011,390,12,378,8
"80914","S01011773",2011,200,3,197,6
"80915","S01011774",2011,354,106,248,29
"80916","S01011775",2011,228,2,226,9
"80917","S01011776",2011,319,5,314,14
"80918","S01011777",2011,264,27,237,20
"80919","S01011778",2011,261,37,224,56
"80920","S01011779",2011,324,3,321,21
"80921","S01011780",2011,315,4,311,6
"80922","S01011781",2011,214,4,210,2
"80923","S01011782",2011,271,5,266,3
"80924","S01011783",2011,213,4,209,6
"80925","S01011784",2011,349,134,215,23
"80926","S01011785",2011,389,106,283,34
"80927","S01011786",2011,124,4,120,7
"80928","S01011787",2011,483,243,240,16
"80929","S01011788",2011,225,3,222,8
"80930","S01011789",2011,284,42,242,14
"80931","S01011790",2011,404,140,264,16
"80932","S01011791",2011,347,128,219,41
"80933","S01011792",2011,515,198,317,63
"80934","S01011793",2011,327,47,280,39
"80935","S01011794",2011,414,141,273,37
"80936","S01011795",2011,317,125,192,44
"80937","S01011796",2011,354,177,177,31
"80938","S01011797",2011,385,5,380,9
"80939","S01011798",2011,242,74,168,28
"80940","S01011799",2011,357,51,306,8
"80941","S01011800",2011,219,55,164,13
"80942","S01011801",2011,253,110,143,14
"80943","S01011802",2011,361,127,234,21
"80944","S01011803",2011,236,74,162,15
"80945","S01011804",2011,379,117,262,44
"80946","S01011805",2011,279,36,243,61
"80947","S01011806",2011,362,61,301,39
"80948","S01011807",2011,444,17,427,45
"80949","S01011808",2011,287,50,237,30
"80950","S01011809",2011,302,13,289,35
"80951","S01011810",2011,413,33,380,30
"80952","S01011811",2011,436,9,427,37
"80953","S01011812",2011,275,7,268,20
"80954","S01011813",2011,306,25,281,29
"80955","S01011814",2011,297,13,284,13
"80956","S01011815",2011,313,30,283,27
"80957","S01011816",2011,257,5,252,24
"80958","S01011817",2011,294,5,289,30
"80959","S01011818",2011,486,81,405,29
"80960","S01011819",2011,438,90,348,53
"80961","S01011820",2011,319,63,256,28
"80962","S01011821",2011,223,93,130,39
"80963","S01011822",2011,410,107,303,123
"80964","S01011823",2011,290,70,220,23
"80965","S01011824",2011,316,111,205,36
"80966","S01011825",2011,275,41,234,55
"80967","S01011826",2011,320,64,256,59
"80968","S01011827",2011,289,54,235,30
"80969","S01011828",2011,411,23,388,35
"80970","S01011829",2011,195,16,179,17
"80971","S01011830",2011,279,34,245,22
"80972","S01011831",2011,425,25,400,39
"80973","S01011832",2011,405,52,353,43
"80974","S01011833",2011,360,13,347,24
"80975","S01011834",2011,180,8,172,11
"80976","S01011835",2011,278,6,272,29
"80977","S01011836",2011,332,13,319,13
"80978","S01011837",2011,255,7,248,19
"80979","S01011838",2011,327,6,321,14
"80980","S01011839",2011,444,8,436,50
"80981","S01011840",2011,406,51,355,33
"80982","S01011841",2011,415,95,320,49
"80983","S01011842",2011,462,142,320,30
"80984","S01011843",2011,415,21,394,33
"80985","S01011844",2011,295,13,282,24
"80986","S01011845",2011,382,80,302,40
"80987","S01011846",2011,385,41,344,43
"80988","S01011847",2011,178,2,176,14
"80989","S01011848",2011,305,30,275,35
"80990","S01011849",2011,352,45,307,46
"80991","S01011850",2011,314,6,308,72
"80992","S01011851",2011,368,68,300,78
"80993","S01011852",2011,460,132,328,64
"80994","S01011853",2011,304,23,281,59
"80995","S01011854",2011,356,39,317,42
"80996","S01011855",2011,364,125,239,23
"80997","S01011856",2011,309,2,307,11
"80998","S01011857",2011,301,36,265,71
"80999","S01011858",2011,403,31,372,26
"81000","S01011859",2011,446,129,317,30
"81001","S01011860",2011,206,3,203,83
"81002","S01011861",2011,343,8,335,90
"81003","S01011862",2011,425,25,400,22
"81004","S01011863",2011,328,44,284,41
"81005","S01011864",2011,315,2,313,16
"81006","S01011865",2011,291,48,243,30
"81007","S01011866",2011,341,68,273,22
"81008","S01011867",2011,444,195,249,28
"81009","S01011868",2011,416,69,347,65
"81010","S01011869",2011,409,30,379,123
"81011","S01011870",2011,315,86,229,43
"81012","S01011871",2011,438,55,383,96
"81013","S01011872",2011,365,9,356,66
"81014","S01011873",2011,339,4,335,106
"81015","S01011874",2011,285,31,254,21
"81016","S01011875",2011,322,63,259,37
"81017","S01011876",2011,398,35,363,99
"81018","S01011877",2011,262,25,237,47
"81019","S01011878",2011,379,21,358,76
"81020","S01011879",2011,218,3,215,14
"81021","S01011880",2011,241,22,219,14
"81022","S01011881",2011,371,52,319,56
"81023","S01011882",2011,450,124,326,19
"81024","S01011883",2011,439,32,407,38
"81025","S01011884",2011,169,2,167,25
"81026","S01011885",2011,270,10,260,22
"81027","S01011886",2011,368,50,318,16
"81028","S01011887",2011,230,44,186,12
"81029","S01011888",2011,369,129,240,21
"81030","S01011889",2011,430,50,380,37
"81031","S01011890",2011,300,26,274,44
"81032","S01011891",2011,378,156,222,65
"81033","S01011892",2011,503,6,497,147
"81034","S01011893",2011,500,87,413,114
"81035","S01011894",2011,291,43,248,57
"81036","S01011895",2011,305,3,302,29
"81037","S01011896",2011,421,35,386,49
"81038","S01011897",2011,436,38,398,28
"81039","S01011898",2011,246,0,0,23
"81040","S01011899",2011,352,2,350,19
"81041","S01011900",2011,293,1,292,6
"81042","S01011901",2011,397,15,382,65
"81043","S01011902",2011,465,14,451,24
"81044","S01011903",2011,352,2,350,14
"81045","S01011904",2011,324,4,320,13
"81046","S01011905",2011,280,5,275,14
"81047","S01011906",2011,201,2,199,13
"81048","S01011907",2011,338,17,321,40
"81049","S01011908",2011,147,6,141,18
"81050","S01011909",2011,404,13,391,45
"81051","S01011910",2011,464,271,193,32
"81052","S01011911",2011,285,97,188,9
"81053","S01011912",2011,327,129,198,24
"81054","S01011913",2011,365,200,165,18
"81055","S01011914",2011,360,193,167,29
"81056","S01011915",2011,337,134,203,20
"81057","S01011916",2011,232,106,126,18
"81058","S01011917",2011,232,61,171,17
"81059","S01011918",2011,368,266,102,27
"81060","S01011919",2011,390,149,241,57
"81061","S01011920",2011,291,106,185,21
"81062","S01011921",2011,285,141,144,17
"81063","S01011922",2011,356,170,186,25
"81064","S01011923",2011,383,208,175,22
"81065","S01011924",2011,206,83,123,15
"81066","S01011925",2011,264,20,244,10
"81067","S01011926",2011,298,95,203,28
"81068","S01011927",2011,285,114,171,16
"81069","S01011928",2011,338,106,232,38
"81070","S01011929",2011,319,118,201,18
"81071","S01011930",2011,294,109,185,32
"81072","S01011931",2011,250,161,89,28
"81073","S01011932",2011,300,70,230,66
"81074","S01011933",2011,344,101,243,96
"81075","S01011934",2011,520,50,470,143
"81076","S01011935",2011,459,86,373,197
"81077","S01011936",2011,380,67,313,119
"81078","S01011937",2011,408,140,268,139
"81079","S01011938",2011,400,71,329,129
"81080","S01011939",2011,446,145,301,153
"81081","S01011940",2011,266,90,176,114
"81082","S01011941",2011,441,50,391,273
"81083","S01011942",2011,573,158,415,228
"81084","S01011943",2011,715,265,450,256
"81085","S01011944",2011,188,3,185,22
"81086","S01011945",2011,313,5,308,12
"81087","S01011946",2011,377,125,252,36
"81088","S01011947",2011,214,41,173,142
"81089","S01011948",2011,527,133,394,63
"81090","S01011949",2011,392,7,385,13
"81091","S01011950",2011,348,84,264,21
"81092","S01011951",2011,306,34,272,41
"81093","S01011952",2011,200,1,199,12
"81094","S01011953",2011,325,6,319,30
"81095","S01011954",2011,230,79,151,14
"81096","S01011955",2011,467,94,373,63
"81097","S01011956",2011,392,23,369,29
"81098","S01011957",2011,325,28,297,95
"81099","S01011958",2011,481,41,440,122
"81100","S01011959",2011,365,27,338,64
"81101","S01011960",2011,325,3,322,52
"81102","S01011961",2011,311,39,272,28
"81103","S01011962",2011,264,2,262,29
"81104","S01011963",2011,231,61,170,4
"81105","S01011964",2011,453,27,426,88
"81106","S01011965",2011,381,54,327,18
"81107","S01011966",2011,351,23,328,32
"81108","S01011967",2011,420,31,389,73
"81109","S01011968",2011,478,47,431,95
"81110","S01011969",2011,480,114,366,48
"81111","S01011970",2011,432,162,270,59
"81112","S01011971",2011,243,14,229,21
"81113","S01011972",2011,512,24,488,141
"81114","S01011973",2011,272,34,238,26
"81115","S01011974",2011,320,12,308,29
"81116","S01011975",2011,199,19,180,31
"81117","S01011976",2011,353,39,314,51
"81118","S01011977",2011,508,130,378,73
"81119","S01011978",2011,351,93,258,38
"81120","S01011979",2011,397,26,371,49
"81121","S01011980",2011,182,5,177,38
"81122","S01011981",2011,396,32,364,131
"81123","S01011982",2011,414,11,403,140
"81124","S01011983",2011,351,46,305,85
"81125","S01011984",2011,315,172,143,21
"81126","S01011985",2011,293,13,280,44
"81127","S01011986",2011,320,178,142,23
"81128","S01011987",2011,403,108,295,33
"81129","S01011988",2011,297,11,286,18
"81130","S01011989",2011,379,36,343,26
"81131","S01011990",2011,364,14,350,27
"81132","S01011991",2011,298,55,243,20
"81133","S01011992",2011,472,11,461,69
"81134","S01011993",2011,460,150,310,127
"81135","S01011994",2011,305,4,301,11
"81136","S01011995",2011,324,8,316,58
"81137","S01011996",2011,254,73,181,22
"81138","S01011997",2011,422,102,320,56
"81139","S01011998",2011,220,9,211,19
"81140","S01011999",2011,291,22,269,99
"81141","S01012000",2011,198,9,189,25
"81142","S01012001",2011,296,61,235,27
"81143","S01012002",2011,243,50,193,10
"81144","S01012003",2011,241,35,206,46
"81145","S01012004",2011,398,63,335,24
"81146","S01012005",2011,334,26,308,12
"81147","S01012006",2011,280,9,271,80
"81148","S01012007",2011,374,71,303,54
"81149","S01012008",2011,421,74,347,90
"81150","S01012009",2011,300,56,244,79
"81151","S01012010",2011,524,46,478,72
"81152","S01012011",2011,537,158,379,74
"81153","S01012012",2011,320,66,254,43
"81154","S01012013",2011,357,38,319,80
"81155","S01012014",2011,402,118,284,64
"81156","S01012015",2011,420,90,330,49
"81157","S01012016",2011,360,45,315,75
"81158","S01012017",2011,221,10,211,34
"81159","S01012018",2011,374,34,340,76
"81160","S01012019",2011,371,25,346,43
"81161","S01012020",2011,361,126,235,23
"81162","S01012021",2011,225,33,192,3
"81163","S01012022",2011,289,49,240,19
"81164","S01012023",2011,228,5,223,23
"81165","S01012024",2011,363,32,331,17
"81166","S01012025",2011,288,52,236,8
"81167","S01012026",2011,211,6,205,11
"81168","S01012027",2011,311,19,292,19
"81169","S01012028",2011,375,3,372,18
"81170","S01012029",2011,418,22,396,90
"81171","S01012030",2011,249,13,236,53
"81172","S01012031",2011,231,6,225,9
"81173","S01012032",2011,142,3,139,13
"81174","S01012033",2011,373,60,313,20
"81175","S01012034",2011,386,74,312,40
"81176","S01012035",2011,431,67,364,28
"81177","S01012036",2011,385,5,380,25
"81178","S01012037",2011,438,152,286,37
"81179","S01012038",2011,366,268,98,9
"81180","S01012039",2011,413,123,290,14
"81181","S01012040",2011,255,42,213,14
"81182","S01012041",2011,382,82,300,36
"81183","S01012042",2011,408,108,300,21
"81184","S01012043",2011,380,175,205,37
"81185","S01012044",2011,474,249,225,21
"81186","S01012045",2011,583,202,381,118
"81187","S01012046",2011,376,199,177,29
"81188","S01012047",2011,548,289,259,47
"81189","S01012048",2011,402,193,209,59
"81190","S01012049",2011,347,70,277,34
"81191","S01012050",2011,423,91,332,25
"81192","S01012051",2011,255,75,180,21
"81193","S01012052",2011,469,117,352,44
"81194","S01012053",2011,461,218,243,22
"81195","S01012054",2011,443,257,186,59
"81196","S01012055",2011,463,178,285,42
"81197","S01012056",2011,354,88,266,8
"81198","S01012057",2011,316,4,312,15
"81199","S01012058",2011,328,30,298,29
"81200","S01012059",2011,412,125,287,29
"81201","S01012060",2011,408,154,254,32
"81202","S01012061",2011,440,34,406,56
"81203","S01012062",2011,335,7,328,26
"81204","S01012063",2011,235,9,226,32
"81205","S01012064",2011,276,194,82,18
"81206","S01012065",2011,261,237,24,2
"81207","S01012066",2011,382,169,213,32
"81208","S01012067",2011,250,205,45,4
"81209","S01012068",2011,268,240,28,8
"81210","S01012069",2011,292,197,95,21
"81211","S01012070",2011,449,298,151,51
"81212","S01012071",2011,692,272,420,256
"81213","S01012072",2011,722,336,386,182
"81214","S01012073",2011,320,47,273,53
"81215","S01012074",2011,343,4,339,75
"81216","S01012075",2011,269,7,262,4
"81217","S01012076",2011,382,82,300,41
"81218","S01012077",2011,363,148,215,48
"81219","S01012078",2011,367,73,294,28
"81220","S01012079",2011,448,190,258,30
"81221","S01012080",2011,352,244,108,12
"81222","S01012081",2011,387,226,161,21
"81223","S01012082",2011,323,159,164,21
"81224","S01012083",2011,383,218,165,10
"81225","S01012084",2011,238,16,222,8
"81226","S01012085",2011,301,55,246,19
"81227","S01012086",2011,448,180,268,25
"81228","S01012087",2011,364,88,276,24
"81229","S01012088",2011,286,64,222,15
"81230","S01012089",2011,357,3,354,25
"81231","S01012090",2011,356,6,350,8
"81232","S01012091",2011,244,7,237,14
"81233","S01012092",2011,214,3,211,12
"81234","S01012093",2011,295,6,289,38
"81235","S01012094",2011,317,4,313,10
"81236","S01012095",2011,410,109,301,16
"81237","S01012096",2011,388,109,279,15
"81238","S01012097",2011,279,80,199,10
"81239","S01012098",2011,277,72,205,14
"81240","S01012099",2011,348,150,198,25
"81241","S01012100",2011,493,183,310,19
"81242","S01012101",2011,311,19,292,7
"81243","S01012102",2011,319,163,156,22
"81244","S01012103",2011,425,54,371,39
"81245","S01012104",2011,345,29,316,44
"81246","S01012105",2011,492,44,448,40
"81247","S01012106",2011,497,13,484,88
"81248","S01012107",2011,279,23,256,17
"81249","S01012108",2011,632,332,300,48
"81250","S01012109",2011,560,205,355,162
"81251","S01012110",2011,458,121,337,77
"81252","S01012111",2011,309,154,155,30
"81253","S01012112",2011,423,97,326,34
"81254","S01012113",2011,511,115,396,30
"81255","S01012114",2011,357,8,349,44
"81256","S01012115",2011,257,46,211,24
"81257","S01012116",2011,283,53,230,13
"81258","S01012117",2011,289,13,276,15
"81259","S01012118",2011,226,6,220,10
"81260","S01012119",2011,349,7,342,10
"81261","S01012120",2011,256,80,176,28
"81262","S01012121",2011,404,160,244,22
"81263","S01012122",2011,318,70,248,12
"81264","S01012123",2011,212,23,189,37
"81265","S01012124",2011,262,14,248,45
"81266","S01012125",2011,504,279,225,85
"81267","S01012126",2011,389,15,374,99
"81268","S01012127",2011,552,95,457,232
"81269","S01012128",2011,278,53,225,121
"81270","S01012129",2011,440,120,320,103
"81271","S01012130",2011,687,289,398,113
"81272","S01012131",2011,610,203,407,164
"81273","S01012132",2011,426,97,329,166
"81274","S01012133",2011,421,88,333,106
"81275","S01012134",2011,606,63,543,101
"81276","S01012135",2011,570,383,187,73
"81277","S01012136",2011,516,214,302,181
"81278","S01012137",2011,463,186,277,82
"81279","S01012138",2011,460,51,409,53
"81280","S01012139",2011,462,80,382,26
"81281","S01012140",2011,205,5,200,5
"81282","S01012141",2011,412,17,395,12
"81283","S01012142",2011,395,5,390,8
"81284","S01012143",2011,376,8,368,4
"81285","S01012144",2011,449,18,431,37
"81286","S01012145",2011,399,7,392,11
"81287","S01012146",2011,572,247,325,101
"81288","S01012147",2011,407,184,223,35
"81289","S01012148",2011,364,172,192,38
"81290","S01012149",2011,335,68,267,44
"81291","S01012150",2011,359,154,205,14
"81292","S01012151",2011,397,181,216,14
"81293","S01012152",2011,362,243,119,13
"81294","S01012153",2011,329,185,144,64
"81295","S01012154",2011,513,263,250,97
"81296","S01012155",2011,357,165,192,77
"81297","S01012156",2011,372,205,167,33
"81298","S01012157",2011,487,137,350,81
"81299","S01012158",2011,487,44,443,66
"81300","S01012159",2011,229,4,225,6
"81301","S01012160",2011,293,2,291,13
"81302","S01012161",2011,208,99,109,30
"81303","S01012162",2011,386,152,234,53
"81304","S01012163",2011,384,133,251,81
"81305","S01012164",2011,413,8,405,34
"81306","S01012165",2011,452,223,229,40
"81307","S01012166",2011,292,100,192,45
"81308","S01012167",2011,425,115,310,49
"81309","S01012168",2011,379,25,354,8
"81310","S01012169",2011,429,88,341,29
"81311","S01012170",2011,543,144,399,30
"81312","S01012171",2011,470,87,383,32
"81313","S01012172",2011,360,79,281,40
"81314","S01012173",2011,289,3,286,3
"81315","S01012174",2011,301,7,294,14
"81316","S01012175",2011,385,5,380,30
"81317","S01012176",2011,367,3,364,26
"81318","S01012177",2011,242,3,239,16
"81319","S01012178",2011,212,3,209,5
"81320","S01012179",2011,301,68,233,30
"81321","S01012180",2011,273,49,224,16
"81322","S01012181",2011,384,77,307,39
"81323","S01012182",2011,431,21,410,61
"81324","S01012183",2011,408,107,301,54
"81325","S01012184",2011,280,7,273,104
"81326","S01012185",2011,506,146,360,159
"81327","S01012186",2011,344,90,254,22
"81328","S01012187",2011,382,135,247,55
"81329","S01012188",2011,252,30,222,10
"81330","S01012189",2011,245,28,217,12
"81331","S01012190",2011,210,3,207,14
"81332","S01012191",2011,322,7,315,13
"81333","S01012192",2011,187,6,181,3
"81334","S01012193",2011,175,3,172,1
"81335","S01012194",2011,179,3,176,1
"81336","S01012195",2011,423,33,390,9
"81337","S01012196",2011,211,10,201,13
"81338","S01012197",2011,311,85,226,7
"81339","S01012198",2011,403,123,280,16
"81340","S01012199",2011,309,54,255,24
"81341","S01012200",2011,278,55,223,15
"81342","S01012201",2011,318,67,251,15
"81343","S01012202",2011,239,25,214,16
"81344","S01012203",2011,316,4,312,5
"81345","S01012204",2011,270,1,269,6
"81346","S01012205",2011,273,4,269,13
"81347","S01012206",2011,317,25,292,12
"81348","S01012207",2011,401,77,324,31
"81349","S01012208",2011,457,95,362,31
"81350","S01012209",2011,318,73,245,27
"81351","S01012210",2011,385,129,256,21
"81352","S01012211",2011,408,75,333,23
"81353","S01012212",2011,304,8,296,5
"81354","S01012213",2011,336,2,334,8
"81355","S01012214",2011,282,1,281,8
"81356","S01012215",2011,329,6,323,6
"81357","S01012216",2011,282,11,271,9
"81358","S01012217",2011,267,131,136,26
"81359","S01012218",2011,228,137,91,17
"81360","S01012219",2011,415,160,255,23
"81361","S01012220",2011,367,208,159,45
"81362","S01012221",2011,332,104,228,28
"81363","S01012222",2011,402,112,290,34
"81364","S01012223",2011,360,169,191,17
"81365","S01012224",2011,333,82,251,20
"81366","S01012225",2011,459,157,302,39
"81367","S01012226",2011,287,29,258,10
"81368","S01012227",2011,260,29,231,17
"81369","S01012228",2011,252,28,224,13
"81370","S01012229",2011,323,4,319,40
"81371","S01012230",2011,392,1,391,23
"81372","S01012231",2011,289,3,286,9
"81373","S01012232",2011,318,1,317,8
"81374","S01012233",2011,341,2,339,13
"81375","S01012234",2011,393,22,371,18
"81376","S01012235",2011,192,2,190,7
"81377","S01012236",2011,278,25,253,48
"81378","S01012237",2011,319,5,314,13
"81379","S01012238",2011,309,68,241,45
"81380","S01012239",2011,274,85,189,33
"81381","S01012240",2011,391,68,323,38
"81382","S01012241",2011,232,8,224,15
"81383","S01012242",2011,307,5,302,5
"81384","S01012243",2011,244,9,235,23
"81385","S01012244",2011,347,7,340,45
"81386","S01012245",2011,335,68,267,27
"81387","S01012246",2011,301,18,283,22
"81388","S01012247",2011,303,16,287,29
"81389","S01012248",2011,332,26,306,68
"81390","S01012249",2011,365,41,324,60
"81391","S01012250",2011,301,9,292,62
"81392","S01012251",2011,457,137,320,42
"81393","S01012252",2011,333,113,220,28
"81394","S01012253",2011,508,151,357,90
"81395","S01012254",2011,399,49,350,70
"81396","S01012255",2011,475,55,420,83
"81397","S01012256",2011,327,45,282,14
"81398","S01012257",2011,412,99,313,22
"81399","S01012258",2011,297,6,291,14
"81400","S01012259",2011,277,4,273,17
"81401","S01012260",2011,368,95,273,17
"81402","S01012261",2011,322,37,285,20
"81403","S01012262",2011,343,11,332,105
"81404","S01012263",2011,366,97,269,46
"81405","S01012264",2011,222,48,174,21
"81406","S01012265",2011,340,132,208,14
"81407","S01012266",2011,536,137,399,38
"81408","S01012267",2011,318,10,308,36
"81409","S01012268",2011,265,5,260,100
"81410","S01012269",2011,461,74,387,32
"81411","S01012270",2011,348,90,258,32
"81412","S01012271",2011,421,25,396,77
"81413","S01012272",2011,305,49,256,27
"81414","S01012273",2011,297,21,276,34
"81415","S01012274",2011,432,86,346,49
"81416","S01012275",2011,450,110,340,166
"81417","S01012276",2011,463,120,343,69
"81418","S01012277",2011,482,110,372,84
"81419","S01012278",2011,401,99,302,127
"81420","S01012279",2011,407,127,280,99
"81421","S01012280",2011,409,140,269,18
"81422","S01012281",2011,371,40,331,91
"81423","S01012282",2011,466,106,360,56
"81424","S01012283",2011,369,90,279,32
"81425","S01012284",2011,436,160,276,76
"81426","S01012285",2011,266,57,209,13
"81427","S01012286",2011,493,184,309,53
"81428","S01012287",2011,479,344,135,15
"81429","S01012288",2011,377,229,148,17
"81430","S01012289",2011,411,27,384,37
"81431","S01012290",2011,292,84,208,31
"81432","S01012291",2011,421,66,355,62
"81433","S01012292",2011,341,21,320,46
"81434","S01012293",2011,212,39,173,15
"81435","S01012294",2011,371,81,290,26
"81436","S01012295",2011,280,69,211,39
"81437","S01012296",2011,330,42,288,44
"81438","S01012297",2011,253,3,250,41
"81439","S01012298",2011,374,62,312,30
"81440","S01012299",2011,257,6,251,52
"81441","S01012300",2011,294,87,207,24
"81442","S01012301",2011,407,48,359,111
"81443","S01012302",2011,240,9,231,78
"81444","S01012303",2011,378,19,359,62
"81445","S01012304",2011,424,45,379,59
"81446","S01012305",2011,333,86,247,36
"81447","S01012306",2011,308,149,159,36
"81448","S01012307",2011,323,127,196,32
"81449","S01012308",2011,334,74,260,21
"81450","S01012309",2011,245,57,188,18
"81451","S01012310",2011,427,52,375,77
"81452","S01012311",2011,263,34,229,9
"81453","S01012312",2011,439,58,381,62
"81454","S01012313",2011,345,56,289,48
"81455","S01012314",2011,365,148,217,12
"81456","S01012315",2011,400,132,268,42
"81457","S01012316",2011,315,144,171,18
"81458","S01012317",2011,209,44,165,19
"81459","S01012318",2011,329,131,198,12
"81460","S01012319",2011,343,13,330,130
"81461","S01012320",2011,276,106,170,15
"81462","S01012321",2011,339,73,266,32
"81463","S01012322",2011,453,22,431,114
"81464","S01012323",2011,403,16,387,68
"81465","S01012324",2011,365,8,357,149
"81466","S01012325",2011,301,72,229,18
"81467","S01012326",2011,310,117,193,44
"81468","S01012327",2011,366,113,253,33
"81469","S01012328",2011,293,72,221,18
"81470","S01012329",2011,381,27,354,138
"81471","S01012330",2011,280,41,239,26
"81472","S01012331",2011,265,20,245,21
"81473","S01012332",2011,435,20,415,134
"81474","S01012333",2011,452,10,442,157
"81475","S01012334",2011,365,111,254,21
"81476","S01012335",2011,414,72,342,31
"81477","S01012336",2011,275,61,214,13
"81478","S01012337",2011,453,210,243,38
"81479","S01012338",2011,384,82,302,76
"81480","S01012339",2011,366,102,264,98
"81481","S01012340",2011,477,156,321,25
"81482","S01012341",2011,404,14,390,98
"81483","S01012342",2011,403,55,348,89
"81484","S01012343",2011,448,33,415,169
"81485","S01012344",2011,296,113,183,21
"81486","S01012345",2011,321,70,251,18
"81487","S01012346",2011,361,14,347,122
"81488","S01012347",2011,364,96,268,25
"81489","S01012348",2011,325,49,276,33
"81490","S01012349",2011,402,136,266,25
"81491","S01012350",2011,337,101,236,17
"81492","S01012351",2011,373,116,257,26
"81493","S01012352",2011,350,74,276,48
"81494","S01012353",2011,453,170,283,82
"81495","S01012354",2011,385,70,315,47
"81496","S01012355",2011,377,10,367,98
"81497","S01012356",2011,320,51,269,18
"81498","S01012357",2011,355,3,352,60
"81499","S01012358",2011,343,22,321,57
"81500","S01012359",2011,367,190,177,25
"81501","S01012360",2011,324,180,144,33
"81502","S01012361",2011,275,174,101,8
"81503","S01012362",2011,306,233,73,12
"81504","S01012363",2011,575,186,389,123
"81505","S01012364",2011,375,47,328,98
"81506","S01012365",2011,443,32,411,42
"81507","S01012366",2011,513,49,464,124
"81508","S01012367",2011,420,72,348,30
"81509","S01012368",2011,261,33,228,7
"81510","S01012369",2011,375,49,326,30
"81511","S01012370",2011,516,215,301,35
"81512","S01012371",2011,486,142,344,63
"81513","S01012372",2011,450,161,289,69
"81514","S01012373",2011,479,113,366,35
"81515","S01012374",2011,402,100,302,11
"81516","S01012375",2011,429,180,249,23
"81517","S01012376",2011,407,18,389,73
"81518","S01012377",2011,324,40,284,66
"81519","S01012378",2011,250,15,235,70
"81520","S01012379",2011,227,19,208,59
"81521","S01012380",2011,423,151,272,22
"81522","S01012381",2011,456,173,283,48
"81523","S01012382",2011,437,54,383,20
"81524","S01012383",2011,424,89,335,49
"81525","S01012384",2011,267,48,219,46
"81526","S01012385",2011,332,41,291,50
"81527","S01012386",2011,440,248,192,33
"81528","S01012387",2011,407,75,332,51
"81529","S01012388",2011,306,13,293,12
"81530","S01012389",2011,339,67,272,26
"81531","S01012390",2011,307,48,259,17
"81532","S01012391",2011,412,50,362,34
"81533","S01012392",2011,327,127,200,12
"81534","S01012393",2011,377,81,296,25
"81535","S01012394",2011,276,155,121,11
"81536","S01012395",2011,279,74,205,21
"81537","S01012396",2011,312,73,239,48
"81538","S01012397",2011,418,126,292,38
"81539","S01012398",2011,432,125,307,73
"81540","S01012399",2011,287,118,169,23
"81541","S01012400",2011,274,105,169,46
"81542","S01012401",2011,408,203,205,18
"81543","S01012402",2011,184,10,174,17
"81544","S01012403",2011,437,49,388,39
"81545","S01012404",2011,448,124,324,57
"81546","S01012405",2011,274,7,267,24
"81547","S01012406",2011,260,36,224,18
"81548","S01012407",2011,335,90,245,18
"81549","S01012408",2011,250,16,234,34
"81550","S01012409",2011,311,60,251,35
"81551","S01012410",2011,420,108,312,28
"81552","S01012411",2011,410,151,259,18
"81553","S01012412",2011,281,68,213,25
"81554","S01012413",2011,419,50,369,48
"81555","S01012414",2011,341,89,252,23
"81556","S01012415",2011,203,30,173,5
"81557","S01012416",2011,216,28,188,10
"81558","S01012417",2011,299,68,231,48
"81559","S01012418",2011,343,39,304,54
"81560","S01012419",2011,313,31,282,36
"81561","S01012420",2011,362,117,245,38
"81562","S01012421",2011,325,73,252,61
"81563","S01012422",2011,402,46,356,82
"81564","S01012423",2011,346,38,308,35
"81565","S01012424",2011,414,130,284,16
"81566","S01012425",2011,307,163,144,21
"81567","S01012426",2011,237,118,119,16
"81568","S01012427",2011,300,145,155,16
"81569","S01012428",2011,286,58,228,20
"81570","S01012429",2011,286,36,250,40
"81571","S01012430",2011,277,14,263,41
"81572","S01012431",2011,432,73,359,53
"81573","S01012432",2011,352,103,249,11
"81574","S01012433",2011,265,63,202,33
"81575","S01012434",2011,334,100,234,51
"81576","S01012435",2011,311,121,190,31
"81577","S01012436",2011,345,132,213,46
"81578","S01012437",2011,336,106,230,15
"81579","S01012438",2011,260,68,192,14
"81580","S01012439",2011,355,97,258,45
"81581","S01012440",2011,221,10,211,13
"81582","S01012441",2011,387,59,328,28
"81583","S01012442",2011,423,52,371,51
"81584","S01012443",2011,313,41,272,41
"81585","S01012444",2011,292,22,270,23
"81586","S01012445",2011,183,21,162,10
"81587","S01012446",2011,252,75,177,27
"81588","S01012447",2011,354,7,347,19
"81589","S01012448",2011,361,40,321,20
"81590","S01012449",2011,252,20,232,23
"81591","S01012450",2011,322,12,310,30
"81592","S01012451",2011,397,5,392,17
"81593","S01012452",2011,301,6,295,17
"81594","S01012453",2011,322,3,319,12
"81595","S01012454",2011,301,3,298,6
"81596","S01012455",2011,246,0,0,16
"81597","S01012456",2011,300,4,296,16
"81598","S01012457",2011,380,6,374,8
"81599","S01012458",2011,330,7,323,19
"81600","S01012459",2011,271,7,264,19
"81601","S01012460",2011,242,2,240,9
"81602","S01012461",2011,250,57,193,24
"81603","S01012462",2011,386,113,273,50
"81604","S01012463",2011,256,75,181,29
"81605","S01012464",2011,255,98,157,16
"81606","S01012465",2011,286,70,216,29
"81607","S01012466",2011,349,41,308,44
"81608","S01012467",2011,307,42,265,37
"81609","S01012468",2011,316,37,279,19
"81610","S01012469",2011,333,1,332,12
"81611","S01012470",2011,492,103,389,51
"81612","S01012471",2011,352,3,349,16
"81613","S01012472",2011,317,4,313,13
"81614","S01012473",2011,218,4,214,14
"81615","S01012474",2011,371,105,266,27
"81616","S01012475",2011,300,14,286,35
"81617","S01012476",2011,422,72,350,44
"81618","S01012477",2011,283,6,277,9
"81619","S01012478",2011,368,63,305,32
"81620","S01012479",2011,261,5,256,9
"81621","S01012480",2011,339,81,258,124
"81622","S01012481",2011,419,29,390,157
"81623","S01012482",2011,439,8,431,73
"81624","S01012483",2011,570,162,408,175
"81625","S01012484",2011,366,32,334,47
"81626","S01012485",2011,384,2,382,72
"81627","S01012486",2011,268,2,266,12
"81628","S01012487",2011,306,67,239,44
"81629","S01012488",2011,483,105,378,63
"81630","S01012489",2011,553,267,286,113
"81631","S01012490",2011,606,245,361,193
"81632","S01012491",2011,245,138,107,38
"81633","S01012492",2011,490,248,242,104
"81634","S01012493",2011,409,246,163,15
"81635","S01012494",2011,383,73,310,37
"81636","S01012495",2011,496,177,319,62
"81637","S01012496",2011,314,115,199,14
"81638","S01012497",2011,231,102,129,10
"81639","S01012498",2011,343,227,116,10
"81640","S01012499",2011,277,119,158,30
"81641","S01012500",2011,217,99,118,24
"81642","S01012501",2011,260,171,89,25
"81643","S01012502",2011,360,238,122,16
"81644","S01012503",2011,308,155,153,21
"81645","S01012504",2011,282,121,161,20
"81646","S01012505",2011,515,202,313,37
"81647","S01012506",2011,241,44,197,23
"81648","S01012507",2011,482,97,385,58
"81649","S01012508",2011,399,81,318,42
"81650","S01012509",2011,256,16,240,19
"81651","S01012510",2011,381,34,347,22
"81652","S01012511",2011,316,47,269,34
"81653","S01012512",2011,286,94,192,13
"81654","S01012513",2011,234,7,227,15
"81655","S01012514",2011,392,16,376,44
"81656","S01012515",2011,319,141,178,21
"81657","S01012516",2011,301,76,225,22
"81658","S01012517",2011,410,97,313,61
"81659","S01012518",2011,277,24,253,38
"81660","S01012519",2011,279,12,267,61
"81661","S01012520",2011,345,8,337,18
"81662","S01012521",2011,270,5,265,56
"81663","S01012522",2011,360,4,356,27
"81664","S01012523",2011,385,21,364,24
"81665","S01012524",2011,467,21,446,41
"81666","S01012525",2011,341,6,335,29
"81667","S01012526",2011,334,3,331,14
"81668","S01012527",2011,285,31,254,12
"81669","S01012528",2011,337,82,255,25
"81670","S01012529",2011,342,56,286,46
"81671","S01012530",2011,400,8,392,14
"81672","S01012531",2011,332,30,302,47
"81673","S01012532",2011,348,43,305,42
"81674","S01012533",2011,274,23,251,59
"81675","S01012534",2011,288,68,220,28
"81676","S01012535",2011,361,75,286,19
"81677","S01012536",2011,312,78,234,22
"81678","S01012537",2011,334,88,246,33
"81679","S01012538",2011,476,120,356,31
"81680","S01012539",2011,315,62,253,29
"81681","S01012540",2011,299,125,174,9
"81682","S01012541",2011,442,87,355,63
"81683","S01012542",2011,380,48,332,21
"81684","S01012543",2011,276,22,254,20
"81685","S01012544",2011,341,70,271,24
"81686","S01012545",2011,214,97,117,6
"81687","S01012546",2011,322,54,268,30
"81688","S01012547",2011,312,46,266,10
"81689","S01012548",2011,394,25,369,30
"81690","S01012549",2011,251,88,163,26
"81691","S01012550",2011,345,70,275,27
"81692","S01012551",2011,319,4,315,9
"81693","S01012552",2011,352,6,346,16
"81694","S01012553",2011,347,7,340,24
"81695","S01012554",2011,190,1,189,14
"81696","S01012555",2011,211,3,208,16
"81697","S01012556",2011,221,6,215,6
"81698","S01012557",2011,249,6,243,15
"81699","S01012558",2011,279,80,199,34
"81700","S01012559",2011,457,166,291,75
"81701","S01012560",2011,264,70,194,19
"81702","S01012561",2011,365,93,272,31
"81703","S01012562",2011,434,93,341,99
"81704","S01012563",2011,271,2,269,8
"81705","S01012564",2011,373,11,362,16
"81706","S01012565",2011,379,67,312,33
"81707","S01012566",2011,445,57,388,126
"81708","S01012567",2011,557,108,449,127
"81709","S01012568",2011,281,15,266,25
"81710","S01012569",2011,315,5,310,21
"81711","S01012570",2011,197,32,165,23
"81712","S01012571",2011,362,58,304,65
"81713","S01012572",2011,224,38,186,25
"81714","S01012573",2011,325,9,316,35
"81715","S01012574",2011,359,34,325,23
"81716","S01012575",2011,289,35,254,44
"81717","S01012576",2011,370,23,347,54
"81718","S01012577",2011,336,41,295,33
"81719","S01012578",2011,463,120,343,38
"81720","S01012579",2011,287,79,208,24
"81721","S01012580",2011,325,26,299,40
"81722","S01012581",2011,331,157,174,19
"81723","S01012582",2011,365,46,319,32
"81724","S01012583",2011,326,112,214,15
"81725","S01012584",2011,331,60,271,15
"81726","S01012585",2011,404,165,239,30
"81727","S01012586",2011,313,10,303,26
"81728","S01012587",2011,327,9,318,22
"81729","S01012588",2011,256,16,240,13
"81730","S01012589",2011,284,118,166,10
"81731","S01012590",2011,371,158,213,18
"81732","S01012591",2011,385,189,196,10
"81733","S01012592",2011,215,4,211,9
"81734","S01012593",2011,333,14,319,13
"81735","S01012594",2011,212,31,181,6
"81736","S01012595",2011,288,53,235,15
"81737","S01012596",2011,347,133,214,20
"81738","S01012597",2011,177,22,155,5
"81739","S01012598",2011,302,20,282,25
"81740","S01012599",2011,330,32,298,34
"81741","S01012600",2011,308,2,306,25
"81742","S01012601",2011,357,18,339,13
"81743","S01012602",2011,329,152,177,33
"81744","S01012603",2011,337,131,206,20
"81745","S01012604",2011,275,72,203,11
"81746","S01012605",2011,240,67,173,8
"81747","S01012606",2011,249,3,246,1
"81748","S01012607",2011,312,53,259,15
"81749","S01012608",2011,358,124,234,10
"81750","S01012609",2011,383,182,201,12
"81751","S01012610",2011,425,225,200,23
"81752","S01012611",2011,352,54,298,13
"81753","S01012612",2011,294,76,218,16
"81754","S01012613",2011,287,83,204,10
"81755","S01012614",2011,455,92,363,26
"81756","S01012615",2011,306,56,250,14
"81757","S01012616",2011,384,74,310,13
"81758","S01012617",2011,151,4,147,10
"81759","S01012618",2011,209,40,169,14
"81760","S01012619",2011,295,119,176,34
"81761","S01012620",2011,325,12,313,14
"81762","S01012621",2011,277,35,242,16
"81763","S01012622",2011,341,81,260,16
"81764","S01012623",2011,320,114,206,26
"81765","S01012624",2011,334,81,253,39
"81766","S01012625",2011,263,100,163,11
"81767","S01012626",2011,216,12,204,11
"81768","S01012627",2011,241,106,135,17
"81769","S01012628",2011,334,7,327,23
"81770","S01012629",2011,197,4,193,22
"81771","S01012630",2011,508,136,372,90
"81772","S01012631",2011,423,205,218,22
"81773","S01012632",2011,304,9,295,38
"81774","S01012633",2011,283,42,241,19
"81775","S01012634",2011,339,100,239,18
"81776","S01012635",2011,430,71,359,19
"81777","S01012636",2011,250,27,223,19
"81778","S01012637",2011,365,193,172,21
"81779","S01012638",2011,406,118,288,47
"81780","S01012639",2011,360,128,232,15
"81781","S01012640",2011,439,252,187,23
"81782","S01012641",2011,484,129,355,77
"81783","S01012642",2011,380,216,164,21
"81784","S01012643",2011,199,59,140,16
"81785","S01012644",2011,301,105,196,22
"81786","S01012645",2011,368,95,273,39
"81787","S01012646",2011,405,45,360,31
"81788","S01012647",2011,269,3,266,28
"81789","S01012648",2011,229,94,135,13
"81790","S01012649",2011,267,75,192,8
"81791","S01012650",2011,266,32,234,24
"81792","S01012651",2011,327,174,153,14
"81793","S01012652",2011,431,14,417,21
"81794","S01012653",2011,363,137,226,22
"81795","S01012654",2011,326,16,310,50
"81796","S01012655",2011,454,131,323,21
"81797","S01012656",2011,405,141,264,22
"81798","S01012657",2011,272,67,205,35
"81799","S01012658",2011,424,16,408,21
"81800","S01012659",2011,366,6,360,13
"81801","S01012660",2011,326,128,198,9
"81802","S01012661",2011,324,22,302,38
"81803","S01012662",2011,370,118,252,30
"81804","S01012663",2011,301,4,297,28
"81805","S01012664",2011,462,61,401,72
"81806","S01012665",2011,346,162,184,22
"81807","S01012666",2011,337,138,199,22
"81808","S01012667",2011,279,139,140,9
"81809","S01012668",2011,347,96,251,37
"81810","S01012669",2011,296,3,293,5
"81811","S01012670",2011,295,4,291,10
"81812","S01012671",2011,388,111,277,18
"81813","S01012672",2011,361,224,137,14
"81814","S01012673",2011,252,128,124,21
"81815","S01012674",2011,240,124,116,12
"81816","S01012675",2011,361,170,191,26
"81817","S01012676",2011,307,57,250,33
"81818","S01012677",2011,256,92,164,21
"81819","S01012678",2011,268,3,265,14
"81820","S01012679",2011,372,126,246,15
"81821","S01012680",2011,210,5,205,11
"81822","S01012681",2011,311,22,289,40
"81823","S01012682",2011,315,39,276,21
"81824","S01012683",2011,326,103,223,18
"81825","S01012684",2011,219,9,210,25
"81826","S01012685",2011,334,104,230,9
"81827","S01012686",2011,434,13,421,69
"81828","S01012687",2011,235,1,234,3
"81829","S01012688",2011,449,41,408,108
"81830","S01012689",2011,185,9,176,9
"81831","S01012690",2011,202,14,188,8
"81832","S01012691",2011,296,2,294,21
"81833","S01012692",2011,334,82,252,18
"81834","S01012693",2011,321,7,314,6
"81835","S01012694",2011,200,38,162,12
"81836","S01012695",2011,306,29,277,27
"81837","S01012696",2011,272,4,268,17
"81838","S01012697",2011,197,9,188,18
"81839","S01012698",2011,339,28,311,13
"81840","S01012699",2011,429,55,374,27
"81841","S01012700",2011,320,33,287,24
"81842","S01012701",2011,221,5,216,12
"81843","S01012702",2011,254,23,231,42
"81844","S01012703",2011,205,25,180,7
"81845","S01012704",2011,329,121,208,14
"81846","S01012705",2011,257,3,254,5
"81847","S01012706",2011,297,96,201,15
"81848","S01012707",2011,322,4,318,12
"81849","S01012708",2011,332,111,221,21
"81850","S01012709",2011,253,92,161,8
"81851","S01012710",2011,356,137,219,33
"81852","S01012711",2011,435,194,241,46
"81853","S01012712",2011,335,6,329,13
"81854","S01012713",2011,329,22,307,22
"81855","S01012714",2011,264,3,261,11
"81856","S01012715",2011,411,109,302,68
"81857","S01012716",2011,369,27,342,33
"81858","S01012717",2011,581,158,423,119
"81859","S01012718",2011,489,36,453,97
"81860","S01012719",2011,438,63,375,138
"81861","S01012720",2011,318,22,296,127
"81862","S01012721",2011,288,36,252,23
"81863","S01012722",2011,413,170,243,42
"81864","S01012723",2011,358,157,201,29
"81865","S01012724",2011,412,74,338,64
"81866","S01012725",2011,494,75,419,105
"81867","S01012726",2011,283,55,228,12
"81868","S01012727",2011,294,154,140,9
"81869","S01012728",2011,339,225,114,22
"81870","S01012729",2011,346,58,288,20
"81871","S01012730",2011,266,103,163,13
"81872","S01012731",2011,335,99,236,13
"81873","S01012732",2011,292,71,221,20
"81874","S01012733",2011,364,11,353,25
"81875","S01012734",2011,198,4,194,6
"81876","S01012735",2011,213,45,168,20
"81877","S01012736",2011,376,71,305,24
"81878","S01012737",2011,329,26,303,28
"81879","S01012738",2011,255,71,184,8
"81880","S01012739",2011,289,4,285,18
"81881","S01012740",2011,308,52,256,9
"81882","S01012741",2011,272,7,265,17
"81883","S01012742",2011,276,10,266,8
"81884","S01012743",2011,237,1,236,7
"81885","S01012744",2011,277,3,274,15
"81886","S01012745",2011,302,6,296,8
"81887","S01012746",2011,311,26,285,24
"81888","S01012747",2011,348,82,266,11
"81889","S01012748",2011,369,228,141,16
"81890","S01012749",2011,387,212,175,35
"81891","S01012750",2011,336,140,196,44
"81892","S01012751",2011,423,140,283,22
"81893","S01012752",2011,375,135,240,22
"81894","S01012753",2011,235,121,114,18
"81895","S01012754",2011,255,95,160,9
"81896","S01012755",2011,280,162,118,17
"81897","S01012756",2011,271,96,175,14
"81898","S01012757",2011,236,85,151,14
"81899","S01012758",2011,274,79,195,19
"81900","S01012759",2011,342,144,198,16
"81901","S01012760",2011,424,170,254,47
"81902","S01012761",2011,369,113,256,27
"81903","S01012762",2011,315,40,275,23
"81904","S01012763",2011,178,57,121,8
"81905","S01012764",2011,348,126,222,21
"81906","S01012765",2011,296,95,201,5
"81907","S01012766",2011,358,133,225,22
"81908","S01012767",2011,228,6,222,5
"81909","S01012768",2011,291,5,286,7
"81910","S01012769",2011,152,1,151,9
"81911","S01012770",2011,408,90,318,50
"81912","S01012771",2011,357,81,276,18
"81913","S01012772",2011,285,114,171,13
"81914","S01012773",2011,391,89,302,25
"81915","S01012774",2011,408,117,291,39
"81916","S01012775",2011,211,48,163,25
"81917","S01012776",2011,359,124,235,20
"81918","S01012777",2011,365,40,325,27
"81919","S01012778",2011,295,128,167,13
"81920","S01012779",2011,200,82,118,15
"81921","S01012780",2011,346,184,162,24
"81922","S01012781",2011,300,35,265,25
"81923","S01012782",2011,313,150,163,29
"81924","S01012783",2011,322,137,185,23
"81925","S01012784",2011,391,163,228,30
"81926","S01012785",2011,388,214,174,31
"81927","S01012786",2011,423,239,184,74
"81928","S01012787",2011,250,47,203,30
"81929","S01012788",2011,259,111,148,15
"81930","S01012789",2011,325,68,257,15
"81931","S01012790",2011,289,40,249,51
"81932","S01012791",2011,324,17,307,17
"81933","S01012792",2011,496,116,380,68
"81934","S01012793",2011,363,162,201,59
"81935","S01012794",2011,378,30,348,108
"81936","S01012795",2011,439,232,207,17
"81937","S01012796",2011,347,109,238,30
"81938","S01012797",2011,276,106,170,15
"81939","S01012798",2011,329,24,305,25
"81940","S01012799",2011,393,35,358,45
"81941","S01012800",2011,398,6,392,46
"81942","S01012801",2011,252,5,247,41
"81943","S01012802",2011,207,3,204,12
"81944","S01012803",2011,262,5,257,8
"81945","S01012804",2011,351,126,225,31
"81946","S01012805",2011,383,94,289,22
"81947","S01012806",2011,299,67,232,19
"81948","S01012807",2011,218,1,217,19
"81949","S01012808",2011,475,56,419,47
"81950","S01012809",2011,337,21,316,113
"81951","S01012810",2011,481,251,230,41
"81952","S01012811",2011,348,62,286,18
"81953","S01012812",2011,285,34,251,20
"81954","S01012813",2011,372,4,368,10
"81955","S01012814",2011,333,6,327,21
"81956","S01012815",2011,320,13,307,56
"81957","S01012816",2011,229,13,216,30
"81958","S01012817",2011,175,6,169,6
"81959","S01012818",2011,271,8,263,16
"81960","S01012819",2011,365,146,219,26
"81961","S01012820",2011,370,26,344,16
"81962","S01012821",2011,263,10,253,25
"81963","S01012822",2011,256,133,123,43
"81964","S01012823",2011,285,3,282,16
"81965","S01012824",2011,273,34,239,17
"81966","S01012825",2011,269,112,157,34
"81967","S01012826",2011,231,163,68,13
"81968","S01012827",2011,233,12,221,18
"81969","S01012828",2011,254,2,252,23
"81970","S01012829",2011,362,161,201,26
"81971","S01012830",2011,313,105,208,17
"81972","S01012831",2011,333,133,200,16
"81973","S01012832",2011,215,68,147,5
"81974","S01012833",2011,319,159,160,11
"81975","S01012834",2011,289,97,192,15
"81976","S01012835",2011,403,91,312,38
"81977","S01012836",2011,220,10,210,6
"81978","S01012837",2011,414,355,59,10
"81979","S01012838",2011,528,466,62,20
"81980","S01012839",2011,300,9,291,8
"81981","S01012840",2011,285,10,275,21
"81982","S01012841",2011,253,16,237,12
"81983","S01012842",2011,198,7,191,9
"81984","S01012843",2011,381,9,372,9
"81985","S01012844",2011,249,7,242,7
"81986","S01012845",2011,281,21,260,12
"81987","S01012846",2011,543,243,300,77
"81988","S01012847",2011,249,62,187,15
"81989","S01012848",2011,283,14,269,30
"81990","S01012849",2011,345,76,269,111
"81991","S01012850",2011,339,90,249,7
"81992","S01012851",2011,374,64,310,7
"81993","S01012852",2011,298,7,291,11
"81994","S01012853",2011,338,3,335,12
"81995","S01012854",2011,374,2,372,26
"81996","S01012855",2011,284,7,277,52
"81997","S01012856",2011,414,124,290,53
"81998","S01012857",2011,472,174,298,39
"81999","S01012858",2011,422,201,221,39
"82000","S01012859",2011,530,95,435,96
"82001","S01012860",2011,382,20,362,38
"82002","S01012861",2011,322,13,309,26
"82003","S01012862",2011,369,187,182,43
"82004","S01012863",2011,424,232,192,70
"82005","S01012864",2011,469,222,247,73
"82006","S01012865",2011,390,113,277,20
"82007","S01012866",2011,374,81,293,32
"82008","S01012867",2011,396,186,210,20
"82009","S01012868",2011,321,96,225,46
"82010","S01012869",2011,257,177,80,16
"82011","S01012870",2011,450,74,376,20
"82012","S01012871",2011,384,13,371,40
"82013","S01012872",2011,318,7,311,64
"82014","S01012873",2011,338,15,323,57
"82015","S01012874",2011,383,146,237,30
"82016","S01012875",2011,277,93,184,25
"82017","S01012876",2011,371,141,230,16
"82018","S01012877",2011,331,73,258,7
"82019","S01012878",2011,373,8,365,23
"82020","S01012879",2011,323,12,311,34
"82021","S01012880",2011,374,9,365,11
"82022","S01012881",2011,406,30,376,17
"82023","S01012882",2011,287,133,154,17
"82024","S01012883",2011,378,244,134,8
"82025","S01012884",2011,285,153,132,19
"82026","S01012885",2011,270,132,138,34
"82027","S01012886",2011,315,14,301,18
"82028","S01012887",2011,352,10,342,10
"82029","S01012888",2011,333,19,314,6
"82030","S01012889",2011,342,43,299,20
"82031","S01012890",2011,300,139,161,17
"82032","S01012891",2011,255,79,176,8
"82033","S01012892",2011,566,269,297,28
"82034","S01012893",2011,369,169,200,11
"82035","S01012894",2011,311,85,226,15
"82036","S01012895",2011,197,19,178,4
"82037","S01012896",2011,482,272,210,15
"82038","S01012897",2011,248,6,242,22
"82039","S01012898",2011,177,4,173,12
"82040","S01012899",2011,317,201,116,14
"82041","S01012900",2011,226,10,216,30
"82042","S01012901",2011,336,39,297,47
"82043","S01012902",2011,359,69,290,40
"82044","S01012903",2011,400,70,330,47
"82045","S01012904",2011,371,70,301,45
"82046","S01012905",2011,272,119,153,33
"82047","S01012906",2011,482,73,409,60
"82048","S01012907",2011,449,97,352,46
"82049","S01012908",2011,355,83,272,29
"82050","S01012909",2011,331,84,247,43
"82051","S01012910",2011,485,245,240,29
"82052","S01012911",2011,340,37,303,31
"82053","S01012912",2011,339,77,262,31
"82054","S01012913",2011,417,67,350,31
"82055","S01012914",2011,410,68,342,71
"82056","S01012915",2011,447,86,361,53
"82057","S01012916",2011,331,76,255,29
"82058","S01012917",2011,270,10,260,13
"82059","S01012918",2011,255,35,220,45
"82060","S01012919",2011,229,33,196,17
"82061","S01012920",2011,258,2,256,5
"82062","S01012921",2011,338,43,295,41
"82063","S01012922",2011,437,60,377,46
"82064","S01012923",2011,306,31,275,34
"82065","S01012924",2011,243,31,212,43
"82066","S01012925",2011,194,8,186,17
"82067","S01012926",2011,333,37,296,47
"82068","S01012927",2011,339,44,295,43
"82069","S01012928",2011,353,22,331,29
"82070","S01012929",2011,340,27,313,21
"82071","S01012930",2011,512,125,387,94
"82072","S01012931",2011,435,95,340,60
"82073","S01012932",2011,211,24,187,11
"82074","S01012933",2011,352,61,291,23
"82075","S01012934",2011,360,75,285,48
"82076","S01012935",2011,363,57,306,24
"82077","S01012936",2011,351,66,285,41
"82078","S01012937",2011,314,49,265,29
"82079","S01012938",2011,307,40,267,10
"82080","S01012939",2011,216,3,213,8
"82081","S01012940",2011,268,2,266,11
"82082","S01012941",2011,257,3,254,5
"82083","S01012942",2011,364,111,253,47
"82084","S01012943",2011,291,18,273,17
"82085","S01012944",2011,207,1,206,6
"82086","S01012945",2011,241,4,237,4
"82087","S01012946",2011,338,3,335,50
"82088","S01012947",2011,151,2,149,2
"82089","S01012948",2011,249,6,243,3
"82090","S01012949",2011,282,5,277,16
"82091","S01012950",2011,273,4,269,13
"82092","S01012951",2011,294,2,292,12
"82093","S01012952",2011,247,4,243,8
"82094","S01012953",2011,292,3,289,23
"82095","S01012954",2011,173,2,171,7
"82096","S01012955",2011,356,12,344,62
"82097","S01012956",2011,458,115,343,35
"82098","S01012957",2011,304,79,225,23
"82099","S01012958",2011,206,31,175,13
"82100","S01012959",2011,228,12,216,14
"82101","S01012960",2011,229,66,163,2
"82102","S01012961",2011,200,3,197,8
"82103","S01012962",2011,236,2,234,9
"82104","S01012963",2011,275,5,270,7
"82105","S01012964",2011,200,1,199,12
"82106","S01012965",2011,229,60,169,6
"82107","S01012966",2011,262,31,231,15
"82108","S01012967",2011,183,31,152,11
"82109","S01012968",2011,271,52,219,41
"82110","S01012969",2011,306,87,219,28
"82111","S01012970",2011,236,70,166,7
"82112","S01012971",2011,299,118,181,25
"82113","S01012972",2011,329,121,208,27
"82114","S01012973",2011,335,60,275,24
"82115","S01012974",2011,446,120,326,35
"82116","S01012975",2011,266,102,164,17
"82117","S01012976",2011,229,57,172,22
"82118","S01012977",2011,287,70,217,28
"82119","S01012978",2011,334,108,226,20
"82120","S01012979",2011,224,37,187,9
"82121","S01012980",2011,311,75,236,35
"82122","S01012981",2011,347,67,280,35
"82123","S01012982",2011,383,60,323,49
"82124","S01012983",2011,326,9,317,23
"82125","S01012984",2011,279,34,245,19
"82126","S01012985",2011,330,29,301,16
"82127","S01012986",2011,394,93,301,46
"82128","S01012987",2011,356,85,271,30
"82129","S01012988",2011,463,95,368,47
"82130","S01012989",2011,409,53,356,32
"82131","S01012990",2011,303,101,202,26
"82132","S01012991",2011,351,46,305,43
"82133","S01012992",2011,380,69,311,39
"82134","S01012993",2011,376,79,297,51
"82135","S01012994",2011,502,158,344,72
"82136","S01012995",2011,331,45,286,20
"82137","S01012996",2011,246,56,190,14
"82138","S01012997",2011,210,49,161,14
"82139","S01012998",2011,414,58,356,43
"82140","S01012999",2011,220,58,162,17
"82141","S01013000",2011,322,70,252,32
"82142","S01013001",2011,156,10,146,31
"82143","S01013002",2011,205,14,191,30
"82144","S01013003",2011,246,2,244,2
"82145","S01013004",2011,264,21,243,14
"82146","S01013005",2011,300,14,286,33
"82147","S01013006",2011,240,10,230,39
"82148","S01013007",2011,397,11,386,28
"82149","S01013008",2011,330,48,282,33
"82150","S01013009",2011,293,64,229,27
"82151","S01013010",2011,246,4,242,30
"82152","S01013011",2011,261,47,214,16
"82153","S01013012",2011,292,70,222,32
"82154","S01013013",2011,297,28,269,30
"82155","S01013014",2011,336,59,277,39
"82156","S01013015",2011,309,10,299,24
"82157","S01013016",2011,244,11,233,32
"82158","S01013017",2011,359,103,256,14
"82159","S01013018",2011,387,46,341,24
"82160","S01013019",2011,355,8,347,64
"82161","S01013020",2011,226,68,158,16
"82162","S01013021",2011,187,42,145,13
"82163","S01013022",2011,186,72,114,13
"82164","S01013023",2011,337,5,332,13
"82165","S01013024",2011,227,8,219,21
"82166","S01013025",2011,211,8,203,21
"82167","S01013026",2011,410,116,294,18
"82168","S01013027",2011,422,225,197,26
"82169","S01013028",2011,191,30,161,19
"82170","S01013029",2011,269,122,147,11
"82171","S01013030",2011,225,104,121,12
"82172","S01013031",2011,291,131,160,16
"82173","S01013032",2011,309,38,271,26
"82174","S01013033",2011,276,50,226,30
"82175","S01013034",2011,296,99,197,9
"82176","S01013035",2011,300,154,146,7
"82177","S01013036",2011,280,146,134,7
"82178","S01013037",2011,283,20,263,28
"82179","S01013038",2011,434,138,296,36
"82180","S01013039",2011,178,4,174,7
"82181","S01013040",2011,324,82,242,31
"82182","S01013041",2011,257,54,203,29
"82183","S01013042",2011,318,70,248,20
"82184","S01013043",2011,278,128,150,14
"82185","S01013044",2011,323,113,210,18
"82186","S01013045",2011,277,65,212,24
"82187","S01013046",2011,214,78,136,12
"82188","S01013047",2011,350,7,343,15
"82189","S01013048",2011,401,5,396,86
"82190","S01013049",2011,354,8,346,24
"82191","S01013050",2011,351,120,231,33
"82192","S01013051",2011,422,135,287,29
"82193","S01013052",2011,391,113,278,31
"82194","S01013053",2011,337,162,175,38
"82195","S01013054",2011,305,54,251,19
"82196","S01013055",2011,336,98,238,36
"82197","S01013056",2011,431,150,281,26
"82198","S01013057",2011,369,223,146,17
"82199","S01013058",2011,213,22,191,16
"82200","S01013059",2011,406,13,393,54
"82201","S01013060",2011,227,8,219,26
"82202","S01013061",2011,362,0,0,19
"82203","S01013062",2011,403,3,400,67
"82204","S01013063",2011,371,43,328,49
"82205","S01013064",2011,386,109,277,26
"82206","S01013065",2011,415,133,282,70
"82207","S01013066",2011,347,92,255,57
"82208","S01013067",2011,396,61,335,249
"82209","S01013068",2011,406,188,218,127
"82210","S01013069",2011,350,76,274,167
"82211","S01013070",2011,301,107,194,125
"82212","S01013071",2011,359,35,324,230
"82213","S01013072",2011,227,172,55,5
"82214","S01013073",2011,352,193,159,35
"82215","S01013074",2011,302,219,83,18
"82216","S01013075",2011,481,309,172,42
"82217","S01013076",2011,172,17,155,42
"82218","S01013077",2011,297,140,157,19
"82219","S01013078",2011,252,173,79,11
"82220","S01013079",2011,376,45,331,32
"82221","S01013080",2011,374,64,310,71
"82222","S01013081",2011,280,5,275,18
"82223","S01013082",2011,395,5,390,22
"82224","S01013083",2011,187,4,183,17
"82225","S01013084",2011,307,2,305,14
"82226","S01013085",2011,259,98,161,20
"82227","S01013086",2011,448,42,406,136
"82228","S01013087",2011,327,5,322,65
"82229","S01013088",2011,388,7,381,32
"82230","S01013089",2011,359,64,295,52
"82231","S01013090",2011,349,27,322,135
"82232","S01013091",2011,254,23,231,126
"82233","S01013092",2011,440,77,363,120
"82234","S01013093",2011,223,8,215,33
"82235","S01013094",2011,230,0,0,4
"82236","S01013095",2011,282,1,281,10
"82237","S01013096",2011,213,44,169,40
"82238","S01013097",2011,248,6,242,35
"82239","S01013098",2011,189,1,188,4
"82240","S01013099",2011,439,22,417,92
"82241","S01013100",2011,265,1,264,15
"82242","S01013101",2011,502,153,349,46
"82243","S01013102",2011,291,13,278,16
"82244","S01013103",2011,289,4,285,6
"82245","S01013104",2011,404,8,396,17
"82246","S01013105",2011,387,15,372,34
"82247","S01013106",2011,350,43,307,46
"82248","S01013107",2011,275,5,270,51
"82249","S01013108",2011,255,71,184,18
"82250","S01013109",2011,412,20,392,45
"82251","S01013110",2011,245,26,219,39
"82252","S01013111",2011,192,17,175,15
"82253","S01013112",2011,265,58,207,28
"82254","S01013113",2011,372,128,244,9
"82255","S01013114",2011,337,46,291,64
"82256","S01013115",2011,320,75,245,51
"82257","S01013116",2011,331,4,327,12
"82258","S01013117",2011,271,78,193,22
"82259","S01013118",2011,195,15,180,20
"82260","S01013119",2011,337,56,281,31
"82261","S01013120",2011,440,96,344,67
"82262","S01013121",2011,146,49,97,14
"82263","S01013122",2011,333,239,94,16
"82264","S01013123",2011,414,186,228,33
"82265","S01013124",2011,334,108,226,12
"82266","S01013125",2011,374,92,282,22
"82267","S01013126",2011,342,233,109,9
"82268","S01013127",2011,378,248,130,11
"82269","S01013128",2011,455,205,250,85
"82270","S01013129",2011,533,208,325,45
"82271","S01013130",2011,340,199,141,32
"82272","S01013131",2011,316,197,119,15
"82273","S01013132",2011,318,238,80,15
"82274","S01013133",2011,441,309,132,21
"82275","S01013134",2011,376,116,260,20
"82276","S01013135",2011,391,267,124,21
"82277","S01013136",2011,395,124,271,12
"82278","S01013137",2011,307,116,191,3
"82279","S01013138",2011,342,231,111,18
"82280","S01013139",2011,409,258,151,15
"82281","S01013140",2011,366,195,171,15
"82282","S01013141",2011,330,164,166,34
"82283","S01013142",2011,517,457,60,9
"82284","S01013143",2011,419,150,269,22
"82285","S01013144",2011,427,139,288,19
"82286","S01013145",2011,336,96,240,12
"82287","S01013146",2011,197,61,136,4
"82288","S01013147",2011,307,87,220,7
"82289","S01013148",2011,381,67,314,33
"82290","S01013149",2011,418,88,330,41
"82291","S01013150",2011,403,103,300,24
"82292","S01013151",2011,261,23,238,24
"82293","S01013152",2011,386,101,285,19
"82294","S01013153",2011,398,258,140,10
"82295","S01013154",2011,452,225,227,22
"82296","S01013155",2011,399,269,130,32
"82297","S01013156",2011,354,267,87,4
"82298","S01013157",2011,430,287,143,6
"82299","S01013158",2011,205,8,197,7
"82300","S01013159",2011,297,26,271,11
"82301","S01013160",2011,264,2,262,9
"82302","S01013161",2011,488,155,333,25
"82303","S01013162",2011,426,169,257,28
"82304","S01013163",2011,253,34,219,7
"82305","S01013164",2011,485,198,287,15
"82306","S01013165",2011,412,123,289,15
"82307","S01013166",2011,387,317,70,19
"82308","S01013167",2011,383,309,74,9
"82309","S01013168",2011,408,180,228,23
"82310","S01013169",2011,436,207,229,16
"82311","S01013170",2011,265,145,120,15
"82312","S01013171",2011,249,49,200,10
"82313","S01013172",2011,319,105,214,15
"82314","S01013173",2011,358,60,298,37
"82315","S01013174",2011,284,11,273,4
"82316","S01013175",2011,343,44,299,17
"82317","S01013176",2011,411,81,330,40
"82318","S01013177",2011,290,16,274,22
"82319","S01013178",2011,346,49,297,41
"82320","S01013179",2011,363,89,274,23
"82321","S01013180",2011,170,2,168,17
"82322","S01013181",2011,310,44,266,11
"82323","S01013182",2011,372,118,254,23
"82324","S01013183",2011,334,56,278,4
"82325","S01013184",2011,279,181,98,20
"82326","S01013185",2011,362,166,196,9
"82327","S01013186",2011,292,159,133,11
"82328","S01013187",2011,386,198,188,9
"82329","S01013188",2011,348,61,287,15
"82330","S01013189",2011,238,24,214,7
"82331","S01013190",2011,367,135,232,19
"82332","S01013191",2011,386,7,379,8
"82333","S01013192",2011,417,58,359,40
"82334","S01013193",2011,356,29,327,63
"82335","S01013194",2011,319,26,293,82
"82336","S01013195",2011,597,137,460,155
"82337","S01013196",2011,371,17,354,76
"82338","S01013197",2011,262,48,214,16
"82339","S01013198",2011,379,132,247,32
"82340","S01013199",2011,488,188,300,40
"82341","S01013200",2011,313,127,186,15
"82342","S01013201",2011,380,267,113,3
"82343","S01013202",2011,235,121,114,9
"82344","S01013203",2011,355,166,189,18
"82345","S01013204",2011,332,41,291,27
"82346","S01013205",2011,240,140,100,8
"82347","S01013206",2011,298,134,164,18
"82348","S01013207",2011,390,158,232,33
"82349","S01013208",2011,436,241,195,34
"82350","S01013209",2011,435,111,324,64
"82351","S01013210",2011,253,7,246,18
"82352","S01013211",2011,411,90,321,26
"82353","S01013212",2011,192,4,188,6
"82354","S01013213",2011,197,4,193,5
"82355","S01013214",2011,159,2,157,4
"82356","S01013215",2011,385,63,322,56
"82357","S01013216",2011,237,99,138,18
"82358","S01013217",2011,279,86,193,16
"82359","S01013218",2011,251,133,118,24
"82360","S01013219",2011,220,117,103,12
"82361","S01013220",2011,313,141,172,18
"82362","S01013221",2011,382,175,207,24
"82363","S01013222",2011,316,205,111,19
"82364","S01013223",2011,637,292,345,71
"82365","S01013224",2011,370,128,242,13
"82366","S01013225",2011,315,159,156,10
"82367","S01013226",2011,207,25,182,15
"82368","S01013227",2011,366,222,144,10
"82369","S01013228",2011,416,83,333,101
"82370","S01013229",2011,370,147,223,25
"82371","S01013230",2011,327,102,225,22
"82372","S01013231",2011,374,152,222,31
"82373","S01013232",2011,331,109,222,24
"82374","S01013233",2011,262,43,219,18
"82375","S01013234",2011,137,7,130,3
"82376","S01013235",2011,386,64,322,43
"82377","S01013236",2011,381,44,337,9
"82378","S01013237",2011,360,62,298,24
"82379","S01013238",2011,389,239,150,18
"82380","S01013239",2011,425,228,197,22
"82381","S01013240",2011,256,169,87,10
"82382","S01013241",2011,336,9,327,8
"82383","S01013242",2011,229,18,211,18
"82384","S01013243",2011,325,122,203,31
"82385","S01013244",2011,351,155,196,32
"82386","S01013245",2011,407,89,318,25
"82387","S01013246",2011,184,43,141,12
"82388","S01013247",2011,338,142,196,38
"82389","S01013248",2011,300,151,149,25
"82390","S01013249",2011,201,49,152,13
"82391","S01013250",2011,339,77,262,32
"82392","S01013251",2011,319,196,123,32
"82393","S01013252",2011,288,110,178,19
"82394","S01013253",2011,316,77,239,39
"82395","S01013254",2011,297,171,126,14
"82396","S01013255",2011,345,115,230,16
"82397","S01013256",2011,322,75,247,54
"82398","S01013257",2011,419,164,255,36
"82399","S01013258",2011,312,32,280,18
"82400","S01013259",2011,361,95,266,47
"82401","S01013260",2011,382,182,200,29
"82402","S01013261",2011,345,143,202,21
"82403","S01013262",2011,276,91,185,15
"82404","S01013263",2011,195,3,192,19
"82405","S01013264",2011,163,0,0,8
"82406","S01013265",2011,201,3,198,2
"82407","S01013266",2011,189,1,188,10
"82408","S01013267",2011,237,106,131,10
"82409","S01013268",2011,328,52,276,22
"82410","S01013269",2011,379,14,365,57
"82411","S01013270",2011,285,2,283,7
"82412","S01013271",2011,242,0,0,9
"82413","S01013272",2011,253,5,248,10
"82414","S01013273",2011,291,3,288,10
"82415","S01013274",2011,348,2,346,40
"82416","S01013275",2011,253,1,252,21
"82417","S01013276",2011,233,4,229,21
"82418","S01013277",2011,363,93,270,44
"82419","S01013278",2011,322,127,195,38
"82420","S01013279",2011,299,144,155,29
"82421","S01013280",2011,227,23,204,22
"82422","S01013281",2011,384,120,264,51
"82423","S01013282",2011,346,169,177,43
"82424","S01013283",2011,310,78,232,119
"82425","S01013284",2011,301,7,294,41
"82426","S01013285",2011,269,6,263,37
"82427","S01013286",2011,284,7,277,23
"82428","S01013287",2011,282,5,277,10
"82429","S01013288",2011,315,66,249,29
"82430","S01013289",2011,303,8,295,26
"82431","S01013290",2011,361,47,314,38
"82432","S01013291",2011,257,13,244,12
"82433","S01013292",2011,284,9,275,21
"82434","S01013293",2011,273,1,272,6
"82435","S01013294",2011,306,42,264,20
"82436","S01013295",2011,324,9,315,34
"82437","S01013296",2011,310,128,182,13
"82438","S01013297",2011,308,64,244,28
"82439","S01013298",2011,310,49,261,48
"82440","S01013299",2011,424,104,320,28
"82441","S01013300",2011,264,76,188,21
"82442","S01013301",2011,217,63,154,24
"82443","S01013302",2011,270,26,244,24
"82444","S01013303",2011,384,64,320,22
"82445","S01013304",2011,422,207,215,46
"82446","S01013305",2011,444,141,303,74
"82447","S01013306",2011,501,366,135,46
"82448","S01013307",2011,436,230,206,54
"82449","S01013308",2011,374,264,110,22
"82450","S01013309",2011,236,14,222,55
"82451","S01013310",2011,241,62,179,21
"82452","S01013311",2011,313,90,223,47
"82453","S01013312",2011,486,177,309,52
"82454","S01013313",2011,276,81,195,39
"82455","S01013314",2011,304,112,192,32
"82456","S01013315",2011,174,2,172,9
"82457","S01013316",2011,273,36,237,12
"82458","S01013317",2011,257,2,255,32
"82459","S01013318",2011,245,6,239,30
"82460","S01013319",2011,209,50,159,14
"82461","S01013320",2011,357,16,341,54
"82462","S01013321",2011,223,93,130,21
"82463","S01013322",2011,267,65,202,22
"82464","S01013323",2011,416,180,236,35
"82465","S01013324",2011,275,154,121,16
"82466","S01013325",2011,353,285,68,11
"82467","S01013326",2011,218,92,126,25
"82468","S01013327",2011,269,129,140,26
"82469","S01013328",2011,236,113,123,28
"82470","S01013329",2011,228,68,160,24
"82471","S01013330",2011,430,30,400,108
"82472","S01013331",2011,248,7,241,68
"82473","S01013332",2011,285,77,208,30
"82474","S01013333",2011,327,36,291,35
"82475","S01013334",2011,294,110,184,26
"82476","S01013335",2011,294,173,121,15
"82477","S01013336",2011,339,196,143,37
"82478","S01013337",2011,365,34,331,24
"82479","S01013338",2011,165,0,0,17
"82480","S01013339",2011,233,4,229,33
"82481","S01013340",2011,335,4,331,20
"82482","S01013341",2011,388,13,375,78
"82483","S01013342",2011,286,125,161,27
"82484","S01013343",2011,276,89,187,22
"82485","S01013344",2011,356,203,153,20
"82486","S01013345",2011,298,97,201,34
"82487","S01013346",2011,282,28,254,28
"82488","S01013347",2011,332,17,315,51
"82489","S01013348",2011,169,3,166,16
"82490","S01013349",2011,359,35,324,179
"82491","S01013350",2011,285,122,163,36
"82492","S01013351",2011,320,45,275,32
"82493","S01013352",2011,355,66,289,37
"82494","S01013353",2011,283,120,163,16
"82495","S01013354",2011,318,53,265,23
"82496","S01013355",2011,274,72,202,21
"82497","S01013356",2011,323,165,158,23
"82498","S01013357",2011,346,71,275,15
"82499","S01013358",2011,382,121,261,29
"82500","S01013359",2011,298,147,151,18
"82501","S01013360",2011,299,113,186,20
"82502","S01013361",2011,280,157,123,20
"82503","S01013362",2011,220,71,149,14
"82504","S01013363",2011,390,226,164,29
"82505","S01013364",2011,366,98,268,14
"82506","S01013365",2011,367,7,360,62
"82507","S01013366",2011,348,54,294,14
"82508","S01013367",2011,221,37,184,11
"82509","S01013368",2011,284,45,239,20
"82510","S01013369",2011,420,195,225,43
"82511","S01013370",2011,298,175,123,8
"82512","S01013371",2011,327,130,197,16
"82513","S01013372",2011,489,317,172,24
"82514","S01013373",2011,451,181,270,35
"82515","S01013374",2011,453,240,213,63
"82516","S01013375",2011,262,96,166,15
"82517","S01013376",2011,272,85,187,36
"82518","S01013377",2011,377,115,262,35
"82519","S01013378",2011,426,163,263,23
"82520","S01013379",2011,345,93,252,26
"82521","S01013380",2011,36,3,33,3
"82522","S01013381",2011,211,73,138,7
"82523","S01013382",2011,225,39,186,12
"82524","S01013383",2011,353,169,184,22
"82525","S01013384",2011,337,123,214,32
"82526","S01013385",2011,217,40,177,14
"82527","S01013386",2011,335,36,299,7
"82528","S01013387",2011,265,118,147,8
"82529","S01013388",2011,382,116,266,40
"82530","S01013389",2011,347,98,249,28
"82531","S01013390",2011,210,60,150,9
"82532","S01013391",2011,173,31,142,13
"82533","S01013392",2011,270,3,267,26
"82534","S01013393",2011,324,135,189,24
"82535","S01013394",2011,288,127,161,20
"82536","S01013395",2011,352,257,95,22
"82537","S01013396",2011,255,5,250,26
"82538","S01013397",2011,376,115,261,28
"82539","S01013398",2011,183,8,175,5
"82540","S01013399",2011,399,43,356,23
"82541","S01013400",2011,314,88,226,54
"82542","S01013401",2011,324,36,288,31
"82543","S01013402",2011,429,5,424,80
"82544","S01013403",2011,332,26,306,66
"82545","S01013404",2011,211,35,176,41
"82546","S01013405",2011,329,77,252,31
"82547","S01013406",2011,270,124,146,25
"82548","S01013407",2011,259,98,161,23
"82549","S01013408",2011,302,151,151,26
"82550","S01013409",2011,428,135,293,46
"82551","S01013410",2011,290,217,73,17
"82552","S01013411",2011,333,64,269,75
"82553","S01013412",2011,364,115,249,37
"82554","S01013413",2011,336,68,268,35
"82555","S01013414",2011,484,138,346,140
"82556","S01013415",2011,385,223,162,41
"82557","S01013416",2011,276,124,152,23
"82558","S01013417",2011,442,155,287,93
"82559","S01013418",2011,256,80,176,26
"82560","S01013419",2011,187,6,181,5
"82561","S01013420",2011,265,49,216,28
"82562","S01013421",2011,278,32,246,13
"82563","S01013422",2011,303,101,202,15
"82564","S01013423",2011,332,65,267,16
"82565","S01013424",2011,188,13,175,16
"82566","S01013425",2011,199,30,169,26
"82567","S01013426",2011,368,134,234,38
"82568","S01013427",2011,171,8,163,33
"82569","S01013428",2011,379,171,208,36
"82570","S01013429",2011,300,71,229,32
"82571","S01013430",2011,277,43,234,17
"82572","S01013431",2011,304,124,180,16
"82573","S01013432",2011,293,77,216,22
"82574","S01013433",2011,309,47,262,15
"82575","S01013434",2011,207,12,195,20
"82576","S01013435",2011,221,5,216,10
"82577","S01013436",2011,339,109,230,13
"82578","S01013437",2011,308,72,236,55
"82579","S01013438",2011,285,76,209,68
"82580","S01013439",2011,351,4,347,12
"82581","S01013440",2011,378,10,368,3
"82582","S01013441",2011,317,8,309,35
"82583","S01013442",2011,328,26,302,35
"82584","S01013443",2011,295,14,281,51
"82585","S01013444",2011,520,156,364,101
"82586","S01013445",2011,252,35,217,8
"82587","S01013446",2011,309,56,253,26
"82588","S01013447",2011,198,3,195,15
"82589","S01013448",2011,390,13,377,38
"82590","S01013449",2011,273,3,270,13
"82591","S01013450",2011,249,1,248,34
"82592","S01013451",2011,296,5,291,10
"82593","S01013452",2011,300,6,294,32
"82594","S01013453",2011,344,201,143,16
"82595","S01013454",2011,317,30,287,29
"82596","S01013455",2011,262,36,226,72
"82597","S01013456",2011,372,127,245,30
"82598","S01013457",2011,384,141,243,24
"82599","S01013458",2011,333,61,272,30
"82600","S01013459",2011,421,129,292,54
"82601","S01013460",2011,346,113,233,14
"82602","S01013461",2011,443,128,315,43
"82603","S01013462",2011,354,39,315,35
"82604","S01013463",2011,216,92,124,15
"82605","S01013464",2011,323,28,295,24
"82606","S01013465",2011,337,37,300,22
"82607","S01013466",2011,116,9,107,10
"82608","S01013467",2011,364,22,342,17
"82609","S01013468",2011,312,109,203,38
"82610","S01013469",2011,329,21,308,15
"82611","S01013470",2011,321,137,184,34
"82612","S01013471",2011,383,128,255,17
"82613","S01013472",2011,208,7,201,14
"82614","S01013473",2011,213,5,208,10
"82615","S01013474",2011,238,10,228,25
"82616","S01013475",2011,246,15,231,18
"82617","S01013476",2011,271,52,219,20
"82618","S01013477",2011,303,110,193,35
"82619","S01013478",2011,358,88,270,46
"82620","S01013479",2011,428,182,246,57
"82621","S01013480",2011,302,76,226,21
"82622","S01013481",2011,189,27,162,12
"82623","Crown copyright 2013",2011,0,0,0,0
"82624","For further information on variables, see www.scotlandscensus.gov.uk/variables",2011,0,0,0,0
"82625","In order to protect against disclosure of personal information, some records have been swapped between different geographic areas.  Some cell values will be affected, particularly small values at the most detailed geographies.",2011,0,0,0,0
